,LAUS Code,State FIPS Code,County FIPS Code,County Name/State Abbreviation,Period,Labor Force,Employed,Unemployed,Unemployment Rate (%)
0,CN0100100000000,01,1,"Autauga County, AL",Mar-19,26255,25424,831,3.2
1,CN0100300000000,01,3,"Baldwin County, AL",Mar-19,97617,94468,3149,3.2
2,CN0100500000000,01,5,"Barbour County, AL",Mar-19,8426,8069,357,4.2
3,CN0100700000000,01,7,"Bibb County, AL",Mar-19,8694,8384,310,3.6
4,CN0100900000000,01,9,"Blount County, AL",Mar-19,25331,24538,793,3.1
5,CN0101100000000,01,11,"Bullock County, AL",Mar-19,4800,4628,172,3.6
6,CN0101300000000,01,13,"Butler County, AL",Mar-19,9190,8826,364,4.0
7,CN0101500000000, ,15,"Calhoun County, AL",Mar-19,46300,44442,1858,4.0
8,CN0101700000000,01,17,"Chambers County, AL",Mar-19,15763,15226,537,3.4
9,CN0101900000000,01,19,"Cherokee County, AL",Mar-19,11733,11345,388,3.3
10,CN0102100000000,01,21,"Chilton County, AL",Mar-19,19813,19194,619,3.1
11,CN0102300000000,01,23,"Choctaw County, AL",Mar-19,4905,4668,237,4.8
12,CN0102500000000,01,25,"Clarke County, AL",Mar-19,7640,7183,457,6.0
13,CN0102700000000,01,27,"Clay County, AL",Mar-19,6112,5906,206,3.4
14,CN0102900000000,01,29,"Cleburne County, AL",Mar-19,5818,5597,221,3.8
15,CN0103100000000,01,31,"Coffee County, AL",Mar-19,21534,20804,730,3.4
16,CN0103300000000,01,33,"Colbert County, AL",Mar-19,23709,22724,985,4.2
17,CN0103500000000,01,35,"Conecuh County, AL",Mar-19,4544,4337,207,4.6
18,CN0103700000000,01,37,"Coosa County, AL",Mar-19,4554,4396,158,3.5
19,CN0103900000000,01,39,"Covington County, AL",Mar-19,15731,15112,619,3.9
20,CN0104100000000,01,41,"Crenshaw County, AL",Mar-19,6490,6264,226,3.5
21,CN0104300000000,01,43,"Cullman County, AL",Mar-19,38907,37714,1193,3.1
22,CN0104500000000,01,45,"Dale County, AL",Mar-19,20827,20064,763,3.7
23,CN0104700000000,01,47,"Dallas County, AL",Mar-19,14893,14028,865,5.8
24,CN0104900000000,01,49,"DeKalb County, AL",Mar-19,31078,30026,1052,3.4
25,CN0105100000000,01,51,"Elmore County, AL",Mar-19,37670,36540,1130,3.0
26,CN0105300000000,01,53,"Escambia County, AL",Mar-19,14846,14283,563,3.8
27,CN0105500000000,01,55,"Etowah County, AL",Mar-19,43087,41434,1653,3.8
28,CN0105700000000,01,57,"Fayette County, AL",Mar-19,6588,6356,232,3.5
29,CN0105900000000,01,59,"Franklin County, AL",Mar-19,14646,14173,473,3.2
30,CN0106100000000,01,61,"Geneva County, AL",Mar-19,11080,10705,375,3.4
31,CN0106300000000,01,63,"Greene County, AL",Mar-19,2854,2699,155,5.4
32,CN0106500000000,01,65,"Hale County, AL",Mar-19,6091,5838,253,4.2
33,CN0106700000000,01,67,"Henry County, AL",Mar-19,6982,6688,294,4.2
34,CN0106900000000,01,69,"Houston County, AL",Mar-19,46447,44834,1613,3.5
35,CN0107100000000,01,71,"Jackson County, AL",Mar-19,23817,22892,925,3.9
36,CN0107300000000,01,73,"Jefferson County, AL",Mar-19,318826,308404,10422,3.3
37,CN0107500000000,01,75,"Lamar County, AL",Mar-19,5827,5623,204,3.5
38,CN0107700000000,01,77,"Lauderdale County, AL",Mar-19,42587,41081,1506,3.5
39,CN0107900000000,01,79,"Lawrence County, AL",Mar-19,14326,13819,507,3.5
40,CN0108100000000,01,81,"Lee County, AL",Mar-19,76430,73908,2522,3.3
41,CN0108300000000,01,83,"Limestone County, AL",Mar-19,43933,42577,1356,3.1
42,CN0108500000000,01,85,"Lowndes County, AL",Mar-19,3601,3379,222,6.2
43,CN0108700000000,01,87,"Macon County, AL",Mar-19,7814,7434,380,4.9
44,CN0108900000000,01,89,"Madison County, AL",Mar-19,185552,180020,5532,3.0
45,CN0109100000000,01,91,"Marengo County, AL",Mar-19,7754,7446,308,4.0
46,CN0109300000000,01,93,"Marion County, AL",Mar-19,12967,12459,508,3.9
47,CN0109500000000,01,95,"Marshall County, AL",Mar-19,43974,42676,1298,3.0
48,CN0109700000000,01,97,"Mobile County, AL",Mar-19,189946,182035,7911,4.2
49,CN0109900000000,01,99,"Monroe County, AL",Mar-19,7286,6900,386,5.3
50,CN0110100000000,01,101,"Montgomery County, AL",Mar-19,106155,102427,3728,3.5
51,CN0110300000000,01,103,"Morgan County, AL",Mar-19,58362,56634,1728,3.0
52,CN0110500000000,01,105,"Perry County, AL",Mar-19,3419,3237,182,5.3
53,CN0110700000000,01,107,"Pickens County, AL",Mar-19,7910,7598,312,3.9
54,CN0110900000000,01,109,"Pike County, AL",Mar-19,15401,14830,571,3.7
55,CN0111100000000,01,111,"Randolph County, AL",Mar-19,9672,9319,353,3.6
56,CN0111300000000,01,113,"Russell County, AL",Mar-19,24205,23395,810,3.3
57,CN0111500000000,01,115,"St. Clair County, AL",Mar-19,40538,39271,1267,3.1
58,CN0111700000000,01,117,"Shelby County, AL",Mar-19,115923,112944,2979,2.6
59,CN0111900000000,01,119,"Sumter County, AL",Mar-19,4822,4584,238,4.9
60,CN0112100000000,01,121,"Talladega County, AL",Mar-19,35966,34633,1333,3.7
61,CN0112300000000,01,123,"Tallapoosa County, AL",Mar-19,18523,17864,659,3.6
62,CN0112500000000,01,125,"Tuscaloosa County, AL",Mar-19,104769,101520,3249,3.1
63,CN0112700000000,01,127,"Walker County, AL",Mar-19,25355,24404,951,3.8
64,CN0112900000000,01,129,"Washington County, AL",Mar-19,6881,6535,346,5.0
65,CN0113100000000,01,131,"Wilcox County, AL",Mar-19,2738,2528,210,7.7
66,CN0113300000000,01,133,"Winston County, AL",Mar-19,9949,9573,376,3.8
67,CN0201300000000,02,13,"Aleutians East Borough, AK",Mar-19,2841,2775,66,2.3
68,CN0201600000000,02,16,"Aleutians West Census Area, AK",Mar-19,4560,4434,126,2.8
69,CN0202000000000,02,20,"Anchorage Borough/municipality, AK",Mar-19,146913,138995,7918,5.4
70,CN0205000000000,02,50,"Bethel Census Area, AK",Mar-19,6922,5999,923,13.3
71,CN0206000000000,02,60,"Bristol Bay Borough, AK",Mar-19,243,210,33,13.6
72,CN0206800000000,02,68,"Denali Borough, AK",Mar-19,593,481,112,18.9
73,CN0207000000000,02,70,"Dillingham Census Area, AK",Mar-19,1835,1657,178,9.7
74,CN0209000000000,02,90,"Fairbanks North Star Borough, AK",Mar-19,44388,41714,2674,6.0
75,CN0210000000000,02,100,"Haines Borough, AK",Mar-19,929,800,129,13.9
76,CN0210500000000,02,105,"Hoonah-Angoon Census Area, AK",Mar-19,1007,822,185,18.4
77,CN0211000000000,02,110,"Juneau Borough/city, AK",Mar-19,16519,15658,861,5.2
78,CN0212200000000,02,122,"Kenai Peninsula Borough, AK",Mar-19,25347,23313,2034,8.0
79,CN0213000000000,02,130,"Ketchikan Gateway Borough, AK",Mar-19,6305,5825,480,7.6
80,CN0215000000000,02,150,"Kodiak Island Borough, AK",Mar-19,6071,5757,314,5.2
81,CN0215800000000,02,158,"Kusilvak Census Area, AK",Mar-19,2754,2183,571,20.7
82,CN0216400000000,02,164,"Lake and Peninsula Borough, AK",Mar-19,633,548,85,13.4
83,CN0217000000000,02,170,"Matanuska-Susitna Borough, AK",Mar-19,47202,43537,3665,7.8
84,CN0218000000000,02,180,"Nome Census Area, AK",Mar-19,4056,3593,463,11.4
85,CN0218500000000,02,185,"North Slope Borough, AK",Mar-19,3673,3449,224,6.1
86,CN0218800000000,02,188,"Northwest Arctic Borough, AK",Mar-19,2827,2440,387,13.7
87,CN0219500000000,02,195,"Petersburg Borough, AK",Mar-19,1326,1175,151,11.4
88,CN0219800000000,02,198,"Prince of Wales-Hyder Census Area, AK",Mar-19,2830,2460,370,13.1
89,CN0222000000000,02,220,"Sitka Borough/city, AK",Mar-19,4113,3925,188,4.6
90,CN0223000000000,02,230,"Skagway Municipality, AK",Mar-19,596,492,104,17.4
91,CN0224000000000,02,240,"Southeast Fairbanks Census Area, AK",Mar-19,2731,2442,289,10.6
92,CN0226100000000,02,261,"Valdez-Cordova Census Area, AK",Mar-19,4208,3808,400,9.5
93,CN0227500000000,02,275,"Wrangell Borough/city, AK",Mar-19,948,861,87,9.2
94,CN0228200000000,02,282,"Yakutat Borough/city, AK",Mar-19,214,189,25,11.7
95,CN0229000000000,02,290,"Yukon-Koyukuk Census Area, AK",Mar-19,2479,2064,415,16.7
96,CN0400100000000,04,1,"Apache County, AZ",Mar-19,20724,18654,2070,10.0
97,CN0400300000000,04,3,"Cochise County, AZ",Mar-19,50888,47900,2988,5.9
98,CN0400500000000,04,5,"Coconino County, AZ",Mar-19,76714,72173,4541,5.9
99,CN0400700000000,04,7,"Gila County, AZ",Mar-19,21680,20464,1216,5.6
100,CN0400900000000,04,9,"Graham County, AZ",Mar-19,15563,14783,780,5.0
101,CN0401100000000,04,11,"Greenlee County, AZ",Mar-19,4453,4269,184,4.1
102,CN0401200000000,04,12,"La Paz County, AZ",Mar-19,9705,9109,596,6.1
103,CN0401300000000,04,13,"Maricopa County, AZ",Mar-19,2283827,2188827,95000,4.2
104,CN0401500000000,04,15,"Mohave County, AZ",Mar-19,86827,81819,5008,5.8
105,CN0401700000000,04,17,"Navajo County, AZ",Mar-19,40780,37562,3218,7.9
106,CN0401900000000,04,19,"Pima County, AZ",Mar-19,497331,475077,22254,4.5
107,CN0402100000000,04,21,"Pinal County, AZ",Mar-19,186693,177398,9295,5.0
108,CN0402300000000,04,23,"Santa Cruz County, AZ",Mar-19,19999,18480,1519,7.6
109,CN0402500000000,04,25,"Yavapai County, AZ",Mar-19,105992,101216,4776,4.5
110,CN0402700000000,04,27,"Yuma County, AZ",Mar-19,99841,87403,12438,12.5
111,CN0500100000000,05,1,"Arkansas County, AR",Mar-19,9347,9045,302,3.2
112,CN0500300000000,05,3,"Ashley County, AR",Mar-19,7761,7321,440,5.7
113,CN0500500000000,05,5,"Baxter County, AR",Mar-19,16288,15596,692,4.2
114,CN0500700000000,05,7,"Benton County, AR",Mar-19,136211,132674,3537,2.6
115,CN0500900000000,05,9,"Boone County, AR",Mar-19,16112,15594,518,3.2
116,CN0501100000000,05,11,"Bradley County, AR",Mar-19,4460,4260,200,4.5
117,CN0501300000000,05,13,"Calhoun County, AR",Mar-19,2434,2313,121,5.0
118,CN0501500000000,05,15,"Carroll County, AR",Mar-19,12410,11991,419,3.4
119,CN0501700000000,05,17,"Chicot County, AR",Mar-19,3231,2989,242,7.5
120,CN0501900000000,05,19,"Clark County, AR",Mar-19,9701,9406,295,3.0
121,CN0502100000000,05,21,"Clay County, AR",Mar-19,5641,5349,292,5.2
122,CN0502300000000,05,23,"Cleburne County, AR",Mar-19,9184,8759,425,4.6
123,CN0502500000000,05,25,"Cleveland County, AR",Mar-19,3200,3070,130,4.1
124,CN0502700000000,05,27,"Columbia County, AR",Mar-19,9178,8792,386,4.2
125,CN0502900000000,05,29,"Conway County, AR",Mar-19,8211,7879,332,4.0
126,CN0503100000000,05,31,"Craighead County, AR",Mar-19,55107,53612,1495,2.7
127,CN0503300000000,05,33,"Crawford County, AR",Mar-19,26789,25924,865,3.2
128,CN0503500000000,05,35,"Crittenden County, AR",Mar-19,21202,20331,871,4.1
129,CN0503700000000,05,37,"Cross County, AR",Mar-19,7289,6975,314,4.3
130,CN0503900000000,05,39,"Dallas County, AR",Mar-19,2841,2703,138,4.9
131,CN0504100000000,05,41,"Desha County, AR",Mar-19,5369,5133,236,4.4
132,CN0504300000000,05,43,"Drew County, AR",Mar-19,7864,7425,439,5.6
133,CN0504500000000,05,45,"Faulkner County, AR",Mar-19,62445,60632,1813,2.9
134,CN0504700000000,05,47,"Franklin County, AR",Mar-19,7408,7176,232,3.1
135,CN0504900000000,05,49,"Fulton County, AR",Mar-19,4916,4720,196,4.0
136,CN0505100000000,05,51,"Garland County, AR",Mar-19,41557,40059,1498,3.6
137,CN0505300000000,05,53,"Grant County, AR",Mar-19,8369,8117,252,3.0
138,CN0505500000000,05,55,"Greene County, AR",Mar-19,20059,19387,672,3.4
139,CN0505700000000,05,57,"Hempstead County, AR",Mar-19,9983,9607,376,3.8
140,CN0505900000000,05,59,"Hot Spring County, AR",Mar-19,13970,13465,505,3.6
141,CN0506100000000,05,61,"Howard County, AR",Mar-19,5708,5528,180,3.2
142,CN0506300000000,05,63,"Independence County, AR",Mar-19,16649,16042,607,3.6
143,CN0506500000000,05,65,"Izard County, AR",Mar-19,4945,4695,250,5.1
144,CN0506700000000,05,67,"Jackson County, AR",Mar-19,5795,5434,361,6.2
145,CN0506900000000,05,69,"Jefferson County, AR",Mar-19,27719,26261,1458,5.3
146,CN0507100000000,05,71,"Johnson County, AR",Mar-19,10436,9975,461,4.4
147,CN0507300000000,05,73,"Lafayette County, AR",Mar-19,2473,2362,111,4.5
148,CN0507500000000,05,75,"Lawrence County, AR",Mar-19,6817,6555,262,3.8
149,CN0507700000000,05,77,"Lee County, AR",Mar-19,2788,2657,131,4.7
150,CN0507900000000,05,79,"Lincoln County, AR",Mar-19,3921,3743,178,4.5
151,CN0508100000000,05,81,"Little River County, AR",Mar-19,5483,5250,233,4.2
152,CN0508300000000,05,83,"Logan County, AR",Mar-19,8552,8212,340,4.0
153,CN0508500000000,05,85,"Lonoke County, AR",Mar-19,34318,33288,1030,3.0
154,CN0508700000000,05,87,"Madison County, AR",Mar-19,7277,7103,174,2.4
155,CN0508900000000,05,89,"Marion County, AR",Mar-19,6636,6363,273,4.1
156,CN0509100000000,05,91,"Miller County, AR",Mar-19,19666,18841,825,4.2
157,CN0509300000000,05,93,"Mississippi County, AR",Mar-19,17223,16411,812,4.7
158,CN0509500000000,05,95,"Monroe County, AR",Mar-19,2748,2629,119,4.3
159,CN0509700000000,05,97,"Montgomery County, AR",Mar-19,2931,2794,137,4.7
160,CN0509900000000,05,99,"Nevada County, AR",Mar-19,3678,3548,130,3.5
161,CN0510100000000,05,101,"Newton County, AR",Mar-19,3334,3213,121,3.6
162,CN0510300000000,05,103,"Ouachita County, AR",Mar-19,9833,9292,541,5.5
163,CN0510500000000,05,105,"Perry County, AR",Mar-19,4276,4090,186,4.3
164,CN0510700000000,05,107,"Phillips County, AR",Mar-19,6453,6070,383,5.9
165,CN0510900000000,05,109,"Pike County, AR",Mar-19,4205,4051,154,3.7
166,CN0511100000000,05,111,"Poinsett County, AR",Mar-19,10097,9766,331,3.3
167,CN0511300000000,05,113,"Polk County, AR",Mar-19,8012,7717,295,3.7
168,CN0511500000000,05,115,"Pope County, AR",Mar-19,28937,27774,1163,4.0
169,CN0511700000000,05,117,"Prairie County, AR",Mar-19,3519,3371,148,4.2
170,CN0511900000000,05,119,"Pulaski County, AR",Mar-19,190490,184185,6305,3.3
171,CN0512100000000,05,121,"Randolph County, AR",Mar-19,7227,6946,281,3.9
172,CN0512300000000,05,123,"St. Francis County, AR",Mar-19,8142,7692,450,5.5
173,CN0512500000000,05,125,"Saline County, AR",Mar-19,59196,57577,1619,2.7
174,CN0512700000000,05,127,"Scott County, AR",Mar-19,4291,4146,145,3.4
175,CN0512900000000,05,129,"Searcy County, AR",Mar-19,2857,2719,138,4.8
176,CN0513100000000,05,131,"Sebastian County, AR",Mar-19,56510,54723,1787,3.2
177,CN0513300000000,05,133,"Sevier County, AR",Mar-19,5403,5150,253,4.7
178,CN0513500000000,05,135,"Sharp County, AR",Mar-19,5808,5539,269,4.6
179,CN0513700000000,05,137,"Stone County, AR",Mar-19,4736,4497,239,5.0
180,CN0513900000000,05,139,"Union County, AR",Mar-19,15915,15108,807,5.1
181,CN0514100000000,05,141,"Van Buren County, AR",Mar-19,5726,5438,288,5.0
182,CN0514300000000,05,143,"Washington County, AR",Mar-19,124010,121081,2929,2.4
183,CN0514500000000,05,145,"White County, AR",Mar-19,34037,32430,1607,4.7
184,CN0514700000000,05,147,"Woodruff County, AR",Mar-19,2725,2578,147,5.4
185,CN0514900000000,05,149,"Yell County, AR",Mar-19,8386,8046,340,4.1
186,CN0600100000000,06,1,"Alameda County, CA",Mar-19,846106,819509,26597,3.1
187,CN0600300000000,06,3,"Alpine County, CA",Mar-19,670,640,30,4.5
188,CN0600500000000,06,5,"Amador County, CA",Mar-19,14742,14062,680,4.6
189,CN0600700000000,06,7,"Butte County, CA",Mar-19,100421,94271,6150,6.1
190,CN0600900000000,06,9,"Calaveras County, CA",Mar-19,21090,20120,970,4.6
191,CN0601100000000,06,11,"Colusa County, CA",Mar-19,11009,8801,2208,20.1
192,CN0601300000000,06,13,"Contra Costa County, CA",Mar-19,563308,544394,18914,3.4
193,CN0601500000000,06,15,"Del Norte County, CA",Mar-19,9655,9056,599,6.2
194,CN0601700000000,06,17,"El Dorado County, CA",Mar-19,92355,88572,3783,4.1
195,CN0601900000000,06,19,"Fresno County, CA",Mar-19,450465,410151,40314,8.9
196,CN0602100000000,06,21,"Glenn County, CA",Mar-19,13048,12052,996,7.6
197,CN0602300000000,06,23,"Humboldt County, CA",Mar-19,62962,60380,2582,4.1
198,CN0602500000000,06,25,"Imperial County, CA",Mar-19,71080,59311,11769,16.6
199,CN0602700000000,06,27,"Inyo County, CA",Mar-19,8697,8310,387,4.4
200,CN0602900000000,06,29,"Kern County, CA",Mar-19,383237,346556,36681,9.6
201,CN0603100000000,06,31,"Kings County, CA",Mar-19,58193,52463,5730,9.8
202,CN0603300000000,06,33,"Lake County, CA",Mar-19,29240,27506,1734,5.9
203,CN0603500000000,06,35,"Lassen County, CA",Mar-19,9831,9231,600,6.1
204,CN0603700000000,06,37,"Los Angeles County, CA",Mar-19,5116385,4886823,229562,4.5
205,CN0603900000000,06,39,"Madera County, CA",Mar-19,61899,56640,5259,8.5
206,CN0604100000000,06,41,"Marin County, CA",Mar-19,139556,136046,3510,2.5
207,CN0604300000000,06,43,"Mariposa County, CA",Mar-19,7395,6925,470,6.4
208,CN0604500000000,06,45,"Mendocino County, CA",Mar-19,39148,37212,1936,4.9
209,CN0604700000000,06,47,"Merced County, CA",Mar-19,117654,105568,12086,10.3
210,CN0604900000000,06,49,"Modoc County, CA",Mar-19,3073,2754,319,10.4
211,CN0605100000000,06,51,"Mono County, CA",Mar-19,8927,8586,341,3.8
212,CN0605300000000,06,53,"Monterey County, CA",Mar-19,215483,194300,21183,9.8
213,CN0605500000000,06,55,"Napa County, CA",Mar-19,73303,70888,2415,3.3
214,CN0605700000000,06,57,"Nevada County, CA",Mar-19,49116,47226,1890,3.8
215,CN0605900000000,06,59,"Orange County, CA",Mar-19,1625454,1576388,49066,3.0
216,CN0606100000000,06,61,"Placer County, CA",Mar-19,188249,181655,6594,3.5
217,CN0606300000000,06,63,"Plumas County, CA",Mar-19,7538,6617,921,12.2
218,CN0606500000000,06,65,"Riverside County, CA",Mar-19,1105024,1056716,48308,4.4
219,CN0606700000000,06,67,"Sacramento County, CA",Mar-19,713215,684390,28825,4.0
220,CN0606900000000,06,69,"San Benito County, CA",Mar-19,31632,29592,2040,6.4
221,CN0607100000000,06,71,"San Bernardino County, CA",Mar-19,968591,929215,39376,4.1
222,CN0607300000000,06,73,"San Diego County, CA",Mar-19,1590122,1535235,54887,3.5
223,CN0607500000000,06,75,"San Francisco County/city, CA",Mar-19,580288,566190,14098,2.4
224,CN0607700000000,06,77,"San Joaquin County, CA",Mar-19,327051,304728,22323,6.8
225,CN0607900000000,06,79,"San Luis Obispo County, CA",Mar-19,141534,137104,4430,3.1
226,CN0608100000000,06,81,"San Mateo County, CA",Mar-19,457709,447409,10300,2.3
227,CN0608300000000,06,83,"Santa Barbara County, CA",Mar-19,216468,206375,10093,4.7
228,CN0608500000000,06,85,"Santa Clara County, CA",Mar-19,1053571,1025058,28513,2.7
229,CN0608700000000,06,87,"Santa Cruz County, CA",Mar-19,141236,131932,9304,6.6
230,CN0608900000000,06,89,"Shasta County, CA",Mar-19,74448,70175,4273,5.7
231,CN0609100000000,06,91,"Sierra County, CA",Mar-19,1285,1186,99,7.7
232,CN0609300000000,06,93,"Siskiyou County, CA",Mar-19,16927,15359,1568,9.3
233,CN0609500000000,06,95,"Solano County, CA",Mar-19,209461,200540,8921,4.3
234,CN0609700000000,06,97,"Sonoma County, CA",Mar-19,258219,250315,7904,3.1
235,CN0609900000000,06,99,"Stanislaus County, CA",Mar-19,243865,226717,17148,7.0
236,CN0610100000000,06,101,"Sutter County, CA",Mar-19,45311,40793,4518,10.0
237,CN0610300000000,06,103,"Tehama County, CA",Mar-19,25458,23735,1723,6.8
238,CN0610500000000,06,105,"Trinity County, CA",Mar-19,4541,4186,355,7.8
239,CN0610700000000,06,107,"Tulare County, CA",Mar-19,202617,178824,23793,11.7
240,CN0610900000000,06,109,"Tuolumne County, CA",Mar-19,21308,20119,1189,5.6
241,CN0611100000000,06,111,"Ventura County, CA",Mar-19,425351,409123,16228,3.8
242,CN0611300000000,06,113,"Yolo County, CA",Mar-19,108859,103405,5454,5.0
243,CN0611500000000,06,115,"Yuba County, CA",Mar-19,29767,27571,2196,7.4
244,CN0800100000000,08,1,"Adams County, CO",Mar-19,271709,262346,9363,3.4
245,CN0800300000000,08,3,"Alamosa County, CO",Mar-19,8521,8150,371,4.4
246,CN0800500000000,08,5,"Arapahoe County, CO",Mar-19,363763,353022,10741,3.0
247,CN0800700000000,08,7,"Archuleta County, CO",Mar-19,6686,6420,266,4.0
248,CN0800900000000,08,9,"Baca County, CO",Mar-19,1991,1951,40,2.0
249,CN0801100000000,08,11,"Bent County, CO",Mar-19,1748,1686,62,3.5
250,CN0801300000000,08,13,"Boulder County, CO",Mar-19,196468,191347,5121,2.6
251,CN0801400000000,08,14,"Broomfield County/city, CO",Mar-19,39933,38857,1076,2.7
252,CN0801500000000,08,15,"Chaffee County, CO",Mar-19,9610,9346,264,2.7
253,CN0801700000000,08,17,"Cheyenne County, CO",Mar-19,1036,1018,18,1.7
254,CN0801900000000,08,19,"Clear Creek County, CO",Mar-19,6024,5863,161,2.7
255,CN0802100000000,08,21,"Conejos County, CO",Mar-19,3983,3790,193,4.8
256,CN0802300000000,08,23,"Costilla County, CO",Mar-19,1803,1712,91,5.0
257,CN0802500000000,08,25,"Crowley County, CO",Mar-19,1491,1420,71,4.8
258,CN0802700000000,08,27,"Custer County, CO",Mar-19,1994,1927,67,3.4
259,CN0802900000000,08,29,"Delta County, CO",Mar-19,13889,13265,624,4.5
260,CN0803100000000,08,31,"Denver County/city, CO",Mar-19,416191,403527,12664,3.0
261,CN0803300000000,08,33,"Dolores County, CO",Mar-19,1078,1031,47,4.4
262,CN0803500000000,08,35,"Douglas County, CO",Mar-19,193570,188471,5099,2.6
263,CN0803700000000,08,37,"Eagle County, CO",Mar-19,38788,37927,861,2.2
264,CN0803900000000,08,39,"Elbert County, CO",Mar-19,14887,14521,366,2.5
265,CN0804100000000,08,41,"El Paso County, CO",Mar-19,339580,326972,12608,3.7
266,CN0804300000000,08,43,"Fremont County, CO",Mar-19,15068,14266,802,5.3
267,CN0804500000000,08,45,"Garfield County, CO",Mar-19,33872,32771,1101,3.3
268,CN0804700000000,08,47,"Gilpin County, CO",Mar-19,3777,3676,101,2.7
269,CN0804900000000,08,49,"Grand County, CO",Mar-19,10436,10202,234,2.2
270,CN0805100000000,08,51,"Gunnison County, CO",Mar-19,11770,11493,277,2.4
271,CN0805300000000,08,53,"Hinsdale County, CO",Mar-19,388,375,13,3.4
272,CN0805500000000,08,55,"Huerfano County, CO",Mar-19,2477,2287,190,7.7
273,CN0805700000000,08,57,"Jackson County, CO",Mar-19,880,855,25,2.8
274,CN0805900000000,08,59,"Jefferson County, CO",Mar-19,334542,324972,9570,2.9
275,CN0806100000000,08,61,"Kiowa County, CO",Mar-19,850,835,15,1.8
276,CN0806300000000,08,63,"Kit Carson County, CO",Mar-19,3968,3892,76,1.9
277,CN0806500000000,08,65,"Lake County, CO",Mar-19,5247,5124,123,2.3
278,CN0806700000000,08,67,"La Plata County, CO",Mar-19,31851,30834,1017,3.2
279,CN0806900000000,08,69,"Larimer County, CO",Mar-19,202331,196844,5487,2.7
280,CN0807100000000,08,71,"Las Animas County, CO",Mar-19,6580,6283,297,4.5
281,CN0807300000000,08,73,"Lincoln County, CO",Mar-19,2341,2274,67,2.9
282,CN0807500000000,08,75,"Logan County, CO",Mar-19,10970,10679,291,2.7
283,CN0807700000000,08,77,"Mesa County, CO",Mar-19,76563,73578,2985,3.9
284,CN0807900000000,08,79,"Mineral County, CO",Mar-19,579,566,13,2.2
285,CN0808100000000,08,81,"Moffat County, CO",Mar-19,7551,7205,346,4.6
286,CN0808300000000,08,83,"Montezuma County, CO",Mar-19,12683,11930,753,5.9
287,CN0808500000000,08,85,"Montrose County, CO",Mar-19,21400,20516,884,4.1
288,CN0808700000000,08,87,"Morgan County, CO",Mar-19,15959,15465,494,3.1
289,CN0808900000000,08,89,"Otero County, CO",Mar-19,8209,7811,398,4.8
290,CN0809100000000,08,91,"Ouray County, CO",Mar-19,2278,2201,77,3.4
291,CN0809300000000,08,93,"Park County, CO",Mar-19,11161,10833,328,2.9
292,CN0809500000000,08,95,"Phillips County, CO",Mar-19,2305,2265,40,1.7
293,CN0809700000000,08,97,"Pitkin County, CO",Mar-19,11629,11368,261,2.2
294,CN0809900000000,08,99,"Prowers County, CO",Mar-19,6043,5867,176,2.9
295,CN0810100000000,08,101,"Pueblo County, CO",Mar-19,75855,72366,3489,4.6
296,CN0810300000000,08,103,"Rio Blanco County, CO",Mar-19,2941,2810,131,4.5
297,CN0810500000000,08,105,"Rio Grande County, CO",Mar-19,5064,4809,255,5.0
298,CN0810700000000,08,107,"Routt County, CO",Mar-19,17084,16699,385,2.3
299,CN0810900000000,08,109,"Saguache County, CO",Mar-19,3296,3148,148,4.5
300,CN0811100000000,08,111,"San Juan County, CO",Mar-19,501,479,22,4.4
301,CN0811300000000,08,113,"San Miguel County, CO",Mar-19,6314,6193,121,1.9
302,CN0811500000000,08,115,"Sedgwick County, CO",Mar-19,1123,1099,24,2.1
303,CN0811700000000,08,117,"Summit County, CO",Mar-19,25707,25302,405,1.6
304,CN0811900000000,08,119,"Teller County, CO",Mar-19,12769,12322,447,3.5
305,CN0812100000000,08,121,"Washington County, CO",Mar-19,2817,2758,59,2.1
306,CN0812300000000,08,123,"Weld County, CO",Mar-19,166439,161629,4810,2.9
307,CN0812500000000,08,125,"Yuma County, CO",Mar-19,5748,5645,103,1.8
308,CN0900100000000,09,1,"Fairfield County, CT",Mar-19,475119,456625,18494,3.9
309,CN0900300000000,09,3,"Hartford County, CT",Mar-19,480963,461381,19582,4.1
310,CN0900500000000,09,5,"Litchfield County, CT",Mar-19,103785,99493,4292,4.1
311,CN0900700000000,09,7,"Middlesex County, CT",Mar-19,92970,89714,3256,3.5
312,CN0900900000000,09,9,"New Haven County, CT",Mar-19,457133,438065,19068,4.2
313,CN0901100000000,09,11,"New London County, CT",Mar-19,135577,130288,5289,3.9
314,CN0901300000000,09,13,"Tolland County, CT",Mar-19,86782,83633,3149,3.6
315,CN0901500000000,09,15,"Windham County, CT",Mar-19,63797,60941,2856,4.5
316,CN1000100000000,10,1,"Kent County, DE",Mar-19,79490,76375,3115,3.9
317,CN1000300000000,10,3,"New Castle County, DE",Mar-19,302554,292146,10408,3.4
318,CN1000500000000,10,5,"Sussex County, DE",Mar-19,104065,99719,4346,4.2
319,CN1100100000000,11,1,District of Columbia,Mar-19,409447,386482,22965,5.6
320,CN1200100000000,12,1,"Alachua County, FL",Mar-19,139002,134849,4153,3.0
321,CN1200300000000,12,3,"Baker County, FL",Mar-19,11656,11280,376,3.2
322,CN1200500000000,12,5,"Bay County, FL",Mar-19,83984,80236,3748,4.5
323,CN1200700000000,12,7,"Bradford County, FL",Mar-19,10894,10540,354,3.2
324,CN1200900000000,12,9,"Brevard County, FL",Mar-19,279950,270699,9251,3.3
325,CN1201100000000,12,11,"Broward County, FL",Mar-19,1031298,999320,31978,3.1
326,CN1201300000000,12,13,"Calhoun County, FL",Mar-19,4809,4600,209,4.3
327,CN1201500000000,12,15,"Charlotte County, FL",Mar-19,72270,69570,2700,3.7
328,CN1201700000000,12,17,"Citrus County, FL",Mar-19,47766,45427,2339,4.9
329,CN1201900000000,12,19,"Clay County, FL",Mar-19,105873,102574,3299,3.1
330,CN1202100000000,12,21,"Collier County, FL",Mar-19,184789,179381,5408,2.9
331,CN1202300000000,12,23,"Columbia County, FL",Mar-19,29367,28397,970,3.3
332,CN1202700000000,12,27,"DeSoto County, FL",Mar-19,14381,13874,507,3.5
333,CN1202900000000,12,29,"Dixie County, FL",Mar-19,5864,5647,217,3.7
334,CN1203100000000,12,31,"Duval County, FL",Mar-19,483521,467421,16100,3.3
335,CN1203300000000,12,33,"Escambia County, FL",Mar-19,144715,139985,4730,3.3
336,CN1203500000000,12,35,"Flagler County, FL",Mar-19,46930,45107,1823,3.9
337,CN1203700000000,12,37,"Franklin County, FL",Mar-19,4641,4452,189,4.1
338,CN1203900000000,12,39,"Gadsden County, FL",Mar-19,18736,17956,780,4.2
339,CN1204100000000,12,41,"Gilchrist County, FL",Mar-19,7137,6884,253,3.5
340,CN1204300000000,12,43,"Glades County, FL",Mar-19,5622,5418,204,3.6
341,CN1204500000000,12,45,"Gulf County, FL",Mar-19,5762,5446,316,5.5
342,CN1204700000000,12,47,"Hamilton County, FL",Mar-19,4343,4156,187,4.3
343,CN1204900000000,12,49,"Hardee County, FL",Mar-19,8726,8307,419,4.8
344,CN1205100000000,12,51,"Hendry County, FL",Mar-19,16031,15292,739,4.6
345,CN1205300000000,12,53,"Hernando County, FL",Mar-19,71158,68080,3078,4.3
346,CN1205500000000,12,55,"Highlands County, FL",Mar-19,36197,34552,1645,4.5
347,CN1205700000000,12,57,"Hillsborough County, FL",Mar-19,743822,720322,23500,3.2
348,CN1205900000000,12,59,"Holmes County, FL",Mar-19,6915,6667,248,3.6
349,CN1206100000000,12,61,"Indian River County, FL",Mar-19,65690,63196,2494,3.8
350,CN1206300000000,12,63,"Jackson County, FL",Mar-19,17175,16523,652,3.8
351,CN1206500000000,12,65,"Jefferson County, FL",Mar-19,5620,5427,193,3.4
352,CN1206700000000,12,67,"Lafayette County, FL",Mar-19,2921,2832,89,3.0
353,CN1206900000000,12,69,"Lake County, FL",Mar-19,157396,152187,5209,3.3
354,CN1207100000000,12,71,"Lee County, FL",Mar-19,350207,339088,11119,3.2
355,CN1207300000000,12,73,"Leon County, FL",Mar-19,155324,150575,4749,3.1
356,CN1207500000000,12,75,"Levy County, FL",Mar-19,16849,16190,659,3.9
357,CN1207700000000,12,77,"Liberty County, FL",Mar-19,2639,2539,100,3.8
358,CN1207900000000,12,79,"Madison County, FL",Mar-19,7351,7067,284,3.9
359,CN1208100000000,12,81,"Manatee County, FL",Mar-19,180677,175055,5622,3.1
360,CN1208300000000,12,83,"Marion County, FL",Mar-19,136656,131246,5410,4.0
361,CN1208500000000,12,85,"Martin County, FL",Mar-19,73957,71578,2379,3.2
362,CN1208600000000,12,86,"Miami-Dade County, FL",Mar-19,1366682,1327849,38833,2.8
363,CN1208700000000,12,87,"Monroe County, FL",Mar-19,47416,46401,1015,2.1
364,CN1208900000000,12,89,"Nassau County, FL",Mar-19,40545,39315,1230,3.0
365,CN1209100000000,12,91,"Okaloosa County, FL",Mar-19,95726,93032,2694,2.8
366,CN1209300000000,12,93,"Okeechobee County, FL",Mar-19,17918,17291,627,3.5
367,CN1209500000000,12,95,"Orange County, FL",Mar-19,754795,732490,22305,3.0
368,CN1209700000000,12,97,"Osceola County, FL",Mar-19,182357,176344,6013,3.3
369,CN1209900000000,12,99,"Palm Beach County, FL",Mar-19,733448,709534,23914,3.3
370,CN1210100000000,12,101,"Pasco County, FL",Mar-19,235415,226923,8492,3.6
371,CN1210300000000,12,103,"Pinellas County, FL",Mar-19,489001,473774,15227,3.1
372,CN1210500000000,12,105,"Polk County, FL",Mar-19,303081,291801,11280,3.7
373,CN1210700000000,12,107,"Putnam County, FL",Mar-19,26827,25639,1188,4.4
374,CN1210900000000,12,109,"St. Johns County, FL",Mar-19,130410,126816,3594,2.8
375,CN1211100000000,12,111,"St. Lucie County, FL",Mar-19,144600,138925,5675,3.9
376,CN1211300000000,12,113,"Santa Rosa County, FL",Mar-19,82084,79580,2504,3.1
377,CN1211500000000,12,115,"Sarasota County, FL",Mar-19,190046,183983,6063,3.2
378,CN1211700000000,12,117,"Seminole County, FL",Mar-19,253126,245510,7616,3.0
379,CN1211900000000,12,119,"Sumter County, FL",Mar-19,32592,31003,1589,4.9
380,CN1212100000000,12,121,"Suwannee County, FL",Mar-19,17888,17261,627,3.5
381,CN1212300000000,12,123,"Taylor County, FL",Mar-19,8163,7871,292,3.6
382,CN1212500000000,12,125,"Union County, FL",Mar-19,4627,4490,137,3.0
383,CN1212700000000,12,127,"Volusia County, FL",Mar-19,253645,244732,8913,3.5
384,CN1212900000000,12,129,"Wakulla County, FL",Mar-19,14910,14469,441,3.0
385,CN1213100000000,12,131,"Walton County, FL",Mar-19,31226,30289,937,3.0
386,CN1213300000000,12,133,"Washington County, FL",Mar-19,9682,9337,345,3.6
387,CN1300100000000,13,1,"Appling County, GA",Mar-19,9144,8807,337,3.7
388,CN1300300000000,13,3,"Atkinson County, GA",Mar-19,4771,4622,149,3.1
389,CN1300500000000,13,5,"Bacon County, GA",Mar-19,5019,4849,170,3.4
390,CN1300700000000,13,7,"Baker County, GA",Mar-19,1178,1127,51,4.3
391,CN1300900000000,13,9,"Baldwin County, GA",Mar-19,17407,16629,778,4.5
392,CN1301100000000,13,11,"Banks County, GA",Mar-19,9655,9372,283,2.9
393,CN1301300000000,13,13,"Barrow County, GA",Mar-19,40248,39008,1240,3.1
394,CN1301500000000,13,15,"Bartow County, GA",Mar-19,50315,48602,1713,3.4
395,CN1301700000000,13,17,"Ben Hill County, GA",Mar-19,5383,5090,293,5.4
396,CN1301900000000,13,19,"Berrien County, GA",Mar-19,7542,7263,279,3.7
397,CN1302100000000,13,21,"Bibb County, GA",Mar-19,68337,65568,2769,4.1
398,CN1302300000000,13,23,"Bleckley County, GA",Mar-19,4661,4423,238,5.1
399,CN1302500000000,13,25,"Brantley County, GA",Mar-19,7200,6900,300,4.2
400,CN1302700000000,13,27,"Brooks County, GA",Mar-19,6970,6726,244,3.5
401,CN1302900000000,13,29,"Bryan County, GA",Mar-19,18407,17827,580,3.2
402,CN1303100000000,13,31,"Bulloch County, GA",Mar-19,36949,35532,1417,3.8
403,CN1303300000000,13,33,"Burke County, GA",Mar-19,9170,8727,443,4.8
404,CN1303500000000,13,35,"Butts County, GA",Mar-19,10701,10319,382,3.6
405,CN1303700000000,13,37,"Calhoun County, GA",Mar-19,2234,2146,88,3.9
406,CN1303900000000,13,39,"Camden County, GA",Mar-19,20943,20130,813,3.9
407,CN1304300000000,13,43,"Candler County, GA",Mar-19,5525,5358,167,3.0
408,CN1304500000000,13,45,"Carroll County, GA",Mar-19,54983,52991,1992,3.6
409,CN1304700000000,13,47,"Catoosa County, GA",Mar-19,33437,32389,1048,3.1
410,CN1304900000000,13,49,"Charlton County, GA",Mar-19,4774,4587,187,3.9
411,CN1305100000000,13,51,"Chatham County, GA",Mar-19,140564,135726,4838,3.4
412,CN1305300000000,13,53,"Chattahoochee County, GA",Mar-19,2033,1926,107,5.3
413,CN1305500000000,13,55,"Chattooga County, GA",Mar-19,10268,9877,391,3.8
414,CN1305700000000,13,57,"Cherokee County, GA",Mar-19,135157,131198,3959,2.9
415,CN1305900000000,13,59,"Clarke County, GA",Mar-19,59254,56997,2257,3.8
416,CN1306100000000,13,61,"Clay County, GA",Mar-19,872,817,55,6.3
417,CN1306300000000,13,63,"Clayton County, GA",Mar-19,137181,131171,6010,4.4
418,CN1306500000000,13,65,"Clinch County, GA",Mar-19,2750,2649,101,3.7
419,CN1306700000000,13,67,"Cobb County, GA",Mar-19,423129,409755,13374,3.2
420,CN1306900000000,13,69,"Coffee County, GA",Mar-19,18949,18212,737,3.9
421,CN1307100000000,13,71,"Colquitt County, GA",Mar-19,21617,20917,700,3.2
422,CN1307300000000,13,73,"Columbia County, GA",Mar-19,75295,72886,2409,3.2
423,CN1307500000000,13,75,"Cook County, GA",Mar-19,8010,7738,272,3.4
424,CN1307700000000,13,77,"Coweta County, GA",Mar-19,74252,71959,2293,3.1
425,CN1307900000000,13,79,"Crawford County, GA",Mar-19,5650,5442,208,3.7
426,CN1308100000000,13,81,"Crisp County, GA",Mar-19,9405,9012,393,4.2
427,CN1308300000000,13,83,"Dade County, GA",Mar-19,8179,7890,289,3.5
428,CN1308500000000,13,85,"Dawson County, GA",Mar-19,12277,11891,386,3.1
429,CN1308700000000,13,87,"Decatur County, GA",Mar-19,11702,11263,439,3.8
430,CN1308900000000,13,89,"DeKalb County, GA",Mar-19,397574,383095,14479,3.6
431,CN1309100000000,13,91,"Dodge County, GA",Mar-19,7049,6759,290,4.1
432,CN1309300000000,13,93,"Dooly County, GA",Mar-19,5100,4908,192,3.8
433,CN1309500000000,13,95,"Dougherty County, GA",Mar-19,38330,36449,1881,4.9
434,CN1309700000000,13,97,"Douglas County, GA",Mar-19,72889,70161,2728,3.7
435,CN1309900000000,13,99,"Early County, GA",Mar-19,4317,4139,178,4.1
436,CN1310100000000,13,101,"Echols County, GA",Mar-19,1943,1887,56,2.9
437,CN1310300000000,13,103,"Effingham County, GA",Mar-19,31118,30170,948,3.0
438,CN1310500000000,13,105,"Elbert County, GA",Mar-19,7628,7323,305,4.0
439,CN1310700000000,13,107,"Emanuel County, GA",Mar-19,8268,7873,395,4.8
440,CN1310900000000,13,109,"Evans County, GA",Mar-19,4866,4698,168,3.5
441,CN1311100000000,13,111,"Fannin County, GA",Mar-19,11520,11131,389,3.4
442,CN1311300000000,13,113,"Fayette County, GA",Mar-19,57739,55895,1844,3.2
443,CN1311500000000,13,115,"Floyd County, GA",Mar-19,44207,42528,1679,3.8
444,CN1311700000000,13,117,"Forsyth County, GA",Mar-19,121555,117972,3583,2.9
445,CN1311900000000,13,119,"Franklin County, GA",Mar-19,10148,9779,369,3.6
446,CN1312100000000,13,121,"Fulton County, GA",Mar-19,554496,534075,20421,3.7
447,CN1312300000000,13,123,"Gilmer County, GA",Mar-19,11877,11434,443,3.7
448,CN1312500000000,13,125,"Glascock County, GA",Mar-19,1274,1225,49,3.8
449,CN1312700000000,13,127,"Glynn County, GA",Mar-19,38958,37597,1361,3.5
450,CN1312900000000,13,129,"Gordon County, GA",Mar-19,27615,26668,947,3.4
451,CN1313100000000,13,131,"Grady County, GA",Mar-19,10732,10367,365,3.4
452,CN1313300000000,13,133,"Greene County, GA",Mar-19,7068,6779,289,4.1
453,CN1313500000000,13,135,"Gwinnett County, GA",Mar-19,487176,471549,15627,3.2
454,CN1313700000000,13,137,"Habersham County, GA",Mar-19,19323,18595,728,3.8
455,CN1313900000000,13,139,"Hall County, GA",Mar-19,101899,98866,3033,3.0
456,CN1314100000000,13,141,"Hancock County, GA",Mar-19,2461,2327,134,5.4
457,CN1314300000000,13,143,"Haralson County, GA",Mar-19,12488,12056,432,3.5
458,CN1314500000000,13,145,"Harris County, GA",Mar-19,16799,16264,535,3.2
459,CN1314700000000,13,147,"Hart County, GA",Mar-19,11613,11220,393,3.4
460,CN1314900000000,13,149,"Heard County, GA",Mar-19,5228,5046,182,3.5
461,CN1315100000000,13,151,"Henry County, GA",Mar-19,115100,110751,4349,3.8
462,CN1315300000000,13,153,"Houston County, GA",Mar-19,70604,68144,2460,3.5
463,CN1315500000000,13,155,"Irwin County, GA",Mar-19,3396,3232,164,4.8
464,CN1315700000000,13,157,"Jackson County, GA",Mar-19,36245,35198,1047,2.9
465,CN1315900000000,13,159,"Jasper County, GA",Mar-19,6922,6691,231,3.3
466,CN1316100000000,13,161,"Jeff Davis County, GA",Mar-19,6078,5817,261,4.3
467,CN1316300000000,13,163,"Jefferson County, GA",Mar-19,6575,6279,296,4.5
468,CN1316500000000,13,165,"Jenkins County, GA",Mar-19,3161,3008,153,4.8
469,CN1316700000000,13,167,"Johnson County, GA",Mar-19,4115,3965,150,3.6
470,CN1316900000000,13,169,"Jones County, GA",Mar-19,13793,13337,456,3.3
471,CN1317100000000,13,171,"Lamar County, GA",Mar-19,8187,7856,331,4.0
472,CN1317300000000,13,173,"Lanier County, GA",Mar-19,3768,3609,159,4.2
473,CN1317500000000,13,175,"Laurens County, GA",Mar-19,19419,18595,824,4.2
474,CN1317700000000,13,177,"Lee County, GA",Mar-19,14710,14246,464,3.2
475,CN1317900000000,13,179,"Liberty County, GA",Mar-19,26182,25215,967,3.7
476,CN1318100000000,13,181,"Lincoln County, GA",Mar-19,3587,3435,152,4.2
477,CN1318300000000,13,183,"Long County, GA",Mar-19,8190,7888,302,3.7
478,CN1318500000000,13,185,"Lowndes County, GA",Mar-19,51369,49482,1887,3.7
479,CN1318700000000,13,187,"Lumpkin County, GA",Mar-19,16670,16123,547,3.3
480,CN1318900000000,13,189,"McDuffie County, GA",Mar-19,8837,8414,423,4.8
481,CN1319100000000,13,191,"McIntosh County, GA",Mar-19,6137,5911,226,3.7
482,CN1319300000000,13,193,"Macon County, GA",Mar-19,4706,4487,219,4.7
483,CN1319500000000,13,195,"Madison County, GA",Mar-19,13299,12868,431,3.2
484,CN1319700000000,13,197,"Marion County, GA",Mar-19,3335,3189,146,4.4
485,CN1319900000000,13,199,"Meriwether County, GA",Mar-19,8874,8465,409,4.6
486,CN1320100000000,13,201,"Miller County, GA",Mar-19,2779,2689,90,3.2
487,CN1320500000000,13,205,"Mitchell County, GA",Mar-19,8505,8118,387,4.6
488,CN1320700000000,13,207,"Monroe County, GA",Mar-19,13092,12639,453,3.5
489,CN1320900000000,13,209,"Montgomery County, GA",Mar-19,3822,3629,193,5.0
490,CN1321100000000,13,211,"Morgan County, GA",Mar-19,9219,8914,305,3.3
491,CN1321300000000,13,213,"Murray County, GA",Mar-19,15595,14821,774,5.0
492,CN1321500000000,13,215,"Muscogee County, GA",Mar-19,78077,74492,3585,4.6
493,CN1321700000000,13,217,"Newton County, GA",Mar-19,52000,49885,2115,4.1
494,CN1321900000000,13,219,"Oconee County, GA",Mar-19,19543,19001,542,2.8
495,CN1322100000000,13,221,"Oglethorpe County, GA",Mar-19,6961,6726,235,3.4
496,CN1322300000000,13,223,"Paulding County, GA",Mar-19,85544,82891,2653,3.1
497,CN1322500000000,13,225,"Peach County, GA",Mar-19,11882,11388,494,4.2
498,CN1322700000000,13,227,"Pickens County, GA",Mar-19,15207,14720,487,3.2
499,CN1322900000000,13,229,"Pierce County, GA",Mar-19,8718,8413,305,3.5
500,CN1323100000000,13,231,"Pike County, GA",Mar-19,8862,8577,285,3.2
501,CN1323300000000,13,233,"Polk County, GA",Mar-19,18354,17648,706,3.8
502,CN1323500000000,13,235,"Pulaski County, GA",Mar-19,4077,3913,164,4.0
503,CN1323700000000,13,237,"Putnam County, GA",Mar-19,8148,7759,389,4.8
504,CN1323900000000,13,239,"Quitman County, GA",Mar-19,809,765,44,5.4
505,CN1324100000000,13,241,"Rabun County, GA",Mar-19,7007,6742,265,3.8
506,CN1324300000000,13,243,"Randolph County, GA",Mar-19,2579,2456,123,4.8
507,CN1324500000000,13,245,"Richmond County, GA",Mar-19,85258,81331,3927,4.6
508,CN1324700000000,13,247,"Rockdale County, GA",Mar-19,44550,42774,1776,4.0
509,CN1324900000000,13,249,"Schley County, GA",Mar-19,2164,2078,86,4.0
510,CN1325100000000,13,251,"Screven County, GA",Mar-19,5090,4846,244,4.8
511,CN1325300000000,13,253,"Seminole County, GA",Mar-19,3074,2932,142,4.6
512,CN1325500000000,13,255,"Spalding County, GA",Mar-19,28593,27360,1233,4.3
513,CN1325700000000,13,257,"Stephens County, GA",Mar-19,10778,10346,432,4.0
514,CN1325900000000,13,259,"Stewart County, GA",Mar-19,2371,2272,99,4.2
515,CN1326100000000,13,261,"Sumter County, GA",Mar-19,12515,11884,631,5.0
516,CN1326300000000,13,263,"Talbot County, GA",Mar-19,2838,2700,138,4.9
517,CN1326500000000,13,265,"Taliaferro County, GA",Mar-19,567,542,25,4.4
518,CN1326700000000,13,267,"Tattnall County, GA",Mar-19,9667,9272,395,4.1
519,CN1326900000000,13,269,"Taylor County, GA",Mar-19,2943,2818,125,4.2
520,CN1327100000000,13,271,"Telfair County, GA",Mar-19,4167,3948,219,5.3
521,CN1327300000000,13,273,"Terrell County, GA",Mar-19,3524,3332,192,5.4
522,CN1327500000000,13,275,"Thomas County, GA",Mar-19,16905,16218,687,4.1
523,CN1327700000000,13,277,"Tift County, GA",Mar-19,19830,19123,707,3.6
524,CN1327900000000,13,279,"Toombs County, GA",Mar-19,11687,11138,549,4.7
525,CN1328100000000,13,281,"Towns County, GA",Mar-19,3848,3650,198,5.1
526,CN1328300000000,13,283,"Treutlen County, GA",Mar-19,2721,2599,122,4.5
527,CN1328500000000,13,285,"Troup County, GA",Mar-19,37233,36029,1204,3.2
528,CN1328700000000,13,287,"Turner County, GA",Mar-19,3151,3028,123,3.9
529,CN1328900000000,13,289,"Twiggs County, GA",Mar-19,2913,2743,170,5.8
530,CN1329100000000,13,291,"Union County, GA",Mar-19,10361,10009,352,3.4
531,CN1329300000000,13,293,"Upson County, GA",Mar-19,11314,10883,431,3.8
532,CN1329500000000,13,295,"Walker County, GA",Mar-19,31227,30143,1084,3.5
533,CN1329700000000,13,297,"Walton County, GA",Mar-19,45855,44330,1525,3.3
534,CN1329900000000,13,299,"Ware County, GA",Mar-19,15571,15000,571,3.7
535,CN1330100000000,13,301,"Warren County, GA",Mar-19,2772,2661,111,4.0
536,CN1330300000000,13,303,"Washington County, GA",Mar-19,7042,6725,317,4.5
537,CN1330500000000,13,305,"Wayne County, GA",Mar-19,11594,11119,475,4.1
538,CN1330700000000,13,307,"Webster County, GA",Mar-19,1009,956,53,5.3
539,CN1330900000000,13,309,"Wheeler County, GA",Mar-19,1621,1531,90,5.6
540,CN1331100000000,13,311,"White County, GA",Mar-19,16120,15645,475,2.9
541,CN1331300000000,13,313,"Whitfield County, GA",Mar-19,43820,41874,1946,4.4
542,CN1331500000000,13,315,"Wilcox County, GA",Mar-19,2757,2643,114,4.1
543,CN1331700000000,13,317,"Wilkes County, GA",Mar-19,3852,3685,167,4.3
544,CN1331900000000,13,319,"Wilkinson County, GA",Mar-19,3933,3791,142,3.6
545,CN1332100000000,13,321,"Worth County, GA",Mar-19,8905,8567,338,3.8
546,CN1500100000000,15,1,"Hawaii County, HI",Mar-19,90582,87511,3071,3.4
547,CN1500300000000,15,3,"Honolulu County/city, HI",Mar-19,452267,440671,11596,2.6
548,CN1500700000000,15,7,"Kauai County, HI",Mar-19,36036,35040,996,2.8
549,CN1500900000000,15,9,"Maui County, HI",Mar-19,86596,84318,2278,2.6
550,CN1600100000000,16,1,"Ada County, ID",Mar-19,251861,244908,6953,2.8
551,CN1600300000000,16,3,"Adams County, ID",Mar-19,1716,1517,199,11.6
552,CN1600500000000,16,5,"Bannock County, ID",Mar-19,42955,41642,1313,3.1
553,CN1600700000000,16,7,"Bear Lake County, ID",Mar-19,2909,2807,102,3.5
554,CN1600900000000,16,9,"Benewah County, ID",Mar-19,4146,3710,436,10.5
555,CN1601100000000,16,11,"Bingham County, ID",Mar-19,23106,22386,720,3.1
556,CN1601300000000,16,13,"Blaine County, ID",Mar-19,12312,11881,431,3.5
557,CN1601500000000,16,15,"Boise County, ID",Mar-19,3519,3329,190,5.4
558,CN1601700000000,16,17,"Bonner County, ID",Mar-19,19878,18699,1179,5.9
559,CN1601900000000,16,19,"Bonneville County, ID",Mar-19,55931,54368,1563,2.8
560,CN1602100000000,16,21,"Boundary County, ID",Mar-19,5244,4892,352,6.7
561,CN1602300000000,16,23,"Butte County, ID",Mar-19,1352,1306,46,3.4
562,CN1602500000000,16,25,"Camas County, ID",Mar-19,678,656,22,3.2
563,CN1602700000000,16,27,"Canyon County, ID",Mar-19,103167,99515,3652,3.5
564,CN1602900000000,16,29,"Caribou County, ID",Mar-19,4049,3924,125,3.1
565,CN1603100000000,16,31,"Cassia County, ID",Mar-19,11737,11412,325,2.8
566,CN1603300000000,16,33,"Clark County, ID",Mar-19,352,337,15,4.3
567,CN1603500000000,16,35,"Clearwater County, ID",Mar-19,2971,2625,346,11.6
568,CN1603700000000,16,37,"Custer County, ID",Mar-19,2000,1873,127,6.4
569,CN1603900000000,16,39,"Elmore County, ID",Mar-19,11278,10841,437,3.9
570,CN1604100000000,16,41,"Franklin County, ID",Mar-19,7048,6866,182,2.6
571,CN1604300000000,16,43,"Fremont County, ID",Mar-19,7720,7470,250,3.2
572,CN1604500000000,16,45,"Gem County, ID",Mar-19,8225,7900,325,4.0
573,CN1604700000000,16,47,"Gooding County, ID",Mar-19,8111,7846,265,3.3
574,CN1604900000000,16,49,"Idaho County, ID",Mar-19,6447,6035,412,6.4
575,CN1605100000000,16,51,"Jefferson County, ID",Mar-19,13636,13264,372,2.7
576,CN1605300000000,16,53,"Jerome County, ID",Mar-19,12105,11728,377,3.1
577,CN1605500000000,16,55,"Kootenai County, ID",Mar-19,78371,74475,3896,5.0
578,CN1605700000000,16,57,"Latah County, ID",Mar-19,20913,20158,755,3.6
579,CN1605900000000,16,59,"Lemhi County, ID",Mar-19,3395,3158,237,7.0
580,CN1606100000000,16,61,"Lewis County, ID",Mar-19,1599,1478,121,7.6
581,CN1606300000000,16,63,"Lincoln County, ID",Mar-19,2654,2519,135,5.1
582,CN1606500000000,16,65,"Madison County, ID",Mar-19,21680,21249,431,2.0
583,CN1606700000000,16,67,"Minidoka County, ID",Mar-19,11056,10735,321,2.9
584,CN1606900000000,16,69,"Nez Perce County, ID",Mar-19,20939,20161,778,3.7
585,CN1607100000000,16,71,"Oneida County, ID",Mar-19,2267,2207,60,2.6
586,CN1607300000000,16,73,"Owyhee County, ID",Mar-19,5374,5161,213,4.0
587,CN1607500000000,16,75,"Payette County, ID",Mar-19,11556,11095,461,4.0
588,CN1607700000000,16,77,"Power County, ID",Mar-19,3874,3737,137,3.5
589,CN1607900000000,16,79,"Shoshone County, ID",Mar-19,5298,4886,412,7.8
590,CN1608100000000,16,81,"Teton County, ID",Mar-19,6083,5911,172,2.8
591,CN1608300000000,16,83,"Twin Falls County, ID",Mar-19,40915,39597,1318,3.2
592,CN1608500000000,16,85,"Valley County, ID",Mar-19,5407,5104,303,5.6
593,CN1608700000000,16,87,"Washington County, ID",Mar-19,4529,4286,243,5.4
594,CN1700100000000,17,1,"Adams County, IL",Mar-19,32630,31354,1276,3.9
595,CN1700300000000,17,3,"Alexander County, IL",Mar-19,2053,1922,131,6.4
596,CN1700500000000,17,5,"Bond County, IL",Mar-19,7759,7411,348,4.5
597,CN1700700000000,17,7,"Boone County, IL",Mar-19,26580,24840,1740,6.5
598,CN1700900000000,17,9,"Brown County, IL",Mar-19,2950,2869,81,2.7
599,CN1701100000000,17,11,"Bureau County, IL",Mar-19,17300,16308,992,5.7
600,CN1701300000000,17,13,"Calhoun County, IL",Mar-19,2320,2196,124,5.3
601,CN1701500000000,17,15,"Carroll County, IL",Mar-19,7076,6701,375,5.3
602,CN1701700000000,17,17,"Cass County, IL",Mar-19,6127,5807,320,5.2
603,CN1701900000000,17,19,"Champaign County, IL",Mar-19,110426,105777,4649,4.2
604,CN1702100000000,17,21,"Christian County, IL",Mar-19,14758,13943,815,5.5
605,CN1702300000000,17,23,"Clark County, IL",Mar-19,7690,7262,428,5.6
606,CN1702500000000,17,25,"Clay County, IL",Mar-19,6413,6085,328,5.1
607,CN1702700000000,17,27,"Clinton County, IL",Mar-19,20399,19651,748,3.7
608,CN1702900000000,17,29,"Coles County, IL",Mar-19,24477,23364,1113,4.5
609,CN1703100000000,17,31,"Cook County, IL",Mar-19,2602041,2498789,103252,4.0
610,CN1703300000000,17,33,"Crawford County, IL",Mar-19,9004,8620,384,4.3
611,CN1703500000000,17,35,"Cumberland County, IL",Mar-19,6145,5885,260,4.2
612,CN1703700000000,17,37,"DeKalb County, IL",Mar-19,55133,52489,2644,4.8
613,CN1703900000000,17,39,"De Witt County, IL",Mar-19,7517,7105,412,5.5
614,CN1704100000000,17,41,"Douglas County, IL",Mar-19,10232,9824,408,4.0
615,CN1704300000000,17,43,"DuPage County, IL",Mar-19,508860,493307,15553,3.1
616,CN1704500000000,17,45,"Edgar County, IL",Mar-19,9066,8612,454,5.0
617,CN1704700000000,17,47,"Edwards County, IL",Mar-19,2708,2574,134,4.9
618,CN1704900000000,17,49,"Effingham County, IL",Mar-19,19408,18639,769,4.0
619,CN1705100000000,17,51,"Fayette County, IL",Mar-19,9896,9370,526,5.3
620,CN1705300000000,17,53,"Ford County, IL",Mar-19,6520,6182,338,5.2
621,CN1705500000000,17,55,"Franklin County, IL",Mar-19,16584,15554,1030,6.2
622,CN1705700000000,17,57,"Fulton County, IL",Mar-19,15281,14275,1006,6.6
623,CN1705900000000,17,59,"Gallatin County, IL",Mar-19,2379,2250,129,5.4
624,CN1706100000000,17,61,"Greene County, IL",Mar-19,6000,5706,294,4.9
625,CN1706300000000,17,63,"Grundy County, IL",Mar-19,25622,24279,1343,5.2
626,CN1706500000000,17,65,"Hamilton County, IL",Mar-19,4459,4241,218,4.9
627,CN1706700000000,17,67,"Hancock County, IL",Mar-19,8367,7893,474,5.7
628,CN1706900000000,17,69,"Hardin County, IL",Mar-19,1320,1221,99,7.5
629,CN1707100000000,17,71,"Henderson County, IL",Mar-19,3584,3363,221,6.2
630,CN1707300000000,17,73,"Henry County, IL",Mar-19,25082,23648,1434,5.7
631,CN1707500000000,17,75,"Iroquois County, IL",Mar-19,14248,13528,720,5.1
632,CN1707700000000,17,77,"Jackson County, IL",Mar-19,28498,27299,1199,4.2
633,CN1707900000000,17,79,"Jasper County, IL",Mar-19,4572,4351,221,4.8
634,CN1708100000000,17,81,"Jefferson County, IL",Mar-19,17643,16754,889,5.0
635,CN1708300000000,17,83,"Jersey County, IL",Mar-19,11014,10455,559,5.1
636,CN1708500000000,17,85,"Jo Daviess County, IL",Mar-19,10667,10067,600,5.6
637,CN1708700000000,17,87,"Johnson County, IL",Mar-19,4268,3947,321,7.5
638,CN1708900000000,17,89,"Kane County, IL",Mar-19,274791,259257,15534,5.7
639,CN1709100000000,17,91,"Kankakee County, IL",Mar-19,55974,52629,3345,6.0
640,CN1709300000000,17,93,"Kendall County, IL",Mar-19,68680,66223,2457,3.6
641,CN1709500000000,17,95,"Knox County, IL",Mar-19,21806,20508,1298,6.0
642,CN1709700000000,17,97,"Lake County, IL",Mar-19,378320,357988,20332,5.4
643,CN1709900000000,17,99,"LaSalle County, IL",Mar-19,55336,51597,3739,6.8
644,CN1710100000000,17,101,"Lawrence County, IL",Mar-19,5956,5615,341,5.7
645,CN1710300000000,17,103,"Lee County, IL",Mar-19,17522,16679,843,4.8
646,CN1710500000000,17,105,"Livingston County, IL",Mar-19,16515,15693,822,5.0
647,CN1710700000000,17,107,"Logan County, IL",Mar-19,12852,12247,605,4.7
648,CN1710900000000,17,109,"McDonough County, IL",Mar-19,13678,13013,665,4.9
649,CN1711100000000,17,111,"McHenry County, IL",Mar-19,166384,160088,6296,3.8
650,CN1711300000000,17,113,"McLean County, IL",Mar-19,88619,84781,3838,4.3
651,CN1711500000000,17,115,"Macon County, IL",Mar-19,48648,45825,2823,5.8
652,CN1711700000000,17,117,"Macoupin County, IL",Mar-19,23024,21870,1154,5.0
653,CN1711900000000,17,119,"Madison County, IL",Mar-19,134444,128553,5891,4.4
654,CN1712100000000,17,121,"Marion County, IL",Mar-19,17754,16932,822,4.6
655,CN1712300000000,17,123,"Marshall County, IL",Mar-19,5371,5048,323,6.0
656,CN1712500000000,17,125,"Mason County, IL",Mar-19,6246,5863,383,6.1
657,CN1712700000000,17,127,"Massac County, IL",Mar-19,5620,5278,342,6.1
658,CN1712900000000,17,129,"Menard County, IL",Mar-19,6568,6245,323,4.9
659,CN1713100000000,17,131,"Mercer County, IL",Mar-19,8158,7625,533,6.5
660,CN1713300000000,17,133,"Monroe County, IL",Mar-19,18785,18127,658,3.5
661,CN1713500000000,17,135,"Montgomery County, IL",Mar-19,11875,11124,751,6.3
662,CN1713700000000,17,137,"Morgan County, IL",Mar-19,16517,15732,785,4.8
663,CN1713900000000,17,139,"Moultrie County, IL",Mar-19,7607,7332,275,3.6
664,CN1714100000000,17,141,"Ogle County, IL",Mar-19,25242,23745,1497,5.9
665,CN1714300000000,17,143,"Peoria County, IL",Mar-19,85573,80544,5029,5.9
666,CN1714500000000,17,145,"Perry County, IL",Mar-19,8450,7962,488,5.8
667,CN1714700000000,17,147,"Piatt County, IL",Mar-19,8702,8329,373,4.3
668,CN1714900000000,17,149,"Pike County, IL",Mar-19,6992,6602,390,5.6
669,CN1715100000000,17,151,"Pope County, IL",Mar-19,1713,1607,106,6.2
670,CN1715300000000,17,153,"Pulaski County, IL",Mar-19,1968,1807,161,8.2
671,CN1715500000000,17,155,"Putnam County, IL",Mar-19,3072,2864,208,6.8
672,CN1715700000000,17,157,"Randolph County, IL",Mar-19,14315,13734,581,4.1
673,CN1715900000000,17,159,"Richland County, IL",Mar-19,7283,6924,359,4.9
674,CN1716100000000,17,161,"Rock Island County, IL",Mar-19,71766,67650,4116,5.7
675,CN1716300000000,17,163,"St. Clair County, IL",Mar-19,126998,120673,6325,5.0
676,CN1716500000000,17,165,"Saline County, IL",Mar-19,9773,9201,572,5.9
677,CN1716700000000,17,167,"Sangamon County, IL",Mar-19,101845,97066,4779,4.7
678,CN1716900000000,17,169,"Schuyler County, IL",Mar-19,3235,3071,164,5.1
679,CN1717100000000,17,171,"Scott County, IL",Mar-19,2511,2354,157,6.3
680,CN1717300000000,17,173,"Shelby County, IL",Mar-19,10624,10136,488,4.6
681,CN1717500000000,17,175,"Stark County, IL",Mar-19,2551,2365,186,7.3
682,CN1717700000000,17,177,"Stephenson County, IL",Mar-19,21684,20577,1107,5.1
683,CN1717900000000,17,179,"Tazewell County, IL",Mar-19,64189,60842,3347,5.2
684,CN1718100000000,17,181,"Union County, IL",Mar-19,7537,6996,541,7.2
685,CN1718300000000,17,183,"Vermilion County, IL",Mar-19,33329,31431,1898,5.7
686,CN1718500000000,17,185,"Wabash County, IL",Mar-19,5825,5561,264,4.5
687,CN1718700000000,17,187,"Warren County, IL",Mar-19,8629,8228,401,4.6
688,CN1718900000000,17,189,"Washington County, IL",Mar-19,10128,9840,288,2.8
689,CN1719100000000,17,191,"Wayne County, IL",Mar-19,6965,6575,390,5.6
690,CN1719300000000,17,193,"White County, IL",Mar-19,6692,6391,301,4.5
691,CN1719500000000,17,195,"Whiteside County, IL",Mar-19,28618,27264,1354,4.7
692,CN1719700000000,17,197,"Will County, IL",Mar-19,358180,343139,15041,4.2
693,CN1719900000000,17,199,"Williamson County, IL",Mar-19,32770,31122,1648,5.0
694,CN1720100000000,17,201,"Winnebago County, IL",Mar-19,140607,132267,8340,5.9
695,CN1720300000000,17,203,"Woodford County, IL",Mar-19,18833,17996,837,4.4
696,CN1800100000000,18,1,"Adams County, IN",Mar-19,17348,16864,484,2.8
697,CN1800300000000,18,3,"Allen County, IN",Mar-19,185409,179296,6113,3.3
698,CN1800500000000,18,5,"Bartholomew County, IN",Mar-19,44883,43615,1268,2.8
699,CN1800700000000,18,7,"Benton County, IN",Mar-19,4574,4410,164,3.6
700,CN1800900000000,18,9,"Blackford County, IN",Mar-19,5111,4870,241,4.7
701,CN1801100000000,18,11,"Boone County, IN",Mar-19,36132,35179,953,2.6
702,CN1801300000000,18,13,"Brown County, IN",Mar-19,7684,7417,267,3.5
703,CN1801500000000,18,15,"Carroll County, IN",Mar-19,10287,9915,372,3.6
704,CN1801700000000,18,17,"Cass County, IN",Mar-19,18058,17306,752,4.2
705,CN1801900000000,18,19,"Clark County, IN",Mar-19,61698,59479,2219,3.6
706,CN1802100000000,18,21,"Clay County, IN",Mar-19,12202,11709,493,4.0
707,CN1802300000000,18,23,"Clinton County, IN",Mar-19,17255,16744,511,3.0
708,CN1802500000000,18,25,"Crawford County, IN",Mar-19,4901,4660,241,4.9
709,CN1802700000000,18,27,"Daviess County, IN",Mar-19,16722,16260,462,2.8
710,CN1802900000000,18,29,"Dearborn County, IN",Mar-19,25846,24814,1032,4.0
711,CN1803100000000,18,31,"Decatur County, IN",Mar-19,15120,14594,526,3.5
712,CN1803300000000,18,33,"DeKalb County, IN",Mar-19,22685,22008,677,3.0
713,CN1803500000000,18,35,"Delaware County, IN",Mar-19,54766,52472,2294,4.2
714,CN1803700000000,18,37,"Dubois County, IN",Mar-19,23103,22492,611,2.6
715,CN1803900000000,18,39,"Elkhart County, IN",Mar-19,114568,111036,3532,3.1
716,CN1804100000000,18,41,"Fayette County, IN",Mar-19,9035,8608,427,4.7
717,CN1804300000000,18,43,"Floyd County, IN",Mar-19,41680,40236,1444,3.5
718,CN1804500000000,18,45,"Fountain County, IN",Mar-19,8028,7706,322,4.0
719,CN1804700000000,18,47,"Franklin County, IN",Mar-19,11402,10937,465,4.1
720,CN1804900000000,18,49,"Fulton County, IN",Mar-19,9869,9492,377,3.8
721,CN1805100000000,18,51,"Gibson County, IN",Mar-19,19557,19000,557,2.8
722,CN1805300000000,18,53,"Grant County, IN",Mar-19,32543,31242,1301,4.0
723,CN1805500000000,18,55,"Greene County, IN",Mar-19,13906,13214,692,5.0
724,CN1805700000000,18,57,"Hamilton County, IN",Mar-19,183429,178464,4965,2.7
725,CN1805900000000,18,59,"Hancock County, IN",Mar-19,40239,38948,1291,3.2
726,CN1806100000000,18,61,"Harrison County, IN",Mar-19,20348,19594,754,3.7
727,CN1806300000000,18,63,"Hendricks County, IN",Mar-19,89894,87265,2629,2.9
728,CN1806500000000,18,65,"Henry County, IN",Mar-19,22175,21334,841,3.8
729,CN1806700000000,18,67,"Howard County, IN",Mar-19,36850,35283,1567,4.3
730,CN1806900000000,18,69,"Huntington County, IN",Mar-19,18369,17657,712,3.9
731,CN1807100000000,18,71,"Jackson County, IN",Mar-19,22830,22177,653,2.9
732,CN1807300000000,18,73,"Jasper County, IN",Mar-19,16544,15736,808,4.9
733,CN1807500000000,18,75,"Jay County, IN",Mar-19,9502,9180,322,3.4
734,CN1807700000000,18,77,"Jefferson County, IN",Mar-19,15225,14680,545,3.6
735,CN1807900000000,18,79,"Jennings County, IN",Mar-19,13583,13015,568,4.2
736,CN1808100000000,18,81,"Johnson County, IN",Mar-19,82895,80432,2463,3.0
737,CN1808300000000,18,83,"Knox County, IN",Mar-19,18727,18127,600,3.2
738,CN1808500000000,18,85,"Kosciusko County, IN",Mar-19,42637,41423,1214,2.8
739,CN1808700000000,18,87,"LaGrange County, IN",Mar-19,20126,19535,591,2.9
740,CN1808900000000,18,89,"Lake County, IN",Mar-19,235736,220244,15492,6.6
741,CN1809100000000,18,91,"LaPorte County, IN",Mar-19,48258,45690,2568,5.3
742,CN1809300000000,18,93,"Lawrence County, IN",Mar-19,21520,20661,859,4.0
743,CN1809500000000,18,95,"Madison County, IN",Mar-19,59316,56742,2574,4.3
744,CN1809700000000,18,97,"Marion County, IN",Mar-19,490391,472838,17553,3.6
745,CN1809900000000,18,99,"Marshall County, IN",Mar-19,23180,22380,800,3.5
746,CN1810100000000,18,101,"Martin County, IN",Mar-19,5328,5168,160,3.0
747,CN1810300000000,18,103,"Miami County, IN",Mar-19,15721,15083,638,4.1
748,CN1810500000000,18,105,"Monroe County, IN",Mar-19,70896,68394,2502,3.5
749,CN1810700000000,18,107,"Montgomery County, IN",Mar-19,18866,18261,605,3.2
750,CN1810900000000,18,109,"Morgan County, IN",Mar-19,36342,35043,1299,3.6
751,CN1811100000000,18,111,"Newton County, IN",Mar-19,7093,6686,407,5.7
752,CN1811300000000,18,113,"Noble County, IN",Mar-19,23756,22994,762,3.2
753,CN1811500000000,18,115,"Ohio County, IN",Mar-19,3196,3065,131,4.1
754,CN1811700000000,18,117,"Orange County, IN",Mar-19,8754,8425,329,3.8
755,CN1811900000000,18,119,"Owen County, IN",Mar-19,9525,9063,462,4.9
756,CN1812100000000,18,121,"Parke County, IN",Mar-19,6999,6718,281,4.0
757,CN1812300000000,18,123,"Perry County, IN",Mar-19,9326,8993,333,3.6
758,CN1812500000000,18,125,"Pike County, IN",Mar-19,6132,5902,230,3.8
759,CN1812700000000,18,127,"Porter County, IN",Mar-19,88005,83948,4057,4.6
760,CN1812900000000,18,129,"Posey County, IN",Mar-19,13731,13324,407,3.0
761,CN1813100000000,18,131,"Pulaski County, IN",Mar-19,6633,6410,223,3.4
762,CN1813300000000,18,133,"Putnam County, IN",Mar-19,16741,16121,620,3.7
763,CN1813500000000,18,135,"Randolph County, IN",Mar-19,11537,11026,511,4.4
764,CN1813700000000,18,137,"Ripley County, IN",Mar-19,14412,13871,541,3.8
765,CN1813900000000,18,139,"Rush County, IN",Mar-19,9011,8735,276,3.1
766,CN1814100000000,18,141,"St. Joseph County, IN",Mar-19,137275,131990,5285,3.8
767,CN1814300000000,18,143,"Scott County, IN",Mar-19,10589,10162,427,4.0
768,CN1814500000000,18,145,"Shelby County, IN",Mar-19,23124,22384,740,3.2
769,CN1814700000000,18,147,"Spencer County, IN",Mar-19,10614,10233,381,3.6
770,CN1814900000000,18,149,"Starke County, IN",Mar-19,9975,9441,534,5.4
771,CN1815100000000,18,151,"Steuben County, IN",Mar-19,20488,19908,580,2.8
772,CN1815300000000,18,153,"Sullivan County, IN",Mar-19,8507,8097,410,4.8
773,CN1815500000000,18,155,"Switzerland County, IN",Mar-19,5017,4835,182,3.6
774,CN1815700000000,18,157,"Tippecanoe County, IN",Mar-19,99395,96304,3091,3.1
775,CN1815900000000,18,159,"Tipton County, IN",Mar-19,9378,9093,285,3.0
776,CN1816100000000,18,161,"Union County, IN",Mar-19,3561,3427,134,3.8
777,CN1816300000000,18,163,"Vanderburgh County, IN",Mar-19,95573,92436,3137,3.3
778,CN1816500000000,18,165,"Vermillion County, IN",Mar-19,7132,6676,456,6.4
779,CN1816700000000,18,167,"Vigo County, IN",Mar-19,48943,46540,2403,4.9
780,CN1816900000000,18,169,"Wabash County, IN",Mar-19,15240,14705,535,3.5
781,CN1817100000000,18,171,"Warren County, IN",Mar-19,4204,4066,138,3.3
782,CN1817300000000,18,173,"Warrick County, IN",Mar-19,33390,32332,1058,3.2
783,CN1817500000000,18,175,"Washington County, IN",Mar-19,13677,13178,499,3.6
784,CN1817700000000,18,177,"Wayne County, IN",Mar-19,31200,29971,1229,3.9
785,CN1817900000000,18,179,"Wells County, IN",Mar-19,14403,13969,434,3.0
786,CN1818100000000,18,181,"White County, IN",Mar-19,13538,13111,427,3.2
787,CN1818300000000,18,183,"Whitley County, IN",Mar-19,17786,17195,591,3.3
788,CN1900100000000,19,1,"Adair County, IA",Mar-19,4140,4006,134,3.2
789,CN1900300000000,19,3,"Adams County, IA",Mar-19,2148,2096,52,2.4
790,CN1900500000000,19,5,"Allamakee County, IA",Mar-19,7432,7025,407,5.5
791,CN1900700000000,19,7,"Appanoose County, IA",Mar-19,5966,5741,225,3.8
792,CN1900900000000,19,9,"Audubon County, IA",Mar-19,3165,3061,104,3.3
793,CN1901100000000,19,11,"Benton County, IA",Mar-19,13680,13179,501,3.7
794,CN1901300000000,19,13,"Black Hawk County, IA",Mar-19,70507,68180,2327,3.3
795,CN1901500000000,19,15,"Boone County, IA",Mar-19,15102,14678,424,2.8
796,CN1901700000000,19,17,"Bremer County, IA",Mar-19,14100,13749,351,2.5
797,CN1901900000000,19,19,"Buchanan County, IA",Mar-19,11343,10939,404,3.6
798,CN1902100000000,19,21,"Buena Vista County, IA",Mar-19,11875,11626,249,2.1
799,CN1902300000000,19,23,"Butler County, IA",Mar-19,7870,7534,336,4.3
800,CN1902500000000,19,25,"Calhoun County, IA",Mar-19,4230,4095,135,3.2
801,CN1902700000000,19,27,"Carroll County, IA",Mar-19,10818,10581,237,2.2
802,CN1902900000000,19,29,"Cass County, IA",Mar-19,6977,6699,278,4.0
803,CN1903100000000,19,31,"Cedar County, IA",Mar-19,10948,10608,340,3.1
804,CN1903300000000,19,33,"Cerro Gordo County, IA",Mar-19,23548,22785,763,3.2
805,CN1903500000000,19,35,"Cherokee County, IA",Mar-19,6145,5967,178,2.9
806,CN1903700000000,19,37,"Chickasaw County, IA",Mar-19,6507,6281,226,3.5
807,CN1903900000000,19,39,"Clarke County, IA",Mar-19,4941,4732,209,4.2
808,CN1904100000000,19,41,"Clay County, IA",Mar-19,8539,8231,308,3.6
809,CN1904300000000,19,43,"Clayton County, IA",Mar-19,10117,9520,597,5.9
810,CN1904500000000,19,45,"Clinton County, IA",Mar-19,22843,21965,878,3.8
811,CN1904700000000,19,47,"Crawford County, IA",Mar-19,8158,7756,402,4.9
812,CN1904900000000,19,49,"Dallas County, IA",Mar-19,49529,48483,1046,2.1
813,CN1905100000000,19,51,"Davis County, IA",Mar-19,4193,4085,108,2.6
814,CN1905300000000,19,53,"Decatur County, IA",Mar-19,4484,4366,118,2.6
815,CN1905500000000,19,55,"Delaware County, IA",Mar-19,10500,10183,317,3.0
816,CN1905700000000,19,57,"Des Moines County, IA",Mar-19,19543,18733,810,4.1
817,CN1905900000000,19,59,"Dickinson County, IA",Mar-19,9323,8939,384,4.1
818,CN1906100000000,19,61,"Dubuque County, IA",Mar-19,56576,54731,1845,3.3
819,CN1906300000000,19,63,"Emmet County, IA",Mar-19,5235,5078,157,3.0
820,CN1906500000000,19,65,"Fayette County, IA",Mar-19,10899,10382,517,4.7
821,CN1906700000000,19,67,"Floyd County, IA",Mar-19,9002,8675,327,3.6
822,CN1906900000000,19,69,"Franklin County, IA",Mar-19,5712,5528,184,3.2
823,CN1907100000000,19,71,"Fremont County, IA",Mar-19,3688,3592,96,2.6
824,CN1907300000000,19,73,"Greene County, IA",Mar-19,5379,5241,138,2.6
825,CN1907500000000,19,75,"Grundy County, IA",Mar-19,6609,6388,221,3.3
826,CN1907700000000,19,77,"Guthrie County, IA",Mar-19,5639,5389,250,4.4
827,CN1907900000000,19,79,"Hamilton County, IA",Mar-19,6949,6709,240,3.5
828,CN1908100000000,19,81,"Hancock County, IA",Mar-19,5882,5724,158,2.7
829,CN1908300000000,19,83,"Hardin County, IA",Mar-19,8223,7896,327,4.0
830,CN1908500000000,19,85,"Harrison County, IA",Mar-19,7373,7136,237,3.2
831,CN1908700000000,19,87,"Henry County, IA",Mar-19,10075,9812,263,2.6
832,CN1908900000000,19,89,"Howard County, IA",Mar-19,5197,4976,221,4.3
833,CN1909100000000,19,91,"Humboldt County, IA",Mar-19,5122,4948,174,3.4
834,CN1909300000000,19,93,"Ida County, IA",Mar-19,4153,4038,115,2.8
835,CN1909500000000,19,95,"Iowa County, IA",Mar-19,10567,10237,330,3.1
836,CN1909700000000,19,97,"Jackson County, IA",Mar-19,11055,10597,458,4.1
837,CN1909900000000,19,99,"Jasper County, IA",Mar-19,19683,18962,721,3.7
838,CN1910100000000,19,101,"Jefferson County, IA",Mar-19,10257,9996,261,2.5
839,CN1910300000000,19,103,"Johnson County, IA",Mar-19,87527,85769,1758,2.0
840,CN1910500000000,19,105,"Jones County, IA",Mar-19,10877,10377,500,4.6
841,CN1910700000000,19,107,"Keokuk County, IA",Mar-19,5279,5063,216,4.1
842,CN1910900000000,19,109,"Kossuth County, IA",Mar-19,8461,8215,246,2.9
843,CN1911100000000,19,111,"Lee County, IA",Mar-19,16132,15452,680,4.2
844,CN1911300000000,19,113,"Linn County, IA",Mar-19,123633,119705,3928,3.2
845,CN1911500000000,19,115,"Louisa County, IA",Mar-19,6019,5810,209,3.5
846,CN1911700000000,19,117,"Lucas County, IA",Mar-19,4684,4572,112,2.4
847,CN1911900000000,19,119,"Lyon County, IA",Mar-19,6989,6845,144,2.1
848,CN1912100000000,19,121,"Madison County, IA",Mar-19,8695,8233,462,5.3
849,CN1912300000000,19,123,"Mahaska County, IA",Mar-19,11895,11565,330,2.8
850,CN1912500000000,19,125,"Marion County, IA",Mar-19,18325,17854,471,2.6
851,CN1912700000000,19,127,"Marshall County, IA",Mar-19,18417,17200,1217,6.6
852,CN1912900000000,19,129,"Mills County, IA",Mar-19,7379,7188,191,2.6
853,CN1913100000000,19,131,"Mitchell County, IA",Mar-19,6243,6106,137,2.2
854,CN1913300000000,19,133,"Monona County, IA",Mar-19,4482,4324,158,3.5
855,CN1913500000000,19,135,"Monroe County, IA",Mar-19,4017,3873,144,3.6
856,CN1913700000000,19,137,"Montgomery County, IA",Mar-19,5013,4859,154,3.1
857,CN1913900000000,19,139,"Muscatine County, IA",Mar-19,21941,21187,754,3.4
858,CN1914100000000,19,141,"O'Brien County, IA",Mar-19,8230,8005,225,2.7
859,CN1914300000000,19,143,"Osceola County, IA",Mar-19,3472,3394,78,2.2
860,CN1914500000000,19,145,"Page County, IA",Mar-19,6457,6299,158,2.4
861,CN1914700000000,19,147,"Palo Alto County, IA",Mar-19,4838,4714,124,2.6
862,CN1914900000000,19,149,"Plymouth County, IA",Mar-19,14813,14467,346,2.3
863,CN1915100000000,19,151,"Pocahontas County, IA",Mar-19,4247,4150,97,2.3
864,CN1915300000000,19,153,"Polk County, IA",Mar-19,270446,261379,9067,3.4
865,CN1915500000000,19,155,"Pottawattamie County, IA",Mar-19,48683,47279,1404,2.9
866,CN1915700000000,19,157,"Poweshiek County, IA",Mar-19,10613,10245,368,3.5
867,CN1915900000000,19,159,"Ringgold County, IA",Mar-19,2471,2380,91,3.7
868,CN1916100000000,19,161,"Sac County, IA",Mar-19,5323,5151,172,3.2
869,CN1916300000000,19,163,"Scott County, IA",Mar-19,89887,86639,3248,3.6
870,CN1916500000000,19,165,"Shelby County, IA",Mar-19,6680,6506,174,2.6
871,CN1916700000000,19,167,"Sioux County, IA",Mar-19,21209,20668,541,2.6
872,CN1916900000000,19,169,"Story County, IA",Mar-19,59940,58900,1040,1.7
873,CN1917100000000,19,171,"Tama County, IA",Mar-19,9627,9192,435,4.5
874,CN1917300000000,19,173,"Taylor County, IA",Mar-19,3200,3137,63,2.0
875,CN1917500000000,19,175,"Union County, IA",Mar-19,6286,6020,266,4.2
876,CN1917700000000,19,177,"Van Buren County, IA",Mar-19,3659,3547,112,3.1
877,CN1917900000000,19,179,"Wapello County, IA",Mar-19,18145,17502,643,3.5
878,CN1918100000000,19,181,"Warren County, IA",Mar-19,28473,27555,918,3.2
879,CN1918300000000,19,183,"Washington County, IA",Mar-19,12200,11799,401,3.3
880,CN1918500000000,19,185,"Wayne County, IA",Mar-19,2822,2737,85,3.0
881,CN1918700000000,19,187,"Webster County, IA",Mar-19,19457,18764,693,3.6
882,CN1918900000000,19,189,"Winnebago County, IA",Mar-19,5100,4946,154,3.0
883,CN1919100000000,19,191,"Winneshiek County, IA",Mar-19,12201,11702,499,4.1
884,CN1919300000000,19,193,"Woodbury County, IA",Mar-19,56260,54477,1783,3.2
885,CN1919500000000,19,195,"Worth County, IA",Mar-19,4152,4004,148,3.6
886,CN1919700000000,19,197,"Wright County, IA",Mar-19,6790,6585,205,3.0
887,CN2000100000000,20,1,"Allen County, KS",Mar-19,6506,6278,228,3.5
888,CN2000300000000,20,3,"Anderson County, KS",Mar-19,4087,3930,157,3.8
889,CN2000500000000,20,5,"Atchison County, KS",Mar-19,6954,6626,328,4.7
890,CN2000700000000,20,7,"Barber County, KS",Mar-19,2256,2202,54,2.4
891,CN2000900000000,20,9,"Barton County, KS",Mar-19,13674,13198,476,3.5
892,CN2001100000000,20,11,"Bourbon County, KS",Mar-19,6795,6475,320,4.7
893,CN2001300000000,20,13,"Brown County, KS",Mar-19,5260,5077,183,3.5
894,CN2001500000000,20,15,"Butler County, KS",Mar-19,32243,31173,1070,3.3
895,CN2001700000000,20,17,"Chase County, KS",Mar-19,1461,1401,60,4.1
896,CN2001900000000,20,19,"Chautauqua County, KS",Mar-19,1413,1354,59,4.2
897,CN2002100000000,20,21,"Cherokee County, KS",Mar-19,10063,9708,355,3.5
898,CN2002300000000,20,23,"Cheyenne County, KS",Mar-19,1249,1216,33,2.6
899,CN2002500000000,20,25,"Clark County, KS",Mar-19,1029,1005,24,2.3
900,CN2002700000000,20,27,"Clay County, KS",Mar-19,3709,3572,137,3.7
901,CN2002900000000,20,29,"Cloud County, KS",Mar-19,3717,3591,126,3.4
902,CN2003100000000,20,31,"Coffey County, KS",Mar-19,3923,3734,189,4.8
903,CN2003300000000,20,33,"Comanche County, KS",Mar-19,851,830,21,2.5
904,CN2003500000000,20,35,"Cowley County, KS",Mar-19,16390,15839,551,3.4
905,CN2003700000000,20,37,"Crawford County, KS",Mar-19,18696,17980,716,3.8
906,CN2003900000000,20,39,"Decatur County, KS",Mar-19,1196,1158,38,3.2
907,CN2004100000000,20,41,"Dickinson County, KS",Mar-19,8690,8318,372,4.3
908,CN2004300000000,20,43,"Doniphan County, KS",Mar-19,4092,3939,153,3.7
909,CN2004500000000,20,45,"Douglas County, KS",Mar-19,66081,64074,2007,3.0
910,CN2004700000000,20,47,"Edwards County, KS",Mar-19,1435,1391,44,3.1
911,CN2004900000000,20,49,"Elk County, KS",Mar-19,1138,1092,46,4.0
912,CN2005100000000,20,51,"Ellis County, KS",Mar-19,16943,16527,416,2.5
913,CN2005300000000,20,53,"Ellsworth County, KS",Mar-19,2659,2584,75,2.8
914,CN2005500000000,20,55,"Finney County, KS",Mar-19,20522,20039,483,2.4
915,CN2005700000000,20,57,"Ford County, KS",Mar-19,16947,16494,453,2.7
916,CN2005900000000,20,59,"Franklin County, KS",Mar-19,13979,13452,527,3.8
917,CN2006100000000,20,61,"Geary County, KS",Mar-19,11383,10848,535,4.7
918,CN2006300000000,20,63,"Gove County, KS",Mar-19,1413,1380,33,2.3
919,CN2006500000000,20,65,"Graham County, KS",Mar-19,1083,1047,36,3.3
920,CN2006700000000,20,67,"Grant County, KS",Mar-19,3131,3027,104,3.3
921,CN2006900000000,20,69,"Gray County, KS",Mar-19,3135,3071,64,2.0
922,CN2007100000000,20,71,"Greeley County, KS",Mar-19,772,754,18,2.3
923,CN2007300000000,20,73,"Greenwood County, KS",Mar-19,3146,3045,101,3.2
924,CN2007500000000,20,75,"Hamilton County, KS",Mar-19,1507,1476,31,2.1
925,CN2007700000000,20,77,"Harper County, KS",Mar-19,2980,2912,68,2.3
926,CN2007900000000,20,79,"Harvey County, KS",Mar-19,16845,16340,505,3.0
927,CN2008100000000,20,81,"Haskell County, KS",Mar-19,2136,2081,55,2.6
928,CN2008300000000,20,83,"Hodgeman County, KS",Mar-19,917,893,24,2.6
929,CN2008500000000,20,85,"Jackson County, KS",Mar-19,7135,6892,243,3.4
930,CN2008700000000,20,87,"Jefferson County, KS",Mar-19,10064,9692,372,3.7
931,CN2008900000000,20,89,"Jewell County, KS",Mar-19,1261,1220,41,3.3
932,CN2009100000000,20,91,"Johnson County, KS",Mar-19,334295,324560,9735,2.9
933,CN2009300000000,20,93,"Kearny County, KS",Mar-19,1996,1947,49,2.5
934,CN2009500000000,20,95,"Kingman County, KS",Mar-19,3372,3248,124,3.7
935,CN2009700000000,20,97,"Kiowa County, KS",Mar-19,1275,1244,31,2.4
936,CN2009900000000,20,99,"Labette County, KS",Mar-19,10146,9712,434,4.3
937,CN2010100000000,20,101,"Lane County, KS",Mar-19,717,696,21,2.9
938,CN2010300000000,20,103,"Leavenworth County, KS",Mar-19,36009,34644,1365,3.8
939,CN2010500000000,20,105,"Lincoln County, KS",Mar-19,1598,1554,44,2.8
940,CN2010700000000,20,107,"Linn County, KS",Mar-19,4436,4095,341,7.7
941,CN2010900000000,20,109,"Logan County, KS",Mar-19,1654,1616,38,2.3
942,CN2011100000000,20,111,"Lyon County, KS",Mar-19,16767,16128,639,3.8
943,CN2011300000000,20,113,"McPherson County, KS",Mar-19,16987,16597,390,2.3
944,CN2011500000000,20,115,"Marion County, KS",Mar-19,5939,5748,191,3.2
945,CN2011700000000,20,117,"Marshall County, KS",Mar-19,5402,5213,189,3.5
946,CN2011900000000,20,119,"Meade County, KS",Mar-19,2130,2075,55,2.6
947,CN2012100000000,20,121,"Miami County, KS",Mar-19,17322,16627,695,4.0
948,CN2012300000000,20,123,"Mitchell County, KS",Mar-19,3366,3271,95,2.8
949,CN2012500000000,20,125,"Montgomery County, KS",Mar-19,14910,14310,600,4.0
950,CN2012700000000,20,127,"Morris County, KS",Mar-19,2947,2857,90,3.1
951,CN2012900000000,20,129,"Morton County, KS",Mar-19,1119,1085,34,3.0
952,CN2013100000000,20,131,"Nemaha County, KS",Mar-19,5263,5116,147,2.8
953,CN2013300000000,20,133,"Neosho County, KS",Mar-19,6037,5773,264,4.4
954,CN2013500000000,20,135,"Ness County, KS",Mar-19,1282,1246,36,2.8
955,CN2013700000000,20,137,"Norton County, KS",Mar-19,2650,2586,64,2.4
956,CN2013900000000,20,139,"Osage County, KS",Mar-19,7960,7621,339,4.3
957,CN2014100000000,20,141,"Osborne County, KS",Mar-19,2006,1959,47,2.3
958,CN2014300000000,20,143,"Ottawa County, KS",Mar-19,2957,2871,86,2.9
959,CN2014500000000,20,145,"Pawnee County, KS",Mar-19,2775,2689,86,3.1
960,CN2014700000000,20,147,"Phillips County, KS",Mar-19,2606,2533,73,2.8
961,CN2014900000000,20,149,"Pottawatomie County, KS",Mar-19,12558,12175,383,3.0
962,CN2015100000000,20,151,"Pratt County, KS",Mar-19,4855,4725,130,2.7
963,CN2015300000000,20,153,"Rawlins County, KS",Mar-19,1426,1392,34,2.4
964,CN2015500000000,20,155,"Reno County, KS",Mar-19,29506,28546,960,3.3
965,CN2015700000000,20,157,"Republic County, KS",Mar-19,2190,2130,60,2.7
966,CN2015900000000,20,159,"Rice County, KS",Mar-19,5105,4947,158,3.1
967,CN2016100000000,20,161,"Riley County, KS",Mar-19,35486,34477,1009,2.8
968,CN2016300000000,20,163,"Rooks County, KS",Mar-19,2512,2416,96,3.8
969,CN2016500000000,20,165,"Rush County, KS",Mar-19,1610,1551,59,3.7
970,CN2016700000000,20,167,"Russell County, KS",Mar-19,3309,3210,99,3.0
971,CN2016900000000,20,169,"Saline County, KS",Mar-19,30169,29161,1008,3.3
972,CN2017100000000,20,171,"Scott County, KS",Mar-19,2686,2632,54,2.0
973,CN2017300000000,20,173,"Sedgwick County, KS",Mar-19,249955,240911,9044,3.6
974,CN2017500000000,20,175,"Seward County, KS",Mar-19,9557,9265,292,3.1
975,CN2017700000000,20,177,"Shawnee County, KS",Mar-19,90196,86901,3295,3.7
976,CN2017900000000,20,179,"Sheridan County, KS",Mar-19,1348,1314,34,2.5
977,CN2018100000000,20,181,"Sherman County, KS",Mar-19,2797,2724,73,2.6
978,CN2018300000000,20,183,"Smith County, KS",Mar-19,1950,1898,52,2.7
979,CN2018500000000,20,185,"Stafford County, KS",Mar-19,1941,1889,52,2.7
980,CN2018700000000,20,187,"Stanton County, KS",Mar-19,940,916,24,2.6
981,CN2018900000000,20,189,"Stevens County, KS",Mar-19,2472,2402,70,2.8
982,CN2019100000000,20,191,"Sumner County, KS",Mar-19,10774,10388,386,3.6
983,CN2019300000000,20,193,"Thomas County, KS",Mar-19,4268,4169,99,2.3
984,CN2019500000000,20,195,"Trego County, KS",Mar-19,1391,1340,51,3.7
985,CN2019700000000,20,197,"Wabaunsee County, KS",Mar-19,3590,3453,137,3.8
986,CN2019900000000,20,199,"Wallace County, KS",Mar-19,761,740,21,2.8
987,CN2020100000000,20,201,"Washington County, KS",Mar-19,2813,2710,103,3.7
988,CN2020300000000,20,203,"Wichita County, KS",Mar-19,1360,1332,28,2.1
989,CN2020500000000,20,205,"Wilson County, KS",Mar-19,3879,3732,147,3.8
990,CN2020700000000,20,207,"Woodson County, KS",Mar-19,1592,1524,68,4.3
991,CN2020900000000,20,209,"Wyandotte County, KS",Mar-19,76302,72712,3590,4.7
992,CN2100100000000,21,1,"Adair County, KY",Mar-19,7211,6771,440,6.1
993,CN2100300000000,21,3,"Allen County, KY",Mar-19,8940,8520,420,4.7
994,CN2100500000000,21,5,"Anderson County, KY",Mar-19,11832,11360,472,4.0
995,CN2100700000000,21,7,"Ballard County, KY",Mar-19,3521,3287,234,6.6
996,CN2100900000000,21,9,"Barren County, KY",Mar-19,19005,18042,963,5.1
997,CN2101100000000,21,11,"Bath County, KY",Mar-19,4583,4262,321,7.0
998,CN2101300000000,21,13,"Bell County, KY",Mar-19,8611,8078,533,6.2
999,CN2101500000000,21,15,"Boone County, KY",Mar-19,71366,68678,2688,3.8
1000,CN2101700000000,21,17,"Bourbon County, KY",Mar-19,9310,8891,419,4.5
1001,CN2101900000000,21,19,"Boyd County, KY",Mar-19,18121,17000,1121,6.2
1002,CN2102100000000,21,21,"Boyle County, KY",Mar-19,12825,12197,628,4.9
1003,CN2102300000000,21,23,"Bracken County, KY",Mar-19,3853,3628,225,5.8
1004,CN2102500000000,21,25,"Breathitt County, KY",Mar-19,3594,3315,279,7.8
1005,CN2102700000000,21,27,"Breckinridge County, KY",Mar-19,7901,7414,487,6.2
1006,CN2102900000000,21,29,"Bullitt County, KY",Mar-19,43076,41181,1895,4.4
1007,CN2103100000000,21,31,"Butler County, KY",Mar-19,5209,4940,269,5.2
1008,CN2103300000000,21,33,"Caldwell County, KY",Mar-19,5443,5147,296,5.4
1009,CN2103500000000,21,35,"Calloway County, KY",Mar-19,19123,18265,858,4.5
1010,CN2103700000000,21,37,"Campbell County, KY",Mar-19,51185,49244,1941,3.8
1011,CN2103900000000,21,39,"Carlisle County, KY",Mar-19,2180,2077,103,4.7
1012,CN2104100000000,21,41,"Carroll County, KY",Mar-19,5288,5052,236,4.5
1013,CN2104300000000,21,43,"Carter County, KY",Mar-19,9828,8960,868,8.8
1014,CN2104500000000,21,45,"Casey County, KY",Mar-19,6663,6350,313,4.7
1015,CN2104700000000,21,47,"Christian County, KY",Mar-19,24824,23428,1396,5.6
1016,CN2104900000000,21,49,"Clark County, KY",Mar-19,17148,16398,750,4.4
1017,CN2105100000000,21,51,"Clay County, KY",Mar-19,5255,4875,380,7.2
1018,CN2105300000000,21,53,"Clinton County, KY",Mar-19,3950,3685,265,6.7
1019,CN2105500000000,21,55,"Crittenden County, KY",Mar-19,3824,3592,232,6.1
1020,CN2105700000000,21,57,"Cumberland County, KY",Mar-19,3116,2951,165,5.3
1021,CN2105900000000,21,59,"Daviess County, KY",Mar-19,47414,45387,2027,4.3
1022,CN2106100000000,21,61,"Edmonson County, KY",Mar-19,4890,4607,283,5.8
1023,CN2106300000000,21,63,"Elliott County, KY",Mar-19,2010,1845,165,8.2
1024,CN2106500000000,21,65,"Estill County, KY",Mar-19,5426,5127,299,5.5
1025,CN2106700000000,21,67,"Fayette County, KY",Mar-19,174435,167948,6487,3.7
1026,CN2106900000000,21,69,"Fleming County, KY",Mar-19,6195,5828,367,5.9
1027,CN2107100000000,21,71,"Floyd County, KY",Mar-19,11257,10501,756,6.7
1028,CN2107300000000,21,73,"Franklin County, KY",Mar-19,24883,23833,1050,4.2
1029,CN2107500000000,21,75,"Fulton County, KY",Mar-19,2014,1898,116,5.8
1030,CN2107700000000,21,77,"Gallatin County, KY",Mar-19,4079,3888,191,4.7
1031,CN2107900000000,21,79,"Garrard County, KY",Mar-19,7748,7357,391,5.0
1032,CN2108100000000,21,81,"Grant County, KY",Mar-19,11816,11245,571,4.8
1033,CN2108300000000,21,83,"Graves County, KY",Mar-19,15696,14870,826,5.3
1034,CN2108500000000,21,85,"Grayson County, KY",Mar-19,11003,10408,595,5.4
1035,CN2108700000000,21,87,"Green County, KY",Mar-19,5099,4862,237,4.6
1036,CN2108900000000,21,89,"Greenup County, KY",Mar-19,13553,12608,945,7.0
1037,CN2109100000000,21,91,"Hancock County, KY",Mar-19,3975,3803,172,4.3
1038,CN2109300000000,21,93,"Hardin County, KY",Mar-19,49544,47309,2235,4.5
1039,CN2109500000000,21,95,"Harlan County, KY",Mar-19,6864,6350,514,7.5
1040,CN2109700000000,21,97,"Harrison County, KY",Mar-19,8710,8293,417,4.8
1041,CN2109900000000,21,99,"Hart County, KY",Mar-19,8049,7671,378,4.7
1042,CN2110100000000,21,101,"Henderson County, KY",Mar-19,22268,21350,918,4.1
1043,CN2110300000000,21,103,"Henry County, KY",Mar-19,8193,7845,348,4.2
1044,CN2110500000000,21,105,"Hickman County, KY",Mar-19,1705,1610,95,5.6
1045,CN2110700000000,21,107,"Hopkins County, KY",Mar-19,18671,17693,978,5.2
1046,CN2110900000000,21,109,"Jackson County, KY",Mar-19,4154,3858,296,7.1
1047,CN2111100000000,21,111,"Jefferson County, KY",Mar-19,403866,386372,17494,4.3
1048,CN2111300000000,21,113,"Jessamine County, KY",Mar-19,26603,25516,1087,4.1
1049,CN2111500000000,21,115,"Johnson County, KY",Mar-19,6819,6325,494,7.2
1050,CN2111700000000,21,117,"Kenton County, KY",Mar-19,88337,84926,3411,3.9
1051,CN2111900000000,21,119,"Knott County, KY",Mar-19,4531,4200,331,7.3
1052,CN2112100000000,21,121,"Knox County, KY",Mar-19,10032,9394,638,6.4
1053,CN2112300000000,21,123,"Larue County, KY",Mar-19,6058,5755,303,5.0
1054,CN2112500000000,21,125,"Laurel County, KY",Mar-19,24908,23611,1297,5.2
1055,CN2112700000000,21,127,"Lawrence County, KY",Mar-19,5159,4772,387,7.5
1056,CN2112900000000,21,129,"Lee County, KY",Mar-19,2098,1968,130,6.2
1057,CN2113100000000,21,131,"Leslie County, KY",Mar-19,2682,2496,186,6.9
1058,CN2113300000000,21,133,"Letcher County, KY",Mar-19,6297,5867,430,6.8
1059,CN2113500000000,21,135,"Lewis County, KY",Mar-19,4679,4224,455,9.7
1060,CN2113700000000,21,137,"Lincoln County, KY",Mar-19,9543,8989,554,5.8
1061,CN2113900000000,21,139,"Livingston County, KY",Mar-19,3683,3425,258,7.0
1062,CN2114100000000,21,141,"Logan County, KY",Mar-19,12572,12028,544,4.3
1063,CN2114300000000,21,143,"Lyon County, KY",Mar-19,3047,2882,165,5.4
1064,CN2114500000000,21,145,"McCracken County, KY",Mar-19,29388,27783,1605,5.5
1065,CN2114700000000,21,147,"McCreary County, KY",Mar-19,4701,4363,338,7.2
1066,CN2114900000000,21,149,"McLean County, KY",Mar-19,4160,3946,214,5.1
1067,CN2115100000000,21,151,"Madison County, KY",Mar-19,47659,45630,2029,4.3
1068,CN2115300000000,21,153,"Magoffin County, KY",Mar-19,3106,2745,361,11.6
1069,CN2115500000000,21,155,"Marion County, KY",Mar-19,9673,9261,412,4.3
1070,CN2115700000000,21,157,"Marshall County, KY",Mar-19,15056,14206,850,5.6
1071,CN2115900000000,21,159,"Martin County, KY",Mar-19,2896,2691,205,7.1
1072,CN2116100000000,21,161,"Mason County, KY",Mar-19,7200,6763,437,6.1
1073,CN2116300000000,21,163,"Meade County, KY",Mar-19,12341,11721,620,5.0
1074,CN2116500000000,21,165,"Menifee County, KY",Mar-19,2343,2148,195,8.3
1075,CN2116700000000,21,167,"Mercer County, KY",Mar-19,10104,9607,497,4.9
1076,CN2116900000000,21,169,"Metcalfe County, KY",Mar-19,4055,3871,184,4.5
1077,CN2117100000000,21,171,"Monroe County, KY",Mar-19,4612,4394,218,4.7
1078,CN2117300000000,21,173,"Montgomery County, KY",Mar-19,11731,11033,698,6.0
1079,CN2117500000000,21,175,"Morgan County, KY",Mar-19,4626,4337,289,6.2
1080,CN2117700000000,21,177,"Muhlenberg County, KY",Mar-19,10941,10261,680,6.2
1081,CN2117900000000,21,179,"Nelson County, KY",Mar-19,23315,22119,1196,5.1
1082,CN2118100000000,21,181,"Nicholas County, KY",Mar-19,3246,3090,156,4.8
1083,CN2118300000000,21,183,"Ohio County, KY",Mar-19,9804,9248,556,5.7
1084,CN2118500000000,21,185,"Oldham County, KY",Mar-19,33545,32306,1239,3.7
1085,CN2118700000000,21,187,"Owen County, KY",Mar-19,5076,4800,276,5.4
1086,CN2118900000000,21,189,"Owsley County, KY",Mar-19,1129,1041,88,7.8
1087,CN2119100000000,21,191,"Pendleton County, KY",Mar-19,7046,6739,307,4.4
1088,CN2119300000000,21,193,"Perry County, KY",Mar-19,8382,7874,508,6.1
1089,CN2119500000000,21,195,"Pike County, KY",Mar-19,20130,18923,1207,6.0
1090,CN2119700000000,21,197,"Powell County, KY",Mar-19,5012,4702,310,6.2
1091,CN2119900000000,21,199,"Pulaski County, KY",Mar-19,26755,25264,1491,5.6
1092,CN2120100000000,21,201,"Robertson County, KY",Mar-19,788,735,53,6.7
1093,CN2120300000000,21,203,"Rockcastle County, KY",Mar-19,6732,6375,357,5.3
1094,CN2120500000000,21,205,"Rowan County, KY",Mar-19,10568,9968,600,5.7
1095,CN2120700000000,21,207,"Russell County, KY",Mar-19,6169,5743,426,6.9
1096,CN2120900000000,21,209,"Scott County, KY",Mar-19,28962,27861,1101,3.8
1097,CN2121100000000,21,211,"Shelby County, KY",Mar-19,25453,24494,959,3.8
1098,CN2121300000000,21,213,"Simpson County, KY",Mar-19,8977,8539,438,4.9
1099,CN2121500000000,21,215,"Spencer County, KY",Mar-19,10297,9891,406,3.9
1100,CN2121700000000,21,217,"Taylor County, KY",Mar-19,12755,12193,562,4.4
1101,CN2121900000000,21,219,"Todd County, KY",Mar-19,5329,5101,228,4.3
1102,CN2122100000000,21,221,"Trigg County, KY",Mar-19,5919,5592,327,5.5
1103,CN2122300000000,21,223,"Trimble County, KY",Mar-19,3875,3687,188,4.9
1104,CN2122500000000,21,225,"Union County, KY",Mar-19,6031,5716,315,5.2
1105,CN2122700000000,21,227,"Warren County, KY",Mar-19,65790,63033,2757,4.2
1106,CN2122900000000,21,229,"Washington County, KY",Mar-19,6179,5900,279,4.5
1107,CN2123100000000,21,231,"Wayne County, KY",Mar-19,7314,6810,504,6.9
1108,CN2123300000000,21,233,"Webster County, KY",Mar-19,5708,5447,261,4.6
1109,CN2123500000000,21,235,"Whitley County, KY",Mar-19,13812,13058,754,5.5
1110,CN2123700000000,21,237,"Wolfe County, KY",Mar-19,1981,1826,155,7.8
1111,CN2123900000000,21,239,"Woodford County, KY",Mar-19,14282,13788,494,3.5
1112,CN2200100000000,22,1,"Acadia Parish, LA",Mar-19,23643,22563,1080,4.6
1113,CN2200300000000,22,3,"Allen Parish, LA",Mar-19,8665,8251,414,4.8
1114,CN2200500000000,22,5,"Ascension Parish, LA",Mar-19,64287,62061,2226,3.5
1115,CN2200700000000,22,7,"Assumption Parish, LA",Mar-19,8789,8297,492,5.6
1116,CN2200900000000,22,9,"Avoyelles Parish, LA",Mar-19,14989,14283,706,4.7
1117,CN2201100000000,22,11,"Beauregard Parish, LA",Mar-19,14354,13702,652,4.5
1118,CN2201300000000,22,13,"Bienville Parish, LA",Mar-19,5474,5182,292,5.3
1119,CN2201500000000,22,15,"Bossier Parish, LA",Mar-19,57355,55274,2081,3.6
1120,CN2201700000000,22,17,"Caddo Parish, LA",Mar-19,102797,98099,4698,4.6
1121,CN2201900000000,22,19,"Calcasieu Parish, LA",Mar-19,107098,103483,3615,3.4
1122,CN2202100000000,22,21,"Caldwell Parish, LA",Mar-19,3773,3573,200,5.3
1123,CN2202300000000,22,23,"Cameron Parish, LA",Mar-19,3981,3852,129,3.2
1124,CN2202500000000,22,25,"Catahoula Parish, LA",Mar-19,3256,3074,182,5.6
1125,CN2202700000000,22,27,"Claiborne Parish, LA",Mar-19,5797,5519,278,4.8
1126,CN2202900000000,22,29,"Concordia Parish, LA",Mar-19,6766,6374,392,5.8
1127,CN2203100000000,22,31,"De Soto Parish, LA",Mar-19,10789,10231,558,5.2
1128,CN2203300000000,22,33,"East Baton Rouge Parish, LA",Mar-19,231235,222994,8241,3.6
1129,CN2203500000000,22,35,"East Carroll Parish, LA",Mar-19,1858,1677,181,9.7
1130,CN2203700000000,22,37,"East Feliciana Parish, LA",Mar-19,8002,7692,310,3.9
1131,CN2203900000000,22,39,"Evangeline Parish, LA",Mar-19,11874,11278,596,5.0
1132,CN2204100000000,22,41,"Franklin Parish, LA",Mar-19,7230,6767,463,6.4
1133,CN2204300000000,22,43,"Grant Parish, LA",Mar-19,8046,7670,376,4.7
1134,CN2204500000000,22,45,"Iberia Parish, LA",Mar-19,27816,26536,1280,4.6
1135,CN2204700000000,22,47,"Iberville Parish, LA",Mar-19,14095,13377,718,5.1
1136,CN2204900000000,22,49,"Jackson Parish, LA",Mar-19,6720,6437,283,4.2
1137,CN2205100000000,22,51,"Jefferson Parish, LA",Mar-19,211400,203702,7698,3.6
1138,CN2205300000000,22,53,"Jefferson Davis Parish, LA",Mar-19,12978,12455,523,4.0
1139,CN2205500000000,22,55,"Lafayette Parish, LA",Mar-19,112675,108523,4152,3.7
1140,CN2205700000000,22,57,"Lafourche Parish, LA",Mar-19,41520,39904,1616,3.9
1141,CN2205900000000,22,59,"LaSalle Parish, LA",Mar-19,6597,6360,237,3.6
1142,CN2206100000000,22,61,"Lincoln Parish, LA",Mar-19,22073,21092,981,4.4
1143,CN2206300000000,22,63,"Livingston Parish, LA",Mar-19,69064,66683,2381,3.4
1144,CN2206500000000,22,65,"Madison Parish, LA",Mar-19,3472,3226,246,7.1
1145,CN2206700000000,22,67,"Morehouse Parish, LA",Mar-19,10023,9293,730,7.3
1146,CN2206900000000,22,69,"Natchitoches Parish, LA",Mar-19,16234,15435,799,4.9
1147,CN2207100000000,22,71,"Orleans Parish, LA",Mar-19,176441,169186,7255,4.1
1148,CN2207300000000,22,73,"Ouachita Parish, LA",Mar-19,70085,66854,3231,4.6
1149,CN2207500000000,22,75,"Plaquemines Parish, LA",Mar-19,9950,9579,371,3.7
1150,CN2207700000000,22,77,"Pointe Coupee Parish, LA",Mar-19,9900,9445,455,4.6
1151,CN2207900000000,22,79,"Rapides Parish, LA",Mar-19,54513,52108,2405,4.4
1152,CN2208100000000,22,81,"Red River Parish, LA",Mar-19,3730,3577,153,4.1
1153,CN2208300000000,22,83,"Richland Parish, LA",Mar-19,8217,7747,470,5.7
1154,CN2208500000000,22,85,"Sabine Parish, LA",Mar-19,9042,8642,400,4.4
1155,CN2208700000000,22,87,"St. Bernard Parish, LA",Mar-19,19601,18780,821,4.2
1156,CN2208900000000,22,89,"St. Charles Parish, LA",Mar-19,24826,23925,901,3.6
1157,CN2209100000000,22,91,"St. Helena Parish, LA",Mar-19,4276,4060,216,5.1
1158,CN2209300000000,22,93,"St. James Parish, LA",Mar-19,9097,8637,460,5.1
1159,CN2209500000000,22,95,"St. John the Baptist Parish, LA",Mar-19,19378,18454,924,4.8
1160,CN2209700000000,22,97,"St. Landry Parish, LA",Mar-19,31521,29809,1712,5.4
1161,CN2209900000000,22,99,"St. Martin Parish, LA",Mar-19,22029,21054,975,4.4
1162,CN2210100000000,22,101,"St. Mary Parish, LA",Mar-19,19580,18516,1064,5.4
1163,CN2210300000000,22,103,"St. Tammany Parish, LA",Mar-19,117870,113689,4181,3.5
1164,CN2210500000000,22,105,"Tangipahoa Parish, LA",Mar-19,53752,51246,2506,4.7
1165,CN2210700000000,22,107,"Tensas Parish, LA",Mar-19,1373,1287,86,6.3
1166,CN2210900000000,22,109,"Terrebonne Parish, LA",Mar-19,45767,43920,1847,4.0
1167,CN2211100000000,22,111,"Union Parish, LA",Mar-19,9124,8640,484,5.3
1168,CN2211300000000,22,113,"Vermilion Parish, LA",Mar-19,23899,22823,1076,4.5
1169,CN2211500000000,22,115,"Vernon Parish, LA",Mar-19,15526,14701,825,5.3
1170,CN2211700000000,22,117,"Washington Parish, LA",Mar-19,16588,15723,865,5.2
1171,CN2211900000000,22,119,"Webster Parish, LA",Mar-19,14393,13647,746,5.2
1172,CN2212100000000,22,121,"West Baton Rouge Parish, LA",Mar-19,13710,13187,523,3.8
1173,CN2212300000000,22,123,"West Carroll Parish, LA",Mar-19,3649,3227,422,11.6
1174,CN2212500000000,22,125,"West Feliciana Parish, LA",Mar-19,5407,5220,187,3.5
1175,CN2212700000000,22,127,"Winn Parish, LA",Mar-19,4825,4565,260,5.4
1176,CN2300100000000,23,1,"Androscoggin County, ME",Mar-19,55279,53251,2028,3.7
1177,CN2300300000000,23,3,"Aroostook County, ME",Mar-19,30397,28768,1629,5.4
1178,CN2300500000000,23,5,"Cumberland County, ME",Mar-19,162236,157501,4735,2.9
1179,CN2300700000000,23,7,"Franklin County, ME",Mar-19,14715,14088,627,4.3
1180,CN2300900000000,23,9,"Hancock County, ME",Mar-19,27264,25754,1510,5.5
1181,CN2301100000000,23,11,"Kennebec County, ME",Mar-19,61892,59617,2275,3.7
1182,CN2301300000000,23,13,"Knox County, ME",Mar-19,19709,18882,827,4.2
1183,CN2301500000000,23,15,"Lincoln County, ME",Mar-19,16030,15359,671,4.2
1184,CN2301700000000,23,17,"Oxford County, ME",Mar-19,26547,25352,1195,4.5
1185,CN2301900000000,23,19,"Penobscot County, ME",Mar-19,76469,73374,3095,4.0
1186,CN2302100000000,23,21,"Piscataquis County, ME",Mar-19,7234,6882,352,4.9
1187,CN2302300000000,23,23,"Sagadahoc County, ME",Mar-19,19357,18779,578,3.0
1188,CN2302500000000,23,25,"Somerset County, ME",Mar-19,22362,21136,1226,5.5
1189,CN2302700000000,23,27,"Waldo County, ME",Mar-19,20358,19505,853,4.2
1190,CN2302900000000,23,29,"Washington County, ME",Mar-19,13513,12664,849,6.3
1191,CN2303100000000,23,31,"York County, ME",Mar-19,111888,107853,4035,3.6
1192,CN2400100000000,24,1,"Allegany County, MD",Mar-19,32727,31006,1721,5.3
1193,CN2400300000000,24,3,"Anne Arundel County, MD",Mar-19,315309,305268,10041,3.2
1194,CN2400500000000,24,5,"Baltimore County, MD",Mar-19,454048,436439,17609,3.9
1195,CN2400900000000,24,9,"Calvert County, MD",Mar-19,50248,48604,1644,3.3
1196,CN2401100000000,24,11,"Caroline County, MD",Mar-19,18503,17767,736,4.0
1197,CN2401300000000,24,13,"Carroll County, MD",Mar-19,96454,93439,3015,3.1
1198,CN2401500000000,24,15,"Cecil County, MD",Mar-19,53746,51397,2349,4.4
1199,CN2401700000000,24,17,"Charles County, MD",Mar-19,87524,84310,3214,3.7
1200,CN2401900000000,24,19,"Dorchester County, MD",Mar-19,15663,14839,824,5.3
1201,CN2402100000000,24,21,"Frederick County, MD",Mar-19,135174,130672,4502,3.3
1202,CN2402300000000,24,23,"Garrett County, MD",Mar-19,15954,15152,802,5.0
1203,CN2402500000000,24,25,"Harford County, MD",Mar-19,141096,136145,4951,3.5
1204,CN2402700000000,24,27,"Howard County, MD",Mar-19,187539,182176,5363,2.9
1205,CN2402900000000,24,29,"Kent County, MD",Mar-19,10565,10104,461,4.4
1206,CN2403100000000,24,31,"Montgomery County, MD",Mar-19,561776,544507,17269,3.1
1207,CN2403300000000,24,33,"Prince George's County, MD",Mar-19,510971,491563,19408,3.8
1208,CN2403500000000,24,35,"Queen Anne's County, MD",Mar-19,28388,27436,952,3.4
1209,CN2403700000000,24,37,"St. Mary's County, MD",Mar-19,57357,55349,2008,3.5
1210,CN2403900000000,24,39,"Somerset County, MD",Mar-19,9210,8613,597,6.5
1211,CN2404100000000,24,41,"Talbot County, MD",Mar-19,19291,18514,777,4.0
1212,CN2404300000000,24,43,"Washington County, MD",Mar-19,74792,71507,3285,4.4
1213,CN2404500000000,24,45,"Wicomico County, MD",Mar-19,49983,47430,2553,5.1
1214,CN2404700000000,24,47,"Worcester County, MD",Mar-19,25555,23137,2418,9.5
1215,CN2451000000000,24,510,"Baltimore city, MD",Mar-19,287840,272923,14917,5.2
1216,CN2500100000000,25,1,"Barnstable County, MA",Mar-19,108374,102156,6218,5.7
1217,CN2500300000000,25,3,"Berkshire County, MA",Mar-19,64618,61843,2775,4.3
1218,CN2500500000000,25,5,"Bristol County, MA",Mar-19,304292,290983,13309,4.4
1219,CN2500700000000,25,7,"Dukes County, MA",Mar-19,8155,7561,594,7.3
1220,CN2500900000000,25,9,"Essex County, MA",Mar-19,429545,415295,14250,3.3
1221,CN2501100000000,25,11,"Franklin County, MA",Mar-19,41212,39895,1317,3.2
1222,CN2501300000000,25,13,"Hampden County, MA",Mar-19,231251,220902,10349,4.5
1223,CN2501500000000,25,15,"Hampshire County, MA",Mar-19,91300,88515,2785,3.1
1224,CN2501700000000,25,17,"Middlesex County, MA",Mar-19,926480,903064,23416,2.5
1225,CN2501900000000,25,19,"Nantucket County/town, MA",Mar-19,6212,5644,568,9.1
1226,CN2502100000000,25,21,"Norfolk County, MA",Mar-19,394153,383387,10766,2.7
1227,CN2502300000000,25,23,"Plymouth County, MA",Mar-19,285313,275417,9896,3.5
1228,CN2502500000000,25,25,"Suffolk County, MA",Mar-19,459164,446742,12422,2.7
1229,CN2502700000000,25,27,"Worcester County, MA",Mar-19,451158,435186,15972,3.5
1230,CN2600100000000,26,1,"Alcona County, MI",Mar-19,3780,3461,319,8.4
1231,CN2600300000000,26,3,"Alger County, MI",Mar-19,3069,2765,304,9.9
1232,CN2600500000000,26,5,"Allegan County, MI",Mar-19,61911,59504,2407,3.9
1233,CN2600700000000,26,7,"Alpena County, MI",Mar-19,13284,12471,813,6.1
1234,CN2600900000000,26,9,"Antrim County, MI",Mar-19,9899,9194,705,7.1
1235,CN2601100000000,26,11,"Arenac County, MI",Mar-19,5953,5419,534,9.0
1236,CN2601300000000,26,13,"Baraga County, MI",Mar-19,3147,2895,252,8.0
1237,CN2601500000000,26,15,"Barry County, MI",Mar-19,31883,30623,1260,4.0
1238,CN2601700000000,26,17,"Bay County, MI",Mar-19,50299,47524,2775,5.5
1239,CN2601900000000,26,19,"Benzie County, MI",Mar-19,8635,8003,632,7.3
1240,CN2602100000000,26,21,"Berrien County, MI",Mar-19,73588,70161,3427,4.7
1241,CN2602300000000,26,23,"Branch County, MI",Mar-19,19227,18414,813,4.2
1242,CN2602500000000,26,25,"Calhoun County, MI",Mar-19,63089,60167,2922,4.6
1243,CN2602700000000,26,27,"Cass County, MI",Mar-19,24770,23576,1194,4.8
1244,CN2602900000000,26,29,"Charlevoix County, MI",Mar-19,12555,11758,797,6.3
1245,CN2603100000000,26,31,"Cheboygan County, MI",Mar-19,10418,8624,1794,17.2
1246,CN2603300000000,26,33,"Chippewa County, MI",Mar-19,16134,14790,1344,8.3
1247,CN2603500000000,26,35,"Clare County, MI",Mar-19,11773,10853,920,7.8
1248,CN2603700000000,26,37,"Clinton County, MI",Mar-19,41543,40125,1418,3.4
1249,CN2603900000000,26,39,"Crawford County, MI",Mar-19,5469,5079,390,7.1
1250,CN2604100000000,26,41,"Delta County, MI",Mar-19,17019,15942,1077,6.3
1251,CN2604300000000,26,43,"Dickinson County, MI",Mar-19,12212,11636,576,4.7
1252,CN2604500000000,26,45,"Eaton County, MI",Mar-19,57859,55743,2116,3.7
1253,CN2604700000000,26,47,"Emmet County, MI",Mar-19,17006,15612,1394,8.2
1254,CN2604900000000,26,49,"Genesee County, MI",Mar-19,182521,172612,9909,5.4
1255,CN2605100000000,26,51,"Gladwin County, MI",Mar-19,9895,9230,665,6.7
1256,CN2605300000000,26,53,"Gogebic County, MI",Mar-19,6233,5863,370,5.9
1257,CN2605500000000,26,55,"Grand Traverse County, MI",Mar-19,47919,45676,2243,4.7
1258,CN2605700000000,26,57,"Gratiot County, MI",Mar-19,18001,17066,935,5.2
1259,CN2605900000000,26,59,"Hillsdale County, MI",Mar-19,20357,19397,960,4.7
1260,CN2606100000000,26,61,"Houghton County, MI",Mar-19,16708,15724,984,5.9
1261,CN2606300000000,26,63,"Huron County, MI",Mar-19,15247,14351,896,5.9
1262,CN2606500000000,26,65,"Ingham County, MI",Mar-19,153000,147164,5836,3.8
1263,CN2606700000000,26,67,"Ionia County, MI",Mar-19,30150,28954,1196,4.0
1264,CN2606900000000,26,69,"Iosco County, MI",Mar-19,9899,9103,796,8.0
1265,CN2607100000000,26,71,"Iron County, MI",Mar-19,5183,4817,366,7.1
1266,CN2607300000000,26,73,"Isabella County, MI",Mar-19,34714,33116,1598,4.6
1267,CN2607500000000,26,75,"Jackson County, MI",Mar-19,74845,71640,3205,4.3
1268,CN2607700000000,26,77,"Kalamazoo County, MI",Mar-19,134833,129871,4962,3.7
1269,CN2607900000000,26,79,"Kalkaska County, MI",Mar-19,7710,7110,600,7.8
1270,CN2608100000000,26,81,"Kent County, MI",Mar-19,361986,350291,11695,3.2
1271,CN2608300000000,26,83,"Keweenaw County, MI",Mar-19,909,837,72,7.9
1272,CN2608500000000,26,85,"Lake County, MI",Mar-19,3613,3329,284,7.9
1273,CN2608700000000,26,87,"Lapeer County, MI",Mar-19,41775,38956,2819,6.7
1274,CN2608900000000,26,89,"Leelanau County, MI",Mar-19,10194,9609,585,5.7
1275,CN2609100000000,26,91,"Lenawee County, MI",Mar-19,46609,44561,2048,4.4
1276,CN2609300000000,26,93,"Livingston County, MI",Mar-19,104109,100048,4061,3.9
1277,CN2609500000000,26,95,"Luce County, MI",Mar-19,2309,2140,169,7.3
1278,CN2609700000000,26,97,"Mackinac County, MI",Mar-19,4536,3601,935,20.6
1279,CN2609900000000,26,99,"Macomb County, MI",Mar-19,450368,429523,20845,4.6
1280,CN2610100000000,26,101,"Manistee County, MI",Mar-19,9982,9253,729,7.3
1281,CN2610300000000,26,103,"Marquette County, MI",Mar-19,32889,30952,1937,5.9
1282,CN2610500000000,26,105,"Mason County, MI",Mar-19,13275,12446,829,6.2
1283,CN2610700000000,26,107,"Mecosta County, MI",Mar-19,18495,17448,1047,5.7
1284,CN2610900000000,26,109,"Menominee County, MI",Mar-19,10950,10450,500,4.6
1285,CN2611100000000,26,111,"Midland County, MI",Mar-19,40736,38921,1815,4.5
1286,CN2611300000000,26,113,"Missaukee County, MI",Mar-19,6916,6481,435,6.3
1287,CN2611500000000,26,115,"Monroe County, MI",Mar-19,75770,72507,3263,4.3
1288,CN2611700000000,26,117,"Montcalm County, MI",Mar-19,28606,27182,1424,5.0
1289,CN2611900000000,26,119,"Montmorency County, MI",Mar-19,2947,2621,326,11.1
1290,CN2612100000000,26,121,"Muskegon County, MI",Mar-19,76784,73077,3707,4.8
1291,CN2612300000000,26,123,"Newaygo County, MI",Mar-19,23111,21912,1199,5.2
1292,CN2612500000000,26,125,"Oakland County, MI",Mar-19,678266,652839,25427,3.7
1293,CN2612700000000,26,127,"Oceana County, MI",Mar-19,11701,10705,996,8.5
1294,CN2612900000000,26,129,"Ogemaw County, MI",Mar-19,7825,7097,728,9.3
1295,CN2613100000000,26,131,"Ontonagon County, MI",Mar-19,2094,1912,182,8.7
1296,CN2613300000000,26,133,"Osceola County, MI",Mar-19,11098,10525,573,5.2
1297,CN2613500000000,26,135,"Oscoda County, MI",Mar-19,2866,2631,235,8.2
1298,CN2613700000000,26,137,"Otsego County, MI",Mar-19,11447,10758,689,6.0
1299,CN2613900000000,26,139,"Ottawa County, MI",Mar-19,161892,156789,5103,3.2
1300,CN2614100000000,26,141,"Presque Isle County, MI",Mar-19,4889,4352,537,11.0
1301,CN2614300000000,26,143,"Roscommon County, MI",Mar-19,7462,6701,761,10.2
1302,CN2614500000000,26,145,"Saginaw County, MI",Mar-19,87158,82420,4738,5.4
1303,CN2614700000000,26,147,"St. Clair County, MI",Mar-19,76502,72022,4480,5.9
1304,CN2614900000000,26,149,"St. Joseph County, MI",Mar-19,27977,26774,1203,4.3
1305,CN2615100000000,26,151,"Sanilac County, MI",Mar-19,19379,18232,1147,5.9
1306,CN2615300000000,26,153,"Schoolcraft County, MI",Mar-19,3283,2976,307,9.4
1307,CN2615500000000,26,155,"Shiawassee County, MI",Mar-19,33725,32016,1709,5.1
1308,CN2615700000000,26,157,"Tuscola County, MI",Mar-19,23910,22428,1482,6.2
1309,CN2615900000000,26,159,"Van Buren County, MI",Mar-19,35468,33506,1962,5.5
1310,CN2616100000000,26,161,"Washtenaw County, MI",Mar-19,199992,193741,6251,3.1
1311,CN2616300000000,26,163,"Wayne County, MI",Mar-19,807165,763927,43238,5.4
1312,CN2616500000000,26,165,"Wexford County, MI",Mar-19,14770,13986,784,5.3
1313,CN2700100000000,27,1,"Aitkin County, MN",Mar-19,7236,6609,627,8.7
1314,CN2700300000000,27,3,"Anoka County, MN",Mar-19,198820,191511,7309,3.7
1315,CN2700500000000,27,5,"Becker County, MN",Mar-19,18505,17420,1085,5.9
1316,CN2700700000000,27,7,"Beltrami County, MN",Mar-19,24443,23145,1298,5.3
1317,CN2700900000000,27,9,"Benton County, MN",Mar-19,22256,21084,1172,5.3
1318,CN2701100000000,27,11,"Big Stone County, MN",Mar-19,2417,2256,161,6.7
1319,CN2701300000000,27,13,"Blue Earth County, MN",Mar-19,40837,39494,1343,3.3
1320,CN2701500000000,27,15,"Brown County, MN",Mar-19,14197,13478,719,5.1
1321,CN2701700000000,27,17,"Carlton County, MN",Mar-19,18090,17079,1011,5.6
1322,CN2701900000000,27,19,"Carver County, MN",Mar-19,58602,56770,1832,3.1
1323,CN2702100000000,27,21,"Cass County, MN",Mar-19,13789,12704,1085,7.9
1324,CN2702300000000,27,23,"Chippewa County, MN",Mar-19,6949,6592,357,5.1
1325,CN2702500000000,27,25,"Chisago County, MN",Mar-19,30317,28739,1578,5.2
1326,CN2702700000000,27,27,"Clay County, MN",Mar-19,36217,34767,1450,4.0
1327,CN2702900000000,27,29,"Clearwater County, MN",Mar-19,4508,3976,532,11.8
1328,CN2703100000000,27,31,"Cook County, MN",Mar-19,2891,2716,175,6.1
1329,CN2703300000000,27,33,"Cottonwood County, MN",Mar-19,5846,5595,251,4.3
1330,CN2703500000000,27,35,"Crow Wing County, MN",Mar-19,31653,29768,1885,6.0
1331,CN2703700000000,27,37,"Dakota County, MN",Mar-19,242654,234652,8002,3.3
1332,CN2703900000000,27,39,"Dodge County, MN",Mar-19,11925,11357,568,4.8
1333,CN2704100000000,27,41,"Douglas County, MN",Mar-19,20720,19847,873,4.2
1334,CN2704300000000,27,43,"Faribault County, MN",Mar-19,6855,6511,344,5.0
1335,CN2704500000000,27,45,"Fillmore County, MN",Mar-19,11521,10957,564,4.9
1336,CN2704700000000,27,47,"Freeborn County, MN",Mar-19,16031,15330,701,4.4
1337,CN2704900000000,27,49,"Goodhue County, MN",Mar-19,26870,25828,1042,3.9
1338,CN2705100000000,27,51,"Grant County, MN",Mar-19,3280,3082,198,6.0
1339,CN2705300000000,27,53,"Hennepin County, MN",Mar-19,707163,686013,21150,3.0
1340,CN2705500000000,27,55,"Houston County, MN",Mar-19,10478,10004,474,4.5
1341,CN2705700000000,27,57,"Hubbard County, MN",Mar-19,9741,9009,732,7.5
1342,CN2705900000000,27,59,"Isanti County, MN",Mar-19,21597,20401,1196,5.5
1343,CN2706100000000,27,61,"Itasca County, MN",Mar-19,21852,20314,1538,7.0
1344,CN2706300000000,27,63,"Jackson County, MN",Mar-19,5628,5409,219,3.9
1345,CN2706500000000,27,65,"Kanabec County, MN",Mar-19,9173,8347,826,9.0
1346,CN2706700000000,27,67,"Kandiyohi County, MN",Mar-19,24243,23087,1156,4.8
1347,CN2706900000000,27,69,"Kittson County, MN",Mar-19,2295,2193,102,4.4
1348,CN2707100000000,27,71,"Koochiching County, MN",Mar-19,5911,5554,357,6.0
1349,CN2707300000000,27,73,"Lac qui Parle County, MN",Mar-19,3523,3333,190,5.4
1350,CN2707500000000,27,75,"Lake County, MN",Mar-19,5418,5167,251,4.6
1351,CN2707700000000,27,77,"Lake of the Woods County, MN",Mar-19,2459,2366,93,3.8
1352,CN2707900000000,27,79,"Le Sueur County, MN",Mar-19,16398,15305,1093,6.7
1353,CN2708100000000,27,81,"Lincoln County, MN",Mar-19,3141,2974,167,5.3
1354,CN2708300000000,27,83,"Lyon County, MN",Mar-19,14582,13998,584,4.0
1355,CN2708500000000,27,85,"McLeod County, MN",Mar-19,19358,18423,935,4.8
1356,CN2708700000000,27,87,"Mahnomen County, MN",Mar-19,2322,2182,140,6.0
1357,CN2708900000000,27,89,"Marshall County, MN",Mar-19,5379,4894,485,9.0
1358,CN2709100000000,27,91,"Martin County, MN",Mar-19,9897,9478,419,4.2
1359,CN2709300000000,27,93,"Meeker County, MN",Mar-19,13331,12595,736,5.5
1360,CN2709500000000,27,95,"Mille Lacs County, MN",Mar-19,13237,12179,1058,8.0
1361,CN2709700000000,27,97,"Morrison County, MN",Mar-19,17655,16334,1321,7.5
1362,CN2709900000000,27,99,"Mower County, MN",Mar-19,20374,19621,753,3.7
1363,CN2710100000000,27,101,"Murray County, MN",Mar-19,4821,4502,319,6.6
1364,CN2710300000000,27,103,"Nicollet County, MN",Mar-19,21000,20357,643,3.1
1365,CN2710500000000,27,105,"Nobles County, MN",Mar-19,10969,10573,396,3.6
1366,CN2710700000000,27,107,"Norman County, MN",Mar-19,3253,3037,216,6.6
1367,CN2710900000000,27,109,"Olmsted County, MN",Mar-19,88856,86132,2724,3.1
1368,CN2711100000000,27,111,"Otter Tail County, MN",Mar-19,30761,28998,1763,5.7
1369,CN2711300000000,27,113,"Pennington County, MN",Mar-19,8944,8343,601,6.7
1370,CN2711500000000,27,115,"Pine County, MN",Mar-19,15109,13918,1191,7.9
1371,CN2711700000000,27,117,"Pipestone County, MN",Mar-19,4777,4513,264,5.5
1372,CN2711900000000,27,119,"Polk County, MN",Mar-19,16664,15842,822,4.9
1373,CN2712100000000,27,121,"Pope County, MN",Mar-19,6407,6140,267,4.2
1374,CN2712300000000,27,123,"Ramsey County, MN",Mar-19,290127,280672,9455,3.3
1375,CN2712500000000,27,125,"Red Lake County, MN",Mar-19,2235,2060,175,7.8
1376,CN2712700000000,27,127,"Redwood County, MN",Mar-19,7555,7178,377,5.0
1377,CN2712900000000,27,129,"Renville County, MN",Mar-19,8529,8005,524,6.1
1378,CN2713100000000,27,131,"Rice County, MN",Mar-19,37134,35704,1430,3.9
1379,CN2713300000000,27,133,"Rock County, MN",Mar-19,5596,5435,161,2.9
1380,CN2713500000000,27,135,"Roseau County, MN",Mar-19,7943,7554,389,4.9
1381,CN2713700000000,27,137,"St. Louis County, MN",Mar-19,103027,98250,4777,4.6
1382,CN2713900000000,27,139,"Scott County, MN",Mar-19,83885,81188,2697,3.2
1383,CN2714100000000,27,141,"Sherburne County, MN",Mar-19,53018,50550,2468,4.7
1384,CN2714300000000,27,143,"Sibley County, MN",Mar-19,8505,8064,441,5.2
1385,CN2714500000000,27,145,"Stearns County, MN",Mar-19,91085,87375,3710,4.1
1386,CN2714700000000,27,147,"Steele County, MN",Mar-19,20888,20081,807,3.9
1387,CN2714900000000,27,149,"Stevens County, MN",Mar-19,5358,5170,188,3.5
1388,CN2715100000000,27,151,"Swift County, MN",Mar-19,4791,4547,244,5.1
1389,CN2715300000000,27,153,"Todd County, MN",Mar-19,13553,12699,854,6.3
1390,CN2715500000000,27,155,"Traverse County, MN",Mar-19,1734,1643,91,5.2
1391,CN2715700000000,27,157,"Wabasha County, MN",Mar-19,12198,11698,500,4.1
1392,CN2715900000000,27,159,"Wadena County, MN",Mar-19,6000,5480,520,8.7
1393,CN2716100000000,27,161,"Waseca County, MN",Mar-19,8833,8395,438,5.0
1394,CN2716300000000,27,163,"Washington County, MN",Mar-19,143974,139245,4729,3.3
1395,CN2716500000000,27,165,"Watonwan County, MN",Mar-19,6440,6094,346,5.4
1396,CN2716700000000,27,167,"Wilkin County, MN",Mar-19,3437,3285,152,4.4
1397,CN2716900000000,27,169,"Winona County, MN",Mar-19,28922,27966,956,3.3
1398,CN2717100000000,27,171,"Wright County, MN",Mar-19,76239,72984,3255,4.3
1399,CN2717300000000,27,173,"Yellow Medicine County, MN",Mar-19,5293,5018,275,5.2
1400,CN2800100000000,28,1,"Adams County, MS",Mar-19,11013,10236,777,7.1
1401,CN2800300000000,28,3,"Alcorn County, MS",Mar-19,16210,15513,697,4.3
1402,CN2800500000000,28,5,"Amite County, MS",Mar-19,4402,4129,273,6.2
1403,CN2800700000000,28,7,"Attala County, MS",Mar-19,7004,6558,446,6.4
1404,CN2800900000000,28,9,"Benton County, MS",Mar-19,3016,2849,167,5.5
1405,CN2801100000000,28,11,"Bolivar County, MS",Mar-19,12371,11591,780,6.3
1406,CN2801300000000,28,13,"Calhoun County, MS",Mar-19,5672,5378,294,5.2
1407,CN2801500000000,28,15,"Carroll County, MS",Mar-19,3450,3251,199,5.8
1408,CN2801700000000,28,17,"Chickasaw County, MS",Mar-19,6959,6610,349,5.0
1409,CN2801900000000,28,19,"Choctaw County, MS",Mar-19,3804,3601,203,5.3
1410,CN2802100000000,28,21,"Claiborne County, MS",Mar-19,2985,2730,255,8.5
1411,CN2802300000000,28,23,"Clarke County, MS",Mar-19,5996,5660,336,5.6
1412,CN2802500000000,28,25,"Clay County, MS",Mar-19,7737,7198,539,7.0
1413,CN2802700000000,28,27,"Coahoma County, MS",Mar-19,8385,7730,655,7.8
1414,CN2802900000000,28,29,"Copiah County, MS",Mar-19,11214,10485,729,6.5
1415,CN2803100000000,28,31,"Covington County, MS",Mar-19,8057,7692,365,4.5
1416,CN2803300000000,28,33,"DeSoto County, MS",Mar-19,90536,86775,3761,4.2
1417,CN2803500000000,28,35,"Forrest County, MS",Mar-19,33087,31488,1599,4.8
1418,CN2803700000000,28,37,"Franklin County, MS",Mar-19,2826,2657,169,6.0
1419,CN2803900000000,28,39,"George County, MS",Mar-19,8757,8199,558,6.4
1420,CN2804100000000,28,41,"Greene County, MS",Mar-19,4314,4022,292,6.8
1421,CN2804300000000,28,43,"Grenada County, MS",Mar-19,9626,9180,446,4.6
1422,CN2804500000000,28,45,"Hancock County, MS",Mar-19,18584,17573,1011,5.4
1423,CN2804700000000,28,47,"Harrison County, MS",Mar-19,85426,81263,4163,4.9
1424,CN2804900000000,28,49,"Hinds County, MS",Mar-19,106546,101210,5336,5.0
1425,CN2805100000000,28,51,"Holmes County, MS",Mar-19,5667,5116,551,9.7
1426,CN2805300000000,28,53,"Humphreys County, MS",Mar-19,2260,2028,232,10.3
1427,CN2805500000000,28,55,"Issaquena County, MS",Mar-19,378,330,48,12.7
1428,CN2805700000000,28,57,"Itawamba County, MS",Mar-19,10428,9965,463,4.4
1429,CN2805900000000,28,59,"Jackson County, MS",Mar-19,57902,54530,3372,5.8
1430,CN2806100000000,28,61,"Jasper County, MS",Mar-19,6205,5807,398,6.4
1431,CN2806300000000,28,63,"Jefferson County, MS",Mar-19,1992,1719,273,13.7
1432,CN2806500000000,28,65,"Jefferson Davis County, MS",Mar-19,4149,3887,262,6.3
1433,CN2806700000000,28,67,"Jones County, MS",Mar-19,26307,24992,1315,5.0
1434,CN2806900000000,28,69,"Kemper County, MS",Mar-19,3585,3346,239,6.7
1435,CN2807100000000,28,71,"Lafayette County, MS",Mar-19,28101,27006,1095,3.9
1436,CN2807300000000,28,73,"Lamar County, MS",Mar-19,30571,29338,1233,4.0
1437,CN2807500000000,28,75,"Lauderdale County, MS",Mar-19,30935,29377,1558,5.0
1438,CN2807700000000,28,77,"Lawrence County, MS",Mar-19,4675,4388,287,6.1
1439,CN2807900000000,28,79,"Leake County, MS",Mar-19,8027,7608,419,5.2
1440,CN2808100000000,28,81,"Lee County, MS",Mar-19,40708,39058,1650,4.1
1441,CN2808300000000,28,83,"Leflore County, MS",Mar-19,9983,9240,743,7.4
1442,CN2808500000000,28,85,"Lincoln County, MS",Mar-19,14455,13694,761,5.3
1443,CN2808700000000,28,87,"Lowndes County, MS",Mar-19,25308,24035,1273,5.0
1444,CN2808900000000,28,89,"Madison County, MS",Mar-19,53104,50852,2252,4.2
1445,CN2809100000000,28,91,"Marion County, MS",Mar-19,9871,9352,519,5.3
1446,CN2809300000000,28,93,"Marshall County, MS",Mar-19,14327,13591,736,5.1
1447,CN2809500000000,28,95,"Monroe County, MS",Mar-19,15260,14485,775,5.1
1448,CN2809700000000,28,97,"Montgomery County, MS",Mar-19,3979,3752,227,5.7
1449,CN2809900000000,28,99,"Neshoba County, MS",Mar-19,10146,9605,541,5.3
1450,CN2810100000000,28,101,"Newton County, MS",Mar-19,8778,8341,437,5.0
1451,CN2810300000000,28,103,"Noxubee County, MS",Mar-19,3775,3520,255,6.8
1452,CN2810500000000,28,105,"Oktibbeha County, MS",Mar-19,22427,21326,1101,4.9
1453,CN2810700000000,28,107,"Panola County, MS",Mar-19,12543,11745,798,6.4
1454,CN2810900000000,28,109,"Pearl River County, MS",Mar-19,23692,22533,1159,4.9
1455,CN2811100000000,28,111,"Perry County, MS",Mar-19,4265,3999,266,6.2
1456,CN2811300000000,28,113,"Pike County, MS",Mar-19,14453,13587,866,6.0
1457,CN2811500000000,28,115,"Pontotoc County, MS",Mar-19,14614,14028,586,4.0
1458,CN2811700000000,28,117,"Prentiss County, MS",Mar-19,11349,10808,541,4.8
1459,CN2811900000000,28,119,"Quitman County, MS",Mar-19,2407,2220,187,7.8
1460,CN2812100000000,28,121,"Rankin County, MS",Mar-19,75799,73003,2796,3.7
1461,CN2812300000000,28,123,"Scott County, MS",Mar-19,12616,12097,519,4.1
1462,CN2812500000000,28,125,"Sharkey County, MS",Mar-19,1615,1471,144,8.9
1463,CN2812700000000,28,127,"Simpson County, MS",Mar-19,10724,10201,523,4.9
1464,CN2812900000000,28,129,"Smith County, MS",Mar-19,6853,6513,340,5.0
1465,CN2813100000000,28,131,"Stone County, MS",Mar-19,6877,6470,407,5.9
1466,CN2813300000000,28,133,"Sunflower County, MS",Mar-19,7750,7105,645,8.3
1467,CN2813500000000,28,135,"Tallahatchie County, MS",Mar-19,5396,5090,306,5.7
1468,CN2813700000000,28,137,"Tate County, MS",Mar-19,12277,11645,632,5.1
1469,CN2813900000000,28,139,"Tippah County, MS",Mar-19,9423,8951,472,5.0
1470,CN2814100000000,28,141,"Tishomingo County, MS",Mar-19,8833,8444,389,4.4
1471,CN2814300000000,28,143,"Tunica County, MS",Mar-19,4453,4175,278,6.2
1472,CN2814500000000,28,145,"Union County, MS",Mar-19,13985,13432,553,4.0
1473,CN2814700000000,28,147,"Walthall County, MS",Mar-19,4949,4629,320,6.5
1474,CN2814900000000,28,149,"Warren County, MS",Mar-19,20437,19261,1176,5.8
1475,CN2815100000000,28,151,"Washington County, MS",Mar-19,16924,15656,1268,7.5
1476,CN2815300000000,28,153,"Wayne County, MS",Mar-19,7440,7030,410,5.5
1477,CN2815500000000,28,155,"Webster County, MS",Mar-19,4001,3800,201,5.0
1478,CN2815700000000,28,157,"Wilkinson County, MS",Mar-19,2770,2511,259,9.4
1479,CN2815900000000,28,159,"Winston County, MS",Mar-19,7401,6954,447,6.0
1480,CN2816100000000,28,161,"Yalobusha County, MS",Mar-19,5042,4769,273,5.4
1481,CN2816300000000,28,163,"Yazoo County, MS",Mar-19,9412,8848,564,6.0
1482,CN2900100000000,29,1,"Adair County, MO",Mar-19,10437,9964,473,4.5
1483,CN2900300000000,29,3,"Andrew County, MO",Mar-19,9744,9413,331,3.4
1484,CN2900500000000,29,5,"Atchison County, MO",Mar-19,2764,2670,94,3.4
1485,CN2900700000000,29,7,"Audrain County, MO",Mar-19,10794,10389,405,3.8
1486,CN2900900000000,29,9,"Barry County, MO",Mar-19,15828,15138,690,4.4
1487,CN2901100000000,29,11,"Barton County, MO",Mar-19,5198,5001,197,3.8
1488,CN2901300000000,29,13,"Bates County, MO",Mar-19,7907,7526,381,4.8
1489,CN2901500000000,29,15,"Benton County, MO",Mar-19,7318,6898,420,5.7
1490,CN2901700000000,29,17,"Bollinger County, MO",Mar-19,5497,5263,234,4.3
1491,CN2901900000000,29,19,"Boone County, MO",Mar-19,99258,96638,2620,2.6
1492,CN2902100000000,29,21,"Buchanan County, MO",Mar-19,44464,42881,1583,3.6
1493,CN2902300000000,29,23,"Butler County, MO",Mar-19,17965,17076,889,4.9
1494,CN2902500000000,29,25,"Caldwell County, MO",Mar-19,4367,4198,169,3.9
1495,CN2902700000000,29,27,"Callaway County, MO",Mar-19,21370,20676,694,3.2
1496,CN2902900000000,29,29,"Camden County, MO",Mar-19,18073,17089,984,5.4
1497,CN2903100000000,29,31,"Cape Girardeau County, MO",Mar-19,40745,39485,1260,3.1
1498,CN2903300000000,29,33,"Carroll County, MO",Mar-19,5206,5026,180,3.5
1499,CN2903500000000,29,35,"Carter County, MO",Mar-19,2526,2376,150,5.9
1500,CN2903700000000,29,37,"Cass County, MO",Mar-19,54495,52542,1953,3.6
1501,CN2903900000000,29,39,"Cedar County, MO",Mar-19,5787,5540,247,4.3
1502,CN2904100000000,29,41,"Chariton County, MO",Mar-19,3799,3673,126,3.3
1503,CN2904300000000,29,43,"Christian County, MO",Mar-19,44904,43471,1433,3.2
1504,CN2904500000000,29,45,"Clark County, MO",Mar-19,3219,3084,135,4.2
1505,CN2904700000000,29,47,"Clay County, MO",Mar-19,135123,130901,4222,3.1
1506,CN2904900000000,29,49,"Clinton County, MO",Mar-19,10695,10305,390,3.6
1507,CN2905100000000,29,51,"Cole County, MO",Mar-19,38961,37840,1121,2.9
1508,CN2905300000000,29,53,"Cooper County, MO",Mar-19,7555,7127,428,5.7
1509,CN2905500000000,29,55,"Crawford County, MO",Mar-19,10909,10457,452,4.1
1510,CN2905700000000,29,57,"Dade County, MO",Mar-19,3563,3439,124,3.5
1511,CN2905900000000,29,59,"Dallas County, MO",Mar-19,7036,6745,291,4.1
1512,CN2906100000000,29,61,"Daviess County, MO",Mar-19,4163,3970,193,4.6
1513,CN2906300000000,29,63,"DeKalb County, MO",Mar-19,4865,4669,196,4.0
1514,CN2906500000000,29,65,"Dent County, MO",Mar-19,6305,6074,231,3.7
1515,CN2906700000000,29,67,"Douglas County, MO",Mar-19,5074,4867,207,4.1
1516,CN2906900000000,29,69,"Dunklin County, MO",Mar-19,11883,11138,745,6.3
1517,CN2907100000000,29,71,"Franklin County, MO",Mar-19,52738,50894,1844,3.5
1518,CN2907300000000,29,73,"Gasconade County, MO",Mar-19,7685,7406,279,3.6
1519,CN2907500000000,29,75,"Gentry County, MO",Mar-19,3526,3435,91,2.6
1520,CN2907700000000,29,77,"Greene County, MO",Mar-19,150958,146565,4393,2.9
1521,CN2907900000000,29,79,"Grundy County, MO",Mar-19,4459,4289,170,3.8
1522,CN2908100000000,29,81,"Harrison County, MO",Mar-19,3941,3780,161,4.1
1523,CN2908300000000,29,83,"Henry County, MO",Mar-19,9803,9408,395,4.0
1524,CN2908500000000,29,85,"Hickory County, MO",Mar-19,3763,3588,175,4.7
1525,CN2908700000000,29,87,"Holt County, MO",Mar-19,2615,2542,73,2.8
1526,CN2908900000000,29,89,"Howard County, MO",Mar-19,5017,4832,185,3.7
1527,CN2909100000000,29,91,"Howell County, MO",Mar-19,16530,15883,647,3.9
1528,CN2909300000000,29,93,"Iron County, MO",Mar-19,3581,3396,185,5.2
1529,CN2909500000000,29,95,"Jackson County, MO",Mar-19,360065,345057,15008,4.2
1530,CN2909700000000,29,97,"Jasper County, MO",Mar-19,57249,55392,1857,3.2
1531,CN2909900000000,29,99,"Jefferson County, MO",Mar-19,117317,112980,4337,3.7
1532,CN2910100000000,29,101,"Johnson County, MO",Mar-19,22996,22023,973,4.2
1533,CN2910300000000,29,103,"Knox County, MO",Mar-19,1794,1735,59,3.3
1534,CN2910500000000,29,105,"Laclede County, MO",Mar-19,16986,16231,755,4.4
1535,CN2910700000000,29,107,"Lafayette County, MO",Mar-19,16788,16170,618,3.7
1536,CN2910900000000,29,109,"Lawrence County, MO",Mar-19,18207,17425,782,4.3
1537,CN2911100000000,29,111,"Lewis County, MO",Mar-19,5072,4875,197,3.9
1538,CN2911300000000,29,113,"Lincoln County, MO",Mar-19,28334,27190,1144,4.0
1539,CN2911500000000,29,115,"Linn County, MO",Mar-19,5147,4873,274,5.3
1540,CN2911700000000,29,117,"Livingston County, MO",Mar-19,7391,7158,233,3.2
1541,CN2911900000000,29,119,"McDonald County, MO",Mar-19,10617,10273,344,3.2
1542,CN2912100000000,29,121,"Macon County, MO",Mar-19,7586,7255,331,4.4
1543,CN2912300000000,29,123,"Madison County, MO",Mar-19,5515,5313,202,3.7
1544,CN2912500000000,29,125,"Maries County, MO",Mar-19,3923,3772,151,3.8
1545,CN2912700000000,29,127,"Marion County, MO",Mar-19,14538,14008,530,3.6
1546,CN2912900000000,29,129,"Mercer County, MO",Mar-19,1909,1820,89,4.7
1547,CN2913100000000,29,131,"Miller County, MO",Mar-19,12176,11611,565,4.6
1548,CN2913300000000,29,133,"Mississippi County, MO",Mar-19,5850,5597,253,4.3
1549,CN2913500000000,29,135,"Moniteau County, MO",Mar-19,7363,7103,260,3.5
1550,CN2913700000000,29,137,"Monroe County, MO",Mar-19,3888,3697,191,4.9
1551,CN2913900000000,29,139,"Montgomery County, MO",Mar-19,5707,5492,215,3.8
1552,CN2914100000000,29,141,"Morgan County, MO",Mar-19,8010,7575,435,5.4
1553,CN2914300000000,29,143,"New Madrid County, MO",Mar-19,8349,7949,400,4.8
1554,CN2914500000000,29,145,"Newton County, MO",Mar-19,27404,26442,962,3.5
1555,CN2914700000000,29,147,"Nodaway County, MO",Mar-19,10795,10459,336,3.1
1556,CN2914900000000,29,149,"Oregon County, MO",Mar-19,4017,3861,156,3.9
1557,CN2915100000000,29,151,"Osage County, MO",Mar-19,7101,6923,178,2.5
1558,CN2915300000000,29,153,"Ozark County, MO",Mar-19,3449,3250,199,5.8
1559,CN2915500000000,29,155,"Pemiscot County, MO",Mar-19,6407,6061,346,5.4
1560,CN2915700000000,29,157,"Perry County, MO",Mar-19,10119,9816,303,3.0
1561,CN2915900000000,29,159,"Pettis County, MO",Mar-19,21001,20195,806,3.8
1562,CN2916100000000,29,161,"Phelps County, MO",Mar-19,19959,19249,710,3.6
1563,CN2916300000000,29,163,"Pike County, MO",Mar-19,7611,7328,283,3.7
1564,CN2916500000000,29,165,"Platte County, MO",Mar-19,58198,56476,1722,3.0
1565,CN2916700000000,29,167,"Polk County, MO",Mar-19,14557,14008,549,3.8
1566,CN2916900000000,29,169,"Pulaski County, MO",Mar-19,14694,14059,635,4.3
1567,CN2917100000000,29,171,"Putnam County, MO",Mar-19,2343,2249,94,4.0
1568,CN2917300000000,29,173,"Ralls County, MO",Mar-19,5693,5456,237,4.2
1569,CN2917500000000,29,175,"Randolph County, MO",Mar-19,10493,10055,438,4.2
1570,CN2917700000000,29,177,"Ray County, MO",Mar-19,10936,10501,435,4.0
1571,CN2917900000000,29,179,"Reynolds County, MO",Mar-19,3038,2907,131,4.3
1572,CN2918100000000,29,181,"Ripley County, MO",Mar-19,5074,4781,293,5.8
1573,CN2918300000000,29,183,"St. Charles County, MO",Mar-19,225141,218649,6492,2.9
1574,CN2918500000000,29,185,"St. Clair County, MO",Mar-19,3788,3610,178,4.7
1575,CN2918600000000,29,186,"Ste. Genevieve County, MO",Mar-19,9221,8925,296,3.2
1576,CN2918700000000,29,187,"St. Francois County, MO",Mar-19,26537,25465,1072,4.0
1577,CN2918900000000,29,189,"St. Louis County, MO",Mar-19,528174,510087,18087,3.4
1578,CN2919500000000,29,195,"Saline County, MO",Mar-19,10726,10339,387,3.6
1579,CN2919700000000,29,197,"Schuyler County, MO",Mar-19,1982,1877,105,5.3
1580,CN2919900000000,29,199,"Scotland County, MO",Mar-19,2385,2291,94,3.9
1581,CN2920100000000,29,201,"Scott County, MO",Mar-19,20114,19373,741,3.7
1582,CN2920300000000,29,203,"Shannon County, MO",Mar-19,3222,3002,220,6.8
1583,CN2920500000000,29,205,"Shelby County, MO",Mar-19,3103,2961,142,4.6
1584,CN2920700000000,29,207,"Stoddard County, MO",Mar-19,13142,12444,698,5.3
1585,CN2920900000000,29,209,"Stone County, MO",Mar-19,13440,12585,855,6.4
1586,CN2921100000000,29,211,"Sullivan County, MO",Mar-19,2759,2632,127,4.6
1587,CN2921300000000,29,213,"Taney County, MO",Mar-19,26270,24561,1709,6.5
1588,CN2921500000000,29,215,"Texas County, MO",Mar-19,9082,8623,459,5.1
1589,CN2921700000000,29,217,"Vernon County, MO",Mar-19,9686,9286,400,4.1
1590,CN2921900000000,29,219,"Warren County, MO",Mar-19,17881,17247,634,3.5
1591,CN2922100000000,29,221,"Washington County, MO",Mar-19,10312,9747,565,5.5
1592,CN2922300000000,29,223,"Wayne County, MO",Mar-19,5391,5095,296,5.5
1593,CN2922500000000,29,225,"Webster County, MO",Mar-19,17257,16629,628,3.6
1594,CN2922700000000,29,227,"Worth County, MO",Mar-19,1176,1146,30,2.6
1595,CN2922900000000,29,229,"Wright County, MO",Mar-19,7521,7175,346,4.6
1596,CN2951000000000,29,510,"St. Louis city, MO",Mar-19,151722,145238,6484,4.3
1597,CN3000100000000,30,1,"Beaverhead County, MT",Mar-19,5011,4836,175,3.5
1598,CN3000300000000,30,3,"Big Horn County, MT",Mar-19,4894,4474,420,8.6
1599,CN3000500000000,30,5,"Blaine County, MT",Mar-19,2479,2373,106,4.3
1600,CN3000700000000,30,7,"Broadwater County, MT",Mar-19,2568,2453,115,4.5
1601,CN3000900000000,30,9,"Carbon County, MT",Mar-19,5483,5235,248,4.5
1602,CN3001100000000,30,11,"Carter County, MT",Mar-19,621,598,23,3.7
1603,CN3001300000000,30,13,"Cascade County, MT",Mar-19,38029,36495,1534,4.0
1604,CN3001500000000,30,15,"Chouteau County, MT",Mar-19,2372,2293,79,3.3
1605,CN3001700000000,30,17,"Custer County, MT",Mar-19,5941,5724,217,3.7
1606,CN3001900000000,30,19,"Daniels County, MT",Mar-19,864,844,20,2.3
1607,CN3002100000000,30,21,"Dawson County, MT",Mar-19,4528,4411,117,2.6
1608,CN3002300000000,30,23,"Deer Lodge County, MT",Mar-19,5008,4830,178,3.6
1609,CN3002500000000,30,25,"Fallon County, MT",Mar-19,1636,1600,36,2.2
1610,CN3002700000000,30,27,"Fergus County, MT",Mar-19,5757,5499,258,4.5
1611,CN3002900000000,30,29,"Flathead County, MT",Mar-19,46977,44140,2837,6.0
1612,CN3003100000000,30,31,"Gallatin County, MT",Mar-19,67140,65450,1690,2.5
1613,CN3003300000000,30,33,"Garfield County, MT",Mar-19,720,698,22,3.1
1614,CN3003500000000,30,35,"Glacier County, MT",Mar-19,5494,5009,485,8.8
1615,CN3003700000000,30,37,"Golden Valley County, MT",Mar-19,365,346,19,5.2
1616,CN3003900000000,30,39,"Granite County, MT",Mar-19,1738,1629,109,6.3
1617,CN3004100000000,30,41,"Hill County, MT",Mar-19,7607,7313,294,3.9
1618,CN3004300000000,30,43,"Jefferson County, MT",Mar-19,5667,5433,234,4.1
1619,CN3004500000000,30,45,"Judith Basin County, MT",Mar-19,900,864,36,4.0
1620,CN3004700000000,30,47,"Lake County, MT",Mar-19,12955,12307,648,5.0
1621,CN3004900000000,30,49,"Lewis and Clark County, MT",Mar-19,35644,34375,1269,3.6
1622,CN3005100000000,30,51,"Liberty County, MT",Mar-19,930,903,27,2.9
1623,CN3005300000000,30,53,"Lincoln County, MT",Mar-19,7922,7209,713,9.0
1624,CN3005500000000,30,55,"McCone County, MT",Mar-19,913,894,19,2.1
1625,CN3005700000000,30,57,"Madison County, MT",Mar-19,5277,5094,183,3.5
1626,CN3005900000000,30,59,"Meagher County, MT",Mar-19,969,928,41,4.2
1627,CN3006100000000,30,61,"Mineral County, MT",Mar-19,1689,1572,117,6.9
1628,CN3006300000000,30,63,"Missoula County, MT",Mar-19,63711,61236,2475,3.9
1629,CN3006500000000,30,65,"Musselshell County, MT",Mar-19,2248,2143,105,4.7
1630,CN3006700000000,30,67,"Park County, MT",Mar-19,8526,8142,384,4.5
1631,CN3006900000000,30,69,"Petroleum County, MT",Mar-19,271,259,12,4.4
1632,CN3007100000000,30,71,"Phillips County, MT",Mar-19,1847,1762,85,4.6
1633,CN3007300000000,30,73,"Pondera County, MT",Mar-19,2666,2536,130,4.9
1634,CN3007500000000,30,75,"Powder River County, MT",Mar-19,912,885,27,3.0
1635,CN3007700000000,30,77,"Powell County, MT",Mar-19,2860,2725,135,4.7
1636,CN3007900000000,30,79,"Prairie County, MT",Mar-19,463,446,17,3.7
1637,CN3008100000000,30,81,"Ravalli County, MT",Mar-19,19952,18904,1048,5.3
1638,CN3008300000000,30,83,"Richland County, MT",Mar-19,5802,5623,179,3.1
1639,CN3008500000000,30,85,"Roosevelt County, MT",Mar-19,4472,4239,233,5.2
1640,CN3008700000000,30,87,"Rosebud County, MT",Mar-19,3748,3531,217,5.8
1641,CN3008900000000,30,89,"Sanders County, MT",Mar-19,4717,4346,371,7.9
1642,CN3009100000000,30,91,"Sheridan County, MT",Mar-19,1763,1714,49,2.8
1643,CN3009300000000,30,93,"Silver Bow County, MT",Mar-19,16957,16192,765,4.5
1644,CN3009500000000,30,95,"Stillwater County, MT",Mar-19,5030,4821,209,4.2
1645,CN3009700000000,30,97,"Sweet Grass County, MT",Mar-19,1727,1676,51,3.0
1646,CN3009900000000,30,99,"Teton County, MT",Mar-19,2650,2543,107,4.0
1647,CN3010100000000,30,101,"Toole County, MT",Mar-19,2073,2020,53,2.6
1648,CN3010300000000,30,103,"Treasure County, MT",Mar-19,333,318,15,4.5
1649,CN3010500000000,30,105,"Valley County, MT",Mar-19,3966,3819,147,3.7
1650,CN3010700000000,30,107,"Wheatland County, MT",Mar-19,759,727,32,4.2
1651,CN3010900000000,30,109,"Wibaux County, MT",Mar-19,442,428,14,3.2
1652,CN3011100000000,30,111,"Yellowstone County, MT",Mar-19,81709,78674,3035,3.7
1653,CN3100100000000,31,1,"Adams County, NE",Mar-19,16574,15997,577,3.5
1654,CN3100300000000,31,3,"Antelope County, NE",Mar-19,3498,3388,110,3.1
1655,CN3100500000000,31,5,"Arthur County, NE",Mar-19,227,214,13,5.7
1656,CN3100700000000,31,7,"Banner County, NE",Mar-19,366,352,14,3.8
1657,CN3100900000000,31,9,"Blaine County, NE",Mar-19,259,245,14,5.4
1658,CN3101100000000,31,11,"Boone County, NE",Mar-19,2982,2874,108,3.6
1659,CN3101300000000,31,13,"Box Butte County, NE",Mar-19,5366,5207,159,3.0
1660,CN3101500000000,31,15,"Boyd County, NE",Mar-19,1090,1045,45,4.1
1661,CN3101700000000,31,17,"Brown County, NE",Mar-19,1377,1323,54,3.9
1662,CN3101900000000,31,19,"Buffalo County, NE",Mar-19,27838,27079,759,2.7
1663,CN3102100000000,31,21,"Burt County, NE",Mar-19,3454,3317,137,4.0
1664,CN3102300000000,31,23,"Butler County, NE",Mar-19,4581,4458,123,2.7
1665,CN3102500000000,31,25,"Cass County, NE",Mar-19,13496,12957,539,4.0
1666,CN3102700000000,31,27,"Cedar County, NE",Mar-19,4495,4376,119,2.6
1667,CN3102900000000,31,29,"Chase County, NE",Mar-19,2292,2231,61,2.7
1668,CN3103100000000,31,31,"Cherry County, NE",Mar-19,3314,3229,85,2.6
1669,CN3103300000000,31,33,"Cheyenne County, NE",Mar-19,4416,4254,162,3.7
1670,CN3103500000000,31,35,"Clay County, NE",Mar-19,3287,3157,130,4.0
1671,CN3103700000000,31,37,"Colfax County, NE",Mar-19,5600,5443,157,2.8
1672,CN3103900000000,31,39,"Cuming County, NE",Mar-19,4711,4574,137,2.9
1673,CN3104100000000,31,41,"Custer County, NE",Mar-19,6413,6244,169,2.6
1674,CN3104300000000,31,43,"Dakota County, NE",Mar-19,10821,10316,505,4.7
1675,CN3104500000000,31,45,"Dawes County, NE",Mar-19,4971,4834,137,2.8
1676,CN3104700000000,31,47,"Dawson County, NE",Mar-19,13058,12597,461,3.5
1677,CN3104900000000,31,49,"Deuel County, NE",Mar-19,931,906,25,2.7
1678,CN3105100000000,31,51,"Dixon County, NE",Mar-19,3038,2932,106,3.5
1679,CN3105300000000,31,53,"Dodge County, NE",Mar-19,19433,18809,624,3.2
1680,CN3105500000000,31,55,"Douglas County, NE",Mar-19,296971,285928,11043,3.7
1681,CN3105700000000,31,57,"Dundy County, NE",Mar-19,1166,1137,29,2.5
1682,CN3105900000000,31,59,"Fillmore County, NE",Mar-19,3127,3037,90,2.9
1683,CN3106100000000,31,61,"Franklin County, NE",Mar-19,1480,1430,50,3.4
1684,CN3106300000000,31,63,"Frontier County, NE",Mar-19,1631,1570,61,3.7
1685,CN3106500000000,31,65,"Furnas County, NE",Mar-19,2564,2492,72,2.8
1686,CN3106700000000,31,67,"Gage County, NE",Mar-19,10958,10527,431,3.9
1687,CN3106900000000,31,69,"Garden County, NE",Mar-19,1109,1073,36,3.2
1688,CN3107100000000,31,71,"Garfield County, NE",Mar-19,1123,1092,31,2.8
1689,CN3107300000000,31,73,"Gosper County, NE",Mar-19,1083,1052,31,2.9
1690,CN3107500000000,31,75,"Grant County, NE",Mar-19,425,414,11,2.6
1691,CN3107700000000,31,77,"Greeley County, NE",Mar-19,1222,1184,38,3.1
1692,CN3107900000000,31,79,"Hall County, NE",Mar-19,31914,30742,1172,3.7
1693,CN3108100000000,31,81,"Hamilton County, NE",Mar-19,4762,4620,142,3.0
1694,CN3108300000000,31,83,"Harlan County, NE",Mar-19,1768,1716,52,2.9
1695,CN3108500000000,31,85,"Hayes County, NE",Mar-19,586,568,18,3.1
1696,CN3108700000000,31,87,"Hitchcock County, NE",Mar-19,1271,1217,54,4.2
1697,CN3108900000000,31,89,"Holt County, NE",Mar-19,5751,5587,164,2.9
1698,CN3109100000000,31,91,"Hooker County, NE",Mar-19,401,387,14,3.5
1699,CN3109300000000,31,93,"Howard County, NE",Mar-19,3351,3241,110,3.3
1700,CN3109500000000,31,95,"Jefferson County, NE",Mar-19,4125,4002,123,3.0
1701,CN3109700000000,31,97,"Johnson County, NE",Mar-19,2101,2013,88,4.2
1702,CN3109900000000,31,99,"Kearney County, NE",Mar-19,3760,3679,81,2.2
1703,CN3110100000000,31,101,"Keith County, NE",Mar-19,4473,4334,139,3.1
1704,CN3110300000000,31,103,"Keya Paha County, NE",Mar-19,596,582,14,2.3
1705,CN3110500000000,31,105,"Kimball County, NE",Mar-19,2038,1975,63,3.1
1706,CN3110700000000,31,107,"Knox County, NE",Mar-19,4619,4437,182,3.9
1707,CN3110900000000,31,109,"Lancaster County, NE",Mar-19,176445,171107,5338,3.0
1708,CN3111100000000,31,111,"Lincoln County, NE",Mar-19,18134,17481,653,3.6
1709,CN3111300000000,31,113,"Logan County, NE",Mar-19,470,459,11,2.3
1710,CN3111500000000,31,115,"Loup County, NE",Mar-19,391,377,14,3.6
1711,CN3111700000000,31,117,"McPherson County, NE",Mar-19,448,437,11,2.5
1712,CN3111900000000,31,119,"Madison County, NE",Mar-19,19852,19208,644,3.2
1713,CN3112100000000,31,121,"Merrick County, NE",Mar-19,4012,3880,132,3.3
1714,CN3112300000000,31,123,"Morrill County, NE",Mar-19,2592,2509,83,3.2
1715,CN3112500000000,31,125,"Nance County, NE",Mar-19,1989,1924,65,3.3
1716,CN3112700000000,31,127,"Nemaha County, NE",Mar-19,3663,3539,124,3.4
1717,CN3112900000000,31,129,"Nuckolls County, NE",Mar-19,2419,2349,70,2.9
1718,CN3113100000000,31,131,"Otoe County, NE",Mar-19,8352,8069,283,3.4
1719,CN3113300000000,31,133,"Pawnee County, NE",Mar-19,1484,1439,45,3.0
1720,CN3113500000000,31,135,"Perkins County, NE",Mar-19,1814,1769,45,2.5
1721,CN3113700000000,31,137,"Phelps County, NE",Mar-19,4981,4851,130,2.6
1722,CN3113900000000,31,139,"Pierce County, NE",Mar-19,4052,3926,126,3.1
1723,CN3114100000000,31,141,"Platte County, NE",Mar-19,17458,16885,573,3.3
1724,CN3114300000000,31,143,"Polk County, NE",Mar-19,2885,2806,79,2.7
1725,CN3114500000000,31,145,"Red Willow County, NE",Mar-19,5848,5686,162,2.8
1726,CN3114700000000,31,147,"Richardson County, NE",Mar-19,4264,4116,148,3.5
1727,CN3114900000000,31,149,"Rock County, NE",Mar-19,848,817,31,3.7
1728,CN3115100000000,31,151,"Saline County, NE",Mar-19,7464,7167,297,4.0
1729,CN3115300000000,31,153,"Sarpy County, NE",Mar-19,95534,92507,3027,3.2
1730,CN3115500000000,31,155,"Saunders County, NE",Mar-19,11095,10751,344,3.1
1731,CN3115700000000,31,157,"Scotts Bluff County, NE",Mar-19,18098,17323,775,4.3
1732,CN3115900000000,31,159,"Seward County, NE",Mar-19,8890,8634,256,2.9
1733,CN3116100000000,31,161,"Sheridan County, NE",Mar-19,2665,2589,76,2.9
1734,CN3116300000000,31,163,"Sherman County, NE",Mar-19,1686,1630,56,3.3
1735,CN3116500000000,31,165,"Sioux County, NE",Mar-19,734,712,22,3.0
1736,CN3116700000000,31,167,"Stanton County, NE",Mar-19,3519,3414,105,3.0
1737,CN3116900000000,31,169,"Thayer County, NE",Mar-19,2831,2744,87,3.1
1738,CN3117100000000,31,171,"Thomas County, NE",Mar-19,420,406,14,3.3
1739,CN3117300000000,31,173,"Thurston County, NE",Mar-19,3059,2893,166,5.4
1740,CN3117500000000,31,175,"Valley County, NE",Mar-19,2114,2033,81,3.8
1741,CN3117700000000,31,177,"Washington County, NE",Mar-19,11201,10810,391,3.5
1742,CN3117900000000,31,179,"Wayne County, NE",Mar-19,5827,5674,153,2.6
1743,CN3118100000000,31,181,"Webster County, NE",Mar-19,1665,1611,54,3.2
1744,CN3118300000000,31,183,"Wheeler County, NE",Mar-19,584,568,16,2.7
1745,CN3118500000000,31,185,"York County, NE",Mar-19,7186,6966,220,3.1
1746,CN3200100000000,32,1,"Churchill County, NV",Mar-19,11088,10653,435,3.9
1747,CN3200300000000,32,3,"Clark County, NV",Mar-19,1122507,1075988,46519,4.1
1748,CN3200500000000,32,5,"Douglas County, NV",Mar-19,22917,21895,1022,4.5
1749,CN3200700000000,32,7,"Elko County, NV",Mar-19,27923,27022,901,3.2
1750,CN3200900000000,32,9,"Esmeralda County, NV",Mar-19,417,403,14,3.4
1751,CN3201100000000,32,11,"Eureka County, NV",Mar-19,1188,1162,26,2.2
1752,CN3201300000000,32,13,"Humboldt County, NV",Mar-19,8433,8196,237,2.8
1753,CN3201500000000,32,15,"Lander County, NV",Mar-19,3294,3176,118,3.6
1754,CN3201700000000,32,17,"Lincoln County, NV",Mar-19,2143,2048,95,4.4
1755,CN3201900000000,32,19,"Lyon County, NV",Mar-19,23536,22290,1246,5.3
1756,CN3202100000000,32,21,"Mineral County, NV",Mar-19,2044,1950,94,4.6
1757,CN3202300000000,32,23,"Nye County, NV",Mar-19,17200,16287,913,5.3
1758,CN3202700000000,32,27,"Pershing County, NV",Mar-19,2661,2540,121,4.5
1759,CN3202900000000,32,29,"Storey County, NV",Mar-19,2010,1923,87,4.3
1760,CN3203100000000,32,31,"Washoe County, NV",Mar-19,252710,243658,9052,3.6
1761,CN3203300000000,32,33,"White Pine County, NV",Mar-19,4571,4424,147,3.2
1762,CN3251000000000,32,510,"Carson City, NV",Mar-19,26020,24842,1178,4.5
1763,CN3300100000000,33,1,"Belknap County, NH",Mar-19,30703,29760,943,3.1
1764,CN3300300000000,33,3,"Carroll County, NH",Mar-19,23143,22413,730,3.2
1765,CN3300500000000,33,5,"Cheshire County, NH",Mar-19,41213,39932,1281,3.1
1766,CN3300700000000,33,7,"Coos County, NH",Mar-19,14596,14010,586,4.0
1767,CN3300900000000,33,9,"Grafton County, NH",Mar-19,49994,48736,1258,2.5
1768,CN3301100000000,33,11,"Hillsborough County, NH",Mar-19,242976,235674,7302,3.0
1769,CN3301300000000,33,13,"Merrimack County, NH",Mar-19,83999,81812,2187,2.6
1770,CN3301500000000,33,15,"Rockingham County, NH",Mar-19,186241,180416,5825,3.1
1771,CN3301700000000,33,17,"Strafford County, NH",Mar-19,74449,72449,2000,2.7
1772,CN3301900000000,33,19,"Sullivan County, NH",Mar-19,23177,22577,600,2.6
1773,CN3400100000000,34,1,"Atlantic County, NJ",Mar-19,119237,112706,6531,5.5
1774,CN3400300000000,34,3,"Bergen County, NJ",Mar-19,479056,464873,14183,3.0
1775,CN3400500000000,34,5,"Burlington County, NJ",Mar-19,229003,221358,7645,3.3
1776,CN3400700000000,34,7,"Camden County, NJ",Mar-19,251717,241420,10297,4.1
1777,CN3400900000000,34,9,"Cape May County, NJ",Mar-19,39870,35530,4340,10.9
1778,CN3401100000000,34,11,"Cumberland County, NJ",Mar-19,64385,60528,3857,6.0
1779,CN3401300000000,34,13,"Essex County, NJ",Mar-19,366004,349705,16299,4.5
1780,CN3401500000000,34,15,"Gloucester County, NJ",Mar-19,148879,143339,5540,3.7
1781,CN3401700000000,34,17,"Hudson County, NJ",Mar-19,359251,347451,11800,3.3
1782,CN3401900000000,34,19,"Hunterdon County, NJ",Mar-19,63803,61902,1901,3.0
1783,CN3402100000000,34,21,"Mercer County, NJ",Mar-19,200508,194172,6336,3.2
1784,CN3402300000000,34,23,"Middlesex County, NJ",Mar-19,433559,419951,13608,3.1
1785,CN3402500000000,34,25,"Monmouth County, NJ",Mar-19,324028,313189,10839,3.3
1786,CN3402700000000,34,27,"Morris County, NJ",Mar-19,255019,247461,7558,3.0
1787,CN3402900000000,34,29,"Ocean County, NJ",Mar-19,271652,260828,10824,4.0
1788,CN3403100000000,34,31,"Passaic County, NJ",Mar-19,241370,230402,10968,4.5
1789,CN3403300000000,34,33,"Salem County, NJ",Mar-19,28834,27388,1446,5.0
1790,CN3403500000000,34,35,"Somerset County, NJ",Mar-19,170135,164931,5204,3.1
1791,CN3403700000000,34,37,"Sussex County, NJ",Mar-19,73389,70612,2777,3.8
1792,CN3403900000000,34,39,"Union County, NJ",Mar-19,275110,264399,10711,3.9
1793,CN3404100000000,34,41,"Warren County, NJ",Mar-19,55378,53366,2012,3.6
1794,CN3500100000000,35,1,"Bernalillo County, NM",Mar-19,330704,316589,14115,4.3
1795,CN3500300000000,35,3,"Catron County, NM",Mar-19,1059,988,71,6.7
1796,CN3500500000000,35,5,"Chaves County, NM",Mar-19,27041,25828,1213,4.5
1797,CN3500600000000,35,6,"Cibola County, NM",Mar-19,8924,8385,539,6.0
1798,CN3500700000000,35,7,"Colfax County, NM",Mar-19,5259,5013,246,4.7
1799,CN3500900000000,35,9,"Curry County, NM",Mar-19,21730,20889,841,3.9
1800,CN3501100000000,35,11,"De Baca County, NM",Mar-19,807,772,35,4.3
1801,CN3501300000000,35,13,"Dona Ana County, NM",Mar-19,97029,91206,5823,6.0
1802,CN3501500000000,35,15,"Eddy County, NM",Mar-19,33785,32849,936,2.8
1803,CN3501700000000,35,17,"Grant County, NM",Mar-19,12215,11647,568,4.7
1804,CN3501900000000,35,19,"Guadalupe County, NM",Mar-19,1518,1434,84,5.5
1805,CN3502100000000,35,21,"Harding County, NM",Mar-19,268,255,13,4.9
1806,CN3502300000000,35,23,"Hidalgo County, NM",Mar-19,2022,1939,83,4.1
1807,CN3502500000000,35,25,"Lea County, NM",Mar-19,30548,29455,1093,3.6
1808,CN3502700000000,35,27,"Lincoln County, NM",Mar-19,8640,8227,413,4.8
1809,CN3502800000000,35,28,"Los Alamos County, NM",Mar-19,9278,9001,277,3.0
1810,CN3502900000000,35,29,"Luna County, NM",Mar-19,10172,8510,1662,16.3
1811,CN3503100000000,35,31,"McKinley County, NM",Mar-19,24069,22442,1627,6.8
1812,CN3503300000000,35,33,"Mora County, NM",Mar-19,2184,2038,146,6.7
1813,CN3503500000000,35,35,"Otero County, NM",Mar-19,24733,23568,1165,4.7
1814,CN3503700000000,35,37,"Quay County, NM",Mar-19,3236,3061,175,5.4
1815,CN3503900000000,35,39,"Rio Arriba County, NM",Mar-19,16549,15661,888,5.4
1816,CN3504100000000,35,41,"Roosevelt County, NM",Mar-19,7913,7585,328,4.1
1817,CN3504300000000,35,43,"Sandoval County, NM",Mar-19,65767,62757,3010,4.6
1818,CN3504500000000,35,45,"San Juan County, NM",Mar-19,51684,48839,2845,5.5
1819,CN3504700000000,35,47,"San Miguel County, NM",Mar-19,10931,10332,599,5.5
1820,CN3504900000000,35,49,"Santa Fe County, NM",Mar-19,73746,70914,2832,3.8
1821,CN3505100000000,35,51,"Sierra County, NM",Mar-19,3737,3428,309,8.3
1822,CN3505300000000,35,53,"Socorro County, NM",Mar-19,6457,6119,338,5.2
1823,CN3505500000000,35,55,"Taos County, NM",Mar-19,15468,14552,916,5.9
1824,CN3505700000000,35,57,"Torrance County, NM",Mar-19,5540,5156,384,6.9
1825,CN3505900000000,35,59,"Union County, NM",Mar-19,1836,1775,61,3.3
1826,CN3506100000000,35,61,"Valencia County, NM",Mar-19,30316,28789,1527,5.0
1827,CN3600100000000,36,1,"Albany County, NY",Mar-19,156674,150834,5840,3.7
1828,CN3600300000000,36,3,"Allegany County, NY",Mar-19,19490,18281,1209,6.2
1829,CN3600500000000,36,5,"Bronx County, NY",Mar-19,602784,568115,34669,5.8
1830,CN3600700000000,36,7,"Broome County, NY",Mar-19,83874,79601,4273,5.1
1831,CN3600900000000,36,9,"Cattaraugus County, NY",Mar-19,33853,31951,1902,5.6
1832,CN3601100000000,36,11,"Cayuga County, NY",Mar-19,35433,33697,1736,4.9
1833,CN3601300000000,36,13,"Chautauqua County, NY",Mar-19,54120,51266,2854,5.3
1834,CN3601500000000,36,15,"Chemung County, NY",Mar-19,35147,33616,1531,4.4
1835,CN3601700000000,36,17,"Chenango County, NY",Mar-19,21774,20630,1144,5.3
1836,CN3601900000000,36,19,"Clinton County, NY",Mar-19,36108,34422,1686,4.7
1837,CN3602100000000,36,21,"Columbia County, NY",Mar-19,30557,29429,1128,3.7
1838,CN3602300000000,36,23,"Cortland County, NY",Mar-19,23248,21910,1338,5.8
1839,CN3602500000000,36,25,"Delaware County, NY",Mar-19,18782,17789,993,5.3
1840,CN3602700000000,36,27,"Dutchess County, NY",Mar-19,143761,138538,5223,3.6
1841,CN3602900000000,36,29,"Erie County, NY",Mar-19,440828,421448,19380,4.4
1842,CN3603100000000,36,31,"Essex County, NY",Mar-19,17007,16022,985,5.8
1843,CN3603300000000,36,33,"Franklin County, NY",Mar-19,19544,18433,1111,5.7
1844,CN3603500000000,36,35,"Fulton County, NY",Mar-19,22587,21277,1310,5.8
1845,CN3603700000000,36,37,"Genesee County, NY",Mar-19,29117,27746,1371,4.7
1846,CN3603900000000,36,39,"Greene County, NY",Mar-19,20255,19282,973,4.8
1847,CN3604100000000,36,41,"Hamilton County, NY",Mar-19,2120,1956,164,7.7
1848,CN3604300000000,36,43,"Herkimer County, NY",Mar-19,27912,26347,1565,5.6
1849,CN3604500000000,36,45,"Jefferson County, NY",Mar-19,43497,40699,2798,6.4
1850,CN3604700000000,36,47,"Kings County, NY",Mar-19,1209006,1156009,52997,4.4
1851,CN3604900000000,36,49,"Lewis County, NY",Mar-19,11448,10589,859,7.5
1852,CN3605100000000,36,51,"Livingston County, NY",Mar-19,30622,29113,1509,4.9
1853,CN3605300000000,36,53,"Madison County, NY",Mar-19,32544,30810,1734,5.3
1854,CN3605500000000,36,55,"Monroe County, NY",Mar-19,361387,346222,15165,4.2
1855,CN3605700000000,36,57,"Montgomery County, NY",Mar-19,22038,20757,1281,5.8
1856,CN3605900000000,36,59,"Nassau County, NY",Mar-19,704349,680551,23798,3.4
1857,CN3606100000000,36,61,"New York County, NY",Mar-19,919632,884928,34704,3.8
1858,CN3606300000000,36,63,"Niagara County, NY",Mar-19,98906,93466,5440,5.5
1859,CN3606500000000,36,65,"Oneida County, NY",Mar-19,101010,96372,4638,4.6
1860,CN3606700000000,36,67,"Onondaga County, NY",Mar-19,219364,210343,9021,4.1
1861,CN3606900000000,36,69,"Ontario County, NY",Mar-19,55372,52978,2394,4.3
1862,CN3607100000000,36,71,"Orange County, NY",Mar-19,183830,176836,6994,3.8
1863,CN3607300000000,36,73,"Orleans County, NY",Mar-19,17338,16451,887,5.1
1864,CN3607500000000,36,75,"Oswego County, NY",Mar-19,52754,49627,3127,5.9
1865,CN3607700000000,36,77,"Otsego County, NY",Mar-19,27796,26502,1294,4.7
1866,CN3607900000000,36,79,"Putnam County, NY",Mar-19,51229,49343,1886,3.7
1867,CN3608100000000,36,81,"Queens County, NY",Mar-19,1148990,1105748,43242,3.8
1868,CN3608300000000,36,83,"Rensselaer County, NY",Mar-19,80818,77563,3255,4.0
1869,CN3608500000000,36,85,"Richmond County, NY",Mar-19,223943,214603,9340,4.2
1870,CN3608700000000,36,87,"Rockland County, NY",Mar-19,154980,149497,5483,3.5
1871,CN3608900000000,36,89,"St. Lawrence County, NY",Mar-19,43256,40557,2699,6.2
1872,CN3609100000000,36,91,"Saratoga County, NY",Mar-19,118588,114212,4376,3.7
1873,CN3609300000000,36,93,"Schenectady County, NY",Mar-19,75768,72697,3071,4.1
1874,CN3609500000000,36,95,"Schoharie County, NY",Mar-19,14534,13737,797,5.5
1875,CN3609700000000,36,97,"Schuyler County, NY",Mar-19,7934,7462,472,5.9
1876,CN3609900000000,36,99,"Seneca County, NY",Mar-19,15767,15089,678,4.3
1877,CN3610100000000,36,101,"Steuben County, NY",Mar-19,42182,39953,2229,5.3
1878,CN3610300000000,36,103,"Suffolk County, NY",Mar-19,774308,744797,29511,3.8
1879,CN3610500000000,36,105,"Sullivan County, NY",Mar-19,35642,34077,1565,4.4
1880,CN3610700000000,36,107,"Tioga County, NY",Mar-19,22777,21700,1077,4.7
1881,CN3610900000000,36,109,"Tompkins County, NY",Mar-19,50805,49015,1790,3.5
1882,CN3611100000000,36,111,"Ulster County, NY",Mar-19,87153,83724,3429,3.9
1883,CN3611300000000,36,113,"Warren County, NY",Mar-19,30666,28947,1719,5.6
1884,CN3611500000000,36,115,"Washington County, NY",Mar-19,26968,25616,1352,5.0
1885,CN3611700000000,36,117,"Wayne County, NY",Mar-19,43586,41578,2008,4.6
1886,CN3611900000000,36,119,"Westchester County, NY",Mar-19,484086,465993,18093,3.7
1887,CN3612100000000,36,121,"Wyoming County, NY",Mar-19,17662,16684,978,5.5
1888,CN3612300000000,36,123,"Yates County, NY",Mar-19,11607,11117,490,4.2
1889,CN3700100000000,37,1,"Alamance County, NC",Mar-19,82651,79408,3243,3.9
1890,CN3700300000000,37,3,"Alexander County, NC",Mar-19,18224,17591,633,3.5
1891,CN3700500000000,37,5,"Alleghany County, NC",Mar-19,4304,4085,219,5.1
1892,CN3700700000000,37,7,"Anson County, NC",Mar-19,10865,10415,450,4.1
1893,CN3700900000000,37,9,"Ashe County, NC",Mar-19,12693,12147,546,4.3
1894,CN3701100000000,37,11,"Avery County, NC",Mar-19,7233,6919,314,4.3
1895,CN3701300000000,37,13,"Beaufort County, NC",Mar-19,19706,18735,971,4.9
1896,CN3701500000000,37,15,"Bertie County, NC",Mar-19,7971,7591,380,4.8
1897,CN3701700000000,37,17,"Bladen County, NC",Mar-19,14684,13976,708,4.8
1898,CN3701900000000,37,19,"Brunswick County, NC",Mar-19,53022,50211,2811,5.3
1899,CN3702100000000,37,21,"Buncombe County, NC",Mar-19,141456,137010,4446,3.1
1900,CN3702300000000,37,23,"Burke County, NC",Mar-19,41357,39768,1589,3.8
1901,CN3702500000000,37,25,"Cabarrus County, NC",Mar-19,109553,105505,4048,3.7
1902,CN3702700000000,37,27,"Caldwell County, NC",Mar-19,36915,35345,1570,4.3
1903,CN3702900000000,37,29,"Camden County, NC",Mar-19,4732,4536,196,4.1
1904,CN3703100000000,37,31,"Carteret County, NC",Mar-19,31524,30052,1472,4.7
1905,CN3703300000000,37,33,"Caswell County, NC",Mar-19,9975,9516,459,4.6
1906,CN3703500000000,37,35,"Catawba County, NC",Mar-19,79758,76789,2969,3.7
1907,CN3703700000000,37,37,"Chatham County, NC",Mar-19,35719,34446,1273,3.6
1908,CN3703900000000,37,39,"Cherokee County, NC",Mar-19,11409,10878,531,4.7
1909,CN3704100000000,37,41,"Chowan County, NC",Mar-19,5539,5267,272,4.9
1910,CN3704300000000,37,43,"Clay County, NC",Mar-19,4113,3922,191,4.6
1911,CN3704500000000,37,45,"Cleveland County, NC",Mar-19,48692,46745,1947,4.0
1912,CN3704700000000,37,47,"Columbus County, NC",Mar-19,22672,21525,1147,5.1
1913,CN3704900000000,37,49,"Craven County, NC",Mar-19,42118,40311,1807,4.3
1914,CN3705100000000,37,51,"Cumberland County, NC",Mar-19,129623,122941,6682,5.2
1915,CN3705300000000,37,53,"Currituck County, NC",Mar-19,14078,13519,559,4.0
1916,CN3705500000000,37,55,"Dare County, NC",Mar-19,18172,16966,1206,6.6
1917,CN3705700000000,37,57,"Davidson County, NC",Mar-19,81914,78844,3070,3.7
1918,CN3705900000000,37,59,"Davie County, NC",Mar-19,20946,20208,738,3.5
1919,CN3706100000000,37,61,"Duplin County, NC",Mar-19,25402,24319,1083,4.3
1920,CN3706300000000,37,63,"Durham County, NC",Mar-19,172441,166311,6130,3.6
1921,CN3706500000000,37,65,"Edgecombe County, NC",Mar-19,21660,20387,1273,5.9
1922,CN3706700000000,37,67,"Forsyth County, NC",Mar-19,190382,183093,7289,3.8
1923,CN3706900000000,37,69,"Franklin County, NC",Mar-19,31488,30170,1318,4.2
1924,CN3707100000000,37,71,"Gaston County, NC",Mar-19,111526,107106,4420,4.0
1925,CN3707300000000,37,73,"Gates County, NC",Mar-19,5357,5130,227,4.2
1926,CN3707500000000,37,75,"Graham County, NC",Mar-19,3264,3074,190,5.8
1927,CN3707700000000,37,77,"Granville County, NC",Mar-19,30594,29530,1064,3.5
1928,CN3707900000000,37,79,"Greene County, NC",Mar-19,9677,9308,369,3.8
1929,CN3708100000000,37,81,"Guilford County, NC",Mar-19,266341,255226,11115,4.2
1930,CN3708300000000,37,83,"Halifax County, NC",Mar-19,20712,19556,1156,5.6
1931,CN3708500000000,37,85,"Harnett County, NC",Mar-19,53651,51074,2577,4.8
1932,CN3708700000000,37,87,"Haywood County, NC",Mar-19,30249,29138,1111,3.7
1933,CN3708900000000,37,89,"Henderson County, NC",Mar-19,55565,53634,1931,3.5
1934,CN3709100000000,37,91,"Hertford County, NC",Mar-19,9347,8855,492,5.3
1935,CN3709300000000,37,93,"Hoke County, NC",Mar-19,20402,19384,1018,5.0
1936,CN3709500000000,37,95,"Hyde County, NC",Mar-19,1810,1605,205,11.3
1937,CN3709700000000,37,97,"Iredell County, NC",Mar-19,89837,86510,3327,3.7
1938,CN3709900000000,37,99,"Jackson County, NC",Mar-19,19598,18686,912,4.7
1939,CN3710100000000,37,101,"Johnston County, NC",Mar-19,99661,95903,3758,3.8
1940,CN3710300000000,37,103,"Jones County, NC",Mar-19,4452,4265,187,4.2
1941,CN3710500000000,37,105,"Lee County, NC",Mar-19,26608,25372,1236,4.6
1942,CN3710700000000,37,107,"Lenoir County, NC",Mar-19,28104,27010,1094,3.9
1943,CN3710900000000,37,109,"Lincoln County, NC",Mar-19,43582,41978,1604,3.7
1944,CN3711100000000,37,111,"McDowell County, NC",Mar-19,21272,20466,806,3.8
1945,CN3711300000000,37,113,"Macon County, NC",Mar-19,15179,14505,674,4.4
1946,CN3711500000000,37,115,"Madison County, NC",Mar-19,10254,9870,384,3.7
1947,CN3711700000000,37,117,"Martin County, NC",Mar-19,9218,8734,484,5.3
1948,CN3711900000000,37,119,"Mecklenburg County, NC",Mar-19,623872,600494,23378,3.7
1949,CN3712100000000,37,121,"Mitchell County, NC",Mar-19,6123,5821,302,4.9
1950,CN3712300000000,37,123,"Montgomery County, NC",Mar-19,11623,11145,478,4.1
1951,CN3712500000000,37,125,"Moore County, NC",Mar-19,42927,41231,1696,4.0
1952,CN3712700000000,37,127,"Nash County, NC",Mar-19,43998,41882,2116,4.8
1953,CN3712900000000,37,129,"New Hanover County, NC",Mar-19,123469,118741,4728,3.8
1954,CN3713100000000,37,131,"Northampton County, NC",Mar-19,7877,7469,408,5.2
1955,CN3713300000000,37,133,"Onslow County, NC",Mar-19,65764,62592,3172,4.8
1956,CN3713500000000,37,135,"Orange County, NC",Mar-19,79226,76473,2753,3.5
1957,CN3713700000000,37,137,"Pamlico County, NC",Mar-19,5397,5181,216,4.0
1958,CN3713900000000,37,139,"Pasquotank County, NC",Mar-19,16991,16197,794,4.7
1959,CN3714100000000,37,141,"Pender County, NC",Mar-19,28785,27587,1198,4.2
1960,CN3714300000000,37,143,"Perquimans County, NC",Mar-19,5033,4775,258,5.1
1961,CN3714500000000,37,145,"Person County, NC",Mar-19,18610,17791,819,4.4
1962,CN3714700000000,37,147,"Pitt County, NC",Mar-19,91455,87608,3847,4.2
1963,CN3714900000000,37,149,"Polk County, NC",Mar-19,8981,8623,358,4.0
1964,CN3715100000000,37,151,"Randolph County, NC",Mar-19,67256,64646,2610,3.9
1965,CN3715300000000,37,153,"Richmond County, NC",Mar-19,16839,15949,890,5.3
1966,CN3715500000000,37,155,"Robeson County, NC",Mar-19,50702,47909,2793,5.5
1967,CN3715700000000,37,157,"Rockingham County, NC",Mar-19,40697,38875,1822,4.5
1968,CN3715900000000,37,159,"Rowan County, NC",Mar-19,66398,63673,2725,4.1
1969,CN3716100000000,37,161,"Rutherford County, NC",Mar-19,25456,24166,1290,5.1
1970,CN3716300000000,37,163,"Sampson County, NC",Mar-19,29758,28581,1177,4.0
1971,CN3716500000000,37,165,"Scotland County, NC",Mar-19,11674,10908,766,6.6
1972,CN3716700000000,37,167,"Stanly County, NC",Mar-19,30416,29272,1144,3.8
1973,CN3716900000000,37,169,"Stokes County, NC",Mar-19,21955,21135,820,3.7
1974,CN3717100000000,37,171,"Surry County, NC",Mar-19,34317,33014,1303,3.8
1975,CN3717300000000,37,173,"Swain County, NC",Mar-19,6903,6575,328,4.8
1976,CN3717500000000,37,175,"Transylvania County, NC",Mar-19,14381,13794,587,4.1
1977,CN3717700000000,37,177,"Tyrrell County, NC",Mar-19,1372,1269,103,7.5
1978,CN3717900000000,37,179,"Union County, NC",Mar-19,124258,119736,4522,3.6
1979,CN3718100000000,37,181,"Vance County, NC",Mar-19,17414,16406,1008,5.8
1980,CN3718300000000,37,183,"Wake County, NC",Mar-19,598875,577878,20997,3.5
1981,CN3718500000000,37,185,"Warren County, NC",Mar-19,6524,6151,373,5.7
1982,CN3718700000000,37,187,"Washington County, NC",Mar-19,4459,4177,282,6.3
1983,CN3718900000000,37,189,"Watauga County, NC",Mar-19,29065,27924,1141,3.9
1984,CN3719100000000,37,191,"Wayne County, NC",Mar-19,53052,50783,2269,4.3
1985,CN3719300000000,37,193,"Wilkes County, NC",Mar-19,29599,28352,1247,4.2
1986,CN3719500000000,37,195,"Wilson County, NC",Mar-19,35166,33199,1967,5.6
1987,CN3719700000000,37,197,"Yadkin County, NC",Mar-19,17995,17360,635,3.5
1988,CN3719900000000,37,199,"Yancey County, NC",Mar-19,8399,8074,325,3.9
1989,CN3800100000000,38,1,"Adams County, ND",Mar-19,1020,994,26,2.5
1990,CN3800300000000,38,3,"Barnes County, ND",Mar-19,5146,4982,164,3.2
1991,CN3800500000000,38,5,"Benson County, ND",Mar-19,2310,2188,122,5.3
1992,CN3800700000000,38,7,"Billings County, ND",Mar-19,359,344,15,4.2
1993,CN3800900000000,38,9,"Bottineau County, ND",Mar-19,2912,2777,135,4.6
1994,CN3801100000000,38,11,"Bowman County, ND",Mar-19,1738,1707,31,1.8
1995,CN3801300000000,38,13,"Burke County, ND",Mar-19,1079,1051,28,2.6
1996,CN3801500000000,38,15,"Burleigh County, ND",Mar-19,48823,47230,1593,3.3
1997,CN3801700000000,38,17,"Cass County, ND",Mar-19,101401,98714,2687,2.6
1998,CN3801900000000,38,19,"Cavalier County, ND",Mar-19,1859,1791,68,3.7
1999,CN3802100000000,38,21,"Dickey County, ND",Mar-19,2268,2215,53,2.3
2000,CN3802300000000,38,23,"Divide County, ND",Mar-19,1417,1398,19,1.3
2001,CN3802500000000,38,25,"Dunn County, ND",Mar-19,3102,3040,62,2.0
2002,CN3802700000000,38,27,"Eddy County, ND",Mar-19,1230,1156,74,6.0
2003,CN3802900000000,38,29,"Emmons County, ND",Mar-19,1427,1340,87,6.1
2004,CN3803100000000,38,31,"Foster County, ND",Mar-19,1502,1448,54,3.6
2005,CN3803300000000,38,33,"Golden Valley County, ND",Mar-19,839,818,21,2.5
2006,CN3803500000000,38,35,"Grand Forks County, ND",Mar-19,37227,36300,927,2.5
2007,CN3803700000000,38,37,"Grant County, ND",Mar-19,1174,1136,38,3.2
2008,CN3803900000000,38,39,"Griggs County, ND",Mar-19,1012,983,29,2.9
2009,CN3804100000000,38,41,"Hettinger County, ND",Mar-19,1338,1314,24,1.8
2010,CN3804300000000,38,43,"Kidder County, ND",Mar-19,1256,1180,76,6.1
2011,CN3804500000000,38,45,"LaMoure County, ND",Mar-19,2041,1988,53,2.6
2012,CN3804700000000,38,47,"Logan County, ND",Mar-19,873,842,31,3.6
2013,CN3804900000000,38,49,"McHenry County, ND",Mar-19,3072,2908,164,5.3
2014,CN3805100000000,38,51,"McIntosh County, ND",Mar-19,1098,1056,42,3.8
2015,CN3805300000000,38,53,"McKenzie County, ND",Mar-19,9836,9667,169,1.7
2016,CN3805500000000,38,55,"McLean County, ND",Mar-19,4545,4346,199,4.4
2017,CN3805700000000,38,57,"Mercer County, ND",Mar-19,3560,3373,187,5.3
2018,CN3805900000000,38,59,"Morton County, ND",Mar-19,16131,15470,661,4.1
2019,CN3806100000000,38,61,"Mountrail County, ND",Mar-19,7033,6919,114,1.6
2020,CN3806300000000,38,63,"Nelson County, ND",Mar-19,1359,1297,62,4.6
2021,CN3806500000000,38,65,"Oliver County, ND",Mar-19,854,816,38,4.4
2022,CN3806700000000,38,67,"Pembina County, ND",Mar-19,3275,3135,140,4.3
2023,CN3806900000000,38,69,"Pierce County, ND",Mar-19,1698,1622,76,4.5
2024,CN3807100000000,38,71,"Ramsey County, ND",Mar-19,5521,5308,213,3.9
2025,CN3807300000000,38,73,"Ransom County, ND",Mar-19,2752,2692,60,2.2
2026,CN3807500000000,38,75,"Renville County, ND",Mar-19,1193,1160,33,2.8
2027,CN3807700000000,38,77,"Richland County, ND",Mar-19,8522,8259,263,3.1
2028,CN3807900000000,38,79,"Rolette County, ND",Mar-19,4558,4180,378,8.3
2029,CN3808100000000,38,81,"Sargent County, ND",Mar-19,2595,2535,60,2.3
2030,CN3808300000000,38,83,"Sheridan County, ND",Mar-19,659,621,38,5.8
2031,CN3808500000000,38,85,"Sioux County, ND",Mar-19,1215,1164,51,4.2
2032,CN3808700000000,38,87,"Slope County, ND",Mar-19,383,374,9,2.3
2033,CN3808900000000,38,89,"Stark County, ND",Mar-19,18228,17785,443,2.4
2034,CN3809100000000,38,91,"Steele County, ND",Mar-19,965,943,22,2.3
2035,CN3809300000000,38,93,"Stutsman County, ND",Mar-19,10242,9955,287,2.8
2036,CN3809500000000,38,95,"Towner County, ND",Mar-19,1132,1099,33,2.9
2037,CN3809700000000,38,97,"Traill County, ND",Mar-19,4349,4216,133,3.1
2038,CN3809900000000,38,99,"Walsh County, ND",Mar-19,5092,4884,208,4.1
2039,CN3810100000000,38,101,"Ward County, ND",Mar-19,31109,30063,1046,3.4
2040,CN3810300000000,38,103,"Wells County, ND",Mar-19,1893,1810,83,4.4
2041,CN3810500000000,38,105,"Williams County, ND",Mar-19,23702,23196,506,2.1
2042,CN3900100000000,39,1,"Adams County, OH",Mar-19,10848,9998,850,7.8
2043,CN3900300000000,39,3,"Allen County, OH",Mar-19,47731,45819,1912,4.0
2044,CN3900500000000,39,5,"Ashland County, OH",Mar-19,27095,25882,1213,4.5
2045,CN3900700000000,39,7,"Ashtabula County, OH",Mar-19,44272,41952,2320,5.2
2046,CN3900900000000,39,9,"Athens County, OH",Mar-19,29086,27617,1469,5.1
2047,CN3901100000000,39,11,"Auglaize County, OH",Mar-19,25045,24319,726,2.9
2048,CN3901300000000,39,13,"Belmont County, OH",Mar-19,29949,28148,1801,6.0
2049,CN3901500000000,39,15,"Brown County, OH",Mar-19,19574,18535,1039,5.3
2050,CN3901700000000,39,17,"Butler County, OH",Mar-19,193854,186756,7098,3.7
2051,CN3901900000000,39,19,"Carroll County, OH",Mar-19,12998,12291,707,5.4
2052,CN3902100000000,39,21,"Champaign County, OH",Mar-19,19964,19259,705,3.5
2053,CN3902300000000,39,23,"Clark County, OH",Mar-19,63127,60460,2667,4.2
2054,CN3902500000000,39,25,"Clermont County, OH",Mar-19,106262,102256,4006,3.8
2055,CN3902700000000,39,27,"Clinton County, OH",Mar-19,17708,16827,881,5.0
2056,CN3902900000000,39,29,"Columbiana County, OH",Mar-19,47259,44905,2354,5.0
2057,CN3903100000000,39,31,"Coshocton County, OH",Mar-19,14524,13682,842,5.8
2058,CN3903300000000,39,33,"Crawford County, OH",Mar-19,18075,17199,876,4.8
2059,CN3903500000000,39,35,"Cuyahoga County, OH",Mar-19,610097,583403,26694,4.4
2060,CN3903700000000,39,37,"Darke County, OH",Mar-19,25880,24868,1012,3.9
2061,CN3903900000000,39,39,"Defiance County, OH",Mar-19,18024,17273,751,4.2
2062,CN3904100000000,39,41,"Delaware County, OH",Mar-19,108844,105604,3240,3.0
2063,CN3904300000000,39,43,"Erie County, OH",Mar-19,36211,34138,2073,5.7
2064,CN3904500000000,39,45,"Fairfield County, OH",Mar-19,77312,74363,2949,3.8
2065,CN3904700000000,39,47,"Fayette County, OH",Mar-19,13846,13281,565,4.1
2066,CN3904900000000,39,49,"Franklin County, OH",Mar-19,688638,664876,23762,3.5
2067,CN3905100000000,39,51,"Fulton County, OH",Mar-19,22619,21527,1092,4.8
2068,CN3905300000000,39,53,"Gallia County, OH",Mar-19,12499,11792,707,5.7
2069,CN3905500000000,39,55,"Geauga County, OH",Mar-19,49055,47156,1899,3.9
2070,CN3905700000000,39,57,"Greene County, OH",Mar-19,82759,79735,3024,3.7
2071,CN3905900000000,39,59,"Guernsey County, OH",Mar-19,18744,17599,1145,6.1
2072,CN3906100000000,39,61,"Hamilton County, OH",Mar-19,412861,397891,14970,3.6
2073,CN3906300000000,39,63,"Hancock County, OH",Mar-19,41918,40641,1277,3.0
2074,CN3906500000000,39,65,"Hardin County, OH",Mar-19,14280,13729,551,3.9
2075,CN3906700000000,39,67,"Harrison County, OH",Mar-19,6838,6483,355,5.2
2076,CN3906900000000,39,69,"Henry County, OH",Mar-19,13377,12610,767,5.7
2077,CN3907100000000,39,71,"Highland County, OH",Mar-19,17228,16310,918,5.3
2078,CN3907300000000,39,73,"Hocking County, OH",Mar-19,13018,12325,693,5.3
2079,CN3907500000000,39,75,"Holmes County, OH",Mar-19,20752,20139,613,3.0
2080,CN3907700000000,39,77,"Huron County, OH",Mar-19,28070,26155,1915,6.8
2081,CN3907900000000,39,79,"Jackson County, OH",Mar-19,12828,11970,858,6.7
2082,CN3908100000000,39,81,"Jefferson County, OH",Mar-19,27657,25975,1682,6.1
2083,CN3908300000000,39,83,"Knox County, OH",Mar-19,31866,30554,1312,4.1
2084,CN3908500000000,39,85,"Lake County, OH",Mar-19,126183,121012,5171,4.1
2085,CN3908700000000,39,87,"Lawrence County, OH",Mar-19,23743,22548,1195,5.0
2086,CN3908900000000,39,89,"Licking County, OH",Mar-19,89553,86227,3326,3.7
2087,CN3909100000000,39,91,"Logan County, OH",Mar-19,22997,22172,825,3.6
2088,CN3909300000000,39,93,"Lorain County, OH",Mar-19,153536,146452,7084,4.6
2089,CN3909500000000,39,95,"Lucas County, OH",Mar-19,209092,199308,9784,4.7
2090,CN3909700000000,39,97,"Madison County, OH",Mar-19,20745,19988,757,3.6
2091,CN3909900000000,39,99,"Mahoning County, OH",Mar-19,103455,97001,6454,6.2
2092,CN3910100000000,39,101,"Marion County, OH",Mar-19,28618,27418,1200,4.2
2093,CN3910300000000,39,103,"Medina County, OH",Mar-19,97273,93778,3495,3.6
2094,CN3910500000000,39,105,"Meigs County, OH",Mar-19,9323,8624,699,7.5
2095,CN3910700000000,39,107,"Mercer County, OH",Mar-19,23447,22853,594,2.5
2096,CN3910900000000,39,109,"Miami County, OH",Mar-19,53926,51912,2014,3.7
2097,CN3911100000000,39,111,"Monroe County, OH",Mar-19,5439,4939,500,9.2
2098,CN3911300000000,39,113,"Montgomery County, OH",Mar-19,250638,240407,10231,4.1
2099,CN3911500000000,39,115,"Morgan County, OH",Mar-19,6829,6320,509,7.5
2100,CN3911700000000,39,117,"Morrow County, OH",Mar-19,16702,15957,745,4.5
2101,CN3911900000000,39,119,"Muskingum County, OH",Mar-19,39364,37211,2153,5.5
2102,CN3912100000000,39,121,"Noble County, OH",Mar-19,4736,4365,371,7.8
2103,CN3912300000000,39,123,"Ottawa County, OH",Mar-19,20305,18771,1534,7.6
2104,CN3912500000000,39,125,"Paulding County, OH",Mar-19,8648,8344,304,3.5
2105,CN3912700000000,39,127,"Perry County, OH",Mar-19,15855,14950,905,5.7
2106,CN3912900000000,39,129,"Pickaway County, OH",Mar-19,26313,25187,1126,4.3
2107,CN3913100000000,39,131,"Pike County, OH",Mar-19,10951,10203,748,6.8
2108,CN3913300000000,39,133,"Portage County, OH",Mar-19,87095,83221,3874,4.4
2109,CN3913500000000,39,135,"Preble County, OH",Mar-19,21136,20313,823,3.9
2110,CN3913700000000,39,137,"Putnam County, OH",Mar-19,18875,18272,603,3.2
2111,CN3913900000000,39,139,"Richland County, OH",Mar-19,52230,49781,2449,4.7
2112,CN3914100000000,39,141,"Ross County, OH",Mar-19,35323,33756,1567,4.4
2113,CN3914300000000,39,143,"Sandusky County, OH",Mar-19,30594,29182,1412,4.6
2114,CN3914500000000,39,145,"Scioto County, OH",Mar-19,28925,27029,1896,6.6
2115,CN3914700000000,39,147,"Seneca County, OH",Mar-19,27502,26348,1154,4.2
2116,CN3914900000000,39,149,"Shelby County, OH",Mar-19,24240,23395,845,3.5
2117,CN3915100000000,39,151,"Stark County, OH",Mar-19,185502,176499,9003,4.9
2118,CN3915300000000,39,153,"Summit County, OH",Mar-19,271569,259371,12198,4.5
2119,CN3915500000000,39,155,"Trumbull County, OH",Mar-19,87178,81240,5938,6.8
2120,CN3915700000000,39,157,"Tuscarawas County, OH",Mar-19,44391,42337,2054,4.6
2121,CN3915900000000,39,159,"Union County, OH",Mar-19,28712,27835,877,3.1
2122,CN3916100000000,39,161,"Van Wert County, OH",Mar-19,15112,14644,468,3.1
2123,CN3916300000000,39,163,"Vinton County, OH",Mar-19,5588,5224,364,6.5
2124,CN3916500000000,39,165,"Warren County, OH",Mar-19,118435,114370,4065,3.4
2125,CN3916700000000,39,167,"Washington County, OH",Mar-19,27246,25696,1550,5.7
2126,CN3916900000000,39,169,"Wayne County, OH",Mar-19,62047,60028,2019,3.3
2127,CN3917100000000,39,171,"Williams County, OH",Mar-19,18957,18337,620,3.3
2128,CN3917300000000,39,173,"Wood County, OH",Mar-19,70847,68253,2594,3.7
2129,CN3917500000000,39,175,"Wyandot County, OH",Mar-19,13050,12648,402,3.1
2130,CN4000100000000,40,1,"Adair County, OK",Mar-19,8041,7704,337,4.2
2131,CN4000300000000,40,3,"Alfalfa County, OK",Mar-19,2797,2741,56,2.0
2132,CN4000500000000,40,5,"Atoka County, OK",Mar-19,4935,4728,207,4.2
2133,CN4000700000000,40,7,"Beaver County, OK",Mar-19,2802,2739,63,2.2
2134,CN4000900000000,40,9,"Beckham County, OK",Mar-19,10817,10534,283,2.6
2135,CN4001100000000,40,11,"Blaine County, OK",Mar-19,4706,4613,93,2.0
2136,CN4001300000000,40,13,"Bryan County, OK",Mar-19,20946,20295,651,3.1
2137,CN4001500000000,40,15,"Caddo County, OK",Mar-19,11892,11500,392,3.3
2138,CN4001700000000,40,17,"Canadian County, OK",Mar-19,73910,71871,2039,2.8
2139,CN4001900000000,40,19,"Carter County, OK",Mar-19,21478,20744,734,3.4
2140,CN4002100000000,40,21,"Cherokee County, OK",Mar-19,18597,17879,718,3.9
2141,CN4002300000000,40,23,"Choctaw County, OK",Mar-19,5360,5115,245,4.6
2142,CN4002500000000,40,25,"Cimarron County, OK",Mar-19,1291,1268,23,1.8
2143,CN4002700000000,40,27,"Cleveland County, OK",Mar-19,142581,138462,4119,2.9
2144,CN4002900000000,40,29,"Coal County, OK",Mar-19,2577,2492,85,3.3
2145,CN4003100000000,40,31,"Comanche County, OK",Mar-19,48186,46446,1740,3.6
2146,CN4003300000000,40,33,"Cotton County, OK",Mar-19,2697,2610,87,3.2
2147,CN4003500000000,40,35,"Craig County, OK",Mar-19,5864,5661,203,3.5
2148,CN4003700000000,40,37,"Creek County, OK",Mar-19,31537,30390,1147,3.6
2149,CN4003900000000,40,39,"Custer County, OK",Mar-19,15725,15351,374,2.4
2150,CN4004100000000,40,41,"Delaware County, OK",Mar-19,17629,16920,709,4.0
2151,CN4004300000000,40,43,"Dewey County, OK",Mar-19,2807,2754,53,1.9
2152,CN4004500000000,40,45,"Ellis County, OK",Mar-19,2138,2087,51,2.4
2153,CN4004700000000,40,47,"Garfield County, OK",Mar-19,27032,26200,832,3.1
2154,CN4004900000000,40,49,"Garvin County, OK",Mar-19,12833,12444,389,3.0
2155,CN4005100000000,40,51,"Grady County, OK",Mar-19,26288,25501,787,3.0
2156,CN4005300000000,40,53,"Grant County, OK",Mar-19,2613,2557,56,2.1
2157,CN4005500000000,40,55,"Greer County, OK",Mar-19,1802,1722,80,4.4
2158,CN4005700000000,40,57,"Harmon County, OK",Mar-19,1189,1156,33,2.8
2159,CN4005900000000,40,59,"Harper County, OK",Mar-19,1722,1673,49,2.8
2160,CN4006100000000,40,61,"Haskell County, OK",Mar-19,4219,4023,196,4.6
2161,CN4006300000000,40,63,"Hughes County, OK",Mar-19,5394,5168,226,4.2
2162,CN4006500000000,40,65,"Jackson County, OK",Mar-19,10633,10314,319,3.0
2163,CN4006700000000,40,67,"Jefferson County, OK",Mar-19,2515,2435,80,3.2
2164,CN4006900000000,40,69,"Johnston County, OK",Mar-19,3833,3681,152,4.0
2165,CN4007100000000,40,71,"Kay County, OK",Mar-19,18275,17525,750,4.1
2166,CN4007300000000,40,73,"Kingfisher County, OK",Mar-19,9080,8888,192,2.1
2167,CN4007500000000,40,75,"Kiowa County, OK",Mar-19,3353,3235,118,3.5
2168,CN4007700000000,40,77,"Latimer County, OK",Mar-19,3142,2968,174,5.5
2169,CN4007900000000,40,79,"Le Flore County, OK",Mar-19,18913,18072,841,4.4
2170,CN4008100000000,40,81,"Lincoln County, OK",Mar-19,15681,15123,558,3.6
2171,CN4008300000000,40,83,"Logan County, OK",Mar-19,22014,21341,673,3.1
2172,CN4008500000000,40,85,"Love County, OK",Mar-19,6183,6045,138,2.2
2173,CN4008700000000,40,87,"McClain County, OK",Mar-19,19480,18953,527,2.7
2174,CN4008900000000,40,89,"McCurtain County, OK",Mar-19,14143,13457,686,4.9
2175,CN4009100000000,40,91,"McIntosh County, OK",Mar-19,6951,6576,375,5.4
2176,CN4009300000000,40,93,"Major County, OK",Mar-19,3868,3780,88,2.3
2177,CN4009500000000,40,95,"Marshall County, OK",Mar-19,6815,6576,239,3.5
2178,CN4009700000000,40,97,"Mayes County, OK",Mar-19,19398,18793,605,3.1
2179,CN4009900000000,40,99,"Murray County, OK",Mar-19,6271,6074,197,3.1
2180,CN4010100000000,40,101,"Muskogee County, OK",Mar-19,29073,28021,1052,3.6
2181,CN4010300000000,40,103,"Noble County, OK",Mar-19,5731,5590,141,2.5
2182,CN4010500000000,40,105,"Nowata County, OK",Mar-19,4608,4439,169,3.7
2183,CN4010700000000,40,107,"Okfuskee County, OK",Mar-19,4648,4454,194,4.2
2184,CN4010900000000,40,109,"Oklahoma County, OK",Mar-19,383639,371647,11992,3.1
2185,CN4011100000000,40,111,"Okmulgee County, OK",Mar-19,15609,14885,724,4.6
2186,CN4011300000000,40,113,"Osage County, OK",Mar-19,20640,19855,785,3.8
2187,CN4011500000000,40,115,"Ottawa County, OK",Mar-19,14148,13654,494,3.5
2188,CN4011700000000,40,117,"Pawnee County, OK",Mar-19,7318,7037,281,3.8
2189,CN4011900000000,40,119,"Payne County, OK",Mar-19,38493,37366,1127,2.9
2190,CN4012100000000,40,121,"Pittsburg County, OK",Mar-19,17424,16792,632,3.6
2191,CN4012300000000,40,123,"Pontotoc County, OK",Mar-19,18963,18424,539,2.8
2192,CN4012500000000,40,125,"Pottawatomie County, OK",Mar-19,32203,31051,1152,3.6
2193,CN4012700000000,40,127,"Pushmataha County, OK",Mar-19,4245,4041,204,4.8
2194,CN4012900000000,40,129,"Roger Mills County, OK",Mar-19,1881,1833,48,2.6
2195,CN4013100000000,40,131,"Rogers County, OK",Mar-19,45092,43703,1389,3.1
2196,CN4013300000000,40,133,"Seminole County, OK",Mar-19,9498,9077,421,4.4
2197,CN4013500000000,40,135,"Sequoyah County, OK",Mar-19,16078,15440,638,4.0
2198,CN4013700000000,40,137,"Stephens County, OK",Mar-19,18663,17963,700,3.8
2199,CN4013900000000,40,139,"Texas County, OK",Mar-19,11073,10833,240,2.2
2200,CN4014100000000,40,141,"Tillman County, OK",Mar-19,3018,2913,105,3.5
2201,CN4014300000000,40,143,"Tulsa County, OK",Mar-19,323001,312893,10108,3.1
2202,CN4014500000000,40,145,"Wagoner County, OK",Mar-19,37914,36737,1177,3.1
2203,CN4014700000000,40,147,"Washington County, OK",Mar-19,22503,21715,788,3.5
2204,CN4014900000000,40,149,"Washita County, OK",Mar-19,5154,5001,153,3.0
2205,CN4015100000000,40,151,"Woods County, OK",Mar-19,4605,4501,104,2.3
2206,CN4015300000000,40,153,"Woodward County, OK",Mar-19,8944,8695,249,2.8
2207,CN4100100000000,41,1,"Baker County, OR",Mar-19,7022,6592,430,6.1
2208,CN4100300000000,41,3,"Benton County, OR",Mar-19,48747,47094,1653,3.4
2209,CN4100500000000,41,5,"Clackamas County, OR",Mar-19,219230,210569,8661,4.0
2210,CN4100700000000,41,7,"Clatsop County, OR",Mar-19,19065,18198,867,4.5
2211,CN4100900000000,41,9,"Columbia County, OR",Mar-19,24456,23236,1220,5.0
2212,CN4101100000000,41,11,"Coos County, OR",Mar-19,26310,24777,1533,5.8
2213,CN4101300000000,41,13,"Crook County, OR",Mar-19,9452,8751,701,7.4
2214,CN4101500000000,41,15,"Curry County, OR",Mar-19,8840,8263,577,6.5
2215,CN4101700000000,41,17,"Deschutes County, OR",Mar-19,94850,89878,4972,5.2
2216,CN4101900000000,41,19,"Douglas County, OR",Mar-19,46237,43497,2740,5.9
2217,CN4102100000000,41,21,"Gilliam County, OR",Mar-19,981,940,41,4.2
2218,CN4102300000000,41,23,"Grant County, OR",Mar-19,3123,2810,313,10.0
2219,CN4102500000000,41,25,"Harney County, OR",Mar-19,3514,3257,257,7.3
2220,CN4102700000000,41,27,"Hood River County, OR",Mar-19,13724,13137,587,4.3
2221,CN4102900000000,41,29,"Jackson County, OR",Mar-19,103253,97688,5565,5.4
2222,CN4103100000000,41,31,"Jefferson County, OR",Mar-19,10064,9330,734,7.3
2223,CN4103300000000,41,33,"Josephine County, OR",Mar-19,35615,33444,2171,6.1
2224,CN4103500000000,41,35,"Klamath County, OR",Mar-19,29068,26805,2263,7.8
2225,CN4103700000000,41,37,"Lake County, OR",Mar-19,3469,3193,276,8.0
2226,CN4103900000000,41,39,"Lane County, OR",Mar-19,181248,172514,8734,4.8
2227,CN4104100000000,41,41,"Lincoln County, OR",Mar-19,20514,19437,1077,5.3
2228,CN4104300000000,41,43,"Linn County, OR",Mar-19,58877,55918,2959,5.0
2229,CN4104500000000,41,45,"Malheur County, OR",Mar-19,12122,11491,631,5.2
2230,CN4104700000000,41,47,"Marion County, OR",Mar-19,160813,153281,7532,4.7
2231,CN4104900000000,41,49,"Morrow County, OR",Mar-19,5564,5282,282,5.1
2232,CN4105100000000,41,51,"Multnomah County, OR",Mar-19,455019,437557,17462,3.8
2233,CN4105300000000,41,53,"Polk County, OR",Mar-19,39626,37744,1882,4.7
2234,CN4105500000000,41,55,"Sherman County, OR",Mar-19,898,860,38,4.2
2235,CN4105700000000,41,57,"Tillamook County, OR",Mar-19,11805,11244,561,4.8
2236,CN4105900000000,41,59,"Umatilla County, OR",Mar-19,35802,33696,2106,5.9
2237,CN4106100000000,41,61,"Union County, OR",Mar-19,11989,11220,769,6.4
2238,CN4106300000000,41,63,"Wallowa County, OR",Mar-19,3344,3021,323,9.7
2239,CN4106500000000,41,65,"Wasco County, OR",Mar-19,12396,11705,691,5.6
2240,CN4106700000000,41,67,"Washington County, OR",Mar-19,324427,312757,11670,3.6
2241,CN4106900000000,41,69,"Wheeler County, OR",Mar-19,729,691,38,5.2
2242,CN4107100000000,41,71,"Yamhill County, OR",Mar-19,54578,52440,2138,3.9
2243,CN4200100000000,42,1,"Adams County, PA",Mar-19,55159,53465,1694,3.1
2244,CN4200300000000,42,3,"Allegheny County, PA",Mar-19,644822,618701,26121,4.1
2245,CN4200500000000,42,5,"Armstrong County, PA",Mar-19,32034,30350,1684,5.3
2246,CN4200700000000,42,7,"Beaver County, PA",Mar-19,83437,79749,3688,4.4
2247,CN4200900000000,42,9,"Bedford County, PA",Mar-19,23155,21974,1181,5.1
2248,CN4201100000000,42,11,"Berks County, PA",Mar-19,213819,204851,8968,4.2
2249,CN4201300000000,42,13,"Blair County, PA",Mar-19,58803,56280,2523,4.3
2250,CN4201500000000,42,15,"Bradford County, PA",Mar-19,28465,27151,1314,4.6
2251,CN4201700000000,42,17,"Bucks County, PA",Mar-19,342122,329249,12873,3.8
2252,CN4201900000000,42,19,"Butler County, PA",Mar-19,99132,95241,3891,3.9
2253,CN4202100000000,42,21,"Cambria County, PA",Mar-19,57872,54858,3014,5.2
2254,CN4202300000000,42,23,"Cameron County, PA",Mar-19,2056,1929,127,6.2
2255,CN4202500000000,42,25,"Carbon County, PA",Mar-19,32070,30254,1816,5.7
2256,CN4202700000000,42,27,"Centre County, PA",Mar-19,80926,78474,2452,3.0
2257,CN4202900000000,42,29,"Chester County, PA",Mar-19,281368,273064,8304,3.0
2258,CN4203100000000,42,31,"Clarion County, PA",Mar-19,17055,16152,903,5.3
2259,CN4203300000000,42,33,"Clearfield County, PA",Mar-19,35866,33875,1991,5.6
2260,CN4203500000000,42,35,"Clinton County, PA",Mar-19,18416,17372,1044,5.7
2261,CN4203700000000,42,37,"Columbia County, PA",Mar-19,33564,31954,1610,4.8
2262,CN4203900000000,42,39,"Crawford County, PA",Mar-19,38136,36339,1797,4.7
2263,CN4204100000000,42,41,"Cumberland County, PA",Mar-19,130358,126292,4066,3.1
2264,CN4204300000000,42,43,"Dauphin County, PA",Mar-19,142562,137219,5343,3.7
2265,CN4204500000000,42,45,"Delaware County, PA",Mar-19,297793,286543,11250,3.8
2266,CN4204700000000,42,47,"Elk County, PA",Mar-19,15656,15020,636,4.1
2267,CN4204900000000,42,49,"Erie County, PA",Mar-19,128543,122538,6005,4.7
2268,CN4205100000000,42,51,"Fayette County, PA",Mar-19,56888,53390,3498,6.1
2269,CN4205300000000,42,53,"Forest County, PA",Mar-19,1786,1655,131,7.3
2270,CN4205500000000,42,55,"Franklin County, PA",Mar-19,76848,74001,2847,3.7
2271,CN4205700000000,42,57,"Fulton County, PA",Mar-19,7769,7403,366,4.7
2272,CN4205900000000,42,59,"Greene County, PA",Mar-19,16627,15804,823,4.9
2273,CN4206100000000,42,61,"Huntingdon County, PA",Mar-19,19881,18576,1305,6.6
2274,CN4206300000000,42,63,"Indiana County, PA",Mar-19,39065,37156,1909,4.9
2275,CN4206500000000,42,65,"Jefferson County, PA",Mar-19,20289,19313,976,4.8
2276,CN4206700000000,42,67,"Juniata County, PA",Mar-19,12371,11769,602,4.9
2277,CN4206900000000,42,69,"Lackawanna County, PA",Mar-19,104569,99438,5131,4.9
2278,CN4207100000000,42,71,"Lancaster County, PA",Mar-19,280334,271145,9189,3.3
2279,CN4207300000000,42,73,"Lawrence County, PA",Mar-19,40568,38232,2336,5.8
2280,CN4207500000000,42,75,"Lebanon County, PA",Mar-19,71381,68742,2639,3.7
2281,CN4207700000000,42,77,"Lehigh County, PA",Mar-19,191918,183270,8648,4.5
2282,CN4207900000000,42,79,"Luzerne County, PA",Mar-19,156827,147784,9043,5.8
2283,CN4208100000000,42,81,"Lycoming County, PA",Mar-19,56557,53628,2929,5.2
2284,CN4208300000000,42,83,"McKean County, PA",Mar-19,17168,16267,901,5.2
2285,CN4208500000000,42,85,"Mercer County, PA",Mar-19,48910,46624,2286,4.7
2286,CN4208700000000,42,87,"Mifflin County, PA",Mar-19,20771,19755,1016,4.9
2287,CN4208900000000,42,89,"Monroe County, PA",Mar-19,82615,78234,4381,5.3
2288,CN4209100000000,42,91,"Montgomery County, PA",Mar-19,452144,436913,15231,3.4
2289,CN4209300000000,42,93,"Montour County, PA",Mar-19,9117,8794,323,3.5
2290,CN4209500000000,42,95,"Northampton County, PA",Mar-19,160557,153470,7087,4.4
2291,CN4209700000000,42,97,"Northumberland County, PA",Mar-19,42573,40059,2514,5.9
2292,CN4209900000000,42,99,"Perry County, PA",Mar-19,24076,23186,890,3.7
2293,CN4210100000000,42,101,"Philadelphia County/city, PA",Mar-19,716194,679288,36906,5.2
2294,CN4210300000000,42,103,"Pike County, PA",Mar-19,25085,23631,1454,5.8
2295,CN4210500000000,42,105,"Potter County, PA",Mar-19,7062,6596,466,6.6
2296,CN4210700000000,42,107,"Schuylkill County, PA",Mar-19,65981,62371,3610,5.5
2297,CN4210900000000,42,109,"Snyder County, PA",Mar-19,20158,19268,890,4.4
2298,CN4211100000000,42,111,"Somerset County, PA",Mar-19,33570,31637,1933,5.8
2299,CN4211300000000,42,113,"Sullivan County, PA",Mar-19,2594,2456,138,5.3
2300,CN4211500000000,42,115,"Susquehanna County, PA",Mar-19,20279,19251,1028,5.1
2301,CN4211700000000,42,117,"Tioga County, PA",Mar-19,18782,17659,1123,6.0
2302,CN4211900000000,42,119,"Union County, PA",Mar-19,19773,19026,747,3.8
2303,CN4212100000000,42,121,"Venango County, PA",Mar-19,22204,21118,1086,4.9
2304,CN4212300000000,42,123,"Warren County, PA",Mar-19,18901,17994,907,4.8
2305,CN4212500000000,42,125,"Washington County, PA",Mar-19,106397,101633,4764,4.5
2306,CN4212700000000,42,127,"Wayne County, PA",Mar-19,21877,20625,1252,5.7
2307,CN4212900000000,42,129,"Westmoreland County, PA",Mar-19,180111,171904,8207,4.6
2308,CN4213100000000,42,131,"Wyoming County, PA",Mar-19,13487,12791,696,5.2
2309,CN4213300000000,42,133,"York County, PA",Mar-19,233997,225486,8511,3.6
2310,CN4400100000000,44,1,"Bristol County, RI",Mar-19,25737,24887,850,3.3
2311,CN4400300000000,44,3,"Kent County, RI",Mar-19,89731,86632,3099,3.5
2312,CN4400500000000,44,5,"Newport County, RI",Mar-19,43988,42326,1662,3.8
2313,CN4400700000000,44,7,"Providence County, RI",Mar-19,322135,308715,13420,4.2
2314,CN4400900000000,44,9,"Washington County, RI",Mar-19,68074,65614,2460,3.6
2315,CN4500100000000,45,1,"Abbeville County, SC",Mar-19,10140,9757,383,3.8
2316,CN4500300000000,45,3,"Aiken County, SC",Mar-19,75334,72710,2624,3.5
2317,CN4500500000000,45,5,"Allendale County, SC",Mar-19,2706,2548,158,5.8
2318,CN4500700000000,45,7,"Anderson County, SC",Mar-19,91648,88737,2911,3.2
2319,CN4500900000000,45,9,"Bamberg County, SC",Mar-19,4939,4654,285,5.8
2320,CN4501100000000,45,11,"Barnwell County, SC",Mar-19,8277,7865,412,5.0
2321,CN4501300000000,45,13,"Beaufort County, SC",Mar-19,76733,74282,2451,3.2
2322,CN4501500000000,45,15,"Berkeley County, SC",Mar-19,104249,101100,3149,3.0
2323,CN4501700000000,45,17,"Calhoun County, SC",Mar-19,6557,6289,268,4.1
2324,CN4501900000000,45,19,"Charleston County, SC",Mar-19,211865,205982,5883,2.8
2325,CN4502100000000,45,21,"Cherokee County, SC",Mar-19,25403,24515,888,3.5
2326,CN4502300000000,45,23,"Chester County, SC",Mar-19,13388,12763,625,4.7
2327,CN4502500000000,45,25,"Chesterfield County, SC",Mar-19,22131,21384,747,3.4
2328,CN4502700000000,45,27,"Clarendon County, SC",Mar-19,12592,12036,556,4.4
2329,CN4502900000000,45,29,"Colleton County, SC",Mar-19,16720,16089,631,3.8
2330,CN4503100000000,45,31,"Darlington County, SC",Mar-19,30391,29229,1162,3.8
2331,CN4503300000000,45,33,"Dillon County, SC",Mar-19,12948,12346,602,4.6
2332,CN4503500000000,45,35,"Dorchester County, SC",Mar-19,78294,75951,2343,3.0
2333,CN4503700000000,45,37,"Edgefield County, SC",Mar-19,10714,10360,354,3.3
2334,CN4503900000000,45,39,"Fairfield County, SC",Mar-19,9585,9097,488,5.1
2335,CN4504100000000,45,41,"Florence County, SC",Mar-19,67178,64843,2335,3.5
2336,CN4504300000000,45,43,"Georgetown County, SC",Mar-19,25256,24053,1203,4.8
2337,CN4504500000000,45,45,"Greenville County, SC",Mar-19,256213,248753,7460,2.9
2338,CN4504700000000,45,47,"Greenwood County, SC",Mar-19,31616,30479,1137,3.6
2339,CN4504900000000,45,49,"Hampton County, SC",Mar-19,8261,8000,261,3.2
2340,CN4505100000000,45,51,"Horry County, SC",Mar-19,146217,139660,6557,4.5
2341,CN4505300000000,45,53,"Jasper County, SC",Mar-19,12496,12113,383,3.1
2342,CN4505500000000,45,55,"Kershaw County, SC",Mar-19,29117,28137,980,3.4
2343,CN4505700000000,45,57,"Lancaster County, SC",Mar-19,41240,39604,1636,4.0
2344,CN4505900000000,45,59,"Laurens County, SC",Mar-19,30296,29246,1050,3.5
2345,CN4506100000000,45,61,"Lee County, SC",Mar-19,6529,6259,270,4.1
2346,CN4506300000000,45,63,"Lexington County, SC",Mar-19,149624,145423,4201,2.8
2347,CN4506500000000,45,65,"McCormick County, SC",Mar-19,3402,3273,129,3.8
2348,CN4506700000000,45,67,"Marion County, SC",Mar-19,13093,12403,690,5.3
2349,CN4506900000000,45,69,"Marlboro County, SC",Mar-19,9194,8742,452,4.9
2350,CN4507100000000,45,71,"Newberry County, SC",Mar-19,19081,18513,568,3.0
2351,CN4507300000000,45,73,"Oconee County, SC",Mar-19,34838,33708,1130,3.2
2352,CN4507500000000,45,75,"Orangeburg County, SC",Mar-19,35078,33301,1777,5.1
2353,CN4507700000000,45,77,"Pickens County, SC",Mar-19,57713,55862,1851,3.2
2354,CN4507900000000,45,79,"Richland County, SC",Mar-19,198721,192163,6558,3.3
2355,CN4508100000000,45,81,"Saluda County, SC",Mar-19,8748,8457,291,3.3
2356,CN4508300000000,45,83,"Spartanburg County, SC",Mar-19,154059,149536,4523,2.9
2357,CN4508500000000,45,85,"Sumter County, SC",Mar-19,43724,42015,1709,3.9
2358,CN4508700000000,45,87,"Union County, SC",Mar-19,11742,11270,472,4.0
2359,CN4508900000000,45,89,"Williamsburg County, SC",Mar-19,12140,11510,630,5.2
2360,CN4509100000000,45,91,"York County, SC",Mar-19,140154,135598,4556,3.3
2361,CN4600300000000,46,3,"Aurora County, SD",Mar-19,1547,1504,43,2.8
2362,CN4600500000000,46,5,"Beadle County, SD",Mar-19,9577,9230,347,3.6
2363,CN4600700000000,46,7,"Bennett County, SD",Mar-19,1080,1017,63,5.8
2364,CN4600900000000,46,9,"Bon Homme County, SD",Mar-19,2866,2773,93,3.2
2365,CN4601100000000,46,11,"Brookings County, SD",Mar-19,19175,18583,592,3.1
2366,CN4601300000000,46,13,"Brown County, SD",Mar-19,20771,20095,676,3.3
2367,CN4601500000000,46,15,"Brule County, SD",Mar-19,2418,2342,76,3.1
2368,CN4601700000000,46,17,"Buffalo County, SD",Mar-19,681,650,31,4.6
2369,CN4601900000000,46,19,"Butte County, SD",Mar-19,5033,4856,177,3.5
2370,CN4602100000000,46,21,"Campbell County, SD",Mar-19,771,742,29,3.8
2371,CN4602300000000,46,23,"Charles Mix County, SD",Mar-19,3757,3614,143,3.8
2372,CN4602500000000,46,25,"Clark County, SD",Mar-19,1907,1811,96,5.0
2373,CN4602700000000,46,27,"Clay County, SD",Mar-19,7675,7437,238,3.1
2374,CN4602900000000,46,29,"Codington County, SD",Mar-19,15420,14841,579,3.8
2375,CN4603100000000,46,31,"Corson County, SD",Mar-19,1393,1325,68,4.9
2376,CN4603300000000,46,33,"Custer County, SD",Mar-19,3993,3769,224,5.6
2377,CN4603500000000,46,35,"Davison County, SD",Mar-19,11045,10686,359,3.3
2378,CN4603700000000,46,37,"Day County, SD",Mar-19,2749,2578,171,6.2
2379,CN4603900000000,46,39,"Deuel County, SD",Mar-19,2121,1979,142,6.7
2380,CN4604100000000,46,41,"Dewey County, SD",Mar-19,2207,2080,127,5.8
2381,CN4604300000000,46,43,"Douglas County, SD",Mar-19,1608,1552,56,3.5
2382,CN4604500000000,46,45,"Edmunds County, SD",Mar-19,2070,2005,65,3.1
2383,CN4604700000000,46,47,"Fall River County, SD",Mar-19,2964,2821,143,4.8
2384,CN4604900000000,46,49,"Faulk County, SD",Mar-19,1068,1034,34,3.2
2385,CN4605100000000,46,51,"Grant County, SD",Mar-19,4483,4259,224,5.0
2386,CN4605300000000,46,53,"Gregory County, SD",Mar-19,2021,1942,79,3.9
2387,CN4605500000000,46,55,"Haakon County, SD",Mar-19,1059,1025,34,3.2
2388,CN4605700000000,46,57,"Hamlin County, SD",Mar-19,3277,3138,139,4.2
2389,CN4605900000000,46,59,"Hand County, SD",Mar-19,1794,1738,56,3.1
2390,CN4606100000000,46,61,"Hanson County, SD",Mar-19,1780,1667,113,6.3
2391,CN4606300000000,46,63,"Harding County, SD",Mar-19,728,708,20,2.7
2392,CN4606500000000,46,65,"Hughes County, SD",Mar-19,9892,9580,312,3.2
2393,CN4606700000000,46,67,"Hutchinson County, SD",Mar-19,3601,3470,131,3.6
2394,CN4606900000000,46,69,"Hyde County, SD",Mar-19,693,670,23,3.3
2395,CN4607100000000,46,71,"Jackson County, SD",Mar-19,1218,1135,83,6.8
2396,CN4607300000000,46,73,"Jerauld County, SD",Mar-19,1115,1084,31,2.8
2397,CN4607500000000,46,75,"Jones County, SD",Mar-19,519,500,19,3.7
2398,CN4607700000000,46,77,"Kingsbury County, SD",Mar-19,2744,2644,100,3.6
2399,CN4607900000000,46,79,"Lake County, SD",Mar-19,6707,6449,258,3.8
2400,CN4608100000000,46,81,"Lawrence County, SD",Mar-19,12960,12526,434,3.3
2401,CN4608300000000,46,83,"Lincoln County, SD",Mar-19,34246,33300,946,2.8
2402,CN4608500000000,46,85,"Lyman County, SD",Mar-19,1627,1544,83,5.1
2403,CN4608700000000,46,87,"McCook County, SD",Mar-19,3102,2989,113,3.6
2404,CN4608900000000,46,89,"McPherson County, SD",Mar-19,1023,975,48,4.7
2405,CN4609100000000,46,91,"Marshall County, SD",Mar-19,2345,2237,108,4.6
2406,CN4609300000000,46,93,"Meade County, SD",Mar-19,13773,13197,576,4.2
2407,CN4609500000000,46,95,"Mellette County, SD",Mar-19,759,719,40,5.3
2408,CN4609700000000,46,97,"Miner County, SD",Mar-19,1180,1146,34,2.9
2409,CN4609900000000,46,99,"Minnehaha County, SD",Mar-19,112052,108434,3618,3.2
2410,CN4610100000000,46,101,"Moody County, SD",Mar-19,4032,3898,134,3.3
2411,CN4610200000000,46,102,"Oglala Lakota County, SD",Mar-19,3472,3157,315,9.1
2412,CN4610300000000,46,103,"Pennington County, SD",Mar-19,54962,52910,2052,3.7
2413,CN4610500000000,46,105,"Perkins County, SD",Mar-19,1447,1401,46,3.2
2414,CN4610700000000,46,107,"Potter County, SD",Mar-19,1035,1001,34,3.3
2415,CN4610900000000,46,109,"Roberts County, SD",Mar-19,4790,4535,255,5.3
2416,CN4611100000000,46,111,"Sanborn County, SD",Mar-19,1173,1138,35,3.0
2417,CN4611500000000,46,115,"Spink County, SD",Mar-19,3226,3098,128,4.0
2418,CN4611700000000,46,117,"Stanley County, SD",Mar-19,1852,1784,68,3.7
2419,CN4611900000000,46,119,"Sully County, SD",Mar-19,818,789,29,3.5
2420,CN4612100000000,46,121,"Todd County, SD",Mar-19,3194,3004,190,5.9
2421,CN4612300000000,46,123,"Tripp County, SD",Mar-19,3112,3027,85,2.7
2422,CN4612500000000,46,125,"Turner County, SD",Mar-19,4733,4560,173,3.7
2423,CN4612700000000,46,127,"Union County, SD",Mar-19,8471,8182,289,3.4
2424,CN4612900000000,46,129,"Walworth County, SD",Mar-19,2118,1971,147,6.9
2425,CN4613500000000,46,135,"Yankton County, SD",Mar-19,11860,11505,355,3.0
2426,CN4613700000000,46,137,"Ziebach County, SD",Mar-19,938,899,39,4.2
2427,CN4700100000000,47,1,"Anderson County, TN",Mar-19,34940,33656,1284,3.7
2428,CN4700300000000,47,3,"Bedford County, TN",Mar-19,21090,20291,799,3.8
2429,CN4700500000000,47,5,"Benton County, TN",Mar-19,7044,6729,315,4.5
2430,CN4700700000000,47,7,"Bledsoe County, TN",Mar-19,4291,4046,245,5.7
2431,CN4700900000000,47,9,"Blount County, TN",Mar-19,64039,61895,2144,3.3
2432,CN4701100000000,47,11,"Bradley County, TN",Mar-19,50990,49146,1844,3.6
2433,CN4701300000000,47,13,"Campbell County, TN",Mar-19,14974,14249,725,4.8
2434,CN4701500000000,47,15,"Cannon County, TN",Mar-19,6613,6407,206,3.1
2435,CN4701700000000,47,17,"Carroll County, TN",Mar-19,12263,11678,585,4.8
2436,CN4701900000000,47,19,"Carter County, TN",Mar-19,24524,23477,1047,4.3
2437,CN4702100000000,47,21,"Cheatham County, TN",Mar-19,22006,21384,622,2.8
2438,CN4702300000000,47,23,"Chester County, TN",Mar-19,8629,8319,310,3.6
2439,CN4702500000000,47,25,"Claiborne County, TN",Mar-19,13258,12676,582,4.4
2440,CN4702700000000,47,27,"Clay County, TN",Mar-19,2869,2687,182,6.3
2441,CN4702900000000,47,29,"Cocke County, TN",Mar-19,15050,14310,740,4.9
2442,CN4703100000000,47,31,"Coffee County, TN",Mar-19,25554,24698,856,3.3
2443,CN4703300000000,47,33,"Crockett County, TN",Mar-19,7016,6753,263,3.7
2444,CN4703500000000,47,35,"Cumberland County, TN",Mar-19,23400,22303,1097,4.7
2445,CN4703700000000,47,37,"Davidson County, TN",Mar-19,406905,396126,10779,2.6
2446,CN4703900000000,47,39,"Decatur County, TN",Mar-19,4607,4350,257,5.6
2447,CN4704100000000,47,41,"DeKalb County, TN",Mar-19,7792,7447,345,4.4
2448,CN4704300000000,47,43,"Dickson County, TN",Mar-19,27188,26341,847,3.1
2449,CN4704500000000,47,45,"Dyer County, TN",Mar-19,16715,15948,767,4.6
2450,CN4704700000000,47,47,"Fayette County, TN",Mar-19,19226,18516,710,3.7
2451,CN4704900000000,47,49,"Fentress County, TN",Mar-19,7520,7210,310,4.1
2452,CN4705100000000,47,51,"Franklin County, TN",Mar-19,20354,19660,694,3.4
2453,CN4705300000000,47,53,"Gibson County, TN",Mar-19,22097,21145,952,4.3
2454,CN4705500000000,47,55,"Giles County, TN",Mar-19,15169,14609,560,3.7
2455,CN4705700000000,47,57,"Grainger County, TN",Mar-19,9566,9164,402,4.2
2456,CN4705900000000,47,59,"Greene County, TN",Mar-19,30138,28693,1445,4.8
2457,CN4706100000000,47,61,"Grundy County, TN",Mar-19,5058,4839,219,4.3
2458,CN4706300000000,47,63,"Hamblen County, TN",Mar-19,28304,27181,1123,4.0
2459,CN4706500000000,47,65,"Hamilton County, TN",Mar-19,185356,179282,6074,3.3
2460,CN4706700000000,47,67,"Hancock County, TN",Mar-19,2097,1973,124,5.9
2461,CN4706900000000,47,69,"Hardeman County, TN",Mar-19,9478,9004,474,5.0
2462,CN4707100000000,47,71,"Hardin County, TN",Mar-19,10371,9920,451,4.3
2463,CN4707300000000,47,73,"Hawkins County, TN",Mar-19,24009,23021,988,4.1
2464,CN4707500000000,47,75,"Haywood County, TN",Mar-19,7689,7297,392,5.1
2465,CN4707700000000,47,77,"Henderson County, TN",Mar-19,12351,11788,563,4.6
2466,CN4707900000000,47,79,"Henry County, TN",Mar-19,14257,13634,623,4.4
2467,CN4708100000000,47,81,"Hickman County, TN",Mar-19,11480,11115,365,3.2
2468,CN4708300000000,47,83,"Houston County, TN",Mar-19,3304,3145,159,4.8
2469,CN4708500000000,47,85,"Humphreys County, TN",Mar-19,9015,8669,346,3.8
2470,CN4708700000000,47,87,"Jackson County, TN",Mar-19,4702,4455,247,5.3
2471,CN4708900000000,47,89,"Jefferson County, TN",Mar-19,24721,23782,939,3.8
2472,CN4709100000000,47,91,"Johnson County, TN",Mar-19,7663,7383,280,3.7
2473,CN4709300000000,47,93,"Knox County, TN",Mar-19,246026,238674,7352,3.0
2474,CN4709500000000,47,95,"Lake County, TN",Mar-19,1781,1687,94,5.3
2475,CN4709700000000,47,97,"Lauderdale County, TN",Mar-19,9694,9148,546,5.6
2476,CN4709900000000,47,99,"Lawrence County, TN",Mar-19,19198,18428,770,4.0
2477,CN4710100000000,47,101,"Lewis County, TN",Mar-19,5094,4872,222,4.4
2478,CN4710300000000,47,103,"Lincoln County, TN",Mar-19,17153,16610,543,3.2
2479,CN4710500000000,47,105,"Loudon County, TN",Mar-19,23589,22758,831,3.5
2480,CN4710700000000,47,107,"McMinn County, TN",Mar-19,23696,22785,911,3.8
2481,CN4710900000000,47,109,"McNairy County, TN",Mar-19,8471,8005,466,5.5
2482,CN4711100000000,47,111,"Macon County, TN",Mar-19,11230,10873,357,3.2
2483,CN4711300000000,47,113,"Madison County, TN",Mar-19,49550,47751,1799,3.6
2484,CN4711500000000,47,115,"Marion County, TN",Mar-19,12615,12046,569,4.5
2485,CN4711700000000,47,117,"Marshall County, TN",Mar-19,15892,15358,534,3.4
2486,CN4711900000000,47,119,"Maury County, TN",Mar-19,49569,48114,1455,2.9
2487,CN4712100000000,47,121,"Meigs County, TN",Mar-19,5211,4969,242,4.6
2488,CN4712300000000,47,123,"Monroe County, TN",Mar-19,20369,19617,752,3.7
2489,CN4712500000000,47,125,"Montgomery County, TN",Mar-19,85881,82568,3313,3.9
2490,CN4712700000000,47,127,"Moore County, TN",Mar-19,3613,3510,103,2.9
2491,CN4712900000000,47,129,"Morgan County, TN",Mar-19,7935,7602,333,4.2
2492,CN4713100000000,47,131,"Obion County, TN",Mar-19,12519,11940,579,4.6
2493,CN4713300000000,47,133,"Overton County, TN",Mar-19,9900,9485,415,4.2
2494,CN4713500000000,47,135,"Perry County, TN",Mar-19,3202,3040,162,5.1
2495,CN4713700000000,47,137,"Pickett County, TN",Mar-19,2286,2166,120,5.2
2496,CN4713900000000,47,139,"Polk County, TN",Mar-19,7349,7049,300,4.1
2497,CN4714100000000,47,141,"Putnam County, TN",Mar-19,35246,33945,1301,3.7
2498,CN4714300000000,47,143,"Rhea County, TN",Mar-19,13286,12466,820,6.2
2499,CN4714500000000,47,145,"Roane County, TN",Mar-19,23588,22602,986,4.2
2500,CN4714700000000,47,147,"Robertson County, TN",Mar-19,38124,36991,1133,3.0
2501,CN4714900000000,47,149,"Rutherford County, TN",Mar-19,185290,180358,4932,2.7
2502,CN4715100000000,47,151,"Scott County, TN",Mar-19,8474,8082,392,4.6
2503,CN4715300000000,47,153,"Sequatchie County, TN",Mar-19,6225,5969,256,4.1
2504,CN4715500000000,47,155,"Sevier County, TN",Mar-19,53693,51670,2023,3.8
2505,CN4715700000000,47,157,"Shelby County, TN",Mar-19,449385,431110,18275,4.1
2506,CN4715900000000,47,159,"Smith County, TN",Mar-19,9499,9189,310,3.3
2507,CN4716100000000,47,161,"Stewart County, TN",Mar-19,5491,5223,268,4.9
2508,CN4716300000000,47,163,"Sullivan County, TN",Mar-19,71202,68446,2756,3.9
2509,CN4716500000000,47,165,"Sumner County, TN",Mar-19,103006,100121,2885,2.8
2510,CN4716700000000,47,167,"Tipton County, TN",Mar-19,28368,27249,1119,3.9
2511,CN4716900000000,47,169,"Trousdale County, TN",Mar-19,5461,5276,185,3.4
2512,CN4717100000000,47,171,"Unicoi County, TN",Mar-19,7215,6838,377,5.2
2513,CN4717300000000,47,173,"Union County, TN",Mar-19,7685,7360,325,4.2
2514,CN4717500000000,47,175,"Van Buren County, TN",Mar-19,2057,1959,98,4.8
2515,CN4717700000000,47,177,"Warren County, TN",Mar-19,16736,16046,690,4.1
2516,CN4717900000000,47,179,"Washington County, TN",Mar-19,61628,59481,2147,3.5
2517,CN4718100000000,47,181,"Wayne County, TN",Mar-19,6267,5987,280,4.5
2518,CN4718300000000,47,183,"Weakley County, TN",Mar-19,16374,15749,625,3.8
2519,CN4718500000000,47,185,"White County, TN",Mar-19,12386,11917,469,3.8
2520,CN4718700000000,47,187,"Williamson County, TN",Mar-19,129149,125847,3302,2.6
2521,CN4718900000000,47,189,"Wilson County, TN",Mar-19,77088,74910,2178,2.8
2522,CN4800100000000,48,1,"Anderson County, TX",Mar-19,23790,23100,690,2.9
2523,CN4800300000000,48,3,"Andrews County, TX",Mar-19,9994,9779,215,2.2
2524,CN4800500000000,48,5,"Angelina County, TX",Mar-19,36014,34589,1425,4.0
2525,CN4800700000000,48,7,"Aransas County, TX",Mar-19,9461,9041,420,4.4
2526,CN4800900000000,48,9,"Archer County, TX",Mar-19,4154,4029,125,3.0
2527,CN4801100000000,48,11,"Armstrong County, TX",Mar-19,932,906,26,2.8
2528,CN4801300000000,48,13,"Atascosa County, TX",Mar-19,21607,20834,773,3.6
2529,CN4801500000000,48,15,"Austin County, TX",Mar-19,14084,13606,478,3.4
2530,CN4801700000000,48,17,"Bailey County, TX",Mar-19,2554,2452,102,4.0
2531,CN4801900000000,48,19,"Bandera County, TX",Mar-19,10056,9707,349,3.5
2532,CN4802100000000,48,21,"Bastrop County, TX",Mar-19,42594,41346,1248,2.9
2533,CN4802300000000,48,23,"Baylor County, TX",Mar-19,1745,1703,42,2.4
2534,CN4802500000000,48,25,"Bee County, TX",Mar-19,9983,9556,427,4.3
2535,CN4802700000000,48,27,"Bell County, TX",Mar-19,142797,137353,5444,3.8
2536,CN4802900000000,48,29,"Bexar County, TX",Mar-19,942350,912924,29426,3.1
2537,CN4803100000000,48,31,"Blanco County, TX",Mar-19,6463,6296,167,2.6
2538,CN4803300000000,48,33,"Borden County, TX",Mar-19,385,375,10,2.6
2539,CN4803500000000,48,35,"Bosque County, TX",Mar-19,8341,8068,273,3.3
2540,CN4803700000000,48,37,"Bowie County, TX",Mar-19,39902,38086,1816,4.6
2541,CN4803900000000,48,39,"Brazoria County, TX",Mar-19,178341,171394,6947,3.9
2542,CN4804100000000,48,41,"Brazos County, TX",Mar-19,121039,117916,3123,2.6
2543,CN4804300000000,48,43,"Brewster County, TX",Mar-19,4274,4149,125,2.9
2544,CN4804500000000,48,45,"Briscoe County, TX",Mar-19,588,565,23,3.9
2545,CN4804700000000,48,47,"Brooks County, TX",Mar-19,2637,2494,143,5.4
2546,CN4804900000000,48,49,"Brown County, TX",Mar-19,15962,15383,579,3.6
2547,CN4805100000000,48,51,"Burleson County, TX",Mar-19,8525,8263,262,3.1
2548,CN4805300000000,48,53,"Burnet County, TX",Mar-19,23590,22938,652,2.8
2549,CN4805500000000,48,55,"Caldwell County, TX",Mar-19,19543,18886,657,3.4
2550,CN4805700000000,48,57,"Calhoun County, TX",Mar-19,12163,11799,364,3.0
2551,CN4805900000000,48,59,"Callahan County, TX",Mar-19,6088,5899,189,3.1
2552,CN4806100000000,48,61,"Cameron County, TX",Mar-19,166421,157436,8985,5.4
2553,CN4806300000000,48,63,"Camp County, TX",Mar-19,4938,4727,211,4.3
2554,CN4806500000000,48,65,"Carson County, TX",Mar-19,3024,2938,86,2.8
2555,CN4806700000000,48,67,"Cass County, TX",Mar-19,12627,12083,544,4.3
2556,CN4806900000000,48,69,"Castro County, TX",Mar-19,3543,3440,103,2.9
2557,CN4807100000000,48,71,"Chambers County, TX",Mar-19,19375,18536,839,4.3
2558,CN4807300000000,48,73,"Cherokee County, TX",Mar-19,21094,20287,807,3.8
2559,CN4807500000000,48,75,"Childress County, TX",Mar-19,2932,2854,78,2.7
2560,CN4807700000000,48,77,"Clay County, TX",Mar-19,4940,4792,148,3.0
2561,CN4807900000000,48,79,"Cochran County, TX",Mar-19,1179,1137,42,3.6
2562,CN4808100000000,48,81,"Coke County, TX",Mar-19,1419,1370,49,3.5
2563,CN4808300000000,48,83,"Coleman County, TX",Mar-19,2895,2780,115,4.0
2564,CN4808500000000,48,85,"Collin County, TX",Mar-19,557221,539561,17660,3.2
2565,CN4808700000000,48,87,"Collingsworth County, TX",Mar-19,1151,1116,35,3.0
2566,CN4808900000000,48,89,"Colorado County, TX",Mar-19,9806,9500,306,3.1
2567,CN4809100000000,48,91,"Comal County, TX",Mar-19,72974,70718,2256,3.1
2568,CN4809300000000,48,93,"Comanche County, TX",Mar-19,5588,5411,177,3.2
2569,CN4809500000000,48,95,"Concho County, TX",Mar-19,1130,1092,38,3.4
2570,CN4809700000000,48,97,"Cooke County, TX",Mar-19,19999,19426,573,2.9
2571,CN4809900000000,48,99,"Coryell County, TX",Mar-19,23955,23009,946,3.9
2572,CN4810100000000,48,101,"Cottle County, TX",Mar-19,557,534,23,4.1
2573,CN4810300000000,48,103,"Crane County, TX",Mar-19,1535,1478,57,3.7
2574,CN4810500000000,48,105,"Crockett County, TX",Mar-19,1643,1601,42,2.6
2575,CN4810700000000,48,107,"Crosby County, TX",Mar-19,2522,2424,98,3.9
2576,CN4810900000000,48,109,"Culberson County, TX",Mar-19,998,967,31,3.1
2577,CN4811100000000,48,111,"Dallam County, TX",Mar-19,3983,3909,74,1.9
2578,CN4811300000000,48,113,"Dallas County, TX",Mar-19,1348687,1301545,47142,3.5
2579,CN4811500000000,48,115,"Dawson County, TX",Mar-19,4728,4557,171,3.6
2580,CN4811700000000,48,117,"Deaf Smith County, TX",Mar-19,8473,8238,235,2.8
2581,CN4811900000000,48,119,"Delta County, TX",Mar-19,2454,2371,83,3.4
2582,CN4812100000000,48,121,"Denton County, TX",Mar-19,488960,473930,15030,3.1
2583,CN4812300000000,48,123,"DeWitt County, TX",Mar-19,9807,9550,257,2.6
2584,CN4812500000000,48,125,"Dickens County, TX",Mar-19,671,641,30,4.5
2585,CN4812700000000,48,127,"Dimmit County, TX",Mar-19,7627,7446,181,2.4
2586,CN4812900000000,48,129,"Donley County, TX",Mar-19,1470,1423,47,3.2
2587,CN4813100000000,48,131,"Duval County, TX",Mar-19,5013,4785,228,4.5
2588,CN4813300000000,48,133,"Eastland County, TX",Mar-19,8700,8424,276,3.2
2589,CN4813500000000,48,135,"Ector County, TX",Mar-19,88268,86124,2144,2.4
2590,CN4813700000000,48,137,"Edwards County, TX",Mar-19,979,951,28,2.9
2591,CN4813900000000,48,139,"Ellis County, TX",Mar-19,91693,88773,2920,3.2
2592,CN4814100000000,48,141,"El Paso County, TX",Mar-19,361861,348004,13857,3.8
2593,CN4814300000000,48,143,"Erath County, TX",Mar-19,21556,20936,620,2.9
2594,CN4814500000000,48,145,"Falls County, TX",Mar-19,6570,6347,223,3.4
2595,CN4814700000000,48,147,"Fannin County, TX",Mar-19,17198,16703,495,2.9
2596,CN4814900000000,48,149,"Fayette County, TX",Mar-19,12579,12230,349,2.8
2597,CN4815100000000,48,151,"Fisher County, TX",Mar-19,1649,1601,48,2.9
2598,CN4815300000000,48,153,"Floyd County, TX",Mar-19,2628,2500,128,4.9
2599,CN4815500000000,48,155,"Foard County, TX",Mar-19,584,568,16,2.7
2600,CN4815700000000,48,157,"Fort Bend County, TX",Mar-19,391023,377395,13628,3.5
2601,CN4815900000000,48,159,"Franklin County, TX",Mar-19,4636,4460,176,3.8
2602,CN4816100000000,48,161,"Freestone County, TX",Mar-19,6428,6121,307,4.8
2603,CN4816300000000,48,163,"Frio County, TX",Mar-19,10558,10296,262,2.5
2604,CN4816500000000,48,165,"Gaines County, TX",Mar-19,9826,9598,228,2.3
2605,CN4816700000000,48,167,"Galveston County, TX",Mar-19,164789,158316,6473,3.9
2606,CN4816900000000,48,169,"Garza County, TX",Mar-19,2183,2121,62,2.8
2607,CN4817100000000,48,171,"Gillespie County, TX",Mar-19,13521,13171,350,2.6
2608,CN4817300000000,48,173,"Glasscock County, TX",Mar-19,811,793,18,2.2
2609,CN4817500000000,48,175,"Goliad County, TX",Mar-19,3294,3185,109,3.3
2610,CN4817700000000,48,177,"Gonzales County, TX",Mar-19,9684,9424,260,2.7
2611,CN4817900000000,48,179,"Gray County, TX",Mar-19,8028,7736,292,3.6
2612,CN4818100000000,48,181,"Grayson County, TX",Mar-19,64018,62066,1952,3.0
2613,CN4818300000000,48,183,"Gregg County, TX",Mar-19,58277,56091,2186,3.8
2614,CN4818500000000,48,185,"Grimes County, TX",Mar-19,11367,10925,442,3.9
2615,CN4818700000000,48,187,"Guadalupe County, TX",Mar-19,80923,78494,2429,3.0
2616,CN4818900000000,48,189,"Hale County, TX",Mar-19,12403,11805,598,4.8
2617,CN4819100000000,48,191,"Hall County, TX",Mar-19,1099,1052,47,4.3
2618,CN4819300000000,48,193,"Hamilton County, TX",Mar-19,3687,3572,115,3.1
2619,CN4819500000000,48,195,"Hansford County, TX",Mar-19,2845,2775,70,2.5
2620,CN4819700000000,48,197,"Hardeman County, TX",Mar-19,1712,1654,58,3.4
2621,CN4819900000000,48,199,"Hardin County, TX",Mar-19,25436,24287,1149,4.5
2622,CN4820100000000,48,201,"Harris County, TX",Mar-19,2309095,2222013,87082,3.8
2623,CN4820300000000,48,203,"Harrison County, TX",Mar-19,29544,28355,1189,4.0
2624,CN4820500000000,48,205,"Hartley County, TX",Mar-19,2835,2790,45,1.6
2625,CN4820700000000,48,207,"Haskell County, TX",Mar-19,2296,2217,79,3.4
2626,CN4820900000000,48,209,"Hays County, TX",Mar-19,118951,115708,3243,2.7
2627,CN4821100000000,48,211,"Hemphill County, TX",Mar-19,1925,1878,47,2.4
2628,CN4821300000000,48,213,"Henderson County, TX",Mar-19,36409,35104,1305,3.6
2629,CN4821500000000,48,215,"Hidalgo County, TX",Mar-19,352114,331869,20245,5.7
2630,CN4821700000000,48,217,"Hill County, TX",Mar-19,16359,15807,552,3.4
2631,CN4821900000000,48,219,"Hockley County, TX",Mar-19,11395,11040,355,3.1
2632,CN4822100000000,48,221,"Hood County, TX",Mar-19,27436,26495,941,3.4
2633,CN4822300000000,48,223,"Hopkins County, TX",Mar-19,17571,17005,566,3.2
2634,CN4822500000000,48,225,"Houston County, TX",Mar-19,10197,9880,317,3.1
2635,CN4822700000000,48,227,"Howard County, TX",Mar-19,13984,13537,447,3.2
2636,CN4822900000000,48,229,"Hudspeth County, TX",Mar-19,1837,1761,76,4.1
2637,CN4823100000000,48,231,"Hunt County, TX",Mar-19,42938,41404,1534,3.6
2638,CN4823300000000,48,233,"Hutchinson County, TX",Mar-19,8560,8195,365,4.3
2639,CN4823500000000,48,235,"Irion County, TX",Mar-19,773,754,19,2.5
2640,CN4823700000000,48,237,"Jack County, TX",Mar-19,3462,3354,108,3.1
2641,CN4823900000000,48,239,"Jackson County, TX",Mar-19,7466,7238,228,3.1
2642,CN4824100000000,48,241,"Jasper County, TX",Mar-19,12971,12198,773,6.0
2643,CN4824300000000,48,243,"Jeff Davis County, TX",Mar-19,1087,1056,31,2.9
2644,CN4824500000000,48,245,"Jefferson County, TX",Mar-19,107191,101296,5895,5.5
2645,CN4824700000000,48,247,"Jim Hogg County, TX",Mar-19,1911,1814,97,5.1
2646,CN4824900000000,48,249,"Jim Wells County, TX",Mar-19,17006,16214,792,4.7
2647,CN4825100000000,48,251,"Johnson County, TX",Mar-19,81657,78963,2694,3.3
2648,CN4825300000000,48,253,"Jones County, TX",Mar-19,5747,5478,269,4.7
2649,CN4825500000000,48,255,"Karnes County, TX",Mar-19,7066,6894,172,2.4
2650,CN4825700000000,48,257,"Kaufman County, TX",Mar-19,63841,61698,2143,3.4
2651,CN4825900000000,48,259,"Kendall County, TX",Mar-19,22082,21467,615,2.8
2652,CN4826100000000,48,261,"Kenedy County, TX",Mar-19,249,241,8,3.2
2653,CN4826300000000,48,263,"Kent County, TX",Mar-19,458,448,10,2.2
2654,CN4826500000000,48,265,"Kerr County, TX",Mar-19,22207,21536,671,3.0
2655,CN4826700000000,48,267,"Kimble County, TX",Mar-19,1852,1795,57,3.1
2656,CN4826900000000,48,269,"King County, TX",Mar-19,220,215,5,2.3
2657,CN4827100000000,48,271,"Kinney County, TX",Mar-19,1399,1342,57,4.1
2658,CN4827300000000,48,273,"Kleberg County, TX",Mar-19,13717,13148,569,4.1
2659,CN4827500000000,48,275,"Knox County, TX",Mar-19,1461,1411,50,3.4
2660,CN4827700000000,48,277,"Lamar County, TX",Mar-19,24023,23202,821,3.4
2661,CN4827900000000,48,279,"Lamb County, TX",Mar-19,5378,5158,220,4.1
2662,CN4828100000000,48,281,"Lampasas County, TX",Mar-19,9177,8866,311,3.4
2663,CN4828300000000,48,283,"La Salle County, TX",Mar-19,4406,4300,106,2.4
2664,CN4828500000000,48,285,"Lavaca County, TX",Mar-19,8623,8356,267,3.1
2665,CN4828700000000,48,287,"Lee County, TX",Mar-19,10264,9987,277,2.7
2666,CN4828900000000,48,289,"Leon County, TX",Mar-19,6301,6038,263,4.2
2667,CN4829100000000,48,291,"Liberty County, TX",Mar-19,32958,31362,1596,4.8
2668,CN4829300000000,48,293,"Limestone County, TX",Mar-19,8632,8301,331,3.8
2669,CN4829500000000,48,295,"Lipscomb County, TX",Mar-19,1660,1613,47,2.8
2670,CN4829700000000,48,297,"Live Oak County, TX",Mar-19,5531,5359,172,3.1
2671,CN4829900000000,48,299,"Llano County, TX",Mar-19,8550,8239,311,3.6
2672,CN4830100000000,48,301,"Loving County, TX",Mar-19,404,400,4,1.0
2673,CN4830300000000,48,303,"Lubbock County, TX",Mar-19,157893,153053,4840,3.1
2674,CN4830500000000,48,305,"Lynn County, TX",Mar-19,2798,2712,86,3.1
2675,CN4830700000000,48,307,"McCulloch County, TX",Mar-19,3726,3562,164,4.4
2676,CN4830900000000,48,309,"McLennan County, TX",Mar-19,119131,115129,4002,3.4
2677,CN4831100000000,48,311,"McMullen County, TX",Mar-19,773,759,14,1.8
2678,CN4831300000000,48,313,"Madison County, TX",Mar-19,4630,4449,181,3.9
2679,CN4831500000000,48,315,"Marion County, TX",Mar-19,4258,4069,189,4.4
2680,CN4831700000000,48,317,"Martin County, TX",Mar-19,2879,2812,67,2.3
2681,CN4831900000000,48,319,"Mason County, TX",Mar-19,1795,1736,59,3.3
2682,CN4832100000000,48,321,"Matagorda County, TX",Mar-19,16701,15841,860,5.1
2683,CN4832300000000,48,323,"Maverick County, TX",Mar-19,24190,22243,1947,8.0
2684,CN4832500000000,48,325,"Medina County, TX",Mar-19,21733,21043,690,3.2
2685,CN4832700000000,48,327,"Menard County, TX",Mar-19,836,806,30,3.6
2686,CN4832900000000,48,329,"Midland County, TX",Mar-19,106633,104462,2171,2.0
2687,CN4833100000000,48,331,"Milam County, TX",Mar-19,9854,9328,526,5.3
2688,CN4833300000000,48,333,"Mills County, TX",Mar-19,1919,1847,72,3.8
2689,CN4833500000000,48,335,"Mitchell County, TX",Mar-19,2312,2231,81,3.5
2690,CN4833700000000,48,337,"Montague County, TX",Mar-19,9201,8929,272,3.0
2691,CN4833900000000,48,339,"Montgomery County, TX",Mar-19,283218,273692,9526,3.4
2692,CN4834100000000,48,341,"Moore County, TX",Mar-19,10953,10698,255,2.3
2693,CN4834300000000,48,343,"Morris County, TX",Mar-19,4783,4528,255,5.3
2694,CN4834500000000,48,345,"Motley County, TX",Mar-19,489,470,19,3.9
2695,CN4834700000000,48,347,"Nacogdoches County, TX",Mar-19,28548,27545,1003,3.5
2696,CN4834900000000,48,349,"Navarro County, TX",Mar-19,23524,22651,873,3.7
2697,CN4835100000000,48,351,"Newton County, TX",Mar-19,5186,4888,298,5.7
2698,CN4835300000000,48,353,"Nolan County, TX",Mar-19,6880,6674,206,3.0
2699,CN4835500000000,48,355,"Nueces County, TX",Mar-19,167527,160477,7050,4.2
2700,CN4835700000000,48,357,"Ochiltree County, TX",Mar-19,4374,4258,116,2.7
2701,CN4835900000000,48,359,"Oldham County, TX",Mar-19,918,892,26,2.8
2702,CN4836100000000,48,361,"Orange County, TX",Mar-19,36499,34704,1795,4.9
2703,CN4836300000000,48,363,"Palo Pinto County, TX",Mar-19,13622,13173,449,3.3
2704,CN4836500000000,48,365,"Panola County, TX",Mar-19,10492,10073,419,4.0
2705,CN4836700000000,48,367,"Parker County, TX",Mar-19,66942,64965,1977,3.0
2706,CN4836900000000,48,369,"Parmer County, TX",Mar-19,4907,4789,118,2.4
2707,CN4837100000000,48,371,"Pecos County, TX",Mar-19,6451,6251,200,3.1
2708,CN4837300000000,48,373,"Polk County, TX",Mar-19,18043,17212,831,4.6
2709,CN4837500000000,48,375,"Potter County, TX",Mar-19,55014,53435,1579,2.9
2710,CN4837700000000,48,377,"Presidio County, TX",Mar-19,3062,2897,165,5.4
2711,CN4837900000000,48,379,"Rains County, TX",Mar-19,6077,5887,190,3.1
2712,CN4838100000000,48,381,"Randall County, TX",Mar-19,71794,69982,1812,2.5
2713,CN4838300000000,48,383,"Reagan County, TX",Mar-19,1857,1817,40,2.2
2714,CN4838500000000,48,385,"Real County, TX",Mar-19,1044,1000,44,4.2
2715,CN4838700000000,48,387,"Red River County, TX",Mar-19,5063,4828,235,4.6
2716,CN4838900000000,48,389,"Reeves County, TX",Mar-19,11048,10866,182,1.6
2717,CN4839100000000,48,391,"Refugio County, TX",Mar-19,3167,3054,113,3.6
2718,CN4839300000000,48,393,"Roberts County, TX",Mar-19,414,401,13,3.1
2719,CN4839500000000,48,395,"Robertson County, TX",Mar-19,7813,7535,278,3.6
2720,CN4839700000000,48,397,"Rockwall County, TX",Mar-19,51489,49882,1607,3.1
2721,CN4839900000000,48,399,"Runnels County, TX",Mar-19,4569,4437,132,2.9
2722,CN4840100000000,48,401,"Rusk County, TX",Mar-19,23034,22251,783,3.4
2723,CN4840300000000,48,403,"Sabine County, TX",Mar-19,3732,3492,240,6.4
2724,CN4840500000000,48,405,"San Augustine County, TX",Mar-19,3461,3310,151,4.4
2725,CN4840700000000,48,407,"San Jacinto County, TX",Mar-19,11728,11220,508,4.3
2726,CN4840900000000,48,409,"San Patricio County, TX",Mar-19,29907,28277,1630,5.5
2727,CN4841100000000,48,411,"San Saba County, TX",Mar-19,2611,2535,76,2.9
2728,CN4841300000000,48,413,"Schleicher County, TX",Mar-19,1366,1331,35,2.6
2729,CN4841500000000,48,415,"Scurry County, TX",Mar-19,6686,6472,214,3.2
2730,CN4841700000000,48,417,"Shackelford County, TX",Mar-19,1907,1859,48,2.5
2731,CN4841900000000,48,419,"Shelby County, TX",Mar-19,11061,10624,437,4.0
2732,CN4842100000000,48,421,"Sherman County, TX",Mar-19,1411,1378,33,2.3
2733,CN4842300000000,48,423,"Smith County, TX",Mar-19,107033,103444,3589,3.4
2734,CN4842500000000,48,425,"Somervell County, TX",Mar-19,4337,4181,156,3.6
2735,CN4842700000000,48,427,"Starr County, TX",Mar-19,25574,23338,2236,8.7
2736,CN4842900000000,48,429,"Stephens County, TX",Mar-19,4210,4080,130,3.1
2737,CN4843100000000,48,431,"Sterling County, TX",Mar-19,589,573,16,2.7
2738,CN4843300000000,48,433,"Stonewall County, TX",Mar-19,576,558,18,3.1
2739,CN4843500000000,48,435,"Sutton County, TX",Mar-19,1517,1467,50,3.3
2740,CN4843700000000,48,437,"Swisher County, TX",Mar-19,2673,2569,104,3.9
2741,CN4843900000000,48,439,"Tarrant County, TX",Mar-19,1074459,1038886,35573,3.3
2742,CN4844100000000,48,441,"Taylor County, TX",Mar-19,66480,64532,1948,2.9
2743,CN4844300000000,48,443,"Terrell County, TX",Mar-19,379,366,13,3.4
2744,CN4844500000000,48,445,"Terry County, TX",Mar-19,5095,4907,188,3.7
2745,CN4844700000000,48,447,"Throckmorton County, TX",Mar-19,665,641,24,3.6
2746,CN4844900000000,48,449,"Titus County, TX",Mar-19,12878,12309,569,4.4
2747,CN4845100000000,48,451,"Tom Green County, TX",Mar-19,54906,53254,1652,3.0
2748,CN4845300000000,48,453,"Travis County, TX",Mar-19,735922,716826,19096,2.6
2749,CN4845500000000,48,455,"Trinity County, TX",Mar-19,5323,5078,245,4.6
2750,CN4845700000000,48,457,"Tyler County, TX",Mar-19,7192,6801,391,5.4
2751,CN4845900000000,48,459,"Upshur County, TX",Mar-19,17910,17251,659,3.7
2752,CN4846100000000,48,461,"Upton County, TX",Mar-19,1639,1586,53,3.2
2753,CN4846300000000,48,463,"Uvalde County, TX",Mar-19,11514,11075,439,3.8
2754,CN4846500000000,48,465,"Val Verde County, TX",Mar-19,22752,21983,769,3.4
2755,CN4846700000000,48,467,"Van Zandt County, TX",Mar-19,26027,25157,870,3.3
2756,CN4846900000000,48,469,"Victoria County, TX",Mar-19,43069,41597,1472,3.4
2757,CN4847100000000,48,471,"Walker County, TX",Mar-19,24213,23311,902,3.7
2758,CN4847300000000,48,473,"Waller County, TX",Mar-19,23428,22561,867,3.7
2759,CN4847500000000,48,475,"Ward County, TX",Mar-19,7472,7305,167,2.2
2760,CN4847700000000,48,477,"Washington County, TX",Mar-19,15009,14465,544,3.6
2761,CN4847900000000,48,479,"Webb County, TX",Mar-19,118259,113829,4430,3.7
2762,CN4848100000000,48,481,"Wharton County, TX",Mar-19,21617,20914,703,3.3
2763,CN4848300000000,48,483,"Wheeler County, TX",Mar-19,2291,2224,67,2.9
2764,CN4848500000000,48,485,"Wichita County, TX",Mar-19,56227,54435,1792,3.2
2765,CN4848700000000,48,487,"Wilbarger County, TX",Mar-19,5005,4817,188,3.8
2766,CN4848900000000,48,489,"Willacy County, TX",Mar-19,6624,6085,539,8.1
2767,CN4849100000000,48,491,"Williamson County, TX",Mar-19,311456,302653,8803,2.8
2768,CN4849300000000,48,493,"Wilson County, TX",Mar-19,24740,24030,710,2.9
2769,CN4849500000000,48,495,"Winkler County, TX",Mar-19,4105,3997,108,2.6
2770,CN4849700000000,48,497,"Wise County, TX",Mar-19,31793,30692,1101,3.5
2771,CN4849900000000,48,499,"Wood County, TX",Mar-19,17568,16881,687,3.9
2772,CN4850100000000,48,501,"Yoakum County, TX",Mar-19,3828,3722,106,2.8
2773,CN4850300000000,48,503,"Young County, TX",Mar-19,7997,7759,238,3.0
2774,CN4850500000000,48,505,"Zapata County, TX",Mar-19,5275,5023,252,4.8
2775,CN4850700000000,48,507,"Zavala County, TX",Mar-19,3369,3093,276,8.2
2776,CN4900100000000,49,1,"Beaver County, UT",Mar-19,3045,2949,96,3.2
2777,CN4900300000000,49,3,"Box Elder County, UT",Mar-19,25734,24930,804,3.1
2778,CN4900500000000,49,5,"Cache County, UT",Mar-19,64853,63203,1650,2.5
2779,CN4900700000000,49,7,"Carbon County, UT",Mar-19,8420,8052,368,4.4
2780,CN4900900000000,49,9,"Daggett County, UT",Mar-19,361,340,21,5.8
2781,CN4901100000000,49,11,"Davis County, UT",Mar-19,170962,166241,4721,2.8
2782,CN4901300000000,49,13,"Duchesne County, UT",Mar-19,7692,7344,348,4.5
2783,CN4901500000000,49,15,"Emery County, UT",Mar-19,4447,4237,210,4.7
2784,CN4901700000000,49,17,"Garfield County, UT",Mar-19,2521,2284,237,9.4
2785,CN4901900000000,49,19,"Grand County, UT",Mar-19,5944,5682,262,4.4
2786,CN4902100000000,49,21,"Iron County, UT",Mar-19,23949,23138,811,3.4
2787,CN4902300000000,49,23,"Juab County, UT",Mar-19,5711,5525,186,3.3
2788,CN4902500000000,49,25,"Kane County, UT",Mar-19,3647,3505,142,3.9
2789,CN4902700000000,49,27,"Millard County, UT",Mar-19,6154,5958,196,3.2
2790,CN4902900000000,49,29,"Morgan County, UT",Mar-19,5486,5333,153,2.8
2791,CN4903100000000,49,31,"Piute County, UT",Mar-19,486,461,25,5.1
2792,CN4903300000000,49,33,"Rich County, UT",Mar-19,977,934,43,4.4
2793,CN4903500000000,49,35,"Salt Lake County, UT",Mar-19,624262,605680,18582,3.0
2794,CN4903700000000,49,37,"San Juan County, UT",Mar-19,5683,5318,365,6.4
2795,CN4903900000000,49,39,"Sanpete County, UT",Mar-19,12733,12265,468,3.7
2796,CN4904100000000,49,41,"Sevier County, UT",Mar-19,9788,9410,378,3.9
2797,CN4904300000000,49,43,"Summit County, UT",Mar-19,26512,25866,646,2.4
2798,CN4904500000000,49,45,"Tooele County, UT",Mar-19,33494,32352,1142,3.4
2799,CN4904700000000,49,47,"Uintah County, UT",Mar-19,13609,12966,643,4.7
2800,CN4904900000000,49,49,"Utah County, UT",Mar-19,305785,297314,8471,2.8
2801,CN4905100000000,49,51,"Wasatch County, UT",Mar-19,15772,15288,484,3.1
2802,CN4905300000000,49,53,"Washington County, UT",Mar-19,75225,72777,2448,3.3
2803,CN4905500000000,49,55,"Wayne County, UT",Mar-19,1349,1253,96,7.1
2804,CN4905700000000,49,57,"Weber County, UT",Mar-19,125833,121538,4295,3.4
2805,CN5000100000000,50,1,"Addison County, VT",Mar-19,20397,19841,556,2.7
2806,CN5000300000000,50,3,"Bennington County, VT",Mar-19,18507,17943,564,3.0
2807,CN5000500000000,50,5,"Caledonia County, VT",Mar-19,14430,13910,520,3.6
2808,CN5000700000000,50,7,"Chittenden County, VT",Mar-19,96044,94263,1781,1.9
2809,CN5000900000000,50,9,"Essex County, VT",Mar-19,2686,2575,111,4.1
2810,CN5001100000000,50,11,"Franklin County, VT",Mar-19,27352,26592,760,2.8
2811,CN5001300000000,50,13,"Grand Isle County, VT",Mar-19,4061,3906,155,3.8
2812,CN5001500000000,50,15,"Lamoille County, VT",Mar-19,14054,13497,557,4.0
2813,CN5001700000000,50,17,"Orange County, VT",Mar-19,15850,15376,474,3.0
2814,CN5001900000000,50,19,"Orleans County, VT",Mar-19,13599,12877,722,5.3
2815,CN5002100000000,50,21,"Rutland County, VT",Mar-19,30428,29552,876,2.9
2816,CN5002300000000,50,23,"Washington County, VT",Mar-19,34654,33716,938,2.7
2817,CN5002500000000,50,25,"Windham County, VT",Mar-19,22378,21814,564,2.5
2818,CN5002700000000,50,27,"Windsor County, VT",Mar-19,29240,28609,631,2.2
2819,CN5100100000000,51,1,"Accomack County, VA",Mar-19,16224,15582,642,4.0
2820,CN5100300000000,51,3,"Albemarle County, VA",Mar-19,57204,55701,1503,2.6
2821,CN5100500000000,51,5,"Alleghany County, VA",Mar-19,6953,6695,258,3.7
2822,CN5100700000000,51,7,"Amelia County, VA",Mar-19,6197,5973,224,3.6
2823,CN5100900000000,51,9,"Amherst County, VA",Mar-19,15126,14629,497,3.3
2824,CN5101100000000,51,11,"Appomattox County, VA",Mar-19,7182,6908,274,3.8
2825,CN5101300000000,51,13,"Arlington County, VA",Mar-19,154788,151611,3177,2.1
2826,CN5101500000000,51,15,"Augusta County, VA",Mar-19,37397,36392,1005,2.7
2827,CN5101700000000,51,17,"Bath County, VA",Mar-19,2386,2319,67,2.8
2828,CN5101900000000,51,19,"Bedford County, VA",Mar-19,38793,37595,1198,3.1
2829,CN5102100000000,51,21,"Bland County, VA",Mar-19,2870,2787,83,2.9
2830,CN5102300000000,51,23,"Botetourt County, VA",Mar-19,17483,16998,485,2.8
2831,CN5102500000000,51,25,"Brunswick County, VA",Mar-19,6075,5750,325,5.3
2832,CN5102700000000,51,27,"Buchanan County, VA",Mar-19,6867,6490,377,5.5
2833,CN5102900000000,51,29,"Buckingham County, VA",Mar-19,6398,6099,299,4.7
2834,CN5103100000000,51,31,"Campbell County, VA",Mar-19,26270,25388,882,3.4
2835,CN5103300000000,51,33,"Caroline County, VA",Mar-19,15259,14740,519,3.4
2836,CN5103500000000,51,35,"Carroll County, VA",Mar-19,13217,12705,512,3.9
2837,CN5103600000000,51,36,"Charles City County, VA",Mar-19,3629,3484,145,4.0
2838,CN5103700000000,51,37,"Charlotte County, VA",Mar-19,5190,4996,194,3.7
2839,CN5104100000000,51,41,"Chesterfield County, VA",Mar-19,188252,182818,5434,2.9
2840,CN5104300000000,51,43,"Clarke County, VA",Mar-19,7478,7264,214,2.9
2841,CN5104500000000,51,45,"Craig County, VA",Mar-19,2305,2225,80,3.5
2842,CN5104700000000,51,47,"Culpeper County, VA",Mar-19,24419,23707,712,2.9
2843,CN5104900000000,51,49,"Cumberland County, VA",Mar-19,4625,4481,144,3.1
2844,CN5105100000000,51,51,"Dickenson County, VA",Mar-19,4691,4457,234,5.0
2845,CN5105300000000,51,53,"Dinwiddie County, VA",Mar-19,13604,13110,494,3.6
2846,CN5105700000000,51,57,"Essex County, VA",Mar-19,5539,5308,231,4.2
2847,CN5105900000000,51,59,"Fairfax County, VA",Mar-19,636612,621003,15609,2.5
2848,CN5106100000000,51,61,"Fauquier County, VA",Mar-19,36775,35776,999,2.7
2849,CN5106300000000,51,63,"Floyd County, VA",Mar-19,8124,7896,228,2.8
2850,CN5106500000000,51,65,"Fluvanna County, VA",Mar-19,13978,13631,347,2.5
2851,CN5106700000000,51,67,"Franklin County, VA",Mar-19,26377,25522,855,3.2
2852,CN5106900000000,51,69,"Frederick County, VA",Mar-19,48058,46749,1309,2.7
2853,CN5107100000000,51,71,"Giles County, VA",Mar-19,8019,7746,273,3.4
2854,CN5107300000000,51,73,"Gloucester County, VA",Mar-19,19534,18987,547,2.8
2855,CN5107500000000,51,75,"Goochland County, VA",Mar-19,11183,10846,337,3.0
2856,CN5107700000000,51,77,"Grayson County, VA",Mar-19,8063,7799,264,3.3
2857,CN5107900000000,51,79,"Greene County, VA",Mar-19,10496,10232,264,2.5
2858,CN5108100000000,51,81,"Greensville County, VA",Mar-19,4337,4166,171,3.9
2859,CN5108300000000,51,83,"Halifax County, VA",Mar-19,15742,15116,626,4.0
2860,CN5108500000000,51,85,"Hanover County, VA",Mar-19,59305,57773,1532,2.6
2861,CN5108700000000,51,87,"Henrico County, VA",Mar-19,183062,177597,5465,3.0
2862,CN5108900000000,51,89,"Henry County, VA",Mar-19,24003,23133,870,3.6
2863,CN5109100000000,51,91,"Highland County, VA",Mar-19,1149,1110,39,3.4
2864,CN5109300000000,51,93,"Isle of Wight County, VA",Mar-19,19359,18782,577,3.0
2865,CN5109500000000,51,95,"James City County, VA",Mar-19,36721,35668,1053,2.9
2866,CN5109700000000,51,97,"King and Queen County, VA",Mar-19,3830,3704,126,3.3
2867,CN5109900000000,51,99,"King George County, VA",Mar-19,13375,12992,383,2.9
2868,CN5110100000000,51,101,"King William County, VA",Mar-19,9120,8852,268,2.9
2869,CN5110300000000,51,103,"Lancaster County, VA",Mar-19,5357,5025,332,6.2
2870,CN5110500000000,51,105,"Lee County, VA",Mar-19,8334,8003,331,4.0
2871,CN5110700000000,51,107,"Loudoun County, VA",Mar-19,222801,217294,5507,2.5
2872,CN5110900000000,51,109,"Louisa County, VA",Mar-19,20082,19513,569,2.8
2873,CN5111100000000,51,111,"Lunenburg County, VA",Mar-19,5309,5136,173,3.3
2874,CN5111300000000,51,113,"Madison County, VA",Mar-19,7215,7024,191,2.6
2875,CN5111500000000,51,115,"Mathews County, VA",Mar-19,4154,4016,138,3.3
2876,CN5111700000000,51,117,"Mecklenburg County, VA",Mar-19,12651,12137,514,4.1
2877,CN5111900000000,51,119,"Middlesex County, VA",Mar-19,5156,5002,154,3.0
2878,CN5112100000000,51,121,"Montgomery County, VA",Mar-19,51391,49923,1468,2.9
2879,CN5112500000000,51,125,"Nelson County, VA",Mar-19,7337,7115,222,3.0
2880,CN5112700000000,51,127,"New Kent County, VA",Mar-19,12480,12157,323,2.6
2881,CN5113100000000,51,131,"Northampton County, VA",Mar-19,5041,4756,285,5.7
2882,CN5113300000000,51,133,"Northumberland County, VA",Mar-19,5552,5196,356,6.4
2883,CN5113500000000,51,135,"Nottoway County, VA",Mar-19,7288,7076,212,2.9
2884,CN5113700000000,51,137,"Orange County, VA",Mar-19,17130,16587,543,3.2
2885,CN5113900000000,51,139,"Page County, VA",Mar-19,11784,11188,596,5.1
2886,CN5114100000000,51,141,"Patrick County, VA",Mar-19,7438,7152,286,3.8
2887,CN5114300000000,51,143,"Pittsylvania County, VA",Mar-19,30134,29083,1051,3.5
2888,CN5114500000000,51,145,"Powhatan County, VA",Mar-19,14153,13779,374,2.6
2889,CN5114700000000,51,147,"Prince Edward County, VA",Mar-19,10396,10012,384,3.7
2890,CN5114900000000,51,149,"Prince George County, VA",Mar-19,15133,14595,538,3.6
2891,CN5115300000000,51,153,"Prince William County, VA",Mar-19,246311,239615,6696,2.7
2892,CN5115500000000,51,155,"Pulaski County, VA",Mar-19,16464,15899,565,3.4
2893,CN5115700000000,51,157,"Rappahannock County, VA",Mar-19,3621,3513,108,3.0
2894,CN5115900000000,51,159,"Richmond County, VA",Mar-19,4024,3888,136,3.4
2895,CN5116100000000,51,161,"Roanoke County, VA",Mar-19,49815,48485,1330,2.7
2896,CN5116300000000,51,163,"Rockbridge County, VA",Mar-19,10654,10331,323,3.0
2897,CN5116500000000,51,165,"Rockingham County, VA",Mar-19,41791,40672,1119,2.7
2898,CN5116700000000,51,167,"Russell County, VA",Mar-19,11203,10665,538,4.8
2899,CN5116900000000,51,169,"Scott County, VA",Mar-19,9110,8788,322,3.5
2900,CN5117100000000,51,171,"Shenandoah County, VA",Mar-19,22202,21573,629,2.8
2901,CN5117300000000,51,173,"Smyth County, VA",Mar-19,13624,13089,535,3.9
2902,CN5117500000000,51,175,"Southampton County, VA",Mar-19,8898,8655,243,2.7
2903,CN5117700000000,51,177,"Spotsylvania County, VA",Mar-19,67113,65022,2091,3.1
2904,CN5117900000000,51,179,"Stafford County, VA",Mar-19,72278,70167,2111,2.9
2905,CN5118100000000,51,181,"Surry County, VA",Mar-19,3624,3505,119,3.3
2906,CN5118300000000,51,183,"Sussex County, VA",Mar-19,3633,3454,179,4.9
2907,CN5118500000000,51,185,"Tazewell County, VA",Mar-19,15939,15207,732,4.6
2908,CN5118700000000,51,187,"Warren County, VA",Mar-19,20407,19771,636,3.1
2909,CN5119100000000,51,191,"Washington County, VA",Mar-19,26752,25788,964,3.6
2910,CN5119300000000,51,193,"Westmoreland County, VA",Mar-19,9211,8818,393,4.3
2911,CN5119500000000,51,195,"Wise County, VA",Mar-19,13649,12998,651,4.8
2912,CN5119700000000,51,197,"Wythe County, VA",Mar-19,13563,13057,506,3.7
2913,CN5119900000000,51,199,"York County, VA",Mar-19,32977,32027,950,2.9
2914,CN5151000000000,51,510,"Alexandria city, VA",Mar-19,101593,99285,2308,2.3
2915,CN5152000000000,51,520,"Bristol city, VA",Mar-19,7230,6941,289,4.0
2916,CN5153000000000,51,530,"Buena Vista city, VA",Mar-19,3438,3336,102,3.0
2917,CN5154000000000,51,540,"Charlottesville city, VA",Mar-19,26598,25938,660,2.5
2918,CN5155000000000,51,550,"Chesapeake city, VA",Mar-19,123371,119611,3760,3.0
2919,CN5157000000000,51,570,"Colonial Heights city, VA",Mar-19,8850,8552,298,3.4
2920,CN5158000000000,51,580,"Covington city, VA",Mar-19,2419,2306,113,4.7
2921,CN5159000000000,51,590,"Danville city, VA",Mar-19,19332,18299,1033,5.3
2922,CN5159500000000,51,595,"Emporia city, VA",Mar-19,2315,2185,130,5.6
2923,CN5160000000000,51,600,"Fairfax city, VA",Mar-19,13497,13171,326,2.4
2924,CN5161000000000,51,610,"Falls Church city, VA",Mar-19,8614,8430,184,2.1
2925,CN5162000000000,51,620,"Franklin city, VA",Mar-19,3582,3434,148,4.1
2926,CN5163000000000,51,630,"Fredericksburg city, VA",Mar-19,14227,13715,512,3.6
2927,CN5164000000000,51,640,"Galax city, VA",Mar-19,2923,2825,98,3.4
2928,CN5165000000000,51,650,"Hampton city, VA",Mar-19,64835,62214,2621,4.0
2929,CN5166000000000,51,660,"Harrisonburg city, VA",Mar-19,25321,24483,838,3.3
2930,CN5167000000000,51,670,"Hopewell city, VA",Mar-19,9729,9301,428,4.4
2931,CN5167800000000,51,678,"Lexington city, VA",Mar-19,2127,2032,95,4.5
2932,CN5168000000000,51,680,"Lynchburg city, VA",Mar-19,36793,35401,1392,3.8
2933,CN5168300000000,51,683,"Manassas city, VA",Mar-19,22147,21527,620,2.8
2934,CN5168500000000,51,685,"Manassas Park city, VA",Mar-19,9397,9143,254,2.7
2935,CN5169000000000,51,690,"Martinsville city, VA",Mar-19,5518,5287,231,4.2
2936,CN5170000000000,51,700,"Newport News city, VA",Mar-19,89485,86194,3291,3.7
2937,CN5171000000000,51,710,"Norfolk city, VA",Mar-19,112423,108353,4070,3.6
2938,CN5172000000000,51,720,"Norton city, VA",Mar-19,1707,1640,67,3.9
2939,CN5173000000000,51,730,"Petersburg city, VA",Mar-19,13099,12338,761,5.8
2940,CN5173500000000,51,735,"Poquoson city, VA",Mar-19,6356,6187,169,2.7
2941,CN5174000000000,51,740,"Portsmouth city, VA",Mar-19,44598,42767,1831,4.1
2942,CN5175000000000,51,750,"Radford city, VA",Mar-19,8882,8577,305,3.4
2943,CN5176000000000,51,760,"Richmond city, VA",Mar-19,118866,114765,4101,3.5
2944,CN5177000000000,51,770,"Roanoke city, VA",Mar-19,49634,48067,1567,3.2
2945,CN5177500000000,51,775,"Salem city, VA",Mar-19,13119,12741,378,2.9
2946,CN5179000000000,51,790,"Staunton city, VA",Mar-19,12359,11996,363,2.9
2947,CN5180000000000,51,800,"Suffolk city, VA",Mar-19,44858,43415,1443,3.2
2948,CN5181000000000,51,810,"Virginia Beach city, VA",Mar-19,234394,227641,6753,2.9
2949,CN5182000000000,51,820,"Waynesboro city, VA",Mar-19,10839,10489,350,3.2
2950,CN5183000000000,51,830,"Williamsburg city, VA",Mar-19,6714,6463,251,3.7
2951,CN5184000000000,51,840,"Winchester city, VA",Mar-19,14671,14226,445,3.0
2952,CN5300100000000,53,1,"Adams County, WA",Mar-19,8669,7919,750,8.7
2953,CN5300300000000,53,3,"Asotin County, WA",Mar-19,10349,9835,514,5.0
2954,CN5300500000000,53,5,"Benton County, WA",Mar-19,100731,94258,6473,6.4
2955,CN5300700000000,53,7,"Chelan County, WA",Mar-19,42708,40003,2705,6.3
2956,CN5300900000000,53,9,"Clallam County, WA",Mar-19,28551,26397,2154,7.5
2957,CN5301100000000,53,11,"Clark County, WA",Mar-19,241607,229142,12465,5.2
2958,CN5301300000000,53,13,"Columbia County, WA",Mar-19,1818,1698,120,6.6
2959,CN5301500000000,53,15,"Cowlitz County, WA",Mar-19,48125,45015,3110,6.5
2960,CN5301700000000,53,17,"Douglas County, WA",Mar-19,20702,19188,1514,7.3
2961,CN5301900000000,53,19,"Ferry County, WA",Mar-19,2533,2163,370,14.6
2962,CN5302100000000,53,21,"Franklin County, WA",Mar-19,41324,37697,3627,8.8
2963,CN5302300000000,53,23,"Garfield County, WA",Mar-19,881,819,62,7.0
2964,CN5302500000000,53,25,"Grant County, WA",Mar-19,45298,41092,4206,9.3
2965,CN5302700000000,53,27,"Grays Harbor County, WA",Mar-19,29114,26749,2365,8.1
2966,CN5302900000000,53,29,"Island County, WA",Mar-19,35566,33623,1943,5.5
2967,CN5303100000000,53,31,"Jefferson County, WA",Mar-19,12519,11700,819,6.5
2968,CN5303300000000,53,33,"King County, WA",Mar-19,1289512,1251347,38165,3.0
2969,CN5303500000000,53,35,"Kitsap County, WA",Mar-19,127968,121483,6485,5.1
2970,CN5303700000000,53,37,"Kittitas County, WA",Mar-19,22855,21326,1529,6.7
2971,CN5303900000000,53,39,"Klickitat County, WA",Mar-19,10027,9302,725,7.2
2972,CN5304100000000,53,41,"Lewis County, WA",Mar-19,34866,32441,2425,7.0
2973,CN5304300000000,53,43,"Lincoln County, WA",Mar-19,4995,4681,314,6.3
2974,CN5304500000000,53,45,"Mason County, WA",Mar-19,24911,23148,1763,7.1
2975,CN5304700000000,53,47,"Okanogan County, WA",Mar-19,19358,17540,1818,9.4
2976,CN5304900000000,53,49,"Pacific County, WA",Mar-19,8254,7580,674,8.2
2977,CN5305100000000,53,51,"Pend Oreille County, WA",Mar-19,5075,4605,470,9.3
2978,CN5305300000000,53,53,"Pierce County, WA",Mar-19,440466,415764,24702,5.6
2979,CN5305500000000,53,55,"San Juan County, WA",Mar-19,7963,7581,382,4.8
2980,CN5305700000000,53,57,"Skagit County, WA",Mar-19,62367,58788,3579,5.7
2981,CN5305900000000,53,59,"Skamania County, WA",Mar-19,5551,5214,337,6.1
2982,CN5306100000000,53,61,"Snohomish County, WA",Mar-19,439194,425049,14145,3.2
2983,CN5306300000000,53,63,"Spokane County, WA",Mar-19,254947,238595,16352,6.4
2984,CN5306500000000,53,65,"Stevens County, WA",Mar-19,19243,17419,1824,9.5
2985,CN5306700000000,53,67,"Thurston County, WA",Mar-19,142696,135164,7532,5.3
2986,CN5306900000000,53,69,"Wahkiakum County, WA",Mar-19,1389,1277,112,8.1
2987,CN5307100000000,53,71,"Walla Walla County, WA",Mar-19,29642,27853,1789,6.0
2988,CN5307300000000,53,73,"Whatcom County, WA",Mar-19,115563,109583,5980,5.2
2989,CN5307500000000,53,75,"Whitman County, WA",Mar-19,24727,23603,1124,4.5
2990,CN5307700000000,53,77,"Yakima County, WA",Mar-19,127283,115465,11818,9.3
2991,CN5400100000000,54,1,"Barbour County, WV",Mar-19,7226,6783,443,6.1
2992,CN5400300000000,54,3,"Berkeley County, WV",Mar-19,57065,54873,2192,3.8
2993,CN5400500000000,54,5,"Boone County, WV",Mar-19,7295,6903,392,5.4
2994,CN5400700000000,54,7,"Braxton County, WV",Mar-19,5185,4764,421,8.1
2995,CN5400900000000,54,9,"Brooke County, WV",Mar-19,9813,9289,524,5.3
2996,CN5401100000000,54,11,"Cabell County, WV",Mar-19,40941,39161,1780,4.3
2997,CN5401300000000,54,13,"Calhoun County, WV",Mar-19,2601,2219,382,14.7
2998,CN5401500000000,54,15,"Clay County, WV",Mar-19,3115,2827,288,9.2
2999,CN5401700000000,54,17,"Doddridge County, WV",Mar-19,3913,3731,182,4.7
3000,CN5401900000000,54,19,"Fayette County, WV",Mar-19,15945,14983,962,6.0
3001,CN5402100000000,54,21,"Gilmer County, WV",Mar-19,2357,2182,175,7.4
3002,CN5402300000000,54,23,"Grant County, WV",Mar-19,5884,5538,346,5.9
3003,CN5402500000000,54,25,"Greenbrier County, WV",Mar-19,15590,14742,848,5.4
3004,CN5402700000000,54,27,"Hampshire County, WV",Mar-19,10653,10202,451,4.2
3005,CN5402900000000,54,29,"Hancock County, WV",Mar-19,12818,12149,669,5.2
3006,CN5403100000000,54,31,"Hardy County, WV",Mar-19,5807,5458,349,6.0
3007,CN5403300000000,54,33,"Harrison County, WV",Mar-19,34218,32617,1601,4.7
3008,CN5403500000000,54,35,"Jackson County, WV",Mar-19,12675,11946,729,5.8
3009,CN5403700000000,54,37,"Jefferson County, WV",Mar-19,30066,29104,962,3.2
3010,CN5403900000000,54,39,"Kanawha County, WV",Mar-19,81141,77140,4001,4.9
3011,CN5404100000000,54,41,"Lewis County, WV",Mar-19,6734,6334,400,5.9
3012,CN5404300000000,54,43,"Lincoln County, WV",Mar-19,7099,6628,471,6.6
3013,CN5404500000000,54,45,"Logan County, WV",Mar-19,11002,10344,658,6.0
3014,CN5404700000000,54,47,"McDowell County, WV",Mar-19,4451,4010,441,9.9
3015,CN5404900000000,54,49,"Marion County, WV",Mar-19,25366,23997,1369,5.4
3016,CN5405100000000,54,51,"Marshall County, WV",Mar-19,13962,12961,1001,7.2
3017,CN5405300000000,54,53,"Mason County, WV",Mar-19,10197,9578,619,6.1
3018,CN5405500000000,54,55,"Mercer County, WV",Mar-19,20810,19587,1223,5.9
3019,CN5405700000000,54,57,"Mineral County, WV",Mar-19,12578,11929,649,5.2
3020,CN5405900000000,54,59,"Mingo County, WV",Mar-19,6749,6309,440,6.5
3021,CN5406100000000,54,61,"Monongalia County, WV",Mar-19,54086,52016,2070,3.8
3022,CN5406300000000,54,63,"Monroe County, WV",Mar-19,5931,5631,300,5.1
3023,CN5406500000000,54,65,"Morgan County, WV",Mar-19,8067,7724,343,4.3
3024,CN5406700000000,54,67,"Nicholas County, WV",Mar-19,9379,8744,635,6.8
3025,CN5406900000000,54,69,"Ohio County, WV",Mar-19,20795,19787,1008,4.8
3026,CN5407100000000,54,71,"Pendleton County, WV",Mar-19,3640,3485,155,4.3
3027,CN5407300000000,54,73,"Pleasants County, WV",Mar-19,2899,2680,219,7.6
3028,CN5407500000000,54,75,"Pocahontas County, WV",Mar-19,4090,3865,225,5.5
3029,CN5407700000000,54,77,"Preston County, WV",Mar-19,15493,14721,772,5.0
3030,CN5407900000000,54,79,"Putnam County, WV",Mar-19,26440,25191,1249,4.7
3031,CN5408100000000,54,81,"Raleigh County, WV",Mar-19,29899,28381,1518,5.1
3032,CN5408300000000,54,83,"Randolph County, WV",Mar-19,12124,11353,771,6.4
3033,CN5408500000000,54,85,"Ritchie County, WV",Mar-19,4335,4056,279,6.4
3034,CN5408700000000,54,87,"Roane County, WV",Mar-19,5175,4567,608,11.7
3035,CN5408900000000,54,89,"Summers County, WV",Mar-19,4223,3948,275,6.5
3036,CN5409100000000,54,91,"Taylor County, WV",Mar-19,7758,7356,402,5.2
3037,CN5409300000000,54,93,"Tucker County, WV",Mar-19,3325,3133,192,5.8
3038,CN5409500000000,54,95,"Tyler County, WV",Mar-19,3142,2885,257,8.2
3039,CN5409700000000,54,97,"Upshur County, WV",Mar-19,9607,9038,569,5.9
3040,CN5409900000000,54,99,"Wayne County, WV",Mar-19,15643,14717,926,5.9
3041,CN5410100000000,54,101,"Webster County, WV",Mar-19,3283,3076,207,6.3
3042,CN5410300000000,54,103,"Wetzel County, WV",Mar-19,6616,6098,518,7.8
3043,CN5410500000000,54,105,"Wirt County, WV",Mar-19,2251,2075,176,7.8
3044,CN5410700000000,54,107,"Wood County, WV",Mar-19,36015,34027,1988,5.5
3045,CN5410900000000,54,109,"Wyoming County, WV",Mar-19,6660,6167,493,7.4
3046,CN5500100000000,55,1,"Adams County, WI",Mar-19,7979,7436,543,6.8
3047,CN5500300000000,55,3,"Ashland County, WI",Mar-19,7562,7129,433,5.7
3048,CN5500500000000,55,5,"Barron County, WI",Mar-19,24313,23003,1310,5.4
3049,CN5500700000000,55,7,"Bayfield County, WI",Mar-19,7315,6746,569,7.8
3050,CN5500900000000,55,9,"Brown County, WI",Mar-19,141649,136913,4736,3.3
3051,CN5501100000000,55,11,"Buffalo County, WI",Mar-19,6368,6026,342,5.4
3052,CN5501300000000,55,13,"Burnett County, WI",Mar-19,7078,6549,529,7.5
3053,CN5501500000000,55,15,"Calumet County, WI",Mar-19,27351,26544,807,3.0
3054,CN5501700000000,55,17,"Chippewa County, WI",Mar-19,33412,31723,1689,5.1
3055,CN5501900000000,55,19,"Clark County, WI",Mar-19,17592,16838,754,4.3
3056,CN5502100000000,55,21,"Columbia County, WI",Mar-19,31458,30287,1171,3.7
3057,CN5502300000000,55,23,"Crawford County, WI",Mar-19,7569,7121,448,5.9
3058,CN5502500000000,55,25,"Dane County, WI",Mar-19,319756,311377,8379,2.6
3059,CN5502700000000,55,27,"Dodge County, WI",Mar-19,47052,45366,1686,3.6
3060,CN5502900000000,55,29,"Door County, WI",Mar-19,13967,13149,818,5.9
3061,CN5503100000000,55,31,"Douglas County, WI",Mar-19,23196,22035,1161,5.0
3062,CN5503300000000,55,33,"Dunn County, WI",Mar-19,24833,23792,1041,4.2
3063,CN5503500000000,55,35,"Eau Claire County, WI",Mar-19,58938,56992,1946,3.3
3064,CN5503700000000,55,37,"Florence County, WI",Mar-19,2200,2078,122,5.5
3065,CN5503900000000,55,39,"Fond du Lac County, WI",Mar-19,57225,55362,1863,3.3
3066,CN5504100000000,55,41,"Forest County, WI",Mar-19,3950,3701,249,6.3
3067,CN5504300000000,55,43,"Grant County, WI",Mar-19,28140,27067,1073,3.8
3068,CN5504500000000,55,45,"Green County, WI",Mar-19,20902,20127,775,3.7
3069,CN5504700000000,55,47,"Green Lake County, WI",Mar-19,9237,8781,456,4.9
3070,CN5504900000000,55,49,"Iowa County, WI",Mar-19,13602,13066,536,3.9
3071,CN5505100000000,55,51,"Iron County, WI",Mar-19,2533,2340,193,7.6
3072,CN5505300000000,55,53,"Jackson County, WI",Mar-19,10118,9587,531,5.2
3073,CN5505500000000,55,55,"Jefferson County, WI",Mar-19,45763,44047,1716,3.7
3074,CN5505700000000,55,57,"Juneau County, WI",Mar-19,13282,12720,562,4.2
3075,CN5505900000000,55,59,"Kenosha County, WI",Mar-19,89209,85294,3915,4.4
3076,CN5506100000000,55,61,"Kewaunee County, WI",Mar-19,10930,10513,417,3.8
3077,CN5506300000000,55,63,"La Crosse County, WI",Mar-19,66846,64648,2198,3.3
3078,CN5506500000000,55,65,"Lafayette County, WI",Mar-19,9940,9609,331,3.3
3079,CN5506700000000,55,67,"Langlade County, WI",Mar-19,9337,8858,479,5.1
3080,CN5506900000000,55,69,"Lincoln County, WI",Mar-19,15022,14334,688,4.6
3081,CN5507100000000,55,71,"Manitowoc County, WI",Mar-19,40996,39383,1613,3.9
3082,CN5507300000000,55,73,"Marathon County, WI",Mar-19,73431,71007,2424,3.3
3083,CN5507500000000,55,75,"Marinette County, WI",Mar-19,19403,18406,997,5.1
3084,CN5507700000000,55,77,"Marquette County, WI",Mar-19,7636,7202,434,5.7
3085,CN5507800000000,55,78,"Menominee County, WI",Mar-19,1579,1476,103,6.5
3086,CN5507900000000,55,79,"Milwaukee County, WI",Mar-19,467459,448249,19210,4.1
3087,CN5508100000000,55,81,"Monroe County, WI",Mar-19,23194,22330,864,3.7
3088,CN5508300000000,55,83,"Oconto County, WI",Mar-19,20529,19593,936,4.6
3089,CN5508500000000,55,85,"Oneida County, WI",Mar-19,17550,16572,978,5.6
3090,CN5508700000000,55,87,"Outagamie County, WI",Mar-19,103026,99575,3451,3.3
3091,CN5508900000000,55,89,"Ozaukee County, WI",Mar-19,48871,47377,1494,3.1
3092,CN5509100000000,55,91,"Pepin County, WI",Mar-19,4051,3855,196,4.8
3093,CN5509300000000,55,93,"Pierce County, WI",Mar-19,25229,24152,1077,4.3
3094,CN5509500000000,55,95,"Polk County, WI",Mar-19,24540,23158,1382,5.6
3095,CN5509700000000,55,97,"Portage County, WI",Mar-19,39011,37472,1539,3.9
3096,CN5509900000000,55,99,"Price County, WI",Mar-19,6409,6091,318,5.0
3097,CN5510100000000,55,101,"Racine County, WI",Mar-19,98748,94253,4495,4.6
3098,CN5510300000000,55,103,"Richland County, WI",Mar-19,9168,8791,377,4.1
3099,CN5510500000000,55,105,"Rock County, WI",Mar-19,85227,81703,3524,4.1
3100,CN5510700000000,55,107,"Rusk County, WI",Mar-19,6687,6239,448,6.7
3101,CN5510900000000,55,109,"St. Croix County, WI",Mar-19,50203,48148,2055,4.1
3102,CN5511100000000,55,111,"Sauk County, WI",Mar-19,34909,33681,1228,3.5
3103,CN5511300000000,55,113,"Sawyer County, WI",Mar-19,7599,7117,482,6.3
3104,CN5511500000000,55,115,"Shawano County, WI",Mar-19,20740,19935,805,3.9
3105,CN5511700000000,55,117,"Sheboygan County, WI",Mar-19,61845,59994,1851,3.0
3106,CN5511900000000,55,119,"Taylor County, WI",Mar-19,10856,10294,562,5.2
3107,CN5512100000000,55,121,"Trempealeau County, WI",Mar-19,15963,15166,797,5.0
3108,CN5512300000000,55,123,"Vernon County, WI",Mar-19,15201,14539,662,4.4
3109,CN5512500000000,55,125,"Vilas County, WI",Mar-19,9518,8957,561,5.9
3110,CN5512700000000,55,127,"Walworth County, WI",Mar-19,57469,55282,2187,3.8
3111,CN5512900000000,55,129,"Washburn County, WI",Mar-19,7620,7222,398,5.2
3112,CN5513100000000,55,131,"Washington County, WI",Mar-19,77255,74821,2434,3.2
3113,CN5513300000000,55,133,"Waukesha County, WI",Mar-19,224990,217914,7076,3.1
3114,CN5513500000000,55,135,"Waupaca County, WI",Mar-19,25944,24952,992,3.8
3115,CN5513700000000,55,137,"Waushara County, WI",Mar-19,11534,10935,599,5.2
3116,CN5513900000000,55,139,"Winnebago County, WI",Mar-19,91766,88893,2873,3.1
3117,CN5514100000000,55,141,"Wood County, WI",Mar-19,34899,33210,1689,4.8
3118,CN5600100000000,56,1,"Albany County, WY",Mar-19,20725,20104,621,3.0
3119,CN5600300000000,56,3,"Big Horn County, WY",Mar-19,5005,4766,239,4.8
3120,CN5600500000000,56,5,"Campbell County, WY",Mar-19,23170,22333,837,3.6
3121,CN5600700000000,56,7,"Carbon County, WY",Mar-19,7547,7262,285,3.8
3122,CN5600900000000,56,9,"Converse County, WY",Mar-19,8407,8173,234,2.8
3123,CN5601100000000,56,11,"Crook County, WY",Mar-19,3510,3359,151,4.3
3124,CN5601300000000,56,13,"Fremont County, WY",Mar-19,18626,17728,898,4.8
3125,CN5601500000000,56,15,"Goshen County, WY",Mar-19,6476,6237,239,3.7
3126,CN5601700000000,56,17,"Hot Springs County, WY",Mar-19,2195,2112,83,3.8
3127,CN5601900000000,56,19,"Johnson County, WY",Mar-19,4032,3843,189,4.7
3128,CN5602100000000,56,21,"Laramie County, WY",Mar-19,48713,46918,1795,3.7
3129,CN5602300000000,56,23,"Lincoln County, WY",Mar-19,8761,8442,319,3.6
3130,CN5602500000000,56,25,"Natrona County, WY",Mar-19,39514,37881,1633,4.1
3131,CN5602700000000,56,27,"Niobrara County, WY",Mar-19,1199,1163,36,3.0
3132,CN5602900000000,56,29,"Park County, WY",Mar-19,14359,13630,729,5.1
3133,CN5603100000000,56,31,"Platte County, WY",Mar-19,4752,4588,164,3.5
3134,CN5603300000000,56,33,"Sheridan County, WY",Mar-19,15563,14929,634,4.1
3135,CN5603500000000,56,35,"Sublette County, WY",Mar-19,3935,3743,192,4.9
3136,CN5603700000000,56,37,"Sweetwater County, WY",Mar-19,21629,20751,878,4.1
3137,CN5603900000000,56,39,"Teton County, WY",Mar-19,14898,14539,359,2.4
3138,CN5604100000000,56,41,"Uinta County, WY",Mar-19,9099,8733,366,4.0
3139,CN5604300000000,56,43,"Washakie County, WY",Mar-19,3906,3704,202,5.2
3140,CN5604500000000,56,45,"Weston County, WY",Mar-19,3783,3655,128,3.4
3141,CN7200100000000,72,1,"Adjuntas Municipio, PR",Mar-19,4240,3396,844,19.9
3142,CN7200300000000,72,3,"Aguada Municipio, PR",Mar-19,11890,10464,1426,12.0
3143,CN7200500000000,72,5,"Aguadilla Municipio, PR",Mar-19,14359,12758,1601,11.1
3144,CN7200700000000,72,7,"Aguas Buenas Municipio, PR",Mar-19,6392,5752,640,10.0
3145,CN7200900000000,72,9,"Aibonito Municipio, PR",Mar-19,6382,5599,783,12.3
3146,CN7201100000000,72,11,"Anasco Municipio, PR",Mar-19,8705,7890,815,9.4
3147,CN7201300000000,72,13,"Arecibo Municipio, PR",Mar-19,23476,21013,2463,10.5
3148,CN7201500000000,72,15,"Arroyo Municipio, PR",Mar-19,4704,3982,722,15.3
3149,CN7201700000000,72,17,"Barceloneta Municipio, PR",Mar-19,5816,5091,725,12.5
3150,CN7201900000000,72,19,"Barranquitas Municipio, PR",Mar-19,7170,6498,672,9.4
3151,CN7202100000000,72,21,"Bayamon Municipio, PR",Mar-19,63541,59292,4249,6.7
3152,CN7202300000000,72,23,"Cabo Rojo Municipio, PR",Mar-19,13331,12029,1302,9.8
3153,CN7202500000000,72,25,"Caguas Municipio, PR",Mar-19,46683,43156,3527,7.6
3154,CN7202700000000,72,27,"Camuy Municipio, PR",Mar-19,9302,8447,855,9.2
3155,CN7202900000000,72,29,"Canovanas Municipio, PR",Mar-19,15633,14511,1122,7.2
3156,CN7203100000000,72,31,"Carolina Municipio, PR",Mar-19,59830,56070,3760,6.3
3157,CN7203300000000,72,33,"Catano Municipio, PR",Mar-19,7635,7048,587,7.7
3158,CN7203500000000,72,35,"Cayey Municipio, PR",Mar-19,15718,14530,1188,7.6
3159,CN7203700000000,72,37,"Ceiba Municipio, PR",Mar-19,3676,3234,442,12.0
3160,CN7203900000000,72,39,"Ciales Municipio, PR",Mar-19,3586,3192,394,11.0
3161,CN7204100000000,72,41,"Cidra Municipio, PR",Mar-19,15199,13990,1209,8.0
3162,CN7204300000000,72,43,"Coamo Municipio, PR",Mar-19,9890,8520,1370,13.9
3163,CN7204500000000,72,45,"Comerio Municipio, PR",Mar-19,4793,4314,479,10.0
3164,CN7204700000000,72,47,"Corozal Municipio, PR",Mar-19,8755,7879,876,10.0
3165,CN7204900000000,72,49,"Culebra Municipio, PR",Mar-19,900,874,26,2.9
3166,CN7205100000000,72,51,"Dorado Municipio, PR",Mar-19,12798,12023,775,6.1
3167,CN7205300000000,72,53,"Fajardo Municipio, PR",Mar-19,10870,9513,1357,12.5
3168,CN7205400000000,72,54,"Florida Municipio, PR",Mar-19,3280,2867,413,12.6
3169,CN7205500000000,72,55,"Guanica Municipio, PR",Mar-19,3885,3266,619,15.9
3170,CN7205700000000,72,57,"Guayama Municipio, PR",Mar-19,11001,9570,1431,13.0
3171,CN7205900000000,72,59,"Guayanilla Municipio, PR",Mar-19,4873,4079,794,16.3
3172,CN7206100000000,72,61,"Guaynabo Municipio, PR",Mar-19,36571,34960,1611,4.4
3173,CN7206300000000,72,63,"Gurabo Municipio, PR",Mar-19,17592,16499,1093,6.2
3174,CN7206500000000,72,65,"Hatillo Municipio, PR",Mar-19,13629,11531,2098,15.4
3175,CN7206700000000,72,67,"Hormigueros Municipio, PR",Mar-19,5280,4780,500,9.5
3176,CN7206900000000,72,69,"Humacao Municipio, PR",Mar-19,16935,14948,1987,11.7
3177,CN7207100000000,72,71,"Isabela Municipio, PR",Mar-19,12156,10936,1220,10.0
3178,CN7207300000000,72,73,"Jayuya Municipio, PR",Mar-19,4292,3530,762,17.8
3179,CN7207500000000,72,75,"Juana Diaz Municipio, PR",Mar-19,14783,13169,1614,10.9
3180,CN7207700000000,72,77,"Juncos Municipio, PR",Mar-19,11968,10883,1085,9.1
3181,CN7207900000000,72,79,"Lajas Municipio, PR",Mar-19,5123,4387,736,14.4
3182,CN7208100000000,72,81,"Lares Municipio, PR",Mar-19,6897,5627,1270,18.4
3183,CN7208300000000,72,83,"Las Marias Municipio, PR",Mar-19,2718,2329,389,14.3
3184,CN7208500000000,72,85,"Las Piedras Municipio, PR",Mar-19,11000,9960,1040,9.5
3185,CN7208700000000,72,87,"Loiza Municipio, PR",Mar-19,8166,7531,635,7.8
3186,CN7208900000000,72,89,"Luquillo Municipio, PR",Mar-19,6079,5441,638,10.5
3187,CN7209100000000,72,91,"Manati Municipio, PR",Mar-19,11301,10327,974,8.6
3188,CN7209300000000,72,93,"Maricao Municipio, PR",Mar-19,1927,1607,320,16.6
3189,CN7209500000000,72,95,"Maunabo Municipio, PR",Mar-19,3016,2431,585,19.4
3190,CN7209700000000,72,97,"Mayaguez Municipio, PR",Mar-19,21533,19022,2511,11.7
3191,CN7209900000000,72,99,"Moca Municipio, PR",Mar-19,10384,9151,1233,11.9
3192,CN7210100000000,72,101,"Morovis Municipio, PR",Mar-19,7761,7010,751,9.7
3193,CN7210300000000,72,103,"Naguabo Municipio, PR",Mar-19,7965,7182,783,9.8
3194,CN7210500000000,72,105,"Naranjito Municipio, PR",Mar-19,6870,6269,601,8.7
3195,CN7210700000000,72,107,"Orocovis Municipio, PR",Mar-19,4899,4312,587,12.0
3196,CN7210900000000,72,109,"Patillas Municipio, PR",Mar-19,4495,3601,894,19.9
3197,CN7211100000000,72,111,"Penuelas Municipio, PR",Mar-19,5825,4939,886,15.2
3198,CN7211300000000,72,113,"Ponce Municipio, PR",Mar-19,44991,40112,4879,10.8
3199,CN7211500000000,72,115,"Quebradillas Municipio, PR",Mar-19,6045,5217,828,13.7
3200,CN7211700000000,72,117,"Rincon Municipio, PR",Mar-19,4899,4015,884,18.0
3201,CN7211900000000,72,119,"Rio Grande Municipio, PR",Mar-19,16559,15181,1378,8.3
3202,CN7212100000000,72,121,"Sabana Grande Municipio, PR",Mar-19,6096,5210,886,14.5
3203,CN7212300000000,72,123,"Salinas Municipio, PR",Mar-19,7049,5985,1064,15.1
3204,CN7212500000000,72,125,"San German Municipio, PR",Mar-19,9646,8381,1265,13.1
3205,CN7212700000000,72,127,"San Juan Municipio, PR",Mar-19,130586,122897,7689,5.9
3206,CN7212900000000,72,129,"San Lorenzo Municipio, PR",Mar-19,11444,10327,1117,9.8
3207,CN7213100000000,72,131,"San Sebastian Municipio, PR",Mar-19,10340,8626,1714,16.6
3208,CN7213300000000,72,133,"Santa Isabel Municipio, PR",Mar-19,9345,8419,926,9.9
3209,CN7213500000000,72,135,"Toa Alta Municipio, PR",Mar-19,26339,24752,1587,6.0
3210,CN7213700000000,72,137,"Toa Baja Municipio, PR",Mar-19,28380,26639,1741,6.1
3211,CN7213900000000,72,139,"Trujillo Alto Municipio, PR",Mar-19,26345,24932,1413,5.4
3212,CN7214100000000,72,141,"Utuado Municipio, PR",Mar-19,6578,5758,820,12.5
3213,CN7214300000000,72,143,"Vega Alta Municipio, PR",Mar-19,9458,8643,815,8.6
3214,CN7214500000000,72,145,"Vega Baja Municipio, PR",Mar-19,12943,11610,1333,10.3
3215,CN7214700000000,72,147,"Vieques Municipio, PR",Mar-19,2677,2449,228,8.5
3216,CN7214900000000,72,149,"Villalba Municipio, PR",Mar-19,7630,6133,1497,19.6
3217,CN7215100000000,72,151,"Yabucoa Municipio, PR",Mar-19,8680,7439,1241,14.3
3218,CN7215300000000,72,153,"Yauco Municipio, PR",Mar-19,9837,8152,1685,17.1
3219,CN0100100000000,01,1,"Autauga County, AL",Apr-19,26165,25552,613,2.3
3220,CN0100300000000,01,3,"Baldwin County, AL",Apr-19,97486,95092,2394,2.5
3221,CN0100500000000,01,5,"Barbour County, AL",Apr-19,8428,8152,276,3.3
3222,CN0100700000000,01,7,"Bibb County, AL",Apr-19,8650,8403,247,2.9
3223,CN0100900000000,01,9,"Blount County, AL",Apr-19,25198,24614,584,2.3
3224,CN0101100000000,01,11,"Bullock County, AL",Apr-19,4816,4678,138,2.9
3225,CN0101300000000,01,13,"Butler County, AL",Apr-19,9280,8983,297,3.2
3226,CN0101500000000,01,15,"Calhoun County, AL",Apr-19,45910,44474,1436,3.1
3227,CN0101700000000,01,17,"Chambers County, AL",Apr-19,15675,15267,408,2.6
3228,CN0101900000000,01,19,"Cherokee County, AL",Apr-19,11585,11297,288,2.5
3229,CN0102100000000,01,21,"Chilton County, AL",Apr-19,19715,19249,466,2.4
3230,CN0102300000000,01,23,"Choctaw County, AL",Apr-19,4774,4587,187,3.9
3231,CN0102500000000,01,25,"Clarke County, AL",Apr-19,7564,7207,357,4.7
3232,CN0102700000000,01,27,"Clay County, AL",Apr-19,6070,5912,158,2.6
3233,CN0102900000000,01,29,"Cleburne County, AL",Apr-19,5783,5611,172,3.0
3234,CN0103100000000,01,31,"Coffee County, AL",Apr-19,21451,20888,563,2.6
3235,CN0103300000000,01,33,"Colbert County, AL",Apr-19,23684,22915,769,3.2
3236,CN0103500000000,01,35,"Conecuh County, AL",Apr-19,4543,4375,168,3.7
3237,CN0103700000000,01,37,"Coosa County, AL",Apr-19,4532,4411,121,2.7
3238,CN0103900000000,01,39,"Covington County, AL",Apr-19,15668,15144,524,3.3
3239,CN0104100000000,01,41,"Crenshaw County, AL",Apr-19,6528,6365,163,2.5
3240,CN0104300000000,01,43,"Cullman County, AL",Apr-19,38613,37710,903,2.3
3241,CN0104500000000,01,45,"Dale County, AL",Apr-19,20630,20055,575,2.8
3242,CN0104700000000,01,47,"Dallas County, AL",Apr-19,14779,14104,675,4.6
3243,CN0104900000000,01,49,"DeKalb County, AL",Apr-19,31021,30258,763,2.5
3244,CN0105100000000,01,51,"Elmore County, AL",Apr-19,37567,36721,846,2.3
3245,CN0105300000000,01,53,"Escambia County, AL",Apr-19,14746,14284,462,3.1
3246,CN0105500000000,01,55,"Etowah County, AL",Apr-19,42464,41220,1244,2.9
3247,CN0105700000000,01,57,"Fayette County, AL",Apr-19,6568,6387,181,2.8
3248,CN0105900000000,01,59,"Franklin County, AL",Apr-19,14628,14280,348,2.4
3249,CN0106100000000,01,61,"Geneva County, AL",Apr-19,10991,10702,289,2.6
3250,CN0106300000000,01,63,"Greene County, AL",Apr-19,2893,2747,146,5.0
3251,CN0106500000000,01,65,"Hale County, AL",Apr-19,6112,5904,208,3.4
3252,CN0106700000000,01,67,"Henry County, AL",Apr-19,6907,6683,224,3.2
3253,CN0106900000000,01,69,"Houston County, AL",Apr-19,45955,44735,1220,2.7
3254,CN0107100000000,01,71,"Jackson County, AL",Apr-19,23625,22936,689,2.9
3255,CN0107300000000,01,73,"Jefferson County, AL",Apr-19,317025,309107,7918,2.5
3256,CN0107500000000,01,75,"Lamar County, AL",Apr-19,5813,5651,162,2.8
3257,CN0107700000000,01,77,"Lauderdale County, AL",Apr-19,42602,41433,1169,2.7
3258,CN0107900000000,01,79,"Lawrence County, AL",Apr-19,14262,13872,390,2.7
3259,CN0108100000000,01,81,"Lee County, AL",Apr-19,76111,74342,1769,2.3
3260,CN0108300000000,01,83,"Limestone County, AL",Apr-19,43741,42718,1023,2.3
3261,CN0108500000000,01,85,"Lowndes County, AL",Apr-19,3581,3396,185,5.2
3262,CN0108700000000,01,87,"Macon County, AL",Apr-19,7822,7545,277,3.5
3263,CN0108900000000,01,89,"Madison County, AL",Apr-19,184753,180583,4170,2.3
3264,CN0109100000000,01,91,"Marengo County, AL",Apr-19,7703,7478,225,2.9
3265,CN0109300000000,01,93,"Marion County, AL",Apr-19,12977,12573,404,3.1
3266,CN0109500000000,01,95,"Marshall County, AL",Apr-19,44001,43046,955,2.2
3267,CN0109700000000,01,97,"Mobile County, AL",Apr-19,188444,182200,6244,3.3
3268,CN0109900000000,01,99,"Monroe County, AL",Apr-19,7260,6942,318,4.4
3269,CN0110100000000,01,101,"Montgomery County, AL",Apr-19,105822,102906,2916,2.8
3270,CN0110300000000,01,103,"Morgan County, AL",Apr-19,58130,56825,1305,2.2
3271,CN0110500000000,01,105,"Perry County, AL",Apr-19,3427,3281,146,4.3
3272,CN0110700000000,01,107,"Pickens County, AL",Apr-19,7917,7681,236,3.0
3273,CN0110900000000,01,109,"Pike County, AL",Apr-19,15437,15016,421,2.7
3274,CN0111100000000,01,111,"Randolph County, AL",Apr-19,9586,9327,259,2.7
3275,CN0111300000000,01,113,"Russell County, AL",Apr-19,23963,23336,627,2.6
3276,CN0111500000000,01,115,"St. Clair County, AL",Apr-19,40355,39371,984,2.4
3277,CN0111700000000,01,117,"Shelby County, AL",Apr-19,115424,113210,2214,1.9
3278,CN0111900000000,01,119,"Sumter County, AL",Apr-19,4881,4698,183,3.7
3279,CN0112100000000,01,121,"Talladega County, AL",Apr-19,35673,34605,1068,3.0
3280,CN0112300000000,01,123,"Tallapoosa County, AL",Apr-19,18718,18224,494,2.6
3281,CN0112500000000,01,125,"Tuscaloosa County, AL",Apr-19,104987,102590,2397,2.3
3282,CN0112700000000,01,127,"Walker County, AL",Apr-19,25188,24473,715,2.8
3283,CN0112900000000,01,129,"Washington County, AL",Apr-19,6739,6473,266,3.9
3284,CN0113100000000,01,131,"Wilcox County, AL",Apr-19,2720,2570,150,5.5
3285,CN0113300000000,01,133,"Winston County, AL",Apr-19,9926,9628,298,3.0
3286,CN0201300000000,02,13,"Aleutians East Borough, AK",Apr-19,2283,2218,65,2.8
3287,CN0201600000000,02,16,"Aleutians West Census Area, AK",Apr-19,3894,3778,116,3.0
3288,CN0202000000000,02,20,"Anchorage Borough/municipality, AK",Apr-19,146540,139189,7351,5.0
3289,CN0205000000000,02,50,"Bethel Census Area, AK",Apr-19,6870,5938,932,13.6
3290,CN0206000000000,02,60,"Bristol Bay Borough, AK",Apr-19,403,375,28,6.9
3291,CN0206800000000,02,68,"Denali Borough, AK",Apr-19,668,564,104,15.6
3292,CN0207000000000,02,70,"Dillingham Census Area, AK",Apr-19,1838,1674,164,8.9
3293,CN0209000000000,02,90,"Fairbanks North Star Borough, AK",Apr-19,44495,42006,2489,5.6
3294,CN0210000000000,02,100,"Haines Borough, AK",Apr-19,1006,919,87,8.6
3295,CN0210500000000,02,105,"Hoonah-Angoon Census Area, AK",Apr-19,1051,909,142,13.5
3296,CN0211000000000,02,110,"Juneau Borough/city, AK",Apr-19,16699,15935,764,4.6
3297,CN0212200000000,02,122,"Kenai Peninsula Borough, AK",Apr-19,25259,23465,1794,7.1
3298,CN0213000000000,02,130,"Ketchikan Gateway Borough, AK",Apr-19,6452,6014,438,6.8
3299,CN0215000000000,02,150,"Kodiak Island Borough, AK",Apr-19,5657,5361,296,5.2
3300,CN0215800000000,02,158,"Kusilvak Census Area, AK",Apr-19,2658,2113,545,20.5
3301,CN0216400000000,02,164,"Lake and Peninsula Borough, AK",Apr-19,625,548,77,12.3
3302,CN0217000000000,02,170,"Matanuska-Susitna Borough, AK",Apr-19,46945,43613,3332,7.1
3303,CN0218000000000,02,180,"Nome Census Area, AK",Apr-19,3984,3521,463,11.6
3304,CN0218500000000,02,185,"North Slope Borough, AK",Apr-19,3579,3364,215,6.0
3305,CN0218800000000,02,188,"Northwest Arctic Borough, AK",Apr-19,2849,2440,409,14.4
3306,CN0219500000000,02,195,"Petersburg Borough, AK",Apr-19,1311,1196,115,8.8
3307,CN0219800000000,02,198,"Prince of Wales-Hyder Census Area, AK",Apr-19,2854,2543,311,10.9
3308,CN0222000000000,02,220,"Sitka Borough/city, AK",Apr-19,4156,3985,171,4.1
3309,CN0223000000000,02,230,"Skagway Municipality, AK",Apr-19,660,583,77,11.7
3310,CN0224000000000,02,240,"Southeast Fairbanks Census Area, AK",Apr-19,2733,2469,264,9.7
3311,CN0226100000000,02,261,"Valdez-Cordova Census Area, AK",Apr-19,4407,4036,371,8.4
3312,CN0227500000000,02,275,"Wrangell Borough/city, AK",Apr-19,995,919,76,7.6
3313,CN0228200000000,02,282,"Yakutat Borough/city, AK",Apr-19,248,233,15,6.0
3314,CN0229000000000,02,290,"Yukon-Koyukuk Census Area, AK",Apr-19,2497,2102,395,15.8
3315,CN0400100000000,04,1,"Apache County, AZ",Apr-19,20328,18506,1822,9.0
3316,CN0400300000000,04,3,"Cochise County, AZ",Apr-19,49838,46997,2841,5.7
3317,CN0400500000000,04,5,"Coconino County, AZ",Apr-19,77030,73162,3868,5.0
3318,CN0400700000000,04,7,"Gila County, AZ",Apr-19,21497,20348,1149,5.3
3319,CN0400900000000,04,9,"Graham County, AZ",Apr-19,15463,14763,700,4.5
3320,CN0401100000000,04,11,"Greenlee County, AZ",Apr-19,4465,4295,170,3.8
3321,CN0401200000000,04,12,"La Paz County, AZ",Apr-19,9002,8449,553,6.1
3322,CN0401300000000,04,13,"Maricopa County, AZ",Apr-19,2278530,2190089,88441,3.9
3323,CN0401500000000,04,15,"Mohave County, AZ",Apr-19,87171,82385,4786,5.5
3324,CN0401700000000,04,17,"Navajo County, AZ",Apr-19,40430,37578,2852,7.1
3325,CN0401900000000,04,19,"Pima County, AZ",Apr-19,494965,474088,20877,4.2
3326,CN0402100000000,04,21,"Pinal County, AZ",Apr-19,184305,175593,8712,4.7
3327,CN0402300000000,04,23,"Santa Cruz County, AZ",Apr-19,19289,17975,1314,6.8
3328,CN0402500000000,04,25,"Yavapai County, AZ",Apr-19,105871,101287,4584,4.3
3329,CN0402700000000,04,27,"Yuma County, AZ",Apr-19,96456,82008,14448,15.0
3330,CN0500100000000,05,1,"Arkansas County, AR",Apr-19,9411,9156,255,2.7
3331,CN0500300000000,05,3,"Ashley County, AR",Apr-19,7849,7460,389,5.0
3332,CN0500500000000,05,5,"Baxter County, AR",Apr-19,16242,15685,557,3.4
3333,CN0500700000000,05,7,"Benton County, AR",Apr-19,136235,133186,3049,2.2
3334,CN0500900000000,05,9,"Boone County, AR",Apr-19,16074,15643,431,2.7
3335,CN0501100000000,05,11,"Bradley County, AR",Apr-19,4464,4287,177,4.0
3336,CN0501300000000,05,13,"Calhoun County, AR",Apr-19,2460,2355,105,4.3
3337,CN0501500000000,05,15,"Carroll County, AR",Apr-19,12692,12349,343,2.7
3338,CN0501700000000,05,17,"Chicot County, AR",Apr-19,3262,3040,222,6.8
3339,CN0501900000000,05,19,"Clark County, AR",Apr-19,9791,9449,342,3.5
3340,CN0502100000000,05,21,"Clay County, AR",Apr-19,5692,5451,241,4.2
3341,CN0502300000000,05,23,"Cleburne County, AR",Apr-19,9189,8840,349,3.8
3342,CN0502500000000,05,25,"Cleveland County, AR",Apr-19,3212,3101,111,3.5
3343,CN0502700000000,05,27,"Columbia County, AR",Apr-19,9160,8821,339,3.7
3344,CN0502900000000,05,29,"Conway County, AR",Apr-19,8289,7954,335,4.0
3345,CN0503100000000,05,31,"Craighead County, AR",Apr-19,55205,53901,1304,2.4
3346,CN0503300000000,05,33,"Crawford County, AR",Apr-19,26810,26061,749,2.8
3347,CN0503500000000,05,35,"Crittenden County, AR",Apr-19,21202,20413,789,3.7
3348,CN0503700000000,05,37,"Cross County, AR",Apr-19,7331,7053,278,3.8
3349,CN0503900000000,05,39,"Dallas County, AR",Apr-19,2823,2711,112,4.0
3350,CN0504100000000,05,41,"Desha County, AR",Apr-19,5384,5170,214,4.0
3351,CN0504300000000,05,43,"Drew County, AR",Apr-19,7883,7504,379,4.8
3352,CN0504500000000,05,45,"Faulkner County, AR",Apr-19,62433,60841,1592,2.5
3353,CN0504700000000,05,47,"Franklin County, AR",Apr-19,7496,7292,204,2.7
3354,CN0504900000000,05,49,"Fulton County, AR",Apr-19,4882,4707,175,3.6
3355,CN0505100000000,05,51,"Garland County, AR",Apr-19,41662,40393,1269,3.0
3356,CN0505300000000,05,53,"Grant County, AR",Apr-19,8392,8173,219,2.6
3357,CN0505500000000,05,55,"Greene County, AR",Apr-19,19996,19438,558,2.8
3358,CN0505700000000,05,57,"Hempstead County, AR",Apr-19,10045,9686,359,3.6
3359,CN0505900000000,05,59,"Hot Spring County, AR",Apr-19,14030,13599,431,3.1
3360,CN0506100000000,05,61,"Howard County, AR",Apr-19,5665,5511,154,2.7
3361,CN0506300000000,05,63,"Independence County, AR",Apr-19,16724,16189,535,3.2
3362,CN0506500000000,05,65,"Izard County, AR",Apr-19,4945,4699,246,5.0
3363,CN0506700000000,05,67,"Jackson County, AR",Apr-19,5787,5468,319,5.5
3364,CN0506900000000,05,69,"Jefferson County, AR",Apr-19,27653,26334,1319,4.8
3365,CN0507100000000,05,71,"Johnson County, AR",Apr-19,10319,9909,410,4.0
3366,CN0507300000000,05,73,"Lafayette County, AR",Apr-19,2488,2391,97,3.9
3367,CN0507500000000,05,75,"Lawrence County, AR",Apr-19,6894,6659,235,3.4
3368,CN0507700000000,05,77,"Lee County, AR",Apr-19,2805,2707,98,3.5
3369,CN0507900000000,05,79,"Lincoln County, AR",Apr-19,3940,3786,154,3.9
3370,CN0508100000000,05,81,"Little River County, AR",Apr-19,5475,5277,198,3.6
3371,CN0508300000000,05,83,"Logan County, AR",Apr-19,8498,8203,295,3.5
3372,CN0508500000000,05,85,"Lonoke County, AR",Apr-19,34381,33502,879,2.6
3373,CN0508700000000,05,87,"Madison County, AR",Apr-19,7362,7205,157,2.1
3374,CN0508900000000,05,89,"Marion County, AR",Apr-19,6668,6433,235,3.5
3375,CN0509100000000,05,91,"Miller County, AR",Apr-19,19637,18926,711,3.6
3376,CN0509300000000,05,93,"Mississippi County, AR",Apr-19,17344,16642,702,4.0
3377,CN0509500000000,05,95,"Monroe County, AR",Apr-19,2750,2653,97,3.5
3378,CN0509700000000,05,97,"Montgomery County, AR",Apr-19,2971,2849,122,4.1
3379,CN0509900000000,05,99,"Nevada County, AR",Apr-19,3704,3562,142,3.8
3380,CN0510100000000,05,101,"Newton County, AR",Apr-19,3341,3237,104,3.1
3381,CN0510300000000,05,103,"Ouachita County, AR",Apr-19,9865,9381,484,4.9
3382,CN0510500000000,05,105,"Perry County, AR",Apr-19,4277,4115,162,3.8
3383,CN0510700000000,05,107,"Phillips County, AR",Apr-19,6405,6082,323,5.0
3384,CN0510900000000,05,109,"Pike County, AR",Apr-19,4257,4123,134,3.1
3385,CN0511100000000,05,111,"Poinsett County, AR",Apr-19,10159,9886,273,2.7
3386,CN0511300000000,05,113,"Polk County, AR",Apr-19,8069,7800,269,3.3
3387,CN0511500000000,05,115,"Pope County, AR",Apr-19,28848,27830,1018,3.5
3388,CN0511700000000,05,117,"Prairie County, AR",Apr-19,3576,3446,130,3.6
3389,CN0511900000000,05,119,"Pulaski County, AR",Apr-19,190303,184689,5614,3.0
3390,CN0512100000000,05,121,"Randolph County, AR",Apr-19,7218,6980,238,3.3
3391,CN0512300000000,05,123,"St. Francis County, AR",Apr-19,8179,7789,390,4.8
3392,CN0512500000000,05,125,"Saline County, AR",Apr-19,59112,57732,1380,2.3
3393,CN0512700000000,05,127,"Scott County, AR",Apr-19,4310,4192,118,2.7
3394,CN0512900000000,05,129,"Searcy County, AR",Apr-19,2884,2772,112,3.9
3395,CN0513100000000,05,131,"Sebastian County, AR",Apr-19,56458,54916,1542,2.7
3396,CN0513300000000,05,133,"Sevier County, AR",Apr-19,5371,5142,229,4.3
3397,CN0513500000000,05,135,"Sharp County, AR",Apr-19,5728,5507,221,3.9
3398,CN0513700000000,05,137,"Stone County, AR",Apr-19,4749,4551,198,4.2
3399,CN0513900000000,05,139,"Union County, AR",Apr-19,15890,15174,716,4.5
3400,CN0514100000000,05,141,"Van Buren County, AR",Apr-19,5733,5488,245,4.3
3401,CN0514300000000,05,143,"Washington County, AR",Apr-19,124069,121523,2546,2.1
3402,CN0514500000000,05,145,"White County, AR",Apr-19,33938,32530,1408,4.1
3403,CN0514700000000,05,147,"Woodruff County, AR",Apr-19,2760,2622,138,5.0
3404,CN0514900000000,05,149,"Yell County, AR",Apr-19,8402,8129,273,3.2
3405,CN0600100000000,06,1,"Alameda County, CA",Apr-19,836116,813944,22172,2.7
3406,CN0600300000000,06,3,"Alpine County, CA",Apr-19,585,562,23,3.9
3407,CN0600500000000,06,5,"Amador County, CA",Apr-19,14788,14237,551,3.7
3408,CN0600700000000,06,7,"Butte County, CA",Apr-19,99475,94459,5016,5.0
3409,CN0600900000000,06,9,"Calaveras County, CA",Apr-19,21031,20254,777,3.7
3410,CN0601100000000,06,11,"Colusa County, CA",Apr-19,11215,9515,1700,15.2
3411,CN0601300000000,06,13,"Contra Costa County, CA",Apr-19,556190,540519,15671,2.8
3412,CN0601500000000,06,15,"Del Norte County, CA",Apr-19,9546,9022,524,5.5
3413,CN0601700000000,06,17,"El Dorado County, CA",Apr-19,91057,87961,3096,3.4
3414,CN0601900000000,06,19,"Fresno County, CA",Apr-19,450096,416012,34084,7.6
3415,CN0602100000000,06,21,"Glenn County, CA",Apr-19,12917,12090,827,6.4
3416,CN0602300000000,06,23,"Humboldt County, CA",Apr-19,62367,60181,2186,3.5
3417,CN0602500000000,06,25,"Imperial County, CA",Apr-19,69023,58205,10818,15.7
3418,CN0602700000000,06,27,"Inyo County, CA",Apr-19,8620,8315,305,3.5
3419,CN0602900000000,06,29,"Kern County, CA",Apr-19,385375,353847,31528,8.2
3420,CN0603100000000,06,31,"Kings County, CA",Apr-19,57420,52653,4767,8.3
3421,CN0603300000000,06,33,"Lake County, CA",Apr-19,29227,27770,1457,5.0
3422,CN0603500000000,06,35,"Lassen County, CA",Apr-19,9598,9113,485,5.1
3423,CN0603700000000,06,37,"Los Angeles County, CA",Apr-19,5077081,4871199,205882,4.1
3424,CN0603900000000,06,39,"Madera County, CA",Apr-19,60745,56244,4501,7.4
3425,CN0604100000000,06,41,"Marin County, CA",Apr-19,137964,135091,2873,2.1
3426,CN0604300000000,06,43,"Mariposa County, CA",Apr-19,7413,7056,357,4.8
3427,CN0604500000000,06,45,"Mendocino County, CA",Apr-19,38879,37296,1583,4.1
3428,CN0604700000000,06,47,"Merced County, CA",Apr-19,115884,105832,10052,8.7
3429,CN0604900000000,06,49,"Modoc County, CA",Apr-19,3100,2856,244,7.9
3430,CN0605100000000,06,51,"Mono County, CA",Apr-19,8574,8308,266,3.1
3431,CN0605300000000,06,53,"Monterey County, CA",Apr-19,223890,208037,15853,7.1
3432,CN0605500000000,06,55,"Napa County, CA",Apr-19,72570,70626,1944,2.7
3433,CN0605700000000,06,57,"Nevada County, CA",Apr-19,48395,46833,1562,3.2
3434,CN0605900000000,06,59,"Orange County, CA",Apr-19,1610768,1570230,40538,2.5
3435,CN0606100000000,06,61,"Placer County, CA",Apr-19,185907,180471,5436,2.9
3436,CN0606300000000,06,63,"Plumas County, CA",Apr-19,7633,6891,742,9.7
3437,CN0606500000000,06,65,"Riverside County, CA",Apr-19,1092375,1051568,40807,3.7
3438,CN0606700000000,06,67,"Sacramento County, CA",Apr-19,704395,680307,24088,3.4
3439,CN0606900000000,06,69,"San Benito County, CA",Apr-19,31245,29635,1610,5.2
3440,CN0607100000000,06,71,"San Bernardino County, CA",Apr-19,958520,925304,33216,3.5
3441,CN0607300000000,06,73,"San Diego County, CA",Apr-19,1575313,1529646,45667,2.9
3442,CN0607500000000,06,75,"San Francisco County/city, CA",Apr-19,575479,563830,11649,2.0
3443,CN0607700000000,06,77,"San Joaquin County, CA",Apr-19,322796,303942,18854,5.8
3444,CN0607900000000,06,79,"San Luis Obispo County, CA",Apr-19,141284,137629,3655,2.6
3445,CN0608100000000,06,81,"San Mateo County, CA",Apr-19,453760,445392,8368,1.8
3446,CN0608300000000,06,83,"Santa Barbara County, CA",Apr-19,218241,210771,7470,3.4
3447,CN0608500000000,06,85,"Santa Clara County, CA",Apr-19,1041330,1017871,23459,2.3
3448,CN0608700000000,06,87,"Santa Cruz County, CA",Apr-19,144070,136409,7661,5.3
3449,CN0608900000000,06,89,"Shasta County, CA",Apr-19,73500,70034,3466,4.7
3450,CN0609100000000,06,91,"Sierra County, CA",Apr-19,1272,1191,81,6.4
3451,CN0609300000000,06,93,"Siskiyou County, CA",Apr-19,16838,15619,1219,7.2
3452,CN0609500000000,06,95,"Solano County, CA",Apr-19,208300,200906,7394,3.5
3453,CN0609700000000,06,97,"Sonoma County, CA",Apr-19,255223,248770,6453,2.5
3454,CN0609900000000,06,99,"Stanislaus County, CA",Apr-19,241563,226701,14862,6.2
3455,CN0610100000000,06,101,"Sutter County, CA",Apr-19,44925,41159,3766,8.4
3456,CN0610300000000,06,103,"Tehama County, CA",Apr-19,25244,23806,1438,5.7
3457,CN0610500000000,06,105,"Trinity County, CA",Apr-19,4632,4357,275,5.9
3458,CN0610700000000,06,107,"Tulare County, CA",Apr-19,204753,184536,20217,9.9
3459,CN0610900000000,06,109,"Tuolumne County, CA",Apr-19,21087,20127,960,4.6
3460,CN0611100000000,06,111,"Ventura County, CA",Apr-19,422466,409159,13307,3.1
3461,CN0611300000000,06,113,"Yolo County, CA",Apr-19,107518,103319,4199,3.9
3462,CN0611500000000,06,115,"Yuba County, CA",Apr-19,29354,27536,1818,6.2
3463,CN0800100000000,08,1,"Adams County, CO",Apr-19,271747,263759,7988,2.9
3464,CN0800300000000,08,3,"Alamosa County, CO",Apr-19,8633,8324,309,3.6
3465,CN0800500000000,08,5,"Arapahoe County, CO",Apr-19,363724,353930,9794,2.7
3466,CN0800700000000,08,7,"Archuleta County, CO",Apr-19,6689,6469,220,3.3
3467,CN0800900000000,08,9,"Baca County, CO",Apr-19,2156,2121,35,1.6
3468,CN0801100000000,08,11,"Bent County, CO",Apr-19,1898,1841,57,3.0
3469,CN0801300000000,08,13,"Boulder County, CO",Apr-19,195703,191068,4635,2.4
3470,CN0801400000000,08,14,"Broomfield County/city, CO",Apr-19,39978,38993,985,2.5
3471,CN0801500000000,08,15,"Chaffee County, CO",Apr-19,9518,9283,235,2.5
3472,CN0801700000000,08,17,"Cheyenne County, CO",Apr-19,1144,1125,19,1.7
3473,CN0801900000000,08,19,"Clear Creek County, CO",Apr-19,6016,5885,131,2.2
3474,CN0802100000000,08,21,"Conejos County, CO",Apr-19,4114,3961,153,3.7
3475,CN0802300000000,08,23,"Costilla County, CO",Apr-19,1827,1746,81,4.4
3476,CN0802500000000,08,25,"Crowley County, CO",Apr-19,1500,1436,64,4.3
3477,CN0802700000000,08,27,"Custer County, CO",Apr-19,2033,1975,58,2.9
3478,CN0802900000000,08,29,"Delta County, CO",Apr-19,14156,13659,497,3.5
3479,CN0803100000000,08,31,"Denver County/city, CO",Apr-19,415838,404639,11199,2.7
3480,CN0803300000000,08,33,"Dolores County, CO",Apr-19,1114,1079,35,3.1
3481,CN0803500000000,08,35,"Douglas County, CO",Apr-19,193743,189063,4680,2.4
3482,CN0803700000000,08,37,"Eagle County, CO",Apr-19,36725,35936,789,2.1
3483,CN0803900000000,08,39,"Elbert County, CO",Apr-19,15136,14802,334,2.2
3484,CN0804100000000,08,41,"El Paso County, CO",Apr-19,338947,327814,11133,3.3
3485,CN0804300000000,08,43,"Fremont County, CO",Apr-19,14998,14317,681,4.5
3486,CN0804500000000,08,45,"Garfield County, CO",Apr-19,32613,31750,863,2.6
3487,CN0804700000000,08,47,"Gilpin County, CO",Apr-19,3776,3686,90,2.4
3488,CN0804900000000,08,49,"Grand County, CO",Apr-19,9514,9304,210,2.2
3489,CN0805100000000,08,51,"Gunnison County, CO",Apr-19,10969,10702,267,2.4
3490,CN0805300000000,08,53,"Hinsdale County, CO",Apr-19,395,381,14,3.5
3491,CN0805500000000,08,55,"Huerfano County, CO",Apr-19,2503,2354,149,6.0
3492,CN0805700000000,08,57,"Jackson County, CO",Apr-19,939,918,21,2.2
3493,CN0805900000000,08,59,"Jefferson County, CO",Apr-19,334456,325894,8562,2.6
3494,CN0806100000000,08,61,"Kiowa County, CO",Apr-19,940,925,15,1.6
3495,CN0806300000000,08,63,"Kit Carson County, CO",Apr-19,4229,4165,64,1.5
3496,CN0806500000000,08,65,"Lake County, CO",Apr-19,4943,4842,101,2.0
3497,CN0806700000000,08,67,"La Plata County, CO",Apr-19,31651,30815,836,2.6
3498,CN0806900000000,08,69,"Larimer County, CO",Apr-19,204209,199365,4844,2.4
3499,CN0807100000000,08,71,"Las Animas County, CO",Apr-19,6582,6333,249,3.8
3500,CN0807300000000,08,73,"Lincoln County, CO",Apr-19,2384,2329,55,2.3
3501,CN0807500000000,08,75,"Logan County, CO",Apr-19,11131,10863,268,2.4
3502,CN0807700000000,08,77,"Mesa County, CO",Apr-19,76505,73976,2529,3.3
3503,CN0807900000000,08,79,"Mineral County, CO",Apr-19,555,538,17,3.1
3504,CN0808100000000,08,81,"Moffat County, CO",Apr-19,7352,7056,296,4.0
3505,CN0808300000000,08,83,"Montezuma County, CO",Apr-19,12687,12119,568,4.5
3506,CN0808500000000,08,85,"Montrose County, CO",Apr-19,21575,20895,680,3.2
3507,CN0808700000000,08,87,"Morgan County, CO",Apr-19,16342,15917,425,2.6
3508,CN0808900000000,08,89,"Otero County, CO",Apr-19,8348,8012,336,4.0
3509,CN0809100000000,08,91,"Ouray County, CO",Apr-19,2223,2151,72,3.2
3510,CN0809300000000,08,93,"Park County, CO",Apr-19,11185,10887,298,2.7
3511,CN0809500000000,08,95,"Phillips County, CO",Apr-19,2543,2502,41,1.6
3512,CN0809700000000,08,97,"Pitkin County, CO",Apr-19,11237,10964,273,2.4
3513,CN0809900000000,08,99,"Prowers County, CO",Apr-19,6302,6145,157,2.5
3514,CN0810100000000,08,101,"Pueblo County, CO",Apr-19,75861,72777,3084,4.1
3515,CN0810300000000,08,103,"Rio Blanco County, CO",Apr-19,3000,2885,115,3.8
3516,CN0810500000000,08,105,"Rio Grande County, CO",Apr-19,5283,5079,204,3.9
3517,CN0810700000000,08,107,"Routt County, CO",Apr-19,16036,15673,363,2.3
3518,CN0810900000000,08,109,"Saguache County, CO",Apr-19,3514,3387,127,3.6
3519,CN0811100000000,08,111,"San Juan County, CO",Apr-19,450,431,19,4.2
3520,CN0811300000000,08,113,"San Miguel County, CO",Apr-19,5582,5442,140,2.5
3521,CN0811500000000,08,115,"Sedgwick County, CO",Apr-19,1196,1173,23,1.9
3522,CN0811700000000,08,117,"Summit County, CO",Apr-19,23159,22779,380,1.6
3523,CN0811900000000,08,119,"Teller County, CO",Apr-19,12700,12309,391,3.1
3524,CN0812100000000,08,121,"Washington County, CO",Apr-19,3015,2957,58,1.9
3525,CN0812300000000,08,123,"Weld County, CO",Apr-19,167964,163703,4261,2.5
3526,CN0812500000000,08,125,"Yuma County, CO",Apr-19,6370,6271,99,1.6
3527,CN0900100000000,09,1,"Fairfield County, CT",Apr-19,472697,457885,14812,3.1
3528,CN0900300000000,09,3,"Hartford County, CT",Apr-19,478319,460950,17369,3.6
3529,CN0900500000000,09,5,"Litchfield County, CT",Apr-19,103111,99881,3230,3.1
3530,CN0900700000000,09,7,"Middlesex County, CT",Apr-19,92458,89881,2577,2.8
3531,CN0900900000000,09,9,"New Haven County, CT",Apr-19,455579,439833,15746,3.5
3532,CN0901100000000,09,11,"New London County, CT",Apr-19,135095,130821,4274,3.2
3533,CN0901300000000,09,13,"Tolland County, CT",Apr-19,85944,83543,2401,2.8
3534,CN0901500000000,09,15,"Windham County, CT",Apr-19,63239,61014,2225,3.5
3535,CN1000100000000,10,1,"Kent County, DE",Apr-19,79157,76232,2925,3.7
3536,CN1000300000000,10,3,"New Castle County, DE",Apr-19,302106,292119,9987,3.3
3537,CN1000500000000,10,5,"Sussex County, DE",Apr-19,104849,100878,3971,3.8
3538,CN1100100000000,11,1,District of Columbia,Apr-19,409186,388445,20741,5.1
3539,CN1200100000000,12,1,"Alachua County, FL",Apr-19,139177,135464,3713,2.7
3540,CN1200300000000,12,3,"Baker County, FL",Apr-19,11585,11248,337,2.9
3541,CN1200500000000,12,5,"Bay County, FL",Apr-19,83485,80299,3186,3.8
3542,CN1200700000000,12,7,"Bradford County, FL",Apr-19,10854,10536,318,2.9
3543,CN1200900000000,12,9,"Brevard County, FL",Apr-19,279366,270907,8459,3.0
3544,CN1201100000000,12,11,"Broward County, FL",Apr-19,1026061,996914,29147,2.8
3545,CN1201300000000,12,13,"Calhoun County, FL",Apr-19,4805,4620,185,3.9
3546,CN1201500000000,12,15,"Charlotte County, FL",Apr-19,71379,68927,2452,3.4
3547,CN1201700000000,12,17,"Citrus County, FL",Apr-19,46966,44851,2115,4.5
3548,CN1201900000000,12,19,"Clay County, FL",Apr-19,105301,102324,2977,2.8
3549,CN1202100000000,12,21,"Collier County, FL",Apr-19,181382,176487,4895,2.7
3550,CN1202300000000,12,23,"Columbia County, FL",Apr-19,29227,28345,882,3.0
3551,CN1202700000000,12,27,"DeSoto County, FL",Apr-19,14475,14025,450,3.1
3552,CN1202900000000,12,29,"Dixie County, FL",Apr-19,5763,5563,200,3.5
3553,CN1203100000000,12,31,"Duval County, FL",Apr-19,480785,466249,14536,3.0
3554,CN1203300000000,12,33,"Escambia County, FL",Apr-19,144438,140183,4255,2.9
3555,CN1203500000000,12,35,"Flagler County, FL",Apr-19,46561,44915,1646,3.5
3556,CN1203700000000,12,37,"Franklin County, FL",Apr-19,4678,4516,162,3.5
3557,CN1203900000000,12,39,"Gadsden County, FL",Apr-19,18733,18027,706,3.8
3558,CN1204100000000,12,41,"Gilchrist County, FL",Apr-19,7100,6873,227,3.2
3559,CN1204300000000,12,43,"Glades County, FL",Apr-19,5601,5406,195,3.5
3560,CN1204500000000,12,45,"Gulf County, FL",Apr-19,5730,5449,281,4.9
3561,CN1204700000000,12,47,"Hamilton County, FL",Apr-19,4260,4101,159,3.7
3562,CN1204900000000,12,49,"Hardee County, FL",Apr-19,8541,8166,375,4.4
3563,CN1205100000000,12,51,"Hendry County, FL",Apr-19,15678,15031,647,4.1
3564,CN1205300000000,12,53,"Hernando County, FL",Apr-19,70671,67903,2768,3.9
3565,CN1205500000000,12,55,"Highlands County, FL",Apr-19,36077,34583,1494,4.1
3566,CN1205700000000,12,57,"Hillsborough County, FL",Apr-19,738205,716904,21301,2.9
3567,CN1205900000000,12,59,"Holmes County, FL",Apr-19,6887,6658,229,3.3
3568,CN1206100000000,12,61,"Indian River County, FL",Apr-19,65229,62939,2290,3.5
3569,CN1206300000000,12,63,"Jackson County, FL",Apr-19,17154,16565,589,3.4
3570,CN1206500000000,12,65,"Jefferson County, FL",Apr-19,5615,5436,179,3.2
3571,CN1206700000000,12,67,"Lafayette County, FL",Apr-19,2857,2778,79,2.8
3572,CN1206900000000,12,69,"Lake County, FL",Apr-19,157046,152328,4718,3.0
3573,CN1207100000000,12,71,"Lee County, FL",Apr-19,345821,335701,10120,2.9
3574,CN1207300000000,12,73,"Leon County, FL",Apr-19,155019,150735,4284,2.8
3575,CN1207500000000,12,75,"Levy County, FL",Apr-19,16642,16052,590,3.5
3576,CN1207700000000,12,77,"Liberty County, FL",Apr-19,2642,2550,92,3.5
3577,CN1207900000000,12,79,"Madison County, FL",Apr-19,7393,7139,254,3.4
3578,CN1208100000000,12,81,"Manatee County, FL",Apr-19,178942,173808,5134,2.9
3579,CN1208300000000,12,83,"Marion County, FL",Apr-19,135997,131083,4914,3.6
3580,CN1208500000000,12,85,"Martin County, FL",Apr-19,73573,71430,2143,2.9
3581,CN1208600000000,12,86,"Miami-Dade County, FL",Apr-19,1383594,1349404,34190,2.5
3582,CN1208700000000,12,87,"Monroe County, FL",Apr-19,46585,45680,905,1.9
3583,CN1208900000000,12,89,"Nassau County, FL",Apr-19,40316,39207,1109,2.8
3584,CN1209100000000,12,91,"Okaloosa County, FL",Apr-19,95661,93230,2431,2.5
3585,CN1209300000000,12,93,"Okeechobee County, FL",Apr-19,17727,17157,570,3.2
3586,CN1209500000000,12,95,"Orange County, FL",Apr-19,751828,731497,20331,2.7
3587,CN1209700000000,12,97,"Osceola County, FL",Apr-19,181527,176042,5485,3.0
3588,CN1209900000000,12,99,"Palm Beach County, FL",Apr-19,729531,707987,21544,3.0
3589,CN1210100000000,12,101,"Pasco County, FL",Apr-19,234114,226416,7698,3.3
3590,CN1210300000000,12,103,"Pinellas County, FL",Apr-19,486421,472664,13757,2.8
3591,CN1210500000000,12,105,"Polk County, FL",Apr-19,301351,291121,10230,3.4
3592,CN1210700000000,12,107,"Putnam County, FL",Apr-19,26585,25519,1066,4.0
3593,CN1210900000000,12,109,"St. Johns County, FL",Apr-19,129763,126559,3204,2.5
3594,CN1211100000000,12,111,"St. Lucie County, FL",Apr-19,143913,138703,5210,3.6
3595,CN1211300000000,12,113,"Santa Rosa County, FL",Apr-19,81953,79710,2243,2.7
3596,CN1211500000000,12,115,"Sarasota County, FL",Apr-19,188043,182558,5485,2.9
3597,CN1211700000000,12,117,"Seminole County, FL",Apr-19,251909,245073,6836,2.7
3598,CN1211900000000,12,119,"Sumter County, FL",Apr-19,32397,30958,1439,4.4
3599,CN1212100000000,12,121,"Suwannee County, FL",Apr-19,17903,17342,561,3.1
3600,CN1212300000000,12,123,"Taylor County, FL",Apr-19,8202,7921,281,3.4
3601,CN1212500000000,12,125,"Union County, FL",Apr-19,4644,4520,124,2.7
3602,CN1212700000000,12,127,"Volusia County, FL",Apr-19,252062,243940,8122,3.2
3603,CN1212900000000,12,129,"Wakulla County, FL",Apr-19,14874,14470,404,2.7
3604,CN1213100000000,12,131,"Walton County, FL",Apr-19,31181,30341,840,2.7
3605,CN1213300000000,12,133,"Washington County, FL",Apr-19,9604,9295,309,3.2
3606,CN1300100000000,13,1,"Appling County, GA",Apr-19,9117,8809,308,3.4
3607,CN1300300000000,13,3,"Atkinson County, GA",Apr-19,4702,4575,127,2.7
3608,CN1300500000000,13,5,"Bacon County, GA",Apr-19,5029,4881,148,2.9
3609,CN1300700000000,13,7,"Baker County, GA",Apr-19,1164,1113,51,4.4
3610,CN1300900000000,13,9,"Baldwin County, GA",Apr-19,17415,16762,653,3.7
3611,CN1301100000000,13,11,"Banks County, GA",Apr-19,9613,9365,248,2.6
3612,CN1301300000000,13,13,"Barrow County, GA",Apr-19,39906,38857,1049,2.6
3613,CN1301500000000,13,15,"Bartow County, GA",Apr-19,49873,48409,1464,2.9
3614,CN1301700000000,13,17,"Ben Hill County, GA",Apr-19,5290,5047,243,4.6
3615,CN1301900000000,13,19,"Berrien County, GA",Apr-19,7477,7236,241,3.2
3616,CN1302100000000,13,21,"Bibb County, GA",Apr-19,67306,64891,2415,3.6
3617,CN1302300000000,13,23,"Bleckley County, GA",Apr-19,4585,4385,200,4.4
3618,CN1302500000000,13,25,"Brantley County, GA",Apr-19,7240,6980,260,3.6
3619,CN1302700000000,13,27,"Brooks County, GA",Apr-19,6884,6679,205,3.0
3620,CN1302900000000,13,29,"Bryan County, GA",Apr-19,18216,17732,484,2.7
3621,CN1303100000000,13,31,"Bulloch County, GA",Apr-19,36686,35495,1191,3.2
3622,CN1303300000000,13,33,"Burke County, GA",Apr-19,9193,8779,414,4.5
3623,CN1303500000000,13,35,"Butts County, GA",Apr-19,10608,10274,334,3.1
3624,CN1303700000000,13,37,"Calhoun County, GA",Apr-19,2214,2136,78,3.5
3625,CN1303900000000,13,39,"Camden County, GA",Apr-19,20732,20049,683,3.3
3626,CN1304300000000,13,43,"Candler County, GA",Apr-19,5453,5311,142,2.6
3627,CN1304500000000,13,45,"Carroll County, GA",Apr-19,54521,52824,1697,3.1
3628,CN1304700000000,13,47,"Catoosa County, GA",Apr-19,33380,32389,991,3.0
3629,CN1304900000000,13,49,"Charlton County, GA",Apr-19,4741,4576,165,3.5
3630,CN1305100000000,13,51,"Chatham County, GA",Apr-19,139101,134970,4131,3.0
3631,CN1305300000000,13,53,"Chattahoochee County, GA",Apr-19,1994,1912,82,4.1
3632,CN1305500000000,13,55,"Chattooga County, GA",Apr-19,10157,9805,352,3.5
3633,CN1305700000000,13,57,"Cherokee County, GA",Apr-19,134227,130840,3387,2.5
3634,CN1305900000000,13,59,"Clarke County, GA",Apr-19,59148,57260,1888,3.2
3635,CN1306100000000,13,61,"Clay County, GA",Apr-19,875,824,51,5.8
3636,CN1306300000000,13,63,"Clayton County, GA",Apr-19,135943,130647,5296,3.9
3637,CN1306500000000,13,65,"Clinch County, GA",Apr-19,2822,2735,87,3.1
3638,CN1306700000000,13,67,"Cobb County, GA",Apr-19,420074,408547,11527,2.7
3639,CN1306900000000,13,69,"Coffee County, GA",Apr-19,18799,18132,667,3.5
3640,CN1307100000000,13,71,"Colquitt County, GA",Apr-19,21387,20768,619,2.9
3641,CN1307300000000,13,73,"Columbia County, GA",Apr-19,75637,73582,2055,2.7
3642,CN1307500000000,13,75,"Cook County, GA",Apr-19,7934,7699,235,3.0
3643,CN1307700000000,13,77,"Coweta County, GA",Apr-19,73702,71694,2008,2.7
3644,CN1307900000000,13,79,"Crawford County, GA",Apr-19,5559,5380,179,3.2
3645,CN1308100000000,13,81,"Crisp County, GA",Apr-19,9470,9111,359,3.8
3646,CN1308300000000,13,83,"Dade County, GA",Apr-19,8170,7924,246,3.0
3647,CN1308500000000,13,85,"Dawson County, GA",Apr-19,12186,11867,319,2.6
3648,CN1308700000000,13,87,"Decatur County, GA",Apr-19,11636,11213,423,3.6
3649,CN1308900000000,13,89,"DeKalb County, GA",Apr-19,394376,381841,12535,3.2
3650,CN1309100000000,13,91,"Dodge County, GA",Apr-19,7049,6702,347,4.9
3651,CN1309300000000,13,93,"Dooly County, GA",Apr-19,5036,4864,172,3.4
3652,CN1309500000000,13,95,"Dougherty County, GA",Apr-19,38038,36423,1615,4.2
3653,CN1309700000000,13,97,"Douglas County, GA",Apr-19,72291,69939,2352,3.3
3654,CN1309900000000,13,99,"Early County, GA",Apr-19,4318,4166,152,3.5
3655,CN1310100000000,13,101,"Echols County, GA",Apr-19,1908,1861,47,2.5
3656,CN1310300000000,13,103,"Effingham County, GA",Apr-19,30777,29979,798,2.6
3657,CN1310500000000,13,105,"Elbert County, GA",Apr-19,7570,7313,257,3.4
3658,CN1310700000000,13,107,"Emanuel County, GA",Apr-19,8256,7901,355,4.3
3659,CN1310900000000,13,109,"Evans County, GA",Apr-19,4786,4638,148,3.1
3660,CN1311100000000,13,111,"Fannin County, GA",Apr-19,11629,11295,334,2.9
3661,CN1311300000000,13,113,"Fayette County, GA",Apr-19,57267,55691,1576,2.8
3662,CN1311500000000,13,115,"Floyd County, GA",Apr-19,43598,42182,1416,3.2
3663,CN1311700000000,13,117,"Forsyth County, GA",Apr-19,120589,117580,3009,2.5
3664,CN1311900000000,13,119,"Franklin County, GA",Apr-19,9947,9632,315,3.2
3665,CN1312100000000,13,121,"Fulton County, GA",Apr-19,550040,532292,17748,3.2
3666,CN1312300000000,13,123,"Gilmer County, GA",Apr-19,11895,11527,368,3.1
3667,CN1312500000000,13,125,"Glascock County, GA",Apr-19,1278,1235,43,3.4
3668,CN1312700000000,13,127,"Glynn County, GA",Apr-19,39193,38034,1159,3.0
3669,CN1312900000000,13,129,"Gordon County, GA",Apr-19,27870,27092,778,2.8
3670,CN1313100000000,13,131,"Grady County, GA",Apr-19,10451,10138,313,3.0
3671,CN1313300000000,13,133,"Greene County, GA",Apr-19,6965,6728,237,3.4
3672,CN1313500000000,13,135,"Gwinnett County, GA",Apr-19,483745,470287,13458,2.8
3673,CN1313700000000,13,137,"Habersham County, GA",Apr-19,19104,18524,580,3.0
3674,CN1313900000000,13,139,"Hall County, GA",Apr-19,100922,98303,2619,2.6
3675,CN1314100000000,13,141,"Hancock County, GA",Apr-19,2452,2330,122,5.0
3676,CN1314300000000,13,143,"Haralson County, GA",Apr-19,12398,12027,371,3.0
3677,CN1314500000000,13,145,"Harris County, GA",Apr-19,16649,16183,466,2.8
3678,CN1314700000000,13,147,"Hart County, GA",Apr-19,11493,11158,335,2.9
3679,CN1314900000000,13,149,"Heard County, GA",Apr-19,5187,5027,160,3.1
3680,CN1315100000000,13,151,"Henry County, GA",Apr-19,114039,110250,3789,3.3
3681,CN1315300000000,13,153,"Houston County, GA",Apr-19,69819,67657,2162,3.1
3682,CN1315500000000,13,155,"Irwin County, GA",Apr-19,3306,3173,133,4.0
3683,CN1315700000000,13,157,"Jackson County, GA",Apr-19,36020,35102,918,2.5
3684,CN1315900000000,13,159,"Jasper County, GA",Apr-19,6863,6667,196,2.9
3685,CN1316100000000,13,161,"Jeff Davis County, GA",Apr-19,6021,5783,238,4.0
3686,CN1316300000000,13,163,"Jefferson County, GA",Apr-19,6472,6211,261,4.0
3687,CN1316500000000,13,165,"Jenkins County, GA",Apr-19,3147,3009,138,4.4
3688,CN1316700000000,13,167,"Johnson County, GA",Apr-19,4066,3928,138,3.4
3689,CN1316900000000,13,169,"Jones County, GA",Apr-19,13583,13198,385,2.8
3690,CN1317100000000,13,171,"Lamar County, GA",Apr-19,8127,7840,287,3.5
3691,CN1317300000000,13,173,"Lanier County, GA",Apr-19,3733,3596,137,3.7
3692,CN1317500000000,13,175,"Laurens County, GA",Apr-19,19217,18452,765,4.0
3693,CN1317700000000,13,177,"Lee County, GA",Apr-19,14635,14236,399,2.7
3694,CN1317900000000,13,179,"Liberty County, GA",Apr-19,25849,25012,837,3.2
3695,CN1318100000000,13,181,"Lincoln County, GA",Apr-19,3576,3454,122,3.4
3696,CN1318300000000,13,183,"Long County, GA",Apr-19,8086,7822,264,3.3
3697,CN1318500000000,13,185,"Lowndes County, GA",Apr-19,50845,49248,1597,3.1
3698,CN1318700000000,13,187,"Lumpkin County, GA",Apr-19,16566,16103,463,2.8
3699,CN1318900000000,13,189,"McDuffie County, GA",Apr-19,8853,8485,368,4.2
3700,CN1319100000000,13,191,"McIntosh County, GA",Apr-19,6158,5956,202,3.3
3701,CN1319300000000,13,193,"Macon County, GA",Apr-19,4706,4510,196,4.2
3702,CN1319500000000,13,195,"Madison County, GA",Apr-19,13300,12941,359,2.7
3703,CN1319700000000,13,197,"Marion County, GA",Apr-19,3301,3175,126,3.8
3704,CN1319900000000,13,199,"Meriwether County, GA",Apr-19,8809,8438,371,4.2
3705,CN1320100000000,13,201,"Miller County, GA",Apr-19,2756,2675,81,2.9
3706,CN1320500000000,13,205,"Mitchell County, GA",Apr-19,8298,7976,322,3.9
3707,CN1320700000000,13,207,"Monroe County, GA",Apr-19,12906,12519,387,3.0
3708,CN1320900000000,13,209,"Montgomery County, GA",Apr-19,3801,3624,177,4.7
3709,CN1321100000000,13,211,"Morgan County, GA",Apr-19,9144,8887,257,2.8
3710,CN1321300000000,13,213,"Murray County, GA",Apr-19,15432,14762,670,4.3
3711,CN1321500000000,13,215,"Muscogee County, GA",Apr-19,77313,74149,3164,4.1
3712,CN1321700000000,13,217,"Newton County, GA",Apr-19,51535,49695,1840,3.6
3713,CN1321900000000,13,219,"Oconee County, GA",Apr-19,19565,19107,458,2.3
3714,CN1322100000000,13,221,"Oglethorpe County, GA",Apr-19,6945,6742,203,2.9
3715,CN1322300000000,13,223,"Paulding County, GA",Apr-19,84833,82565,2268,2.7
3716,CN1322500000000,13,225,"Peach County, GA",Apr-19,11730,11305,425,3.6
3717,CN1322700000000,13,227,"Pickens County, GA",Apr-19,15072,14669,403,2.7
3718,CN1322900000000,13,229,"Pierce County, GA",Apr-19,8660,8382,278,3.2
3719,CN1323100000000,13,231,"Pike County, GA",Apr-19,8795,8553,242,2.8
3720,CN1323300000000,13,233,"Polk County, GA",Apr-19,18345,17766,579,3.2
3721,CN1323500000000,13,235,"Pulaski County, GA",Apr-19,4030,3884,146,3.6
3722,CN1323700000000,13,237,"Putnam County, GA",Apr-19,8151,7825,326,4.0
3723,CN1323900000000,13,239,"Quitman County, GA",Apr-19,802,762,40,5.0
3724,CN1324100000000,13,241,"Rabun County, GA",Apr-19,7099,6866,233,3.3
3725,CN1324300000000,13,243,"Randolph County, GA",Apr-19,2519,2412,107,4.2
3726,CN1324500000000,13,245,"Richmond County, GA",Apr-19,85485,82034,3451,4.0
3727,CN1324700000000,13,247,"Rockdale County, GA",Apr-19,44195,42635,1560,3.5
3728,CN1324900000000,13,249,"Schley County, GA",Apr-19,2197,2122,75,3.4
3729,CN1325100000000,13,251,"Screven County, GA",Apr-19,5059,4837,222,4.4
3730,CN1325300000000,13,253,"Seminole County, GA",Apr-19,3045,2924,121,4.0
3731,CN1325500000000,13,255,"Spalding County, GA",Apr-19,28331,27263,1068,3.8
3732,CN1325700000000,13,257,"Stephens County, GA",Apr-19,10648,10280,368,3.5
3733,CN1325900000000,13,259,"Stewart County, GA",Apr-19,2380,2290,90,3.8
3734,CN1326100000000,13,261,"Sumter County, GA",Apr-19,12653,12116,537,4.2
3735,CN1326300000000,13,263,"Talbot County, GA",Apr-19,2813,2693,120,4.3
3736,CN1326500000000,13,265,"Taliaferro County, GA",Apr-19,563,538,25,4.4
3737,CN1326700000000,13,267,"Tattnall County, GA",Apr-19,9454,9122,332,3.5
3738,CN1326900000000,13,269,"Taylor County, GA",Apr-19,2979,2874,105,3.5
3739,CN1327100000000,13,271,"Telfair County, GA",Apr-19,4290,3919,371,8.6
3740,CN1327300000000,13,273,"Terrell County, GA",Apr-19,3495,3327,168,4.8
3741,CN1327500000000,13,275,"Thomas County, GA",Apr-19,16292,15707,585,3.6
3742,CN1327700000000,13,277,"Tift County, GA",Apr-19,19530,18957,573,2.9
3743,CN1327900000000,13,279,"Toombs County, GA",Apr-19,11644,11128,516,4.4
3744,CN1328100000000,13,281,"Towns County, GA",Apr-19,3910,3745,165,4.2
3745,CN1328300000000,13,283,"Treutlen County, GA",Apr-19,2670,2558,112,4.2
3746,CN1328500000000,13,285,"Troup County, GA",Apr-19,36956,35875,1081,2.9
3747,CN1328700000000,13,287,"Turner County, GA",Apr-19,3133,3026,107,3.4
3748,CN1328900000000,13,289,"Twiggs County, GA",Apr-19,2838,2705,133,4.7
3749,CN1329100000000,13,291,"Union County, GA",Apr-19,10348,10052,296,2.9
3750,CN1329300000000,13,293,"Upson County, GA",Apr-19,11254,10891,363,3.2
3751,CN1329500000000,13,295,"Walker County, GA",Apr-19,31190,30130,1060,3.4
3752,CN1329700000000,13,297,"Walton County, GA",Apr-19,45448,44159,1289,2.8
3753,CN1329900000000,13,299,"Ware County, GA",Apr-19,15447,14940,507,3.3
3754,CN1330100000000,13,301,"Warren County, GA",Apr-19,2780,2672,108,3.9
3755,CN1330300000000,13,303,"Washington County, GA",Apr-19,7007,6739,268,3.8
3756,CN1330500000000,13,305,"Wayne County, GA",Apr-19,11487,11083,404,3.5
3757,CN1330700000000,13,307,"Webster County, GA",Apr-19,1006,960,46,4.6
3758,CN1330900000000,13,309,"Wheeler County, GA",Apr-19,1628,1528,100,6.1
3759,CN1331100000000,13,311,"White County, GA",Apr-19,16075,15678,397,2.5
3760,CN1331300000000,13,313,"Whitfield County, GA",Apr-19,43500,41730,1770,4.1
3761,CN1331500000000,13,315,"Wilcox County, GA",Apr-19,2690,2578,112,4.2
3762,CN1331700000000,13,317,"Wilkes County, GA",Apr-19,3801,3650,151,4.0
3763,CN1331900000000,13,319,"Wilkinson County, GA",Apr-19,3873,3743,130,3.4
3764,CN1332100000000,13,321,"Worth County, GA",Apr-19,8835,8542,293,3.3
3765,CN1500100000000,15,1,"Hawaii County, HI",Apr-19,91024,87954,3070,3.4
3766,CN1500300000000,15,3,"Honolulu County/city, HI",Apr-19,449581,438526,11055,2.5
3767,CN1500700000000,15,7,"Kauai County, HI",Apr-19,36262,35336,926,2.6
3768,CN1500900000000,15,9,"Maui County, HI",Apr-19,86343,84170,2173,2.5
3769,CN1600100000000,16,1,"Ada County, ID",Apr-19,251331,245266,6065,2.4
3770,CN1600300000000,16,3,"Adams County, ID",Apr-19,1668,1494,174,10.4
3771,CN1600500000000,16,5,"Bannock County, ID",Apr-19,42992,41828,1164,2.7
3772,CN1600700000000,16,7,"Bear Lake County, ID",Apr-19,2942,2849,93,3.2
3773,CN1600900000000,16,9,"Benewah County, ID",Apr-19,4139,3753,386,9.3
3774,CN1601100000000,16,11,"Bingham County, ID",Apr-19,23775,23175,600,2.5
3775,CN1601300000000,16,13,"Blaine County, ID",Apr-19,11671,11304,367,3.1
3776,CN1601500000000,16,15,"Boise County, ID",Apr-19,3499,3324,175,5.0
3777,CN1601700000000,16,17,"Bonner County, ID",Apr-19,19624,18632,992,5.1
3778,CN1601900000000,16,19,"Bonneville County, ID",Apr-19,56035,54759,1276,2.3
3779,CN1602100000000,16,21,"Boundary County, ID",Apr-19,5441,5132,309,5.7
3780,CN1602300000000,16,23,"Butte County, ID",Apr-19,1377,1343,34,2.5
3781,CN1602500000000,16,25,"Camas County, ID",Apr-19,676,656,20,3.0
3782,CN1602700000000,16,27,"Canyon County, ID",Apr-19,102989,99816,3173,3.1
3783,CN1602900000000,16,29,"Caribou County, ID",Apr-19,4112,4004,108,2.6
3784,CN1603100000000,16,31,"Cassia County, ID",Apr-19,11957,11663,294,2.5
3785,CN1603300000000,16,33,"Clark County, ID",Apr-19,368,357,11,3.0
3786,CN1603500000000,16,35,"Clearwater County, ID",Apr-19,2945,2611,334,11.3
3787,CN1603700000000,16,37,"Custer County, ID",Apr-19,2025,1920,105,5.2
3788,CN1603900000000,16,39,"Elmore County, ID",Apr-19,11340,10987,353,3.1
3789,CN1604100000000,16,41,"Franklin County, ID",Apr-19,7133,6956,177,2.5
3790,CN1604300000000,16,43,"Fremont County, ID",Apr-19,7916,7714,202,2.6
3791,CN1604500000000,16,45,"Gem County, ID",Apr-19,8210,7939,271,3.3
3792,CN1604700000000,16,47,"Gooding County, ID",Apr-19,8173,7962,211,2.6
3793,CN1604900000000,16,49,"Idaho County, ID",Apr-19,6466,6116,350,5.4
3794,CN1605100000000,16,51,"Jefferson County, ID",Apr-19,13794,13495,299,2.2
3795,CN1605300000000,16,53,"Jerome County, ID",Apr-19,12173,11863,310,2.5
3796,CN1605500000000,16,55,"Kootenai County, ID",Apr-19,79261,76392,2869,3.6
3797,CN1605700000000,16,57,"Latah County, ID",Apr-19,21144,20488,656,3.1
3798,CN1605900000000,16,59,"Lemhi County, ID",Apr-19,3421,3227,194,5.7
3799,CN1606100000000,16,61,"Lewis County, ID",Apr-19,1654,1542,112,6.8
3800,CN1606300000000,16,63,"Lincoln County, ID",Apr-19,2608,2499,109,4.2
3801,CN1606500000000,16,65,"Madison County, ID",Apr-19,21911,21521,390,1.8
3802,CN1606700000000,16,67,"Minidoka County, ID",Apr-19,11304,11020,284,2.5
3803,CN1606900000000,16,69,"Nez Perce County, ID",Apr-19,20990,20393,597,2.8
3804,CN1607100000000,16,71,"Oneida County, ID",Apr-19,2324,2258,66,2.8
3805,CN1607300000000,16,73,"Owyhee County, ID",Apr-19,5393,5214,179,3.3
3806,CN1607500000000,16,75,"Payette County, ID",Apr-19,11548,11158,390,3.4
3807,CN1607700000000,16,77,"Power County, ID",Apr-19,4131,4015,116,2.8
3808,CN1607900000000,16,79,"Shoshone County, ID",Apr-19,5133,4774,359,7.0
3809,CN1608100000000,16,81,"Teton County, ID",Apr-19,5968,5817,151,2.5
3810,CN1608300000000,16,83,"Twin Falls County, ID",Apr-19,40921,39816,1105,2.7
3811,CN1608500000000,16,85,"Valley County, ID",Apr-19,5093,4832,261,5.1
3812,CN1608700000000,16,87,"Washington County, ID",Apr-19,4541,4337,204,4.5
3813,CN1700100000000,17,1,"Adams County, IL",Apr-19,32235,31276,959,3.0
3814,CN1700300000000,17,3,"Alexander County, IL",Apr-19,2035,1932,103,5.1
3815,CN1700500000000,17,5,"Bond County, IL",Apr-19,7779,7518,261,3.4
3816,CN1700700000000,17,7,"Boone County, IL",Apr-19,26036,24917,1119,4.3
3817,CN1700900000000,17,9,"Brown County, IL",Apr-19,2967,2906,61,2.1
3818,CN1701100000000,17,11,"Bureau County, IL",Apr-19,17265,16583,682,4.0
3819,CN1701300000000,17,13,"Calhoun County, IL",Apr-19,2323,2222,101,4.3
3820,CN1701500000000,17,15,"Carroll County, IL",Apr-19,7160,6898,262,3.7
3821,CN1701700000000,17,17,"Cass County, IL",Apr-19,6115,5883,232,3.8
3822,CN1701900000000,17,19,"Champaign County, IL",Apr-19,111105,107452,3653,3.3
3823,CN1702100000000,17,21,"Christian County, IL",Apr-19,14661,14058,603,4.1
3824,CN1702300000000,17,23,"Clark County, IL",Apr-19,7652,7360,292,3.8
3825,CN1702500000000,17,25,"Clay County, IL",Apr-19,6451,6194,257,4.0
3826,CN1702700000000,17,27,"Clinton County, IL",Apr-19,20422,19888,534,2.6
3827,CN1702900000000,17,29,"Coles County, IL",Apr-19,24038,23200,838,3.5
3828,CN1703100000000,17,31,"Cook County, IL",Apr-19,2580663,2486263,94400,3.7
3829,CN1703300000000,17,33,"Crawford County, IL",Apr-19,8614,8290,324,3.8
3830,CN1703500000000,17,35,"Cumberland County, IL",Apr-19,6125,5941,184,3.0
3831,CN1703700000000,17,37,"DeKalb County, IL",Apr-19,54811,52867,1944,3.5
3832,CN1703900000000,17,39,"De Witt County, IL",Apr-19,7586,7296,290,3.8
3833,CN1704100000000,17,41,"Douglas County, IL",Apr-19,10171,9870,301,3.0
3834,CN1704300000000,17,43,"DuPage County, IL",Apr-19,505311,490945,14366,2.8
3835,CN1704500000000,17,45,"Edgar County, IL",Apr-19,9076,8759,317,3.5
3836,CN1704700000000,17,47,"Edwards County, IL",Apr-19,2739,2638,101,3.7
3837,CN1704900000000,17,49,"Effingham County, IL",Apr-19,19199,18627,572,3.0
3838,CN1705100000000,17,51,"Fayette County, IL",Apr-19,10006,9624,382,3.8
3839,CN1705300000000,17,53,"Ford County, IL",Apr-19,6556,6316,240,3.7
3840,CN1705500000000,17,55,"Franklin County, IL",Apr-19,16553,15769,784,4.7
3841,CN1705700000000,17,57,"Fulton County, IL",Apr-19,15166,14445,721,4.8
3842,CN1705900000000,17,59,"Gallatin County, IL",Apr-19,2388,2283,105,4.4
3843,CN1706100000000,17,61,"Greene County, IL",Apr-19,6015,5790,225,3.7
3844,CN1706300000000,17,63,"Grundy County, IL",Apr-19,25271,24196,1075,4.3
3845,CN1706500000000,17,65,"Hamilton County, IL",Apr-19,4450,4296,154,3.5
3846,CN1706700000000,17,67,"Hancock County, IL",Apr-19,8356,8027,329,3.9
3847,CN1706900000000,17,69,"Hardin County, IL",Apr-19,1306,1236,70,5.4
3848,CN1707100000000,17,71,"Henderson County, IL",Apr-19,3620,3472,148,4.1
3849,CN1707300000000,17,73,"Henry County, IL",Apr-19,24911,23853,1058,4.2
3850,CN1707500000000,17,75,"Iroquois County, IL",Apr-19,14280,13764,516,3.6
3851,CN1707700000000,17,77,"Jackson County, IL",Apr-19,28428,27518,910,3.2
3852,CN1707900000000,17,79,"Jasper County, IL",Apr-19,4666,4501,165,3.5
3853,CN1708100000000,17,81,"Jefferson County, IL",Apr-19,17479,16788,691,4.0
3854,CN1708300000000,17,83,"Jersey County, IL",Apr-19,10979,10552,427,3.9
3855,CN1708500000000,17,85,"Jo Daviess County, IL",Apr-19,10654,10252,402,3.8
3856,CN1708700000000,17,87,"Johnson County, IL",Apr-19,4224,4011,213,5.0
3857,CN1708900000000,17,89,"Kane County, IL",Apr-19,271707,261009,10698,3.9
3858,CN1709100000000,17,91,"Kankakee County, IL",Apr-19,55298,52876,2422,4.4
3859,CN1709300000000,17,93,"Kendall County, IL",Apr-19,68249,66061,2188,3.2
3860,CN1709500000000,17,95,"Knox County, IL",Apr-19,21819,20859,960,4.4
3861,CN1709700000000,17,97,"Lake County, IL",Apr-19,373959,360111,13848,3.7
3862,CN1709900000000,17,99,"LaSalle County, IL",Apr-19,54602,52011,2591,4.7
3863,CN1710100000000,17,101,"Lawrence County, IL",Apr-19,5893,5641,252,4.3
3864,CN1710300000000,17,103,"Lee County, IL",Apr-19,17566,16958,608,3.5
3865,CN1710500000000,17,105,"Livingston County, IL",Apr-19,16566,15962,604,3.6
3866,CN1710700000000,17,107,"Logan County, IL",Apr-19,12946,12480,466,3.6
3867,CN1710900000000,17,109,"McDonough County, IL",Apr-19,13767,13278,489,3.6
3868,CN1711100000000,17,111,"McHenry County, IL",Apr-19,164764,159394,5370,3.3
3869,CN1711300000000,17,113,"McLean County, IL",Apr-19,89846,86954,2892,3.2
3870,CN1711500000000,17,115,"Macon County, IL",Apr-19,48864,46643,2221,4.5
3871,CN1711700000000,17,117,"Macoupin County, IL",Apr-19,22963,22115,848,3.7
3872,CN1711900000000,17,119,"Madison County, IL",Apr-19,134263,129758,4505,3.4
3873,CN1712100000000,17,121,"Marion County, IL",Apr-19,17661,16989,672,3.8
3874,CN1712300000000,17,123,"Marshall County, IL",Apr-19,5313,5090,223,4.2
3875,CN1712500000000,17,125,"Mason County, IL",Apr-19,6256,5971,285,4.6
3876,CN1712700000000,17,127,"Massac County, IL",Apr-19,5535,5283,252,4.6
3877,CN1712900000000,17,129,"Menard County, IL",Apr-19,6503,6286,217,3.3
3878,CN1713100000000,17,131,"Mercer County, IL",Apr-19,8056,7702,354,4.4
3879,CN1713300000000,17,133,"Monroe County, IL",Apr-19,18808,18315,493,2.6
3880,CN1713500000000,17,135,"Montgomery County, IL",Apr-19,11791,11274,517,4.4
3881,CN1713700000000,17,137,"Morgan County, IL",Apr-19,16600,16034,566,3.4
3882,CN1713900000000,17,139,"Moultrie County, IL",Apr-19,7560,7345,215,2.8
3883,CN1714100000000,17,141,"Ogle County, IL",Apr-19,25184,24139,1045,4.1
3884,CN1714300000000,17,143,"Peoria County, IL",Apr-19,84762,80995,3767,4.4
3885,CN1714500000000,17,145,"Perry County, IL",Apr-19,8451,8074,377,4.5
3886,CN1714700000000,17,147,"Piatt County, IL",Apr-19,8767,8486,281,3.2
3887,CN1714900000000,17,149,"Pike County, IL",Apr-19,7039,6771,268,3.8
3888,CN1715100000000,17,151,"Pope County, IL",Apr-19,1703,1622,81,4.8
3889,CN1715300000000,17,153,"Pulaski County, IL",Apr-19,1936,1821,115,5.9
3890,CN1715500000000,17,155,"Putnam County, IL",Apr-19,3052,2916,136,4.5
3891,CN1715700000000,17,157,"Randolph County, IL",Apr-19,14342,13909,433,3.0
3892,CN1715900000000,17,159,"Richland County, IL",Apr-19,7263,6998,265,3.6
3893,CN1716100000000,17,161,"Rock Island County, IL",Apr-19,71032,68006,3026,4.3
3894,CN1716300000000,17,163,"St. Clair County, IL",Apr-19,126589,121747,4842,3.8
3895,CN1716500000000,17,165,"Saline County, IL",Apr-19,9767,9320,447,4.6
3896,CN1716700000000,17,167,"Sangamon County, IL",Apr-19,101104,97522,3582,3.5
3897,CN1716900000000,17,169,"Schuyler County, IL",Apr-19,3316,3207,109,3.3
3898,CN1717100000000,17,171,"Scott County, IL",Apr-19,2496,2401,95,3.8
3899,CN1717300000000,17,173,"Shelby County, IL",Apr-19,10646,10290,356,3.3
3900,CN1717500000000,17,175,"Stark County, IL",Apr-19,2550,2396,154,6.0
3901,CN1717700000000,17,177,"Stephenson County, IL",Apr-19,21672,20865,807,3.7
3902,CN1717900000000,17,179,"Tazewell County, IL",Apr-19,63631,61250,2381,3.7
3903,CN1718100000000,17,181,"Union County, IL",Apr-19,7490,7128,362,4.8
3904,CN1718300000000,17,183,"Vermilion County, IL",Apr-19,33138,31698,1440,4.3
3905,CN1718500000000,17,185,"Wabash County, IL",Apr-19,5742,5537,205,3.6
3906,CN1718700000000,17,187,"Warren County, IL",Apr-19,8544,8241,303,3.5
3907,CN1718900000000,17,189,"Washington County, IL",Apr-19,10211,9988,223,2.2
3908,CN1719100000000,17,191,"Wayne County, IL",Apr-19,6999,6687,312,4.5
3909,CN1719300000000,17,193,"White County, IL",Apr-19,6717,6486,231,3.4
3910,CN1719500000000,17,195,"Whiteside County, IL",Apr-19,28702,27704,998,3.5
3911,CN1719700000000,17,197,"Will County, IL",Apr-19,355276,342107,13169,3.7
3912,CN1719900000000,17,199,"Williamson County, IL",Apr-19,32541,31358,1183,3.6
3913,CN1720100000000,17,201,"Winnebago County, IL",Apr-19,138790,132511,6279,4.5
3914,CN1720300000000,17,203,"Woodford County, IL",Apr-19,18734,18128,606,3.2
3915,CN1800100000000,18,1,"Adams County, IN",Apr-19,16988,16621,367,2.2
3916,CN1800300000000,18,3,"Allen County, IN",Apr-19,185773,181147,4626,2.5
3917,CN1800500000000,18,5,"Bartholomew County, IN",Apr-19,44676,43767,909,2.0
3918,CN1800700000000,18,7,"Benton County, IN",Apr-19,4489,4371,118,2.6
3919,CN1800900000000,18,9,"Blackford County, IN",Apr-19,5018,4844,174,3.5
3920,CN1801100000000,18,11,"Boone County, IN",Apr-19,36116,35366,750,2.1
3921,CN1801300000000,18,13,"Brown County, IN",Apr-19,7674,7479,195,2.5
3922,CN1801500000000,18,15,"Carroll County, IN",Apr-19,10201,9916,285,2.8
3923,CN1801700000000,18,17,"Cass County, IN",Apr-19,18201,17491,710,3.9
3924,CN1801900000000,18,19,"Clark County, IN",Apr-19,61549,59759,1790,2.9
3925,CN1802100000000,18,21,"Clay County, IN",Apr-19,12117,11756,361,3.0
3926,CN1802300000000,18,23,"Clinton County, IN",Apr-19,17018,16626,392,2.3
3927,CN1802500000000,18,25,"Crawford County, IN",Apr-19,4790,4624,166,3.5
3928,CN1802700000000,18,27,"Daviess County, IN",Apr-19,16390,16049,341,2.1
3929,CN1802900000000,18,29,"Dearborn County, IN",Apr-19,25726,24980,746,2.9
3930,CN1803100000000,18,31,"Decatur County, IN",Apr-19,15180,14808,372,2.5
3931,CN1803300000000,18,33,"DeKalb County, IN",Apr-19,22590,22093,497,2.2
3932,CN1803500000000,18,35,"Delaware County, IN",Apr-19,54445,52716,1729,3.2
3933,CN1803700000000,18,37,"Dubois County, IN",Apr-19,22805,22351,454,2.0
3934,CN1803900000000,18,39,"Elkhart County, IN",Apr-19,113517,110720,2797,2.5
3935,CN1804100000000,18,41,"Fayette County, IN",Apr-19,8802,8464,338,3.8
3936,CN1804300000000,18,43,"Floyd County, IN",Apr-19,41517,40403,1114,2.7
3937,CN1804500000000,18,45,"Fountain County, IN",Apr-19,7922,7682,240,3.0
3938,CN1804700000000,18,47,"Franklin County, IN",Apr-19,11219,10899,320,2.9
3939,CN1804900000000,18,49,"Fulton County, IN",Apr-19,9629,9385,244,2.5
3940,CN1805100000000,18,51,"Gibson County, IN",Apr-19,19318,18919,399,2.1
3941,CN1805300000000,18,53,"Grant County, IN",Apr-19,32481,31387,1094,3.4
3942,CN1805500000000,18,55,"Greene County, IN",Apr-19,13625,13159,466,3.4
3943,CN1805700000000,18,57,"Hamilton County, IN",Apr-19,183713,179742,3971,2.2
3944,CN1805900000000,18,59,"Hancock County, IN",Apr-19,40149,39176,973,2.4
3945,CN1806100000000,18,61,"Harrison County, IN",Apr-19,20253,19669,584,2.9
3946,CN1806300000000,18,63,"Hendricks County, IN",Apr-19,89920,87884,2036,2.3
3947,CN1806500000000,18,65,"Henry County, IN",Apr-19,21941,21301,640,2.9
3948,CN1806700000000,18,67,"Howard County, IN",Apr-19,37534,35049,2485,6.6
3949,CN1806900000000,18,69,"Huntington County, IN",Apr-19,18294,17790,504,2.8
3950,CN1807100000000,18,71,"Jackson County, IN",Apr-19,22659,22146,513,2.3
3951,CN1807300000000,18,73,"Jasper County, IN",Apr-19,16218,15711,507,3.1
3952,CN1807500000000,18,75,"Jay County, IN",Apr-19,9314,9068,246,2.6
3953,CN1807700000000,18,77,"Jefferson County, IN",Apr-19,14969,14559,410,2.7
3954,CN1807900000000,18,79,"Jennings County, IN",Apr-19,13424,13060,364,2.7
3955,CN1808100000000,18,81,"Johnson County, IN",Apr-19,82760,80928,1832,2.2
3956,CN1808300000000,18,83,"Knox County, IN",Apr-19,18228,17769,459,2.5
3957,CN1808500000000,18,85,"Kosciusko County, IN",Apr-19,42154,41230,924,2.2
3958,CN1808700000000,18,87,"LaGrange County, IN",Apr-19,19750,19292,458,2.3
3959,CN1808900000000,18,89,"Lake County, IN",Apr-19,232365,221866,10499,4.5
3960,CN1809100000000,18,91,"LaPorte County, IN",Apr-19,47814,46026,1788,3.7
3961,CN1809300000000,18,93,"Lawrence County, IN",Apr-19,21242,20606,636,3.0
3962,CN1809500000000,18,95,"Madison County, IN",Apr-19,58948,57063,1885,3.2
3963,CN1809700000000,18,97,"Marion County, IN",Apr-19,490350,476589,13761,2.8
3964,CN1809900000000,18,99,"Marshall County, IN",Apr-19,22949,22357,592,2.6
3965,CN1810100000000,18,101,"Martin County, IN",Apr-19,5209,5089,120,2.3
3966,CN1810300000000,18,103,"Miami County, IN",Apr-19,15735,14972,763,4.8
3967,CN1810500000000,18,105,"Monroe County, IN",Apr-19,71411,69562,1849,2.6
3968,CN1810700000000,18,107,"Montgomery County, IN",Apr-19,18634,18166,468,2.5
3969,CN1810900000000,18,109,"Morgan County, IN",Apr-19,36228,35273,955,2.6
3970,CN1811100000000,18,111,"Newton County, IN",Apr-19,6911,6673,238,3.4
3971,CN1811300000000,18,113,"Noble County, IN",Apr-19,23525,22938,587,2.5
3972,CN1811500000000,18,115,"Ohio County, IN",Apr-19,3188,3093,95,3.0
3973,CN1811700000000,18,117,"Orange County, IN",Apr-19,8373,8132,241,2.9
3974,CN1811900000000,18,119,"Owen County, IN",Apr-19,9497,9182,315,3.3
3975,CN1812100000000,18,121,"Parke County, IN",Apr-19,6975,6740,235,3.4
3976,CN1812300000000,18,123,"Perry County, IN",Apr-19,9192,8951,241,2.6
3977,CN1812500000000,18,125,"Pike County, IN",Apr-19,6029,5873,156,2.6
3978,CN1812700000000,18,127,"Porter County, IN",Apr-19,87364,84552,2812,3.2
3979,CN1812900000000,18,129,"Posey County, IN",Apr-19,13501,13204,297,2.2
3980,CN1813100000000,18,131,"Pulaski County, IN",Apr-19,6454,6275,179,2.8
3981,CN1813300000000,18,133,"Putnam County, IN",Apr-19,16680,16186,494,3.0
3982,CN1813500000000,18,135,"Randolph County, IN",Apr-19,11181,10835,346,3.1
3983,CN1813700000000,18,137,"Ripley County, IN",Apr-19,14234,13857,377,2.6
3984,CN1813900000000,18,139,"Rush County, IN",Apr-19,8838,8630,208,2.4
3985,CN1814100000000,18,141,"St. Joseph County, IN",Apr-19,136630,132583,4047,3.0
3986,CN1814300000000,18,143,"Scott County, IN",Apr-19,10521,10199,322,3.1
3987,CN1814500000000,18,145,"Shelby County, IN",Apr-19,23065,22502,563,2.4
3988,CN1814700000000,18,147,"Spencer County, IN",Apr-19,10794,10532,262,2.4
3989,CN1814900000000,18,149,"Starke County, IN",Apr-19,9894,9536,358,3.6
3990,CN1815100000000,18,151,"Steuben County, IN",Apr-19,20499,20051,448,2.2
3991,CN1815300000000,18,153,"Sullivan County, IN",Apr-19,8420,8090,330,3.9
3992,CN1815500000000,18,155,"Switzerland County, IN",Apr-19,4958,4820,138,2.8
3993,CN1815700000000,18,157,"Tippecanoe County, IN",Apr-19,99690,97395,2295,2.3
3994,CN1815900000000,18,159,"Tipton County, IN",Apr-19,9404,9030,374,4.0
3995,CN1816100000000,18,161,"Union County, IN",Apr-19,3529,3431,98,2.8
3996,CN1816300000000,18,163,"Vanderburgh County, IN",Apr-19,94396,92006,2390,2.5
3997,CN1816500000000,18,165,"Vermillion County, IN",Apr-19,7019,6683,336,4.8
3998,CN1816700000000,18,167,"Vigo County, IN",Apr-19,48654,46874,1780,3.7
3999,CN1816900000000,18,169,"Wabash County, IN",Apr-19,15048,14651,397,2.6
4000,CN1817100000000,18,171,"Warren County, IN",Apr-19,4169,4066,103,2.5
4001,CN1817300000000,18,173,"Warrick County, IN",Apr-19,32970,32197,773,2.3
4002,CN1817500000000,18,175,"Washington County, IN",Apr-19,13494,13122,372,2.8
4003,CN1817700000000,18,177,"Wayne County, IN",Apr-19,30902,29965,937,3.0
4004,CN1817900000000,18,179,"Wells County, IN",Apr-19,14338,14023,315,2.2
4005,CN1818100000000,18,181,"White County, IN",Apr-19,13431,13126,305,2.3
4006,CN1818300000000,18,183,"Whitley County, IN",Apr-19,17752,17319,433,2.4
4007,CN1900100000000,19,1,"Adair County, IA",Apr-19,4153,4057,96,2.3
4008,CN1900300000000,19,3,"Adams County, IA",Apr-19,2170,2136,34,1.6
4009,CN1900500000000,19,5,"Allamakee County, IA",Apr-19,7322,7050,272,3.7
4010,CN1900700000000,19,7,"Appanoose County, IA",Apr-19,6010,5841,169,2.8
4011,CN1900900000000,19,9,"Audubon County, IA",Apr-19,3098,3030,68,2.2
4012,CN1901100000000,19,11,"Benton County, IA",Apr-19,13585,13236,349,2.6
4013,CN1901300000000,19,13,"Black Hawk County, IA",Apr-19,70515,68531,1984,2.8
4014,CN1901500000000,19,15,"Boone County, IA",Apr-19,15154,14836,318,2.1
4015,CN1901700000000,19,17,"Bremer County, IA",Apr-19,14050,13764,286,2.0
4016,CN1901900000000,19,19,"Buchanan County, IA",Apr-19,11347,11064,283,2.5
4017,CN1902100000000,19,21,"Buena Vista County, IA",Apr-19,11672,11449,223,1.9
4018,CN1902300000000,19,23,"Butler County, IA",Apr-19,7870,7620,250,3.2
4019,CN1902500000000,19,25,"Calhoun County, IA",Apr-19,4231,4126,105,2.5
4020,CN1902700000000,19,27,"Carroll County, IA",Apr-19,10824,10641,183,1.7
4021,CN1902900000000,19,29,"Cass County, IA",Apr-19,6953,6756,197,2.8
4022,CN1903100000000,19,31,"Cedar County, IA",Apr-19,10962,10744,218,2.0
4023,CN1903300000000,19,33,"Cerro Gordo County, IA",Apr-19,23688,23080,608,2.6
4024,CN1903500000000,19,35,"Cherokee County, IA",Apr-19,6059,5935,124,2.0
4025,CN1903700000000,19,37,"Chickasaw County, IA",Apr-19,6513,6345,168,2.6
4026,CN1903900000000,19,39,"Clarke County, IA",Apr-19,4868,4727,141,2.9
4027,CN1904100000000,19,41,"Clay County, IA",Apr-19,8452,8220,232,2.7
4028,CN1904300000000,19,43,"Clayton County, IA",Apr-19,10141,9791,350,3.5
4029,CN1904500000000,19,45,"Clinton County, IA",Apr-19,22912,22194,718,3.1
4030,CN1904700000000,19,47,"Crawford County, IA",Apr-19,8083,7814,269,3.3
4031,CN1904900000000,19,49,"Dallas County, IA",Apr-19,49972,49088,884,1.8
4032,CN1905100000000,19,51,"Davis County, IA",Apr-19,4186,4105,81,1.9
4033,CN1905300000000,19,53,"Decatur County, IA",Apr-19,4452,4368,84,1.9
4034,CN1905500000000,19,55,"Delaware County, IA",Apr-19,10505,10286,219,2.1
4035,CN1905700000000,19,57,"Des Moines County, IA",Apr-19,19597,18922,675,3.4
4036,CN1905900000000,19,59,"Dickinson County, IA",Apr-19,9526,9242,284,3.0
4037,CN1906100000000,19,61,"Dubuque County, IA",Apr-19,56738,55415,1323,2.3
4038,CN1906300000000,19,63,"Emmet County, IA",Apr-19,5153,5026,127,2.5
4039,CN1906500000000,19,65,"Fayette County, IA",Apr-19,10813,10444,369,3.4
4040,CN1906700000000,19,67,"Floyd County, IA",Apr-19,8907,8664,243,2.7
4041,CN1906900000000,19,69,"Franklin County, IA",Apr-19,5682,5543,139,2.4
4042,CN1907100000000,19,71,"Fremont County, IA",Apr-19,3633,3494,139,3.8
4043,CN1907300000000,19,73,"Greene County, IA",Apr-19,5364,5227,137,2.6
4044,CN1907500000000,19,75,"Grundy County, IA",Apr-19,6518,6360,158,2.4
4045,CN1907700000000,19,77,"Guthrie County, IA",Apr-19,5570,5403,167,3.0
4046,CN1907900000000,19,79,"Hamilton County, IA",Apr-19,6932,6751,181,2.6
4047,CN1908100000000,19,81,"Hancock County, IA",Apr-19,5850,5717,133,2.3
4048,CN1908300000000,19,83,"Hardin County, IA",Apr-19,8034,7792,242,3.0
4049,CN1908500000000,19,85,"Harrison County, IA",Apr-19,7319,7147,172,2.4
4050,CN1908700000000,19,87,"Henry County, IA",Apr-19,9981,9771,210,2.1
4051,CN1908900000000,19,89,"Howard County, IA",Apr-19,5118,4960,158,3.1
4052,CN1909100000000,19,91,"Humboldt County, IA",Apr-19,5065,4931,134,2.6
4053,CN1909300000000,19,93,"Ida County, IA",Apr-19,4068,3993,75,1.8
4054,CN1909500000000,19,95,"Iowa County, IA",Apr-19,10462,10246,216,2.1
4055,CN1909700000000,19,97,"Jackson County, IA",Apr-19,11049,10710,339,3.1
4056,CN1909900000000,19,99,"Jasper County, IA",Apr-19,19881,19336,545,2.7
4057,CN1910100000000,19,101,"Jefferson County, IA",Apr-19,10245,10038,207,2.0
4058,CN1910300000000,19,103,"Johnson County, IA",Apr-19,87903,86372,1531,1.7
4059,CN1910500000000,19,105,"Jones County, IA",Apr-19,10732,10400,332,3.1
4060,CN1910700000000,19,107,"Keokuk County, IA",Apr-19,5231,5083,148,2.8
4061,CN1910900000000,19,109,"Kossuth County, IA",Apr-19,8309,8128,181,2.2
4062,CN1911100000000,19,111,"Lee County, IA",Apr-19,16141,15557,584,3.6
4063,CN1911300000000,19,113,"Linn County, IA",Apr-19,123945,120825,3120,2.5
4064,CN1911500000000,19,115,"Louisa County, IA",Apr-19,6007,5863,144,2.4
4065,CN1911700000000,19,117,"Lucas County, IA",Apr-19,4655,4578,77,1.7
4066,CN1911900000000,19,119,"Lyon County, IA",Apr-19,6942,6828,114,1.6
4067,CN1912100000000,19,121,"Madison County, IA",Apr-19,8633,8313,320,3.7
4068,CN1912300000000,19,123,"Mahaska County, IA",Apr-19,11897,11640,257,2.2
4069,CN1912500000000,19,125,"Marion County, IA",Apr-19,18499,18137,362,2.0
4070,CN1912700000000,19,127,"Marshall County, IA",Apr-19,18058,17301,757,4.2
4071,CN1912900000000,19,129,"Mills County, IA",Apr-19,7386,7217,169,2.3
4072,CN1913100000000,19,131,"Mitchell County, IA",Apr-19,6505,6382,123,1.9
4073,CN1913300000000,19,133,"Monona County, IA",Apr-19,4430,4314,116,2.6
4074,CN1913500000000,19,135,"Monroe County, IA",Apr-19,3957,3858,99,2.5
4075,CN1913700000000,19,137,"Montgomery County, IA",Apr-19,5019,4902,117,2.3
4076,CN1913900000000,19,139,"Muscatine County, IA",Apr-19,21981,21381,600,2.7
4077,CN1914100000000,19,141,"O'Brien County, IA",Apr-19,8211,8050,161,2.0
4078,CN1914300000000,19,143,"Osceola County, IA",Apr-19,3497,3436,61,1.7
4079,CN1914500000000,19,145,"Page County, IA",Apr-19,6395,6249,146,2.3
4080,CN1914700000000,19,147,"Palo Alto County, IA",Apr-19,4759,4634,125,2.6
4081,CN1914900000000,19,149,"Plymouth County, IA",Apr-19,14685,14433,252,1.7
4082,CN1915100000000,19,151,"Pocahontas County, IA",Apr-19,4123,4040,83,2.0
4083,CN1915300000000,19,153,"Polk County, IA",Apr-19,272248,265026,7222,2.7
4084,CN1915500000000,19,155,"Pottawattamie County, IA",Apr-19,48697,47647,1050,2.2
4085,CN1915700000000,19,157,"Poweshiek County, IA",Apr-19,10656,10401,255,2.4
4086,CN1915900000000,19,159,"Ringgold County, IA",Apr-19,2409,2339,70,2.9
4087,CN1916100000000,19,161,"Sac County, IA",Apr-19,5208,5090,118,2.3
4088,CN1916300000000,19,163,"Scott County, IA",Apr-19,89756,87183,2573,2.9
4089,CN1916500000000,19,165,"Shelby County, IA",Apr-19,6631,6494,137,2.1
4090,CN1916700000000,19,167,"Sioux County, IA",Apr-19,20981,20593,388,1.8
4091,CN1916900000000,19,169,"Story County, IA",Apr-19,60566,59662,904,1.5
4092,CN1917100000000,19,171,"Tama County, IA",Apr-19,9462,9213,249,2.6
4093,CN1917300000000,19,173,"Taylor County, IA",Apr-19,3177,3126,51,1.6
4094,CN1917500000000,19,175,"Union County, IA",Apr-19,6291,6109,182,2.9
4095,CN1917700000000,19,177,"Van Buren County, IA",Apr-19,3665,3580,85,2.3
4096,CN1917900000000,19,179,"Wapello County, IA",Apr-19,17885,17330,555,3.1
4097,CN1918100000000,19,181,"Warren County, IA",Apr-19,28581,27927,654,2.3
4098,CN1918300000000,19,183,"Washington County, IA",Apr-19,12075,11809,266,2.2
4099,CN1918500000000,19,185,"Wayne County, IA",Apr-19,2794,2734,60,2.1
4100,CN1918700000000,19,187,"Webster County, IA",Apr-19,19358,18782,576,3.0
4101,CN1918900000000,19,189,"Winnebago County, IA",Apr-19,5028,4890,138,2.7
4102,CN1919100000000,19,191,"Winneshiek County, IA",Apr-19,12310,11964,346,2.8
4103,CN1919300000000,19,193,"Woodbury County, IA",Apr-19,56004,54659,1345,2.4
4104,CN1919500000000,19,195,"Worth County, IA",Apr-19,4112,4002,110,2.7
4105,CN1919700000000,19,197,"Wright County, IA",Apr-19,7042,6873,169,2.4
4106,CN2000100000000,20,1,"Allen County, KS",Apr-19,6511,6324,187,2.9
4107,CN2000300000000,20,3,"Anderson County, KS",Apr-19,4083,3964,119,2.9
4108,CN2000500000000,20,5,"Atchison County, KS",Apr-19,6738,6459,279,4.1
4109,CN2000700000000,20,7,"Barber County, KS",Apr-19,2169,2123,46,2.1
4110,CN2000900000000,20,9,"Barton County, KS",Apr-19,13438,13086,352,2.6
4111,CN2001100000000,20,11,"Bourbon County, KS",Apr-19,6836,6567,269,3.9
4112,CN2001300000000,20,13,"Brown County, KS",Apr-19,5180,5026,154,3.0
4113,CN2001500000000,20,15,"Butler County, KS",Apr-19,32289,31370,919,2.8
4114,CN2001700000000,20,17,"Chase County, KS",Apr-19,1472,1432,40,2.7
4115,CN2001900000000,20,19,"Chautauqua County, KS",Apr-19,1384,1332,52,3.8
4116,CN2002100000000,20,21,"Cherokee County, KS",Apr-19,9997,9710,287,2.9
4117,CN2002300000000,20,23,"Cheyenne County, KS",Apr-19,1183,1153,30,2.5
4118,CN2002500000000,20,25,"Clark County, KS",Apr-19,987,966,21,2.1
4119,CN2002700000000,20,27,"Clay County, KS",Apr-19,3580,3480,100,2.8
4120,CN2002900000000,20,29,"Cloud County, KS",Apr-19,3672,3568,104,2.8
4121,CN2003100000000,20,31,"Coffey County, KS",Apr-19,3912,3757,155,4.0
4122,CN2003300000000,20,33,"Comanche County, KS",Apr-19,824,806,18,2.2
4123,CN2003500000000,20,35,"Cowley County, KS",Apr-19,16252,15771,481,3.0
4124,CN2003700000000,20,37,"Crawford County, KS",Apr-19,18666,18062,604,3.2
4125,CN2003900000000,20,39,"Decatur County, KS",Apr-19,1116,1085,31,2.8
4126,CN2004100000000,20,41,"Dickinson County, KS",Apr-19,8747,8475,272,3.1
4127,CN2004300000000,20,43,"Doniphan County, KS",Apr-19,4052,3922,130,3.2
4128,CN2004500000000,20,45,"Douglas County, KS",Apr-19,66701,65027,1674,2.5
4129,CN2004700000000,20,47,"Edwards County, KS",Apr-19,1376,1343,33,2.4
4130,CN2004900000000,20,49,"Elk County, KS",Apr-19,1110,1073,37,3.3
4131,CN2005100000000,20,51,"Ellis County, KS",Apr-19,16831,16485,346,2.1
4132,CN2005300000000,20,53,"Ellsworth County, KS",Apr-19,2731,2658,73,2.7
4133,CN2005500000000,20,55,"Finney County, KS",Apr-19,20199,19757,442,2.2
4134,CN2005700000000,20,57,"Ford County, KS",Apr-19,16731,16349,382,2.3
4135,CN2005900000000,20,59,"Franklin County, KS",Apr-19,13835,13435,400,2.9
4136,CN2006100000000,20,61,"Geary County, KS",Apr-19,11378,10948,430,3.8
4137,CN2006300000000,20,63,"Gove County, KS",Apr-19,1360,1330,30,2.2
4138,CN2006500000000,20,65,"Graham County, KS",Apr-19,1028,997,31,3.0
4139,CN2006700000000,20,67,"Grant County, KS",Apr-19,3004,2925,79,2.6
4140,CN2006900000000,20,69,"Gray County, KS",Apr-19,2960,2905,55,1.9
4141,CN2007100000000,20,71,"Greeley County, KS",Apr-19,733,718,15,2.0
4142,CN2007300000000,20,73,"Greenwood County, KS",Apr-19,3185,3100,85,2.7
4143,CN2007500000000,20,75,"Hamilton County, KS",Apr-19,1409,1384,25,1.8
4144,CN2007700000000,20,77,"Harper County, KS",Apr-19,2945,2882,63,2.1
4145,CN2007900000000,20,79,"Harvey County, KS",Apr-19,16836,16411,425,2.5
4146,CN2008100000000,20,81,"Haskell County, KS",Apr-19,2033,1985,48,2.4
4147,CN2008300000000,20,83,"Hodgeman County, KS",Apr-19,875,856,19,2.2
4148,CN2008500000000,20,85,"Jackson County, KS",Apr-19,7077,6899,178,2.5
4149,CN2008700000000,20,87,"Jefferson County, KS",Apr-19,9948,9681,267,2.7
4150,CN2008900000000,20,89,"Jewell County, KS",Apr-19,1236,1202,34,2.8
4151,CN2009100000000,20,91,"Johnson County, KS",Apr-19,336234,327900,8334,2.5
4152,CN2009300000000,20,93,"Kearny County, KS",Apr-19,1917,1874,43,2.2
4153,CN2009500000000,20,95,"Kingman County, KS",Apr-19,3298,3195,103,3.1
4154,CN2009700000000,20,97,"Kiowa County, KS",Apr-19,1236,1209,27,2.2
4155,CN2009900000000,20,99,"Labette County, KS",Apr-19,9943,9533,410,4.1
4156,CN2010100000000,20,101,"Lane County, KS",Apr-19,703,687,16,2.3
4157,CN2010300000000,20,103,"Leavenworth County, KS",Apr-19,36051,34991,1060,2.9
4158,CN2010500000000,20,105,"Lincoln County, KS",Apr-19,1578,1544,34,2.2
4159,CN2010700000000,20,107,"Linn County, KS",Apr-19,4301,4091,210,4.9
4160,CN2010900000000,20,109,"Logan County, KS",Apr-19,1539,1508,31,2.0
4161,CN2011100000000,20,111,"Lyon County, KS",Apr-19,16617,16136,481,2.9
4162,CN2011300000000,20,113,"McPherson County, KS",Apr-19,17448,17127,321,1.8
4163,CN2011500000000,20,115,"Marion County, KS",Apr-19,5791,5628,163,2.8
4164,CN2011700000000,20,117,"Marshall County, KS",Apr-19,5292,5129,163,3.1
4165,CN2011900000000,20,119,"Meade County, KS",Apr-19,2002,1956,46,2.3
4166,CN2012100000000,20,121,"Miami County, KS",Apr-19,17264,16782,482,2.8
4167,CN2012300000000,20,123,"Mitchell County, KS",Apr-19,3281,3211,70,2.1
4168,CN2012500000000,20,125,"Montgomery County, KS",Apr-19,14700,14203,497,3.4
4169,CN2012700000000,20,127,"Morris County, KS",Apr-19,2862,2795,67,2.3
4170,CN2012900000000,20,129,"Morton County, KS",Apr-19,1076,1046,30,2.8
4171,CN2013100000000,20,131,"Nemaha County, KS",Apr-19,5114,4995,119,2.3
4172,CN2013300000000,20,133,"Neosho County, KS",Apr-19,5959,5720,239,4.0
4173,CN2013500000000,20,135,"Ness County, KS",Apr-19,1254,1223,31,2.5
4174,CN2013700000000,20,137,"Norton County, KS",Apr-19,2549,2495,54,2.1
4175,CN2013900000000,20,139,"Osage County, KS",Apr-19,7830,7597,233,3.0
4176,CN2014100000000,20,141,"Osborne County, KS",Apr-19,1928,1891,37,1.9
4177,CN2014300000000,20,143,"Ottawa County, KS",Apr-19,2908,2835,73,2.5
4178,CN2014500000000,20,145,"Pawnee County, KS",Apr-19,2630,2555,75,2.9
4179,CN2014700000000,20,147,"Phillips County, KS",Apr-19,2523,2463,60,2.4
4180,CN2014900000000,20,149,"Pottawatomie County, KS",Apr-19,12683,12382,301,2.4
4181,CN2015100000000,20,151,"Pratt County, KS",Apr-19,4774,4661,113,2.4
4182,CN2015300000000,20,153,"Rawlins County, KS",Apr-19,1328,1295,33,2.5
4183,CN2015500000000,20,155,"Reno County, KS",Apr-19,29572,28741,831,2.8
4184,CN2015700000000,20,157,"Republic County, KS",Apr-19,2114,2057,57,2.7
4185,CN2015900000000,20,159,"Rice County, KS",Apr-19,5136,5000,136,2.6
4186,CN2016100000000,20,161,"Riley County, KS",Apr-19,36152,35285,867,2.4
4187,CN2016300000000,20,163,"Rooks County, KS",Apr-19,2391,2313,78,3.3
4188,CN2016500000000,20,165,"Rush County, KS",Apr-19,1588,1539,49,3.1
4189,CN2016700000000,20,167,"Russell County, KS",Apr-19,3168,3084,84,2.7
4190,CN2016900000000,20,169,"Saline County, KS",Apr-19,30099,29311,788,2.6
4191,CN2017100000000,20,171,"Scott County, KS",Apr-19,2582,2537,45,1.7
4192,CN2017300000000,20,173,"Sedgwick County, KS",Apr-19,250744,243092,7652,3.1
4193,CN2017500000000,20,175,"Seward County, KS",Apr-19,9322,9071,251,2.7
4194,CN2017700000000,20,177,"Shawnee County, KS",Apr-19,90026,87438,2588,2.9
4195,CN2017900000000,20,179,"Sheridan County, KS",Apr-19,1265,1237,28,2.2
4196,CN2018100000000,20,181,"Sherman County, KS",Apr-19,2696,2627,69,2.6
4197,CN2018300000000,20,183,"Smith County, KS",Apr-19,1831,1788,43,2.3
4198,CN2018500000000,20,185,"Stafford County, KS",Apr-19,1827,1781,46,2.5
4199,CN2018700000000,20,187,"Stanton County, KS",Apr-19,869,848,21,2.4
4200,CN2018900000000,20,189,"Stevens County, KS",Apr-19,2325,2264,61,2.6
4201,CN2019100000000,20,191,"Sumner County, KS",Apr-19,10712,10390,322,3.0
4202,CN2019300000000,20,193,"Thomas County, KS",Apr-19,4111,4026,85,2.1
4203,CN2019500000000,20,195,"Trego County, KS",Apr-19,1345,1302,43,3.2
4204,CN2019700000000,20,197,"Wabaunsee County, KS",Apr-19,3505,3411,94,2.7
4205,CN2019900000000,20,199,"Wallace County, KS",Apr-19,718,696,22,3.1
4206,CN2020100000000,20,201,"Washington County, KS",Apr-19,2699,2627,72,2.7
4207,CN2020300000000,20,203,"Wichita County, KS",Apr-19,1339,1317,22,1.6
4208,CN2020500000000,20,205,"Wilson County, KS",Apr-19,3822,3692,130,3.4
4209,CN2020700000000,20,207,"Woodson County, KS",Apr-19,1644,1586,58,3.5
4210,CN2020900000000,20,209,"Wyandotte County, KS",Apr-19,76406,73508,2898,3.8
4211,CN2100100000000,21,1,"Adair County, KY",Apr-19,7162,6809,353,4.9
4212,CN2100300000000,21,3,"Allen County, KY",Apr-19,8965,8628,337,3.8
4213,CN2100500000000,21,5,"Anderson County, KY",Apr-19,11794,11413,381,3.2
4214,CN2100700000000,21,7,"Ballard County, KY",Apr-19,3485,3304,181,5.2
4215,CN2100900000000,21,9,"Barren County, KY",Apr-19,18746,17992,754,4.0
4216,CN2101100000000,21,11,"Bath County, KY",Apr-19,4570,4316,254,5.6
4217,CN2101300000000,21,13,"Bell County, KY",Apr-19,8403,7987,416,5.0
4218,CN2101500000000,21,15,"Boone County, KY",Apr-19,71105,68926,2179,3.1
4219,CN2101700000000,21,17,"Bourbon County, KY",Apr-19,9556,9225,331,3.5
4220,CN2101900000000,21,19,"Boyd County, KY",Apr-19,17888,16956,932,5.2
4221,CN2102100000000,21,21,"Boyle County, KY",Apr-19,12669,12145,524,4.1
4222,CN2102300000000,21,23,"Bracken County, KY",Apr-19,3817,3648,169,4.4
4223,CN2102500000000,21,25,"Breathitt County, KY",Apr-19,3537,3312,225,6.4
4224,CN2102700000000,21,27,"Breckinridge County, KY",Apr-19,7901,7513,388,4.9
4225,CN2102900000000,21,29,"Bullitt County, KY",Apr-19,42839,41166,1673,3.9
4226,CN2103100000000,21,31,"Butler County, KY",Apr-19,5143,4927,216,4.2
4227,CN2103300000000,21,33,"Caldwell County, KY",Apr-19,5410,5168,242,4.5
4228,CN2103500000000,21,35,"Calloway County, KY",Apr-19,18895,18226,669,3.5
4229,CN2103700000000,21,37,"Campbell County, KY",Apr-19,50924,49352,1572,3.1
4230,CN2103900000000,21,39,"Carlisle County, KY",Apr-19,2207,2126,81,3.7
4231,CN2104100000000,21,41,"Carroll County, KY",Apr-19,5300,5111,189,3.6
4232,CN2104300000000,21,43,"Carter County, KY",Apr-19,9553,8874,679,7.1
4233,CN2104500000000,21,45,"Casey County, KY",Apr-19,6605,6357,248,3.8
4234,CN2104700000000,21,47,"Christian County, KY",Apr-19,24801,23587,1214,4.9
4235,CN2104900000000,21,49,"Clark County, KY",Apr-19,17222,16599,623,3.6
4236,CN2105100000000,21,51,"Clay County, KY",Apr-19,5193,4876,317,6.1
4237,CN2105300000000,21,53,"Clinton County, KY",Apr-19,4012,3796,216,5.4
4238,CN2105500000000,21,55,"Crittenden County, KY",Apr-19,3850,3669,181,4.7
4239,CN2105700000000,21,57,"Cumberland County, KY",Apr-19,3157,3023,134,4.2
4240,CN2105900000000,21,59,"Daviess County, KY",Apr-19,47456,45786,1670,3.5
4241,CN2106100000000,21,61,"Edmonson County, KY",Apr-19,4827,4621,206,4.3
4242,CN2106300000000,21,63,"Elliott County, KY",Apr-19,1976,1850,126,6.4
4243,CN2106500000000,21,65,"Estill County, KY",Apr-19,5377,5142,235,4.4
4244,CN2106700000000,21,67,"Fayette County, KY",Apr-19,175451,170166,5285,3.0
4245,CN2106900000000,21,69,"Fleming County, KY",Apr-19,6213,5908,305,4.9
4246,CN2107100000000,21,71,"Floyd County, KY",Apr-19,11134,10500,634,5.7
4247,CN2107300000000,21,73,"Franklin County, KY",Apr-19,24769,23928,841,3.4
4248,CN2107500000000,21,75,"Fulton County, KY",Apr-19,2012,1919,93,4.6
4249,CN2107700000000,21,77,"Gallatin County, KY",Apr-19,4071,3923,148,3.6
4250,CN2107900000000,21,79,"Garrard County, KY",Apr-19,7773,7436,337,4.3
4251,CN2108100000000,21,81,"Grant County, KY",Apr-19,11742,11294,448,3.8
4252,CN2108300000000,21,83,"Graves County, KY",Apr-19,15690,15033,657,4.2
4253,CN2108500000000,21,85,"Grayson County, KY",Apr-19,10881,10383,498,4.6
4254,CN2108700000000,21,87,"Green County, KY",Apr-19,5040,4843,197,3.9
4255,CN2108900000000,21,89,"Greenup County, KY",Apr-19,13397,12600,797,5.9
4256,CN2109100000000,21,91,"Hancock County, KY",Apr-19,3981,3842,139,3.5
4257,CN2109300000000,21,93,"Hardin County, KY",Apr-19,49130,47271,1859,3.8
4258,CN2109500000000,21,95,"Harlan County, KY",Apr-19,6780,6352,428,6.3
4259,CN2109700000000,21,97,"Harrison County, KY",Apr-19,8754,8391,363,4.1
4260,CN2109900000000,21,99,"Hart County, KY",Apr-19,7988,7677,311,3.9
4261,CN2110100000000,21,101,"Henderson County, KY",Apr-19,21970,21199,771,3.5
4262,CN2110300000000,21,103,"Henry County, KY",Apr-19,8177,7895,282,3.4
4263,CN2110500000000,21,105,"Hickman County, KY",Apr-19,1765,1693,72,4.1
4264,CN2110700000000,21,107,"Hopkins County, KY",Apr-19,18480,17671,809,4.4
4265,CN2110900000000,21,109,"Jackson County, KY",Apr-19,4141,3903,238,5.7
4266,CN2111100000000,21,111,"Jefferson County, KY",Apr-19,401062,385678,15384,3.8
4267,CN2111300000000,21,113,"Jessamine County, KY",Apr-19,26670,25779,891,3.3
4268,CN2111500000000,21,115,"Johnson County, KY",Apr-19,6730,6334,396,5.9
4269,CN2111700000000,21,117,"Kenton County, KY",Apr-19,87995,85198,2797,3.2
4270,CN2111900000000,21,119,"Knott County, KY",Apr-19,4489,4218,271,6.0
4271,CN2112100000000,21,121,"Knox County, KY",Apr-19,9974,9421,553,5.5
4272,CN2112300000000,21,123,"Larue County, KY",Apr-19,5985,5743,242,4.0
4273,CN2112500000000,21,125,"Laurel County, KY",Apr-19,24752,23666,1086,4.4
4274,CN2112700000000,21,127,"Lawrence County, KY",Apr-19,5106,4777,329,6.4
4275,CN2112900000000,21,129,"Lee County, KY",Apr-19,2058,1953,105,5.1
4276,CN2113100000000,21,131,"Leslie County, KY",Apr-19,2660,2503,157,5.9
4277,CN2113300000000,21,133,"Letcher County, KY",Apr-19,6191,5819,372,6.0
4278,CN2113500000000,21,135,"Lewis County, KY",Apr-19,4665,4266,399,8.6
4279,CN2113700000000,21,137,"Lincoln County, KY",Apr-19,9395,8968,427,4.5
4280,CN2113900000000,21,139,"Livingston County, KY",Apr-19,3633,3440,193,5.3
4281,CN2114100000000,21,141,"Logan County, KY",Apr-19,12570,12122,448,3.6
4282,CN2114300000000,21,143,"Lyon County, KY",Apr-19,3062,2942,120,3.9
4283,CN2114500000000,21,145,"McCracken County, KY",Apr-19,29078,27788,1290,4.4
4284,CN2114700000000,21,147,"McCreary County, KY",Apr-19,4583,4341,242,5.3
4285,CN2114900000000,21,149,"McLean County, KY",Apr-19,4183,4015,168,4.0
4286,CN2115100000000,21,151,"Madison County, KY",Apr-19,47536,45886,1650,3.5
4287,CN2115300000000,21,153,"Magoffin County, KY",Apr-19,3081,2798,283,9.2
4288,CN2115500000000,21,155,"Marion County, KY",Apr-19,9710,9357,353,3.6
4289,CN2115700000000,21,157,"Marshall County, KY",Apr-19,15026,14389,637,4.2
4290,CN2115900000000,21,159,"Martin County, KY",Apr-19,2743,2574,169,6.2
4291,CN2116100000000,21,161,"Mason County, KY",Apr-19,7153,6783,370,5.2
4292,CN2116300000000,21,163,"Meade County, KY",Apr-19,12253,11743,510,4.2
4293,CN2116500000000,21,165,"Menifee County, KY",Apr-19,2321,2163,158,6.8
4294,CN2116700000000,21,167,"Mercer County, KY",Apr-19,10132,9721,411,4.1
4295,CN2116900000000,21,169,"Metcalfe County, KY",Apr-19,4041,3886,155,3.8
4296,CN2117100000000,21,171,"Monroe County, KY",Apr-19,4622,4456,166,3.6
4297,CN2117300000000,21,173,"Montgomery County, KY",Apr-19,11665,11094,571,4.9
4298,CN2117500000000,21,175,"Morgan County, KY",Apr-19,4593,4386,207,4.5
4299,CN2117700000000,21,177,"Muhlenberg County, KY",Apr-19,10862,10286,576,5.3
4300,CN2117900000000,21,179,"Nelson County, KY",Apr-19,23263,22207,1056,4.5
4301,CN2118100000000,21,181,"Nicholas County, KY",Apr-19,3237,3111,126,3.9
4302,CN2118300000000,21,183,"Ohio County, KY",Apr-19,9674,9234,440,4.5
4303,CN2118500000000,21,185,"Oldham County, KY",Apr-19,33312,32299,1013,3.0
4304,CN2118700000000,21,187,"Owen County, KY",Apr-19,5107,4883,224,4.4
4305,CN2118900000000,21,189,"Owsley County, KY",Apr-19,1119,1046,73,6.5
4306,CN2119100000000,21,191,"Pendleton County, KY",Apr-19,7004,6757,247,3.5
4307,CN2119300000000,21,193,"Perry County, KY",Apr-19,8289,7876,413,5.0
4308,CN2119500000000,21,195,"Pike County, KY",Apr-19,19953,18934,1019,5.1
4309,CN2119700000000,21,197,"Powell County, KY",Apr-19,5032,4790,242,4.8
4310,CN2119900000000,21,199,"Pulaski County, KY",Apr-19,26510,25392,1118,4.2
4311,CN2120100000000,21,201,"Robertson County, KY",Apr-19,800,759,41,5.1
4312,CN2120300000000,21,203,"Rockcastle County, KY",Apr-19,6708,6414,294,4.4
4313,CN2120500000000,21,205,"Rowan County, KY",Apr-19,10548,10076,472,4.5
4314,CN2120700000000,21,207,"Russell County, KY",Apr-19,6197,5869,328,5.3
4315,CN2120900000000,21,209,"Scott County, KY",Apr-19,29167,28253,914,3.1
4316,CN2121100000000,21,211,"Shelby County, KY",Apr-19,25395,24598,797,3.1
4317,CN2121300000000,21,213,"Simpson County, KY",Apr-19,8919,8563,356,4.0
4318,CN2121500000000,21,215,"Spencer County, KY",Apr-19,10215,9880,335,3.3
4319,CN2121700000000,21,217,"Taylor County, KY",Apr-19,12623,12128,495,3.9
4320,CN2121900000000,21,219,"Todd County, KY",Apr-19,5314,5121,193,3.6
4321,CN2122100000000,21,221,"Trigg County, KY",Apr-19,5949,5675,274,4.6
4322,CN2122300000000,21,223,"Trimble County, KY",Apr-19,3869,3703,166,4.3
4323,CN2122500000000,21,225,"Union County, KY",Apr-19,6034,5790,244,4.0
4324,CN2122700000000,21,227,"Warren County, KY",Apr-19,65362,63153,2209,3.4
4325,CN2122900000000,21,229,"Washington County, KY",Apr-19,6216,5986,230,3.7
4326,CN2123100000000,21,231,"Wayne County, KY",Apr-19,7300,6896,404,5.5
4327,CN2123300000000,21,233,"Webster County, KY",Apr-19,5801,5580,221,3.8
4328,CN2123500000000,21,235,"Whitley County, KY",Apr-19,13735,13113,622,4.5
4329,CN2123700000000,21,237,"Wolfe County, KY",Apr-19,1957,1840,117,6.0
4330,CN2123900000000,21,239,"Woodford County, KY",Apr-19,14631,14223,408,2.8
4331,CN2200100000000,22,1,"Acadia Parish, LA",Apr-19,23580,22581,999,4.2
4332,CN2200300000000,22,3,"Allen Parish, LA",Apr-19,8716,8342,374,4.3
4333,CN2200500000000,22,5,"Ascension Parish, LA",Apr-19,63800,61758,2042,3.2
4334,CN2200700000000,22,7,"Assumption Parish, LA",Apr-19,8744,8304,440,5.0
4335,CN2200900000000,22,9,"Avoyelles Parish, LA",Apr-19,15007,14363,644,4.3
4336,CN2201100000000,22,11,"Beauregard Parish, LA",Apr-19,14542,13961,581,4.0
4337,CN2201300000000,22,13,"Bienville Parish, LA",Apr-19,5406,5139,267,4.9
4338,CN2201500000000,22,15,"Bossier Parish, LA",Apr-19,57195,55261,1934,3.4
4339,CN2201700000000,22,17,"Caddo Parish, LA",Apr-19,102500,98135,4365,4.3
4340,CN2201900000000,22,19,"Calcasieu Parish, LA",Apr-19,106860,103534,3326,3.1
4341,CN2202100000000,22,21,"Caldwell Parish, LA",Apr-19,3717,3544,173,4.7
4342,CN2202300000000,22,23,"Cameron Parish, LA",Apr-19,3971,3849,122,3.1
4343,CN2202500000000,22,25,"Catahoula Parish, LA",Apr-19,3262,3079,183,5.6
4344,CN2202700000000,22,27,"Claiborne Parish, LA",Apr-19,5736,5484,252,4.4
4345,CN2202900000000,22,29,"Concordia Parish, LA",Apr-19,6843,6482,361,5.3
4346,CN2203100000000,22,31,"De Soto Parish, LA",Apr-19,10730,10212,518,4.8
4347,CN2203300000000,22,33,"East Baton Rouge Parish, LA",Apr-19,229566,221945,7621,3.3
4348,CN2203500000000,22,35,"East Carroll Parish, LA",Apr-19,1841,1675,166,9.0
4349,CN2203700000000,22,37,"East Feliciana Parish, LA",Apr-19,7947,7655,292,3.7
4350,CN2203900000000,22,39,"Evangeline Parish, LA",Apr-19,11877,11333,544,4.6
4351,CN2204100000000,22,41,"Franklin Parish, LA",Apr-19,7236,6828,408,5.6
4352,CN2204300000000,22,43,"Grant Parish, LA",Apr-19,8068,7735,333,4.1
4353,CN2204500000000,22,45,"Iberia Parish, LA",Apr-19,27816,26629,1187,4.3
4354,CN2204700000000,22,47,"Iberville Parish, LA",Apr-19,13933,13269,664,4.8
4355,CN2204900000000,22,49,"Jackson Parish, LA",Apr-19,6730,6476,254,3.8
4356,CN2205100000000,22,51,"Jefferson Parish, LA",Apr-19,213053,205968,7085,3.3
4357,CN2205300000000,22,53,"Jefferson Davis Parish, LA",Apr-19,13088,12605,483,3.7
4358,CN2205500000000,22,55,"Lafayette Parish, LA",Apr-19,113046,109211,3835,3.4
4359,CN2205700000000,22,57,"Lafourche Parish, LA",Apr-19,41490,40006,1484,3.6
4360,CN2205900000000,22,59,"LaSalle Parish, LA",Apr-19,6598,6391,207,3.1
4361,CN2206100000000,22,61,"Lincoln Parish, LA",Apr-19,22129,21256,873,3.9
4362,CN2206300000000,22,63,"Livingston Parish, LA",Apr-19,68505,66356,2149,3.1
4363,CN2206500000000,22,65,"Madison Parish, LA",Apr-19,3415,3196,219,6.4
4364,CN2206700000000,22,67,"Morehouse Parish, LA",Apr-19,9938,9279,659,6.6
4365,CN2206900000000,22,69,"Natchitoches Parish, LA",Apr-19,16117,15425,692,4.3
4366,CN2207100000000,22,71,"Orleans Parish, LA",Apr-19,177892,171143,6749,3.8
4367,CN2207300000000,22,73,"Ouachita Parish, LA",Apr-19,69685,66722,2963,4.3
4368,CN2207500000000,22,75,"Plaquemines Parish, LA",Apr-19,9969,9629,340,3.4
4369,CN2207700000000,22,77,"Pointe Coupee Parish, LA",Apr-19,9769,9364,405,4.1
4370,CN2207900000000,22,79,"Rapides Parish, LA",Apr-19,54708,52530,2178,4.0
4371,CN2208100000000,22,81,"Red River Parish, LA",Apr-19,3668,3524,144,3.9
4372,CN2208300000000,22,83,"Richland Parish, LA",Apr-19,8145,7727,418,5.1
4373,CN2208500000000,22,85,"Sabine Parish, LA",Apr-19,9053,8692,361,4.0
4374,CN2208700000000,22,87,"St. Bernard Parish, LA",Apr-19,19741,18975,766,3.9
4375,CN2208900000000,22,89,"St. Charles Parish, LA",Apr-19,25022,24185,837,3.3
4376,CN2209100000000,22,91,"St. Helena Parish, LA",Apr-19,4236,4035,201,4.7
4377,CN2209300000000,22,93,"St. James Parish, LA",Apr-19,9141,8711,430,4.7
4378,CN2209500000000,22,95,"St. John the Baptist Parish, LA",Apr-19,19503,18652,851,4.4
4379,CN2209700000000,22,97,"St. Landry Parish, LA",Apr-19,31480,29918,1562,5.0
4380,CN2209900000000,22,99,"St. Martin Parish, LA",Apr-19,22000,21105,895,4.1
4381,CN2210100000000,22,101,"St. Mary Parish, LA",Apr-19,19451,18515,936,4.8
4382,CN2210300000000,22,103,"St. Tammany Parish, LA",Apr-19,118851,115013,3838,3.2
4383,CN2210500000000,22,105,"Tangipahoa Parish, LA",Apr-19,53833,51542,2291,4.3
4384,CN2210700000000,22,107,"Tensas Parish, LA",Apr-19,1340,1245,95,7.1
4385,CN2210900000000,22,109,"Terrebonne Parish, LA",Apr-19,45630,43952,1678,3.7
4386,CN2211100000000,22,111,"Union Parish, LA",Apr-19,9012,8575,437,4.8
4387,CN2211300000000,22,113,"Vermilion Parish, LA",Apr-19,23908,22940,968,4.0
4388,CN2211500000000,22,115,"Vernon Parish, LA",Apr-19,15432,14687,745,4.8
4389,CN2211700000000,22,117,"Washington Parish, LA",Apr-19,16511,15719,792,4.8
4390,CN2211900000000,22,119,"Webster Parish, LA",Apr-19,14339,13639,700,4.9
4391,CN2212100000000,22,121,"West Baton Rouge Parish, LA",Apr-19,13607,13126,481,3.5
4392,CN2212300000000,22,123,"West Carroll Parish, LA",Apr-19,3553,3189,364,10.2
4393,CN2212500000000,22,125,"West Feliciana Parish, LA",Apr-19,5349,5182,167,3.1
4394,CN2212700000000,22,127,"Winn Parish, LA",Apr-19,4754,4508,246,5.2
4395,CN2300100000000,23,1,"Androscoggin County, ME",Apr-19,55367,53622,1745,3.2
4396,CN2300300000000,23,3,"Aroostook County, ME",Apr-19,29952,28286,1666,5.6
4397,CN2300500000000,23,5,"Cumberland County, ME",Apr-19,162958,158792,4166,2.6
4398,CN2300700000000,23,7,"Franklin County, ME",Apr-19,14278,13665,613,4.3
4399,CN2300900000000,23,9,"Hancock County, ME",Apr-19,27485,26269,1216,4.4
4400,CN2301100000000,23,11,"Kennebec County, ME",Apr-19,61775,59852,1923,3.1
4401,CN2301300000000,23,13,"Knox County, ME",Apr-19,19572,18874,698,3.6
4402,CN2301500000000,23,15,"Lincoln County, ME",Apr-19,16079,15514,565,3.5
4403,CN2301700000000,23,17,"Oxford County, ME",Apr-19,25726,24685,1041,4.0
4404,CN2301900000000,23,19,"Penobscot County, ME",Apr-19,77310,74566,2744,3.5
4405,CN2302100000000,23,21,"Piscataquis County, ME",Apr-19,7161,6853,308,4.3
4406,CN2302300000000,23,23,"Sagadahoc County, ME",Apr-19,19340,18841,499,2.6
4407,CN2302500000000,23,25,"Somerset County, ME",Apr-19,22020,20949,1071,4.9
4408,CN2302700000000,23,27,"Waldo County, ME",Apr-19,20287,19577,710,3.5
4409,CN2302900000000,23,29,"Washington County, ME",Apr-19,13343,12569,774,5.8
4410,CN2303100000000,23,31,"York County, ME",Apr-19,112380,109146,3234,2.9
4411,CN2400100000000,24,1,"Allegany County, MD",Apr-19,32377,30955,1422,4.4
4412,CN2400300000000,24,3,"Anne Arundel County, MD",Apr-19,314372,305913,8459,2.7
4413,CN2400500000000,24,5,"Baltimore County, MD",Apr-19,452764,437427,15337,3.4
4414,CN2400900000000,24,9,"Calvert County, MD",Apr-19,49925,48546,1379,2.8
4415,CN2401100000000,24,11,"Caroline County, MD",Apr-19,18332,17719,613,3.3
4416,CN2401300000000,24,13,"Carroll County, MD",Apr-19,95900,93524,2376,2.5
4417,CN2401500000000,24,15,"Cecil County, MD",Apr-19,53416,51518,1898,3.6
4418,CN2401700000000,24,17,"Charles County, MD",Apr-19,87118,84358,2760,3.2
4419,CN2401900000000,24,19,"Dorchester County, MD",Apr-19,15931,15196,735,4.6
4420,CN2402100000000,24,21,"Frederick County, MD",Apr-19,134546,130842,3704,2.8
4421,CN2402300000000,24,23,"Garrett County, MD",Apr-19,15661,15073,588,3.8
4422,CN2402500000000,24,25,"Harford County, MD",Apr-19,140758,136585,4173,3.0
4423,CN2402700000000,24,27,"Howard County, MD",Apr-19,187025,182532,4493,2.4
4424,CN2402900000000,24,29,"Kent County, MD",Apr-19,10400,10022,378,3.6
4425,CN2403100000000,24,31,"Montgomery County, MD",Apr-19,557918,543537,14381,2.6
4426,CN2403300000000,24,33,"Prince George's County, MD",Apr-19,508585,491296,17289,3.4
4427,CN2403500000000,24,35,"Queen Anne's County, MD",Apr-19,28137,27391,746,2.7
4428,CN2403700000000,24,37,"St. Mary's County, MD",Apr-19,56776,55183,1593,2.8
4429,CN2403900000000,24,39,"Somerset County, MD",Apr-19,9263,8748,515,5.6
4430,CN2404100000000,24,41,"Talbot County, MD",Apr-19,19117,18550,567,3.0
4431,CN2404300000000,24,43,"Washington County, MD",Apr-19,74379,71748,2631,3.5
4432,CN2404500000000,24,45,"Wicomico County, MD",Apr-19,50516,48292,2224,4.4
4433,CN2404700000000,24,47,"Worcester County, MD",Apr-19,25482,23485,1997,7.8
4434,CN2451000000000,24,510,"Baltimore city, MD",Apr-19,287396,273845,13551,4.7
4435,CN2500100000000,25,1,"Barnstable County, MA",Apr-19,110193,105664,4529,4.1
4436,CN2500300000000,25,3,"Berkshire County, MA",Apr-19,63940,61676,2264,3.5
4437,CN2500500000000,25,5,"Bristol County, MA",Apr-19,302134,291682,10452,3.5
4438,CN2500700000000,25,7,"Dukes County, MA",Apr-19,8555,8130,425,5.0
4439,CN2500900000000,25,9,"Essex County, MA",Apr-19,426586,414450,12136,2.8
4440,CN2501100000000,25,11,"Franklin County, MA",Apr-19,41138,40015,1123,2.7
4441,CN2501300000000,25,13,"Hampden County, MA",Apr-19,230137,221381,8756,3.8
4442,CN2501500000000,25,15,"Hampshire County, MA",Apr-19,90949,88719,2230,2.5
4443,CN2501700000000,25,17,"Middlesex County, MA",Apr-19,922329,902342,19987,2.2
4444,CN2501900000000,25,19,"Nantucket County/town, MA",Apr-19,6576,6278,298,4.5
4445,CN2502100000000,25,21,"Norfolk County, MA",Apr-19,392413,383038,9375,2.4
4446,CN2502300000000,25,23,"Plymouth County, MA",Apr-19,284001,275999,8002,2.8
4447,CN2502500000000,25,25,"Suffolk County, MA",Apr-19,457092,446257,10835,2.4
4448,CN2502700000000,25,27,"Worcester County, MA",Apr-19,448235,434988,13247,3.0
4449,CN2600100000000,26,1,"Alcona County, MI",Apr-19,3747,3516,231,6.2
4450,CN2600300000000,26,3,"Alger County, MI",Apr-19,2966,2688,278,9.4
4451,CN2600500000000,26,5,"Allegan County, MI",Apr-19,61672,59874,1798,2.9
4452,CN2600700000000,26,7,"Alpena County, MI",Apr-19,13141,12529,612,4.7
4453,CN2600900000000,26,9,"Antrim County, MI",Apr-19,9742,9156,586,6.0
4454,CN2601100000000,26,11,"Arenac County, MI",Apr-19,5948,5561,387,6.5
4455,CN2601300000000,26,13,"Baraga County, MI",Apr-19,3192,2974,218,6.8
4456,CN2601500000000,26,15,"Barry County, MI",Apr-19,31546,30605,941,3.0
4457,CN2601700000000,26,17,"Bay County, MI",Apr-19,49743,47580,2163,4.3
4458,CN2601900000000,26,19,"Benzie County, MI",Apr-19,8559,8101,458,5.4
4459,CN2602100000000,26,21,"Berrien County, MI",Apr-19,73127,70490,2637,3.6
4460,CN2602300000000,26,23,"Branch County, MI",Apr-19,19240,18604,636,3.3
4461,CN2602500000000,26,25,"Calhoun County, MI",Apr-19,62268,59903,2365,3.8
4462,CN2602700000000,26,27,"Cass County, MI",Apr-19,24495,23564,931,3.8
4463,CN2602900000000,26,29,"Charlevoix County, MI",Apr-19,12186,11548,638,5.2
4464,CN2603100000000,26,31,"Cheboygan County, MI",Apr-19,9960,8801,1159,11.6
4465,CN2603300000000,26,33,"Chippewa County, MI",Apr-19,15815,14731,1084,6.9
4466,CN2603500000000,26,35,"Clare County, MI",Apr-19,11678,10976,702,6.0
4467,CN2603700000000,26,37,"Clinton County, MI",Apr-19,41475,40382,1093,2.6
4468,CN2603900000000,26,39,"Crawford County, MI",Apr-19,5513,5194,319,5.8
4469,CN2604100000000,26,41,"Delta County, MI",Apr-19,16958,16064,894,5.3
4470,CN2604300000000,26,43,"Dickinson County, MI",Apr-19,12040,11561,479,4.0
4471,CN2604500000000,26,45,"Eaton County, MI",Apr-19,57735,56063,1672,2.9
4472,CN2604700000000,26,47,"Emmet County, MI",Apr-19,16762,15623,1139,6.8
4473,CN2604900000000,26,49,"Genesee County, MI",Apr-19,181839,173864,7975,4.4
4474,CN2605100000000,26,51,"Gladwin County, MI",Apr-19,9806,9291,515,5.3
4475,CN2605300000000,26,53,"Gogebic County, MI",Apr-19,5951,5624,327,5.5
4476,CN2605500000000,26,55,"Grand Traverse County, MI",Apr-19,47909,46228,1681,3.5
4477,CN2605700000000,26,57,"Gratiot County, MI",Apr-19,18053,17328,725,4.0
4478,CN2605900000000,26,59,"Hillsdale County, MI",Apr-19,20269,19531,738,3.6
4479,CN2606100000000,26,61,"Houghton County, MI",Apr-19,16361,15543,818,5.0
4480,CN2606300000000,26,63,"Huron County, MI",Apr-19,14998,14299,699,4.7
4481,CN2606500000000,26,65,"Ingham County, MI",Apr-19,152656,148013,4643,3.0
4482,CN2606700000000,26,67,"Ionia County, MI",Apr-19,30072,29188,884,2.9
4483,CN2606900000000,26,69,"Iosco County, MI",Apr-19,9860,9256,604,6.1
4484,CN2607100000000,26,71,"Iron County, MI",Apr-19,5011,4701,310,6.2
4485,CN2607300000000,26,73,"Isabella County, MI",Apr-19,34720,33512,1208,3.5
4486,CN2607500000000,26,75,"Jackson County, MI",Apr-19,74315,71799,2516,3.4
4487,CN2607700000000,26,77,"Kalamazoo County, MI",Apr-19,133506,129624,3882,2.9
4488,CN2607900000000,26,79,"Kalkaska County, MI",Apr-19,7658,7197,461,6.0
4489,CN2608100000000,26,81,"Kent County, MI",Apr-19,358971,349868,9103,2.5
4490,CN2608300000000,26,83,"Keweenaw County, MI",Apr-19,903,828,75,8.3
4491,CN2608500000000,26,85,"Lake County, MI",Apr-19,3591,3360,231,6.4
4492,CN2608700000000,26,87,"Lapeer County, MI",Apr-19,40795,38795,2000,4.9
4493,CN2608900000000,26,89,"Leelanau County, MI",Apr-19,10133,9732,401,4.0
4494,CN2609100000000,26,91,"Lenawee County, MI",Apr-19,46510,44952,1558,3.3
4495,CN2609300000000,26,93,"Livingston County, MI",Apr-19,102603,99594,3009,2.9
4496,CN2609500000000,26,95,"Luce County, MI",Apr-19,2228,2061,167,7.5
4497,CN2609700000000,26,97,"Mackinac County, MI",Apr-19,4429,3791,638,14.4
4498,CN2609900000000,26,99,"Macomb County, MI",Apr-19,443763,427465,16298,3.7
4499,CN2610100000000,26,101,"Manistee County, MI",Apr-19,10155,9606,549,5.4
4500,CN2610300000000,26,103,"Marquette County, MI",Apr-19,32722,31043,1679,5.1
4501,CN2610500000000,26,105,"Mason County, MI",Apr-19,13431,12831,600,4.5
4502,CN2610700000000,26,107,"Mecosta County, MI",Apr-19,18529,17758,771,4.2
4503,CN2610900000000,26,109,"Menominee County, MI",Apr-19,11001,10573,428,3.9
4504,CN2611100000000,26,111,"Midland County, MI",Apr-19,40406,39008,1398,3.5
4505,CN2611300000000,26,113,"Missaukee County, MI",Apr-19,6836,6492,344,5.0
4506,CN2611500000000,26,115,"Monroe County, MI",Apr-19,75588,72844,2744,3.6
4507,CN2611700000000,26,117,"Montcalm County, MI",Apr-19,28256,27172,1084,3.8
4508,CN2611900000000,26,119,"Montmorency County, MI",Apr-19,2928,2694,234,8.0
4509,CN2612100000000,26,121,"Muskegon County, MI",Apr-19,76134,73211,2923,3.8
4510,CN2612300000000,26,123,"Newaygo County, MI",Apr-19,23310,22409,901,3.9
4511,CN2612500000000,26,125,"Oakland County, MI",Apr-19,669585,649730,19855,3.0
4512,CN2612700000000,26,127,"Oceana County, MI",Apr-19,11693,10961,732,6.3
4513,CN2612900000000,26,129,"Ogemaw County, MI",Apr-19,7867,7331,536,6.8
4514,CN2613100000000,26,131,"Ontonagon County, MI",Apr-19,2019,1836,183,9.1
4515,CN2613300000000,26,133,"Osceola County, MI",Apr-19,11059,10611,448,4.1
4516,CN2613500000000,26,135,"Oscoda County, MI",Apr-19,2871,2683,188,6.5
4517,CN2613700000000,26,137,"Otsego County, MI",Apr-19,11411,10805,606,5.3
4518,CN2613900000000,26,139,"Ottawa County, MI",Apr-19,160611,156682,3929,2.4
4519,CN2614100000000,26,141,"Presque Isle County, MI",Apr-19,4868,4487,381,7.8
4520,CN2614300000000,26,143,"Roscommon County, MI",Apr-19,7484,6887,597,8.0
4521,CN2614500000000,26,145,"Saginaw County, MI",Apr-19,86097,82369,3728,4.3
4522,CN2614700000000,26,147,"St. Clair County, MI",Apr-19,75024,71700,3324,4.4
4523,CN2614900000000,26,149,"St. Joseph County, MI",Apr-19,27936,26896,1040,3.7
4524,CN2615100000000,26,151,"Sanilac County, MI",Apr-19,19181,18242,939,4.9
4525,CN2615300000000,26,153,"Schoolcraft County, MI",Apr-19,3307,3048,259,7.8
4526,CN2615500000000,26,155,"Shiawassee County, MI",Apr-19,33533,32185,1348,4.0
4527,CN2615700000000,26,157,"Tuscola County, MI",Apr-19,23767,22593,1174,4.9
4528,CN2615900000000,26,159,"Van Buren County, MI",Apr-19,34939,33518,1421,4.1
4529,CN2616100000000,26,161,"Washtenaw County, MI",Apr-19,198131,193056,5075,2.6
4530,CN2616300000000,26,163,"Wayne County, MI",Apr-19,793142,758747,34395,4.3
4531,CN2616500000000,26,165,"Wexford County, MI",Apr-19,14593,13955,638,4.4
4532,CN2700100000000,27,1,"Aitkin County, MN",Apr-19,7165,6669,496,6.9
4533,CN2700300000000,27,3,"Anoka County, MN",Apr-19,197812,192170,5642,2.9
4534,CN2700500000000,27,5,"Becker County, MN",Apr-19,18703,17915,788,4.2
4535,CN2700700000000,27,7,"Beltrami County, MN",Apr-19,24158,23129,1029,4.3
4536,CN2700900000000,27,9,"Benton County, MN",Apr-19,22175,21320,855,3.9
4537,CN2701100000000,27,11,"Big Stone County, MN",Apr-19,2438,2327,111,4.6
4538,CN2701300000000,27,13,"Blue Earth County, MN",Apr-19,40994,39932,1062,2.6
4539,CN2701500000000,27,15,"Brown County, MN",Apr-19,14446,13932,514,3.6
4540,CN2701700000000,27,17,"Carlton County, MN",Apr-19,18025,17216,809,4.5
4541,CN2701900000000,27,19,"Carver County, MN",Apr-19,58592,57111,1481,2.5
4542,CN2702100000000,27,21,"Cass County, MN",Apr-19,13789,12984,805,5.8
4543,CN2702300000000,27,23,"Chippewa County, MN",Apr-19,6995,6695,300,4.3
4544,CN2702500000000,27,25,"Chisago County, MN",Apr-19,30004,28890,1114,3.7
4545,CN2702700000000,27,27,"Clay County, MN",Apr-19,36191,35077,1114,3.1
4546,CN2702900000000,27,29,"Clearwater County, MN",Apr-19,4433,3994,439,9.9
4547,CN2703100000000,27,31,"Cook County, MN",Apr-19,2950,2798,152,5.2
4548,CN2703300000000,27,33,"Cottonwood County, MN",Apr-19,5916,5724,192,3.2
4549,CN2703500000000,27,35,"Crow Wing County, MN",Apr-19,31601,30278,1323,4.2
4550,CN2703700000000,27,37,"Dakota County, MN",Apr-19,241786,235436,6350,2.6
4551,CN2703900000000,27,39,"Dodge County, MN",Apr-19,11890,11488,402,3.4
4552,CN2704100000000,27,41,"Douglas County, MN",Apr-19,20836,20146,690,3.3
4553,CN2704300000000,27,43,"Faribault County, MN",Apr-19,6958,6650,308,4.4
4554,CN2704500000000,27,45,"Fillmore County, MN",Apr-19,11557,11190,367,3.2
4555,CN2704700000000,27,47,"Freeborn County, MN",Apr-19,16161,15631,530,3.3
4556,CN2704900000000,27,49,"Goodhue County, MN",Apr-19,26909,26110,799,3.0
4557,CN2705100000000,27,51,"Grant County, MN",Apr-19,3350,3198,152,4.5
4558,CN2705300000000,27,53,"Hennepin County, MN",Apr-19,705175,687962,17213,2.4
4559,CN2705500000000,27,55,"Houston County, MN",Apr-19,10509,10188,321,3.1
4560,CN2705700000000,27,57,"Hubbard County, MN",Apr-19,9690,9165,525,5.4
4561,CN2705900000000,27,59,"Isanti County, MN",Apr-19,21388,20507,881,4.1
4562,CN2706100000000,27,61,"Itasca County, MN",Apr-19,21579,20222,1357,6.3
4563,CN2706300000000,27,63,"Jackson County, MN",Apr-19,5738,5563,175,3.0
4564,CN2706500000000,27,65,"Kanabec County, MN",Apr-19,9057,8455,602,6.6
4565,CN2706700000000,27,67,"Kandiyohi County, MN",Apr-19,24120,23213,907,3.8
4566,CN2706900000000,27,69,"Kittson County, MN",Apr-19,2357,2273,84,3.6
4567,CN2707100000000,27,71,"Koochiching County, MN",Apr-19,5947,5495,452,7.6
4568,CN2707300000000,27,73,"Lac qui Parle County, MN",Apr-19,3608,3457,151,4.2
4569,CN2707500000000,27,75,"Lake County, MN",Apr-19,5362,5167,195,3.6
4570,CN2707700000000,27,77,"Lake of the Woods County, MN",Apr-19,2365,2254,111,4.7
4571,CN2707900000000,27,79,"Le Sueur County, MN",Apr-19,16314,15470,844,5.2
4572,CN2708100000000,27,81,"Lincoln County, MN",Apr-19,3265,3132,133,4.1
4573,CN2708300000000,27,83,"Lyon County, MN",Apr-19,14710,14224,486,3.3
4574,CN2708500000000,27,85,"McLeod County, MN",Apr-19,19327,18615,712,3.7
4575,CN2708700000000,27,87,"Mahnomen County, MN",Apr-19,2312,2205,107,4.6
4576,CN2708900000000,27,89,"Marshall County, MN",Apr-19,5476,5096,380,6.9
4577,CN2709100000000,27,91,"Martin County, MN",Apr-19,10071,9734,337,3.3
4578,CN2709300000000,27,93,"Meeker County, MN",Apr-19,13365,12829,536,4.0
4579,CN2709500000000,27,95,"Mille Lacs County, MN",Apr-19,13023,12262,761,5.8
4580,CN2709700000000,27,97,"Morrison County, MN",Apr-19,17655,16788,867,4.9
4581,CN2709900000000,27,99,"Mower County, MN",Apr-19,20423,19845,578,2.8
4582,CN2710100000000,27,101,"Murray County, MN",Apr-19,4898,4688,210,4.3
4583,CN2710300000000,27,103,"Nicollet County, MN",Apr-19,21117,20624,493,2.3
4584,CN2710500000000,27,105,"Nobles County, MN",Apr-19,11232,10935,297,2.6
4585,CN2710700000000,27,107,"Norman County, MN",Apr-19,3293,3125,168,5.1
4586,CN2710900000000,27,109,"Olmsted County, MN",Apr-19,88328,86201,2127,2.4
4587,CN2711100000000,27,111,"Otter Tail County, MN",Apr-19,31145,29851,1294,4.2
4588,CN2711300000000,27,113,"Pennington County, MN",Apr-19,8838,8305,533,6.0
4589,CN2711500000000,27,115,"Pine County, MN",Apr-19,15085,14171,914,6.1
4590,CN2711700000000,27,117,"Pipestone County, MN",Apr-19,4898,4702,196,4.0
4591,CN2711900000000,27,119,"Polk County, MN",Apr-19,16648,15971,677,4.1
4592,CN2712100000000,27,121,"Pope County, MN",Apr-19,6532,6334,198,3.0
4593,CN2712300000000,27,123,"Ramsey County, MN",Apr-19,289255,281558,7697,2.7
4594,CN2712500000000,27,125,"Red Lake County, MN",Apr-19,2238,2105,133,5.9
4595,CN2712700000000,27,127,"Redwood County, MN",Apr-19,7624,7342,282,3.7
4596,CN2712900000000,27,129,"Renville County, MN",Apr-19,8626,8160,466,5.4
4597,CN2713100000000,27,131,"Rice County, MN",Apr-19,37197,36127,1070,2.9
4598,CN2713300000000,27,133,"Rock County, MN",Apr-19,5690,5573,117,2.1
4599,CN2713500000000,27,135,"Roseau County, MN",Apr-19,7791,7531,260,3.3
4600,CN2713700000000,27,137,"St. Louis County, MN",Apr-19,102878,98916,3962,3.9
4601,CN2713900000000,27,139,"Scott County, MN",Apr-19,83547,81476,2071,2.5
4602,CN2714100000000,27,141,"Sherburne County, MN",Apr-19,52617,50780,1837,3.5
4603,CN2714300000000,27,143,"Sibley County, MN",Apr-19,8629,8295,334,3.9
4604,CN2714500000000,27,145,"Stearns County, MN",Apr-19,91319,88500,2819,3.1
4605,CN2714700000000,27,147,"Steele County, MN",Apr-19,20924,20303,621,3.0
4606,CN2714900000000,27,149,"Stevens County, MN",Apr-19,5523,5385,138,2.5
4607,CN2715100000000,27,151,"Swift County, MN",Apr-19,4893,4687,206,4.2
4608,CN2715300000000,27,153,"Todd County, MN",Apr-19,13515,12911,604,4.5
4609,CN2715500000000,27,155,"Traverse County, MN",Apr-19,1803,1731,72,4.0
4610,CN2715700000000,27,157,"Wabasha County, MN",Apr-19,12295,11913,382,3.1
4611,CN2715900000000,27,159,"Wadena County, MN",Apr-19,5954,5585,369,6.2
4612,CN2716100000000,27,161,"Waseca County, MN",Apr-19,8966,8644,322,3.6
4613,CN2716300000000,27,163,"Washington County, MN",Apr-19,143478,139792,3686,2.6
4614,CN2716500000000,27,165,"Watonwan County, MN",Apr-19,6603,6332,271,4.1
4615,CN2716700000000,27,167,"Wilkin County, MN",Apr-19,3497,3384,113,3.2
4616,CN2716900000000,27,169,"Winona County, MN",Apr-19,28955,28222,733,2.5
4617,CN2717100000000,27,171,"Wright County, MN",Apr-19,75832,73378,2454,3.2
4618,CN2717300000000,27,173,"Yellow Medicine County, MN",Apr-19,5367,5138,229,4.3
4619,CN2800100000000,28,1,"Adams County, MS",Apr-19,11029,10358,671,6.1
4620,CN2800300000000,28,3,"Alcorn County, MS",Apr-19,16164,15502,662,4.1
4621,CN2800500000000,28,5,"Amite County, MS",Apr-19,4453,4203,250,5.6
4622,CN2800700000000,28,7,"Attala County, MS",Apr-19,7050,6654,396,5.6
4623,CN2800900000000,28,9,"Benton County, MS",Apr-19,3008,2853,155,5.2
4624,CN2801100000000,28,11,"Bolivar County, MS",Apr-19,12396,11694,702,5.7
4625,CN2801300000000,28,13,"Calhoun County, MS",Apr-19,5731,5468,263,4.6
4626,CN2801500000000,28,15,"Carroll County, MS",Apr-19,3469,3279,190,5.5
4627,CN2801700000000,28,17,"Chickasaw County, MS",Apr-19,6896,6563,333,4.8
4628,CN2801900000000,28,19,"Choctaw County, MS",Apr-19,3747,3569,178,4.8
4629,CN2802100000000,28,21,"Claiborne County, MS",Apr-19,2973,2714,259,8.7
4630,CN2802300000000,28,23,"Clarke County, MS",Apr-19,5897,5561,336,5.7
4631,CN2802500000000,28,25,"Clay County, MS",Apr-19,7797,7320,477,6.1
4632,CN2802700000000,28,27,"Coahoma County, MS",Apr-19,8356,7838,518,6.2
4633,CN2802900000000,28,29,"Copiah County, MS",Apr-19,11162,10510,652,5.8
4634,CN2803100000000,28,31,"Covington County, MS",Apr-19,8063,7717,346,4.3
4635,CN2803300000000,28,33,"DeSoto County, MS",Apr-19,90326,86762,3564,3.9
4636,CN2803500000000,28,35,"Forrest County, MS",Apr-19,33029,31507,1522,4.6
4637,CN2803700000000,28,37,"Franklin County, MS",Apr-19,2819,2669,150,5.3
4638,CN2803900000000,28,39,"George County, MS",Apr-19,8843,8320,523,5.9
4639,CN2804100000000,28,41,"Greene County, MS",Apr-19,4358,4083,275,6.3
4640,CN2804300000000,28,43,"Grenada County, MS",Apr-19,9451,9043,408,4.3
4641,CN2804500000000,28,45,"Hancock County, MS",Apr-19,18491,17558,933,5.0
4642,CN2804700000000,28,47,"Harrison County, MS",Apr-19,85290,81385,3905,4.6
4643,CN2804900000000,28,49,"Hinds County, MS",Apr-19,106070,101079,4991,4.7
4644,CN2805100000000,28,51,"Holmes County, MS",Apr-19,5653,5155,498,8.8
4645,CN2805300000000,28,53,"Humphreys County, MS",Apr-19,2285,2104,181,7.9
4646,CN2805500000000,28,55,"Issaquena County, MS",Apr-19,382,345,37,9.7
4647,CN2805700000000,28,57,"Itawamba County, MS",Apr-19,10428,10000,428,4.1
4648,CN2805900000000,28,59,"Jackson County, MS",Apr-19,57772,54656,3116,5.4
4649,CN2806100000000,28,61,"Jasper County, MS",Apr-19,6212,5845,367,5.9
4650,CN2806300000000,28,63,"Jefferson County, MS",Apr-19,1954,1733,221,11.3
4651,CN2806500000000,28,65,"Jefferson Davis County, MS",Apr-19,4107,3877,230,5.6
4652,CN2806700000000,28,67,"Jones County, MS",Apr-19,26346,25086,1260,4.8
4653,CN2806900000000,28,69,"Kemper County, MS",Apr-19,3556,3312,244,6.9
4654,CN2807100000000,28,71,"Lafayette County, MS",Apr-19,28396,27270,1126,4.0
4655,CN2807300000000,28,73,"Lamar County, MS",Apr-19,30493,29340,1153,3.8
4656,CN2807500000000,28,75,"Lauderdale County, MS",Apr-19,30259,28806,1453,4.8
4657,CN2807700000000,28,77,"Lawrence County, MS",Apr-19,4580,4334,246,5.4
4658,CN2807900000000,28,79,"Leake County, MS",Apr-19,8006,7623,383,4.8
4659,CN2808100000000,28,81,"Lee County, MS",Apr-19,40657,39088,1569,3.9
4660,CN2808300000000,28,83,"Leflore County, MS",Apr-19,9964,9316,648,6.5
4661,CN2808500000000,28,85,"Lincoln County, MS",Apr-19,14518,13803,715,4.9
4662,CN2808700000000,28,87,"Lowndes County, MS",Apr-19,25352,24164,1188,4.7
4663,CN2808900000000,28,89,"Madison County, MS",Apr-19,52884,50767,2117,4.0
4664,CN2809100000000,28,91,"Marion County, MS",Apr-19,9864,9399,465,4.7
4665,CN2809300000000,28,93,"Marshall County, MS",Apr-19,14287,13592,695,4.9
4666,CN2809500000000,28,95,"Monroe County, MS",Apr-19,15258,14541,717,4.7
4667,CN2809700000000,28,97,"Montgomery County, MS",Apr-19,3995,3783,212,5.3
4668,CN2809900000000,28,99,"Neshoba County, MS",Apr-19,10156,9616,540,5.3
4669,CN2810100000000,28,101,"Newton County, MS",Apr-19,8849,8407,442,5.0
4670,CN2810300000000,28,103,"Noxubee County, MS",Apr-19,3813,3583,230,6.0
4671,CN2810500000000,28,105,"Oktibbeha County, MS",Apr-19,22630,21522,1108,4.9
4672,CN2810700000000,28,107,"Panola County, MS",Apr-19,12496,11756,740,5.9
4673,CN2810900000000,28,109,"Pearl River County, MS",Apr-19,23807,22719,1088,4.6
4674,CN2811100000000,28,111,"Perry County, MS",Apr-19,4253,4009,244,5.7
4675,CN2811300000000,28,113,"Pike County, MS",Apr-19,14562,13751,811,5.6
4676,CN2811500000000,28,115,"Pontotoc County, MS",Apr-19,14598,14036,562,3.8
4677,CN2811700000000,28,117,"Prentiss County, MS",Apr-19,11282,10795,487,4.3
4678,CN2811900000000,28,119,"Quitman County, MS",Apr-19,2412,2252,160,6.6
4679,CN2812100000000,28,121,"Rankin County, MS",Apr-19,75604,72919,2685,3.6
4680,CN2812300000000,28,123,"Scott County, MS",Apr-19,12737,12239,498,3.9
4681,CN2812500000000,28,125,"Sharkey County, MS",Apr-19,1607,1498,109,6.8
4682,CN2812700000000,28,127,"Simpson County, MS",Apr-19,10709,10217,492,4.6
4683,CN2812900000000,28,129,"Smith County, MS",Apr-19,6849,6537,312,4.6
4684,CN2813100000000,28,131,"Stone County, MS",Apr-19,6904,6510,394,5.7
4685,CN2813300000000,28,133,"Sunflower County, MS",Apr-19,7823,7272,551,7.0
4686,CN2813500000000,28,135,"Tallahatchie County, MS",Apr-19,5338,5085,253,4.7
4687,CN2813700000000,28,137,"Tate County, MS",Apr-19,12282,11677,605,4.9
4688,CN2813900000000,28,139,"Tippah County, MS",Apr-19,9470,9043,427,4.5
4689,CN2814100000000,28,141,"Tishomingo County, MS",Apr-19,8746,8387,359,4.1
4690,CN2814300000000,28,143,"Tunica County, MS",Apr-19,4435,4213,222,5.0
4691,CN2814500000000,28,145,"Union County, MS",Apr-19,14036,13525,511,3.6
4692,CN2814700000000,28,147,"Walthall County, MS",Apr-19,4921,4624,297,6.0
4693,CN2814900000000,28,149,"Warren County, MS",Apr-19,20168,19114,1054,5.2
4694,CN2815100000000,28,151,"Washington County, MS",Apr-19,16850,15780,1070,6.4
4695,CN2815300000000,28,153,"Wayne County, MS",Apr-19,7484,7101,383,5.1
4696,CN2815500000000,28,155,"Webster County, MS",Apr-19,4031,3825,206,5.1
4697,CN2815700000000,28,157,"Wilkinson County, MS",Apr-19,2756,2535,221,8.0
4698,CN2815900000000,28,159,"Winston County, MS",Apr-19,7396,6988,408,5.5
4699,CN2816100000000,28,161,"Yalobusha County, MS",Apr-19,4932,4677,255,5.2
4700,CN2816300000000,28,163,"Yazoo County, MS",Apr-19,9423,8889,534,5.7
4701,CN2900100000000,29,1,"Adair County, MO",Apr-19,10523,10215,308,2.9
4702,CN2900300000000,29,3,"Andrew County, MO",Apr-19,9753,9512,241,2.5
4703,CN2900500000000,29,5,"Atchison County, MO",Apr-19,2836,2727,109,3.8
4704,CN2900700000000,29,7,"Audrain County, MO",Apr-19,10811,10535,276,2.6
4705,CN2900900000000,29,9,"Barry County, MO",Apr-19,15798,15366,432,2.7
4706,CN2901100000000,29,11,"Barton County, MO",Apr-19,5297,5156,141,2.7
4707,CN2901300000000,29,13,"Bates County, MO",Apr-19,7918,7653,265,3.3
4708,CN2901500000000,29,15,"Benton County, MO",Apr-19,7294,7015,279,3.8
4709,CN2901700000000,29,17,"Bollinger County, MO",Apr-19,5493,5324,169,3.1
4710,CN2901900000000,29,19,"Boone County, MO",Apr-19,98838,96946,1892,1.9
4711,CN2902100000000,29,21,"Buchanan County, MO",Apr-19,44419,43229,1190,2.7
4712,CN2902300000000,29,23,"Butler County, MO",Apr-19,18029,17095,934,5.2
4713,CN2902500000000,29,25,"Caldwell County, MO",Apr-19,4389,4279,110,2.5
4714,CN2902700000000,29,27,"Callaway County, MO",Apr-19,21314,20839,475,2.2
4715,CN2902900000000,29,29,"Camden County, MO",Apr-19,18216,17562,654,3.6
4716,CN2903100000000,29,31,"Cape Girardeau County, MO",Apr-19,40558,39623,935,2.3
4717,CN2903300000000,29,33,"Carroll County, MO",Apr-19,4875,4755,120,2.5
4718,CN2903500000000,29,35,"Carter County, MO",Apr-19,2548,2418,130,5.1
4719,CN2903700000000,29,37,"Cass County, MO",Apr-19,54247,52913,1334,2.5
4720,CN2903900000000,29,39,"Cedar County, MO",Apr-19,5855,5684,171,2.9
4721,CN2904100000000,29,41,"Chariton County, MO",Apr-19,3802,3720,82,2.2
4722,CN2904300000000,29,43,"Christian County, MO",Apr-19,44438,43475,963,2.2
4723,CN2904500000000,29,45,"Clark County, MO",Apr-19,3266,3164,102,3.1
4724,CN2904700000000,29,47,"Clay County, MO",Apr-19,134800,131710,3090,2.3
4725,CN2904900000000,29,49,"Clinton County, MO",Apr-19,10700,10441,259,2.4
4726,CN2905100000000,29,51,"Cole County, MO",Apr-19,38815,38019,796,2.1
4727,CN2905300000000,29,53,"Cooper County, MO",Apr-19,7486,7280,206,2.8
4728,CN2905500000000,29,55,"Crawford County, MO",Apr-19,10893,10564,329,3.0
4729,CN2905700000000,29,57,"Dade County, MO",Apr-19,3671,3575,96,2.6
4730,CN2905900000000,29,59,"Dallas County, MO",Apr-19,7061,6823,238,3.4
4731,CN2906100000000,29,61,"Daviess County, MO",Apr-19,4278,4164,114,2.7
4732,CN2906300000000,29,63,"DeKalb County, MO",Apr-19,4903,4769,134,2.7
4733,CN2906500000000,29,65,"Dent County, MO",Apr-19,6277,6104,173,2.8
4734,CN2906700000000,29,67,"Douglas County, MO",Apr-19,5123,4982,141,2.8
4735,CN2906900000000,29,69,"Dunklin County, MO",Apr-19,11922,11348,574,4.8
4736,CN2907100000000,29,71,"Franklin County, MO",Apr-19,52659,51244,1415,2.7
4737,CN2907300000000,29,73,"Gasconade County, MO",Apr-19,7763,7553,210,2.7
4738,CN2907500000000,29,75,"Gentry County, MO",Apr-19,3682,3601,81,2.2
4739,CN2907700000000,29,77,"Greene County, MO",Apr-19,150048,146800,3248,2.2
4740,CN2907900000000,29,79,"Grundy County, MO",Apr-19,4567,4435,132,2.9
4741,CN2908100000000,29,81,"Harrison County, MO",Apr-19,3951,3869,82,2.1
4742,CN2908300000000,29,83,"Henry County, MO",Apr-19,9792,9516,276,2.8
4743,CN2908500000000,29,85,"Hickory County, MO",Apr-19,3830,3706,124,3.2
4744,CN2908700000000,29,87,"Holt County, MO",Apr-19,2693,2623,70,2.6
4745,CN2908900000000,29,89,"Howard County, MO",Apr-19,4976,4864,112,2.3
4746,CN2909100000000,29,91,"Howell County, MO",Apr-19,16320,15847,473,2.9
4747,CN2909300000000,29,93,"Iron County, MO",Apr-19,3537,3410,127,3.6
4748,CN2909500000000,29,95,"Jackson County, MO",Apr-19,357955,346695,11260,3.1
4749,CN2909700000000,29,97,"Jasper County, MO",Apr-19,56486,55120,1366,2.4
4750,CN2909900000000,29,99,"Jefferson County, MO",Apr-19,116451,113414,3037,2.6
4751,CN2910100000000,29,101,"Johnson County, MO",Apr-19,23127,22433,694,3.0
4752,CN2910300000000,29,103,"Knox County, MO",Apr-19,1833,1784,49,2.7
4753,CN2910500000000,29,105,"Laclede County, MO",Apr-19,17196,16470,726,4.2
4754,CN2910700000000,29,107,"Lafayette County, MO",Apr-19,16842,16411,431,2.6
4755,CN2910900000000,29,109,"Lawrence County, MO",Apr-19,18110,17619,491,2.7
4756,CN2911100000000,29,111,"Lewis County, MO",Apr-19,5107,4962,145,2.8
4757,CN2911300000000,29,113,"Lincoln County, MO",Apr-19,28222,27430,792,2.8
4758,CN2911500000000,29,115,"Linn County, MO",Apr-19,5126,4957,169,3.3
4759,CN2911700000000,29,117,"Livingston County, MO",Apr-19,7488,7343,145,1.9
4760,CN2911900000000,29,119,"McDonald County, MO",Apr-19,10573,10290,283,2.7
4761,CN2912100000000,29,121,"Macon County, MO",Apr-19,7641,7439,202,2.6
4762,CN2912300000000,29,123,"Madison County, MO",Apr-19,5497,5339,158,2.9
4763,CN2912500000000,29,125,"Maries County, MO",Apr-19,3963,3838,125,3.2
4764,CN2912700000000,29,127,"Marion County, MO",Apr-19,14546,14165,381,2.6
4765,CN2912900000000,29,129,"Mercer County, MO",Apr-19,2022,1969,53,2.6
4766,CN2913100000000,29,131,"Miller County, MO",Apr-19,12303,11960,343,2.8
4767,CN2913300000000,29,133,"Mississippi County, MO",Apr-19,5878,5702,176,3.0
4768,CN2913500000000,29,135,"Moniteau County, MO",Apr-19,7425,7251,174,2.3
4769,CN2913700000000,29,137,"Monroe County, MO",Apr-19,3917,3786,131,3.3
4770,CN2913900000000,29,139,"Montgomery County, MO",Apr-19,5837,5688,149,2.6
4771,CN2914100000000,29,141,"Morgan County, MO",Apr-19,8009,7747,262,3.3
4772,CN2914300000000,29,143,"New Madrid County, MO",Apr-19,8393,8100,293,3.5
4773,CN2914500000000,29,145,"Newton County, MO",Apr-19,27157,26417,740,2.7
4774,CN2914700000000,29,147,"Nodaway County, MO",Apr-19,11045,10798,247,2.2
4775,CN2914900000000,29,149,"Oregon County, MO",Apr-19,4046,3925,121,3.0
4776,CN2915100000000,29,151,"Osage County, MO",Apr-19,7149,7019,130,1.8
4777,CN2915300000000,29,153,"Ozark County, MO",Apr-19,3497,3346,151,4.3
4778,CN2915500000000,29,155,"Pemiscot County, MO",Apr-19,6428,6176,252,3.9
4779,CN2915700000000,29,157,"Perry County, MO",Apr-19,10156,9936,220,2.2
4780,CN2915900000000,29,159,"Pettis County, MO",Apr-19,20804,20255,549,2.6
4781,CN2916100000000,29,161,"Phelps County, MO",Apr-19,19812,19277,535,2.7
4782,CN2916300000000,29,163,"Pike County, MO",Apr-19,7599,7377,222,2.9
4783,CN2916500000000,29,165,"Platte County, MO",Apr-19,58116,56856,1260,2.2
4784,CN2916700000000,29,167,"Polk County, MO",Apr-19,14490,14080,410,2.8
4785,CN2916900000000,29,169,"Pulaski County, MO",Apr-19,14583,14119,464,3.2
4786,CN2917100000000,29,171,"Putnam County, MO",Apr-19,2391,2325,66,2.8
4787,CN2917300000000,29,173,"Ralls County, MO",Apr-19,5698,5543,155,2.7
4788,CN2917500000000,29,175,"Randolph County, MO",Apr-19,10344,10042,302,2.9
4789,CN2917700000000,29,177,"Ray County, MO",Apr-19,10904,10595,309,2.8
4790,CN2917900000000,29,179,"Reynolds County, MO",Apr-19,3021,2921,100,3.3
4791,CN2918100000000,29,181,"Ripley County, MO",Apr-19,5159,4844,315,6.1
4792,CN2918300000000,29,183,"St. Charles County, MO",Apr-19,224952,220168,4784,2.1
4793,CN2918500000000,29,185,"St. Clair County, MO",Apr-19,3796,3672,124,3.3
4794,CN2918600000000,29,186,"Ste. Genevieve County, MO",Apr-19,9212,9022,190,2.1
4795,CN2918700000000,29,187,"St. Francois County, MO",Apr-19,26457,25695,762,2.9
4796,CN2918900000000,29,189,"St. Louis County, MO",Apr-19,526302,512584,13718,2.6
4797,CN2919500000000,29,195,"Saline County, MO",Apr-19,10842,10567,275,2.5
4798,CN2919700000000,29,197,"Schuyler County, MO",Apr-19,2011,1951,60,3.0
4799,CN2919900000000,29,199,"Scotland County, MO",Apr-19,2451,2390,61,2.5
4800,CN2920100000000,29,201,"Scott County, MO",Apr-19,20177,19631,546,2.7
4801,CN2920300000000,29,203,"Shannon County, MO",Apr-19,3250,3102,148,4.6
4802,CN2920500000000,29,205,"Shelby County, MO",Apr-19,3139,3072,67,2.1
4803,CN2920700000000,29,207,"Stoddard County, MO",Apr-19,13264,12722,542,4.1
4804,CN2920900000000,29,209,"Stone County, MO",Apr-19,13426,12917,509,3.8
4805,CN2921100000000,29,211,"Sullivan County, MO",Apr-19,2792,2717,75,2.7
4806,CN2921300000000,29,213,"Taney County, MO",Apr-19,26236,25276,960,3.7
4807,CN2921500000000,29,215,"Texas County, MO",Apr-19,9204,8879,325,3.5
4808,CN2921700000000,29,217,"Vernon County, MO",Apr-19,9733,9451,282,2.9
4809,CN2921900000000,29,219,"Warren County, MO",Apr-19,17821,17386,435,2.4
4810,CN2922100000000,29,221,"Washington County, MO",Apr-19,10202,9817,385,3.8
4811,CN2922300000000,29,223,"Wayne County, MO",Apr-19,5282,5042,240,4.5
4812,CN2922500000000,29,225,"Webster County, MO",Apr-19,17228,16765,463,2.7
4813,CN2922700000000,29,227,"Worth County, MO",Apr-19,1239,1213,26,2.1
4814,CN2922900000000,29,229,"Wright County, MO",Apr-19,7684,7409,275,3.6
4815,CN2951000000000,29,510,"St. Louis city, MO",Apr-19,151014,145993,5021,3.3
4816,CN3000100000000,30,1,"Beaverhead County, MT",Apr-19,5038,4894,144,2.9
4817,CN3000300000000,30,3,"Big Horn County, MT",Apr-19,4890,4517,373,7.6
4818,CN3000500000000,30,5,"Blaine County, MT",Apr-19,2495,2415,80,3.2
4819,CN3000700000000,30,7,"Broadwater County, MT",Apr-19,2538,2442,96,3.8
4820,CN3000900000000,30,9,"Carbon County, MT",Apr-19,5471,5291,180,3.3
4821,CN3001100000000,30,11,"Carter County, MT",Apr-19,629,611,18,2.9
4822,CN3001300000000,30,13,"Cascade County, MT",Apr-19,37969,36794,1175,3.1
4823,CN3001500000000,30,15,"Chouteau County, MT",Apr-19,2418,2359,59,2.4
4824,CN3001700000000,30,17,"Custer County, MT",Apr-19,6009,5851,158,2.6
4825,CN3001900000000,30,19,"Daniels County, MT",Apr-19,882,870,12,1.4
4826,CN3002100000000,30,21,"Dawson County, MT",Apr-19,4619,4522,97,2.1
4827,CN3002300000000,30,23,"Deer Lodge County, MT",Apr-19,5029,4867,162,3.2
4828,CN3002500000000,30,25,"Fallon County, MT",Apr-19,1687,1661,26,1.5
4829,CN3002700000000,30,27,"Fergus County, MT",Apr-19,6079,5910,169,2.8
4830,CN3002900000000,30,29,"Flathead County, MT",Apr-19,46972,44622,2350,5.0
4831,CN3003100000000,30,31,"Gallatin County, MT",Apr-19,66990,65587,1403,2.1
4832,CN3003300000000,30,33,"Garfield County, MT",Apr-19,736,724,12,1.6
4833,CN3003500000000,30,35,"Glacier County, MT",Apr-19,5455,5042,413,7.6
4834,CN3003700000000,30,37,"Golden Valley County, MT",Apr-19,367,352,15,4.1
4835,CN3003900000000,30,39,"Granite County, MT",Apr-19,1697,1589,108,6.4
4836,CN3004100000000,30,41,"Hill County, MT",Apr-19,7561,7308,253,3.3
4837,CN3004300000000,30,43,"Jefferson County, MT",Apr-19,5641,5468,173,3.1
4838,CN3004500000000,30,45,"Judith Basin County, MT",Apr-19,918,892,26,2.8
4839,CN3004700000000,30,47,"Lake County, MT",Apr-19,13014,12489,525,4.0
4840,CN3004900000000,30,49,"Lewis and Clark County, MT",Apr-19,35453,34505,948,2.7
4841,CN3005100000000,30,51,"Liberty County, MT",Apr-19,968,949,19,2.0
4842,CN3005300000000,30,53,"Lincoln County, MT",Apr-19,7963,7351,612,7.7
4843,CN3005500000000,30,55,"McCone County, MT",Apr-19,943,928,15,1.6
4844,CN3005700000000,30,57,"Madison County, MT",Apr-19,5084,4957,127,2.5
4845,CN3005900000000,30,59,"Meagher County, MT",Apr-19,950,918,32,3.4
4846,CN3006100000000,30,61,"Mineral County, MT",Apr-19,1741,1644,97,5.6
4847,CN3006300000000,30,63,"Missoula County, MT",Apr-19,63578,61632,1946,3.1
4848,CN3006500000000,30,65,"Musselshell County, MT",Apr-19,2266,2182,84,3.7
4849,CN3006700000000,30,67,"Park County, MT",Apr-19,8629,8332,297,3.4
4850,CN3006900000000,30,69,"Petroleum County, MT",Apr-19,278,270,8,2.9
4851,CN3007100000000,30,71,"Phillips County, MT",Apr-19,1886,1813,73,3.9
4852,CN3007300000000,30,73,"Pondera County, MT",Apr-19,2662,2563,99,3.7
4853,CN3007500000000,30,75,"Powder River County, MT",Apr-19,938,922,16,1.7
4854,CN3007700000000,30,77,"Powell County, MT",Apr-19,2914,2794,120,4.1
4855,CN3007900000000,30,79,"Prairie County, MT",Apr-19,470,454,16,3.4
4856,CN3008100000000,30,81,"Ravalli County, MT",Apr-19,20103,19312,791,3.9
4857,CN3008300000000,30,83,"Richland County, MT",Apr-19,5797,5646,151,2.6
4858,CN3008500000000,30,85,"Roosevelt County, MT",Apr-19,4533,4322,211,4.7
4859,CN3008700000000,30,87,"Rosebud County, MT",Apr-19,3781,3605,176,4.7
4860,CN3008900000000,30,89,"Sanders County, MT",Apr-19,4807,4502,305,6.3
4861,CN3009100000000,30,91,"Sheridan County, MT",Apr-19,1752,1720,32,1.8
4862,CN3009300000000,30,93,"Silver Bow County, MT",Apr-19,17086,16451,635,3.7
4863,CN3009500000000,30,95,"Stillwater County, MT",Apr-19,5115,4962,153,3.0
4864,CN3009700000000,30,97,"Sweet Grass County, MT",Apr-19,1763,1713,50,2.8
4865,CN3009900000000,30,99,"Teton County, MT",Apr-19,2739,2654,85,3.1
4866,CN3010100000000,30,101,"Toole County, MT",Apr-19,2091,2053,38,1.8
4867,CN3010300000000,30,103,"Treasure County, MT",Apr-19,334,325,9,2.7
4868,CN3010500000000,30,105,"Valley County, MT",Apr-19,4023,3910,113,2.8
4869,CN3010700000000,30,107,"Wheatland County, MT",Apr-19,774,751,23,3.0
4870,CN3010900000000,30,109,"Wibaux County, MT",Apr-19,450,436,14,3.1
4871,CN3011100000000,30,111,"Yellowstone County, MT",Apr-19,81651,79269,2382,2.9
4872,CN3100100000000,31,1,"Adams County, NE",Apr-19,16699,16207,492,2.9
4873,CN3100300000000,31,3,"Antelope County, NE",Apr-19,3524,3434,90,2.6
4874,CN3100500000000,31,5,"Arthur County, NE",Apr-19,223,211,12,5.4
4875,CN3100700000000,31,7,"Banner County, NE",Apr-19,383,368,15,3.9
4876,CN3100900000000,31,9,"Blaine County, NE",Apr-19,263,251,12,4.6
4877,CN3101100000000,31,11,"Boone County, NE",Apr-19,2951,2878,73,2.5
4878,CN3101300000000,31,13,"Box Butte County, NE",Apr-19,5454,5275,179,3.3
4879,CN3101500000000,31,15,"Boyd County, NE",Apr-19,1080,1037,43,4.0
4880,CN3101700000000,31,17,"Brown County, NE",Apr-19,1391,1343,48,3.5
4881,CN3101900000000,31,19,"Buffalo County, NE",Apr-19,27879,27186,693,2.5
4882,CN3102100000000,31,21,"Burt County, NE",Apr-19,3553,3450,103,2.9
4883,CN3102300000000,31,23,"Butler County, NE",Apr-19,4619,4499,120,2.6
4884,CN3102500000000,31,25,"Cass County, NE",Apr-19,13504,13051,453,3.4
4885,CN3102700000000,31,27,"Cedar County, NE",Apr-19,4500,4384,116,2.6
4886,CN3102900000000,31,29,"Chase County, NE",Apr-19,2277,2226,51,2.2
4887,CN3103100000000,31,31,"Cherry County, NE",Apr-19,3376,3300,76,2.3
4888,CN3103300000000,31,33,"Cheyenne County, NE",Apr-19,4429,4275,154,3.5
4889,CN3103500000000,31,35,"Clay County, NE",Apr-19,3299,3196,103,3.1
4890,CN3103700000000,31,37,"Colfax County, NE",Apr-19,5560,5416,144,2.6
4891,CN3103900000000,31,39,"Cuming County, NE",Apr-19,4708,4590,118,2.5
4892,CN3104100000000,31,41,"Custer County, NE",Apr-19,6471,6308,163,2.5
4893,CN3104300000000,31,43,"Dakota County, NE",Apr-19,10740,10365,375,3.5
4894,CN3104500000000,31,45,"Dawes County, NE",Apr-19,5070,4932,138,2.7
4895,CN3104700000000,31,47,"Dawson County, NE",Apr-19,13033,12659,374,2.9
4896,CN3104900000000,31,49,"Deuel County, NE",Apr-19,945,918,27,2.9
4897,CN3105100000000,31,51,"Dixon County, NE",Apr-19,3048,2948,100,3.3
4898,CN3105300000000,31,53,"Dodge County, NE",Apr-19,19400,18852,548,2.8
4899,CN3105500000000,31,55,"Douglas County, NE",Apr-19,297705,288217,9488,3.2
4900,CN3105700000000,31,57,"Dundy County, NE",Apr-19,1182,1152,30,2.5
4901,CN3105900000000,31,59,"Fillmore County, NE",Apr-19,3205,3115,90,2.8
4902,CN3106100000000,31,61,"Franklin County, NE",Apr-19,1485,1438,47,3.2
4903,CN3106300000000,31,63,"Frontier County, NE",Apr-19,1643,1596,47,2.9
4904,CN3106500000000,31,65,"Furnas County, NE",Apr-19,2611,2543,68,2.6
4905,CN3106700000000,31,67,"Gage County, NE",Apr-19,10991,10644,347,3.2
4906,CN3106900000000,31,69,"Garden County, NE",Apr-19,1094,1062,32,2.9
4907,CN3107100000000,31,71,"Garfield County, NE",Apr-19,1154,1124,30,2.6
4908,CN3107300000000,31,73,"Gosper County, NE",Apr-19,1094,1064,30,2.7
4909,CN3107500000000,31,75,"Grant County, NE",Apr-19,428,418,10,2.3
4910,CN3107700000000,31,77,"Greeley County, NE",Apr-19,1242,1204,38,3.1
4911,CN3107900000000,31,79,"Hall County, NE",Apr-19,31875,30900,975,3.1
4912,CN3108100000000,31,81,"Hamilton County, NE",Apr-19,4775,4645,130,2.7
4913,CN3108300000000,31,83,"Harlan County, NE",Apr-19,1792,1745,47,2.6
4914,CN3108500000000,31,85,"Hayes County, NE",Apr-19,617,600,17,2.8
4915,CN3108700000000,31,87,"Hitchcock County, NE",Apr-19,1267,1224,43,3.4
4916,CN3108900000000,31,89,"Holt County, NE",Apr-19,5780,5634,146,2.5
4917,CN3109100000000,31,91,"Hooker County, NE",Apr-19,371,358,13,3.5
4918,CN3109300000000,31,93,"Howard County, NE",Apr-19,3359,3264,95,2.8
4919,CN3109500000000,31,95,"Jefferson County, NE",Apr-19,4115,4012,103,2.5
4920,CN3109700000000,31,97,"Johnson County, NE",Apr-19,2091,2025,66,3.2
4921,CN3109900000000,31,99,"Kearney County, NE",Apr-19,3791,3706,85,2.2
4922,CN3110100000000,31,101,"Keith County, NE",Apr-19,4547,4416,131,2.9
4923,CN3110300000000,31,103,"Keya Paha County, NE",Apr-19,589,574,15,2.5
4924,CN3110500000000,31,105,"Kimball County, NE",Apr-19,2050,1984,66,3.2
4925,CN3110700000000,31,107,"Knox County, NE",Apr-19,4590,4452,138,3.0
4926,CN3110900000000,31,109,"Lancaster County, NE",Apr-19,176835,172090,4745,2.7
4927,CN3111100000000,31,111,"Lincoln County, NE",Apr-19,18221,17633,588,3.2
4928,CN3111300000000,31,113,"Logan County, NE",Apr-19,480,467,13,2.7
4929,CN3111500000000,31,115,"Loup County, NE",Apr-19,400,388,12,3.0
4930,CN3111700000000,31,117,"McPherson County, NE",Apr-19,446,434,12,2.7
4931,CN3111900000000,31,119,"Madison County, NE",Apr-19,19720,19179,541,2.7
4932,CN3112100000000,31,121,"Merrick County, NE",Apr-19,4015,3904,111,2.8
4933,CN3112300000000,31,123,"Morrill County, NE",Apr-19,2576,2505,71,2.8
4934,CN3112500000000,31,125,"Nance County, NE",Apr-19,1985,1927,58,2.9
4935,CN3112700000000,31,127,"Nemaha County, NE",Apr-19,3637,3509,128,3.5
4936,CN3112900000000,31,129,"Nuckolls County, NE",Apr-19,2332,2274,58,2.5
4937,CN3113100000000,31,131,"Otoe County, NE",Apr-19,8419,8137,282,3.3
4938,CN3113300000000,31,133,"Pawnee County, NE",Apr-19,1493,1451,42,2.8
4939,CN3113500000000,31,135,"Perkins County, NE",Apr-19,1838,1796,42,2.3
4940,CN3113700000000,31,137,"Phelps County, NE",Apr-19,4956,4831,125,2.5
4941,CN3113900000000,31,139,"Pierce County, NE",Apr-19,4084,3986,98,2.4
4942,CN3114100000000,31,141,"Platte County, NE",Apr-19,17507,17010,497,2.8
4943,CN3114300000000,31,143,"Polk County, NE",Apr-19,2935,2862,73,2.5
4944,CN3114500000000,31,145,"Red Willow County, NE",Apr-19,5819,5663,156,2.7
4945,CN3114700000000,31,147,"Richardson County, NE",Apr-19,4242,4107,135,3.2
4946,CN3114900000000,31,149,"Rock County, NE",Apr-19,863,836,27,3.1
4947,CN3115100000000,31,151,"Saline County, NE",Apr-19,7424,7201,223,3.0
4948,CN3115300000000,31,153,"Sarpy County, NE",Apr-19,96031,93304,2727,2.8
4949,CN3115500000000,31,155,"Saunders County, NE",Apr-19,11110,10796,314,2.8
4950,CN3115700000000,31,157,"Scotts Bluff County, NE",Apr-19,18231,17548,683,3.7
4951,CN3115900000000,31,159,"Seward County, NE",Apr-19,8918,8667,251,2.8
4952,CN3116100000000,31,161,"Sheridan County, NE",Apr-19,2681,2603,78,2.9
4953,CN3116300000000,31,163,"Sherman County, NE",Apr-19,1703,1653,50,2.9
4954,CN3116500000000,31,165,"Sioux County, NE",Apr-19,740,718,22,3.0
4955,CN3116700000000,31,167,"Stanton County, NE",Apr-19,3412,3322,90,2.6
4956,CN3116900000000,31,169,"Thayer County, NE",Apr-19,2828,2753,75,2.7
4957,CN3117100000000,31,171,"Thomas County, NE",Apr-19,418,405,13,3.1
4958,CN3117300000000,31,173,"Thurston County, NE",Apr-19,3029,2888,141,4.7
4959,CN3117500000000,31,175,"Valley County, NE",Apr-19,2114,2046,68,3.2
4960,CN3117700000000,31,177,"Washington County, NE",Apr-19,11213,10904,309,2.8
4961,CN3117900000000,31,179,"Wayne County, NE",Apr-19,5842,5704,138,2.4
4962,CN3118100000000,31,181,"Webster County, NE",Apr-19,1681,1628,53,3.2
4963,CN3118300000000,31,183,"Wheeler County, NE",Apr-19,599,582,17,2.8
4964,CN3118500000000,31,185,"York County, NE",Apr-19,7283,7092,191,2.6
4965,CN3200100000000,32,1,"Churchill County, NV",Apr-19,10934,10527,407,3.7
4966,CN3200300000000,32,3,"Clark County, NV",Apr-19,1124041,1078572,45469,4.0
4967,CN3200500000000,32,5,"Douglas County, NV",Apr-19,22825,21857,968,4.2
4968,CN3200700000000,32,7,"Elko County, NV",Apr-19,27536,26702,834,3.0
4969,CN3200900000000,32,9,"Esmeralda County, NV",Apr-19,413,401,12,2.9
4970,CN3201100000000,32,11,"Eureka County, NV",Apr-19,1089,1062,27,2.5
4971,CN3201300000000,32,13,"Humboldt County, NV",Apr-19,8217,7987,230,2.8
4972,CN3201500000000,32,15,"Lander County, NV",Apr-19,3209,3108,101,3.1
4973,CN3201700000000,32,17,"Lincoln County, NV",Apr-19,2076,1988,88,4.2
4974,CN3201900000000,32,19,"Lyon County, NV",Apr-19,23461,22338,1123,4.8
4975,CN3202100000000,32,21,"Mineral County, NV",Apr-19,2033,1950,83,4.1
4976,CN3202300000000,32,23,"Nye County, NV",Apr-19,17095,16190,905,5.3
4977,CN3202700000000,32,27,"Pershing County, NV",Apr-19,2548,2439,109,4.3
4978,CN3202900000000,32,29,"Storey County, NV",Apr-19,2018,1938,80,4.0
4979,CN3203100000000,32,31,"Washoe County, NV",Apr-19,253514,245173,8341,3.3
4980,CN3203300000000,32,33,"White Pine County, NV",Apr-19,4592,4451,141,3.1
4981,CN3251000000000,32,510,"Carson City, NV",Apr-19,26084,25028,1056,4.0
4982,CN3300100000000,33,1,"Belknap County, NH",Apr-19,30490,29695,795,2.6
4983,CN3300300000000,33,3,"Carroll County, NH",Apr-19,22441,21779,662,2.9
4984,CN3300500000000,33,5,"Cheshire County, NH",Apr-19,41033,40006,1027,2.5
4985,CN3300700000000,33,7,"Coos County, NH",Apr-19,14235,13698,537,3.8
4986,CN3300900000000,33,9,"Grafton County, NH",Apr-19,48905,47820,1085,2.2
4987,CN3301100000000,33,11,"Hillsborough County, NH",Apr-19,241634,235496,6138,2.5
4988,CN3301300000000,33,13,"Merrimack County, NH",Apr-19,83268,81455,1813,2.2
4989,CN3301500000000,33,15,"Rockingham County, NH",Apr-19,186420,181443,4977,2.7
4990,CN3301700000000,33,17,"Strafford County, NH",Apr-19,74556,72868,1688,2.3
4991,CN3301900000000,33,19,"Sullivan County, NH",Apr-19,22998,22474,524,2.3
4992,CN3400100000000,34,1,"Atlantic County, NJ",Apr-19,118301,113381,4920,4.2
4993,CN3400300000000,34,3,"Bergen County, NJ",Apr-19,475513,464806,10707,2.3
4994,CN3400500000000,34,5,"Burlington County, NJ",Apr-19,228031,222237,5794,2.5
4995,CN3400700000000,34,7,"Camden County, NJ",Apr-19,249834,241837,7997,3.2
4996,CN3400900000000,34,9,"Cape May County, NJ",Apr-19,41418,38367,3051,7.4
4997,CN3401100000000,34,11,"Cumberland County, NJ",Apr-19,64732,61851,2881,4.5
4998,CN3401300000000,34,13,"Essex County, NJ",Apr-19,363255,350320,12935,3.6
4999,CN3401500000000,34,15,"Gloucester County, NJ",Apr-19,147854,143691,4163,2.8
5000,CN3401700000000,34,17,"Hudson County, NJ",Apr-19,356236,347066,9170,2.6
5001,CN3401900000000,34,19,"Hunterdon County, NJ",Apr-19,63792,62457,1335,2.1
5002,CN3402100000000,34,21,"Mercer County, NJ",Apr-19,198761,193914,4847,2.4
5003,CN3402300000000,34,23,"Middlesex County, NJ",Apr-19,431162,420656,10506,2.4
5004,CN3402500000000,34,25,"Monmouth County, NJ",Apr-19,322775,314565,8210,2.5
5005,CN3402700000000,34,27,"Morris County, NJ",Apr-19,253668,248061,5607,2.2
5006,CN3402900000000,34,29,"Ocean County, NJ",Apr-19,269673,261761,7912,2.9
5007,CN3403100000000,34,31,"Passaic County, NJ",Apr-19,238587,230307,8280,3.5
5008,CN3403300000000,34,33,"Salem County, NJ",Apr-19,28971,27875,1096,3.8
5009,CN3403500000000,34,35,"Somerset County, NJ",Apr-19,169259,165335,3924,2.3
5010,CN3403700000000,34,37,"Sussex County, NJ",Apr-19,73024,71062,1962,2.7
5011,CN3403900000000,34,39,"Union County, NJ",Apr-19,272771,264718,8053,3.0
5012,CN3404100000000,34,41,"Warren County, NJ",Apr-19,55324,53871,1453,2.6
5013,CN3500100000000,35,1,"Bernalillo County, NM",Apr-19,331488,318289,13199,4.0
5014,CN3500300000000,35,3,"Catron County, NM",Apr-19,1096,1032,64,5.8
5015,CN3500500000000,35,5,"Chaves County, NM",Apr-19,27015,25881,1134,4.2
5016,CN3500600000000,35,6,"Cibola County, NM",Apr-19,8850,8350,500,5.6
5017,CN3500700000000,35,7,"Colfax County, NM",Apr-19,4999,4744,255,5.1
5018,CN3500900000000,35,9,"Curry County, NM",Apr-19,21772,20984,788,3.6
5019,CN3501100000000,35,11,"De Baca County, NM",Apr-19,774,745,29,3.7
5020,CN3501300000000,35,13,"Dona Ana County, NM",Apr-19,96675,91348,5327,5.5
5021,CN3501500000000,35,15,"Eddy County, NM",Apr-19,33571,32662,909,2.7
5022,CN3501700000000,35,17,"Grant County, NM",Apr-19,12206,11677,529,4.3
5023,CN3501900000000,35,19,"Guadalupe County, NM",Apr-19,1533,1453,80,5.2
5024,CN3502100000000,35,21,"Harding County, NM",Apr-19,257,244,13,5.1
5025,CN3502300000000,35,23,"Hidalgo County, NM",Apr-19,2087,2013,74,3.5
5026,CN3502500000000,35,25,"Lea County, NM",Apr-19,30736,29703,1033,3.4
5027,CN3502700000000,35,27,"Lincoln County, NM",Apr-19,8797,8422,375,4.3
5028,CN3502800000000,35,28,"Los Alamos County, NM",Apr-19,9311,9043,268,2.9
5029,CN3502900000000,35,29,"Luna County, NM",Apr-19,10032,8594,1438,14.3
5030,CN3503100000000,35,31,"McKinley County, NM",Apr-19,24070,22600,1470,6.1
5031,CN3503300000000,35,33,"Mora County, NM",Apr-19,2174,2053,121,5.6
5032,CN3503500000000,35,35,"Otero County, NM",Apr-19,24563,23484,1079,4.4
5033,CN3503700000000,35,37,"Quay County, NM",Apr-19,3282,3119,163,5.0
5034,CN3503900000000,35,39,"Rio Arriba County, NM",Apr-19,16724,15921,803,4.8
5035,CN3504100000000,35,41,"Roosevelt County, NM",Apr-19,7903,7602,301,3.8
5036,CN3504300000000,35,43,"Sandoval County, NM",Apr-19,65929,63088,2841,4.3
5037,CN3504500000000,35,45,"San Juan County, NM",Apr-19,51885,49334,2551,4.9
5038,CN3504700000000,35,47,"San Miguel County, NM",Apr-19,10883,10313,570,5.2
5039,CN3504900000000,35,49,"Santa Fe County, NM",Apr-19,73569,70846,2723,3.7
5040,CN3505100000000,35,51,"Sierra County, NM",Apr-19,3737,3448,289,7.7
5041,CN3505300000000,35,53,"Socorro County, NM",Apr-19,6410,6093,317,4.9
5042,CN3505500000000,35,55,"Taos County, NM",Apr-19,14806,13936,870,5.9
5043,CN3505700000000,35,57,"Torrance County, NM",Apr-19,5558,5217,341,6.1
5044,CN3505900000000,35,59,"Union County, NM",Apr-19,1841,1787,54,2.9
5045,CN3506100000000,35,61,"Valencia County, NM",Apr-19,30429,28977,1452,4.8
5046,CN3600100000000,36,1,"Albany County, NY",Apr-19,156127,151009,5118,3.3
5047,CN3600300000000,36,3,"Allegany County, NY",Apr-19,19262,18271,991,5.1
5048,CN3600500000000,36,5,"Bronx County, NY",Apr-19,595453,565719,29734,5.0
5049,CN3600700000000,36,7,"Broome County, NY",Apr-19,83137,79590,3547,4.3
5050,CN3600900000000,36,9,"Cattaraugus County, NY",Apr-19,33010,31440,1570,4.8
5051,CN3601100000000,36,11,"Cayuga County, NY",Apr-19,35251,33860,1391,3.9
5052,CN3601300000000,36,13,"Chautauqua County, NY",Apr-19,53593,51234,2359,4.4
5053,CN3601500000000,36,15,"Chemung County, NY",Apr-19,34754,33421,1333,3.8
5054,CN3601700000000,36,17,"Chenango County, NY",Apr-19,21516,20635,881,4.1
5055,CN3601900000000,36,19,"Clinton County, NY",Apr-19,35827,34315,1512,4.2
5056,CN3602100000000,36,21,"Columbia County, NY",Apr-19,30581,29666,915,3.0
5057,CN3602300000000,36,23,"Cortland County, NY",Apr-19,22760,21707,1053,4.6
5058,CN3602500000000,36,25,"Delaware County, NY",Apr-19,18681,17855,826,4.4
5059,CN3602700000000,36,27,"Dutchess County, NY",Apr-19,142832,138226,4606,3.2
5060,CN3602900000000,36,29,"Erie County, NY",Apr-19,436664,420168,16496,3.8
5061,CN3603100000000,36,31,"Essex County, NY",Apr-19,15767,14911,856,5.4
5062,CN3603300000000,36,33,"Franklin County, NY",Apr-19,19034,18071,963,5.1
5063,CN3603500000000,36,35,"Fulton County, NY",Apr-19,22306,21255,1051,4.7
5064,CN3603700000000,36,37,"Genesee County, NY",Apr-19,29075,27998,1077,3.7
5065,CN3603900000000,36,39,"Greene County, NY",Apr-19,19546,18681,865,4.4
5066,CN3604100000000,36,41,"Hamilton County, NY",Apr-19,2024,1857,167,8.3
5067,CN3604300000000,36,43,"Herkimer County, NY",Apr-19,27643,26396,1247,4.5
5068,CN3604500000000,36,45,"Jefferson County, NY",Apr-19,43014,40690,2324,5.4
5069,CN3604700000000,36,47,"Kings County, NY",Apr-19,1196624,1150800,45824,3.8
5070,CN3604900000000,36,49,"Lewis County, NY",Apr-19,11316,10635,681,6.0
5071,CN3605100000000,36,51,"Livingston County, NY",Apr-19,30438,29206,1232,4.0
5072,CN3605300000000,36,53,"Madison County, NY",Apr-19,32166,30872,1294,4.0
5073,CN3605500000000,36,55,"Monroe County, NY",Apr-19,359498,346164,13334,3.7
5074,CN3605700000000,36,57,"Montgomery County, NY",Apr-19,21930,20876,1054,4.8
5075,CN3605900000000,36,59,"Nassau County, NY",Apr-19,700948,679915,21033,3.0
5076,CN3606100000000,36,61,"New York County, NY",Apr-19,911126,880891,30235,3.3
5077,CN3606300000000,36,63,"Niagara County, NY",Apr-19,97632,93242,4390,4.5
5078,CN3606500000000,36,65,"Oneida County, NY",Apr-19,100391,96447,3944,3.9
5079,CN3606700000000,36,67,"Onondaga County, NY",Apr-19,217915,210186,7729,3.5
5080,CN3606900000000,36,69,"Ontario County, NY",Apr-19,55038,53046,1992,3.6
5081,CN3607100000000,36,71,"Orange County, NY",Apr-19,183113,176976,6137,3.4
5082,CN3607300000000,36,73,"Orleans County, NY",Apr-19,17258,16538,720,4.2
5083,CN3607500000000,36,75,"Oswego County, NY",Apr-19,52238,49622,2616,5.0
5084,CN3607700000000,36,77,"Otsego County, NY",Apr-19,27719,26672,1047,3.8
5085,CN3607900000000,36,79,"Putnam County, NY",Apr-19,50858,49194,1664,3.3
5086,CN3608100000000,36,81,"Queens County, NY",Apr-19,1137831,1100884,36947,3.2
5087,CN3608300000000,36,83,"Rensselaer County, NY",Apr-19,80376,77663,2713,3.4
5088,CN3608500000000,36,85,"Richmond County, NY",Apr-19,221683,213682,8001,3.6
5089,CN3608700000000,36,87,"Rockland County, NY",Apr-19,154212,149408,4804,3.1
5090,CN3608900000000,36,89,"St. Lawrence County, NY",Apr-19,42856,40557,2299,5.4
5091,CN3609100000000,36,91,"Saratoga County, NY",Apr-19,118046,114366,3680,3.1
5092,CN3609300000000,36,93,"Schenectady County, NY",Apr-19,75407,72781,2626,3.5
5093,CN3609500000000,36,95,"Schoharie County, NY",Apr-19,14405,13798,607,4.2
5094,CN3609700000000,36,97,"Schuyler County, NY",Apr-19,7955,7596,359,4.5
5095,CN3609900000000,36,99,"Seneca County, NY",Apr-19,15714,15183,531,3.4
5096,CN3610100000000,36,101,"Steuben County, NY",Apr-19,41928,40118,1810,4.3
5097,CN3610300000000,36,103,"Suffolk County, NY",Apr-19,768876,744398,24478,3.2
5098,CN3610500000000,36,105,"Sullivan County, NY",Apr-19,35525,34243,1282,3.6
5099,CN3610700000000,36,107,"Tioga County, NY",Apr-19,22566,21719,847,3.8
5100,CN3610900000000,36,109,"Tompkins County, NY",Apr-19,49954,48371,1583,3.2
5101,CN3611100000000,36,111,"Ulster County, NY",Apr-19,86796,83912,2884,3.3
5102,CN3611300000000,36,113,"Warren County, NY",Apr-19,30443,28995,1448,4.8
5103,CN3611500000000,36,115,"Washington County, NY",Apr-19,26814,25750,1064,4.0
5104,CN3611700000000,36,117,"Wayne County, NY",Apr-19,43323,41724,1599,3.7
5105,CN3611900000000,36,119,"Westchester County, NY",Apr-19,481366,465600,15766,3.3
5106,CN3612100000000,36,121,"Wyoming County, NY",Apr-19,17670,16959,711,4.0
5107,CN3612300000000,36,123,"Yates County, NY",Apr-19,11607,11208,399,3.4
5108,CN3700100000000,37,1,"Alamance County, NC",Apr-19,81976,79147,2829,3.5
5109,CN3700300000000,37,3,"Alexander County, NC",Apr-19,18143,17589,554,3.1
5110,CN3700500000000,37,5,"Alleghany County, NC",Apr-19,4361,4160,201,4.6
5111,CN3700700000000,37,7,"Anson County, NC",Apr-19,10737,10335,402,3.7
5112,CN3700900000000,37,9,"Ashe County, NC",Apr-19,12773,12322,451,3.5
5113,CN3701100000000,37,11,"Avery County, NC",Apr-19,7112,6852,260,3.7
5114,CN3701300000000,37,13,"Beaufort County, NC",Apr-19,19552,18707,845,4.3
5115,CN3701500000000,37,15,"Bertie County, NC",Apr-19,7811,7450,361,4.6
5116,CN3701700000000,37,17,"Bladen County, NC",Apr-19,14502,13861,641,4.4
5117,CN3701900000000,37,19,"Brunswick County, NC",Apr-19,54187,51664,2523,4.7
5118,CN3702100000000,37,21,"Buncombe County, NC",Apr-19,141169,137358,3811,2.7
5119,CN3702300000000,37,23,"Burke County, NC",Apr-19,41176,39798,1378,3.3
5120,CN3702500000000,37,25,"Cabarrus County, NC",Apr-19,108881,105345,3536,3.2
5121,CN3702700000000,37,27,"Caldwell County, NC",Apr-19,36743,35374,1369,3.7
5122,CN3702900000000,37,29,"Camden County, NC",Apr-19,4668,4505,163,3.5
5123,CN3703100000000,37,31,"Carteret County, NC",Apr-19,31867,30547,1320,4.1
5124,CN3703300000000,37,33,"Caswell County, NC",Apr-19,9930,9508,422,4.2
5125,CN3703500000000,37,35,"Catawba County, NC",Apr-19,79333,76761,2572,3.2
5126,CN3703700000000,37,37,"Chatham County, NC",Apr-19,35674,34569,1105,3.1
5127,CN3703900000000,37,39,"Cherokee County, NC",Apr-19,11255,10804,451,4.0
5128,CN3704100000000,37,41,"Chowan County, NC",Apr-19,5534,5282,252,4.6
5129,CN3704300000000,37,43,"Clay County, NC",Apr-19,4151,3989,162,3.9
5130,CN3704500000000,37,45,"Cleveland County, NC",Apr-19,48671,46937,1734,3.6
5131,CN3704700000000,37,47,"Columbus County, NC",Apr-19,22610,21603,1007,4.5
5132,CN3704900000000,37,49,"Craven County, NC",Apr-19,41816,40244,1572,3.8
5133,CN3705100000000,37,51,"Cumberland County, NC",Apr-19,129023,123078,5945,4.6
5134,CN3705300000000,37,53,"Currituck County, NC",Apr-19,14014,13548,466,3.3
5135,CN3705500000000,37,55,"Dare County, NC",Apr-19,19505,18618,887,4.5
5136,CN3705700000000,37,57,"Davidson County, NC",Apr-19,81570,78844,2726,3.3
5137,CN3705900000000,37,59,"Davie County, NC",Apr-19,20829,20201,628,3.0
5138,CN3706100000000,37,61,"Duplin County, NC",Apr-19,25277,24334,943,3.7
5139,CN3706300000000,37,63,"Durham County, NC",Apr-19,171727,166256,5471,3.2
5140,CN3706500000000,37,65,"Edgecombe County, NC",Apr-19,21296,20087,1209,5.7
5141,CN3706700000000,37,67,"Forsyth County, NC",Apr-19,189341,182987,6354,3.4
5142,CN3706900000000,37,69,"Franklin County, NC",Apr-19,31279,30124,1155,3.7
5143,CN3707100000000,37,71,"Gaston County, NC",Apr-19,110866,106937,3929,3.5
5144,CN3707300000000,37,73,"Gates County, NC",Apr-19,5335,5134,201,3.8
5145,CN3707500000000,37,75,"Graham County, NC",Apr-19,3231,3072,159,4.9
5146,CN3707700000000,37,77,"Granville County, NC",Apr-19,30324,29370,954,3.1
5147,CN3707900000000,37,79,"Greene County, NC",Apr-19,9611,9273,338,3.5
5148,CN3708100000000,37,81,"Guilford County, NC",Apr-19,265038,255292,9746,3.7
5149,CN3708300000000,37,83,"Halifax County, NC",Apr-19,20498,19460,1038,5.1
5150,CN3708500000000,37,85,"Harnett County, NC",Apr-19,53539,51274,2265,4.2
5151,CN3708700000000,37,87,"Haywood County, NC",Apr-19,30141,29195,946,3.1
5152,CN3708900000000,37,89,"Henderson County, NC",Apr-19,55446,53760,1686,3.0
5153,CN3709100000000,37,91,"Hertford County, NC",Apr-19,9207,8774,433,4.7
5154,CN3709300000000,37,93,"Hoke County, NC",Apr-19,20312,19421,891,4.4
5155,CN3709500000000,37,95,"Hyde County, NC",Apr-19,1957,1798,159,8.1
5156,CN3709700000000,37,97,"Iredell County, NC",Apr-19,89306,86405,2901,3.2
5157,CN3709900000000,37,99,"Jackson County, NC",Apr-19,19637,18885,752,3.8
5158,CN3710100000000,37,101,"Johnston County, NC",Apr-19,99064,95786,3278,3.3
5159,CN3710300000000,37,103,"Jones County, NC",Apr-19,4422,4262,160,3.6
5160,CN3710500000000,37,105,"Lee County, NC",Apr-19,26184,25089,1095,4.2
5161,CN3710700000000,37,107,"Lenoir County, NC",Apr-19,28166,27181,985,3.5
5162,CN3710900000000,37,109,"Lincoln County, NC",Apr-19,43372,41978,1394,3.2
5163,CN3711100000000,37,111,"McDowell County, NC",Apr-19,20980,20276,704,3.4
5164,CN3711300000000,37,113,"Macon County, NC",Apr-19,15382,14800,582,3.8
5165,CN3711500000000,37,115,"Madison County, NC",Apr-19,10224,9891,333,3.3
5166,CN3711700000000,37,117,"Martin County, NC",Apr-19,9145,8699,446,4.9
5167,CN3711900000000,37,119,"Mecklenburg County, NC",Apr-19,620869,599812,21057,3.4
5168,CN3712100000000,37,121,"Mitchell County, NC",Apr-19,6065,5804,261,4.3
5169,CN3712300000000,37,123,"Montgomery County, NC",Apr-19,11600,11198,402,3.5
5170,CN3712500000000,37,125,"Moore County, NC",Apr-19,42911,41424,1487,3.5
5171,CN3712700000000,37,127,"Nash County, NC",Apr-19,43232,41279,1953,4.5
5172,CN3712900000000,37,129,"New Hanover County, NC",Apr-19,124098,119999,4099,3.3
5173,CN3713100000000,37,131,"Northampton County, NC",Apr-19,7800,7439,361,4.6
5174,CN3713300000000,37,133,"Onslow County, NC",Apr-19,65523,62732,2791,4.3
5175,CN3713500000000,37,135,"Orange County, NC",Apr-19,78891,76580,2311,2.9
5176,CN3713700000000,37,137,"Pamlico County, NC",Apr-19,5363,5172,191,3.6
5177,CN3713900000000,37,139,"Pasquotank County, NC",Apr-19,16759,16081,678,4.0
5178,CN3714100000000,37,141,"Pender County, NC",Apr-19,28922,27878,1044,3.6
5179,CN3714300000000,37,143,"Perquimans County, NC",Apr-19,4989,4757,232,4.7
5180,CN3714500000000,37,145,"Person County, NC",Apr-19,18512,17783,729,3.9
5181,CN3714700000000,37,147,"Pitt County, NC",Apr-19,90534,87190,3344,3.7
5182,CN3714900000000,37,149,"Polk County, NC",Apr-19,8985,8675,310,3.5
5183,CN3715100000000,37,151,"Randolph County, NC",Apr-19,66963,64677,2286,3.4
5184,CN3715300000000,37,153,"Richmond County, NC",Apr-19,16676,15880,796,4.8
5185,CN3715500000000,37,155,"Robeson County, NC",Apr-19,50069,47601,2468,4.9
5186,CN3715700000000,37,157,"Rockingham County, NC",Apr-19,40528,38909,1619,4.0
5187,CN3715900000000,37,159,"Rowan County, NC",Apr-19,66001,63641,2360,3.6
5188,CN3716100000000,37,161,"Rutherford County, NC",Apr-19,25402,24273,1129,4.4
5189,CN3716300000000,37,163,"Sampson County, NC",Apr-19,29475,28447,1028,3.5
5190,CN3716500000000,37,165,"Scotland County, NC",Apr-19,11580,10895,685,5.9
5191,CN3716700000000,37,167,"Stanly County, NC",Apr-19,30280,29282,998,3.3
5192,CN3716900000000,37,169,"Stokes County, NC",Apr-19,21869,21158,711,3.3
5193,CN3717100000000,37,171,"Surry County, NC",Apr-19,34296,33167,1129,3.3
5194,CN3717300000000,37,173,"Swain County, NC",Apr-19,6929,6651,278,4.0
5195,CN3717500000000,37,175,"Transylvania County, NC",Apr-19,14481,13979,502,3.5
5196,CN3717700000000,37,177,"Tyrrell County, NC",Apr-19,1467,1375,92,6.3
5197,CN3717900000000,37,179,"Union County, NC",Apr-19,123579,119699,3880,3.1
5198,CN3718100000000,37,181,"Vance County, NC",Apr-19,17456,16541,915,5.2
5199,CN3718300000000,37,183,"Wake County, NC",Apr-19,595332,576965,18367,3.1
5200,CN3718500000000,37,185,"Warren County, NC",Apr-19,6555,6205,350,5.3
5201,CN3718700000000,37,187,"Washington County, NC",Apr-19,4446,4196,250,5.6
5202,CN3718900000000,37,189,"Watauga County, NC",Apr-19,29041,28136,905,3.1
5203,CN3719100000000,37,191,"Wayne County, NC",Apr-19,52676,50659,2017,3.8
5204,CN3719300000000,37,193,"Wilkes County, NC",Apr-19,29247,28167,1080,3.7
5205,CN3719500000000,37,195,"Wilson County, NC",Apr-19,34874,32972,1902,5.5
5206,CN3719700000000,37,197,"Yadkin County, NC",Apr-19,17908,17354,554,3.1
5207,CN3719900000000,37,199,"Yancey County, NC",Apr-19,8426,8145,281,3.3
5208,CN3800100000000,38,1,"Adams County, ND",Apr-19,1029,1008,21,2.0
5209,CN3800300000000,38,3,"Barnes County, ND",Apr-19,5177,5038,139,2.7
5210,CN3800500000000,38,5,"Benson County, ND",Apr-19,2277,2164,113,5.0
5211,CN3800700000000,38,7,"Billings County, ND",Apr-19,378,369,9,2.4
5212,CN3800900000000,38,9,"Bottineau County, ND",Apr-19,2895,2782,113,3.9
5213,CN3801100000000,38,11,"Bowman County, ND",Apr-19,1727,1699,28,1.6
5214,CN3801300000000,38,13,"Burke County, ND",Apr-19,1104,1077,27,2.4
5215,CN3801500000000,38,15,"Burleigh County, ND",Apr-19,48892,47680,1212,2.5
5216,CN3801700000000,38,17,"Cass County, ND",Apr-19,101652,99441,2211,2.2
5217,CN3801900000000,38,19,"Cavalier County, ND",Apr-19,1885,1823,62,3.3
5218,CN3802100000000,38,21,"Dickey County, ND",Apr-19,2272,2230,42,1.8
5219,CN3802300000000,38,23,"Divide County, ND",Apr-19,1454,1436,18,1.2
5220,CN3802500000000,38,25,"Dunn County, ND",Apr-19,3126,3070,56,1.8
5221,CN3802700000000,38,27,"Eddy County, ND",Apr-19,1233,1165,68,5.5
5222,CN3802900000000,38,29,"Emmons County, ND",Apr-19,1458,1388,70,4.8
5223,CN3803100000000,38,31,"Foster County, ND",Apr-19,1512,1467,45,3.0
5224,CN3803300000000,38,33,"Golden Valley County, ND",Apr-19,842,825,17,2.0
5225,CN3803500000000,38,35,"Grand Forks County, ND",Apr-19,36896,36087,809,2.2
5226,CN3803700000000,38,37,"Grant County, ND",Apr-19,1201,1171,30,2.5
5227,CN3803900000000,38,39,"Griggs County, ND",Apr-19,1022,996,26,2.5
5228,CN3804100000000,38,41,"Hettinger County, ND",Apr-19,1369,1346,23,1.7
5229,CN3804300000000,38,43,"Kidder County, ND",Apr-19,1255,1199,56,4.5
5230,CN3804500000000,38,45,"LaMoure County, ND",Apr-19,2071,2028,43,2.1
5231,CN3804700000000,38,47,"Logan County, ND",Apr-19,876,856,20,2.3
5232,CN3804900000000,38,49,"McHenry County, ND",Apr-19,3077,2952,125,4.1
5233,CN3805100000000,38,51,"McIntosh County, ND",Apr-19,1098,1064,34,3.1
5234,CN3805300000000,38,53,"McKenzie County, ND",Apr-19,10228,10089,139,1.4
5235,CN3805500000000,38,55,"McLean County, ND",Apr-19,4805,4658,147,3.1
5236,CN3805700000000,38,57,"Mercer County, ND",Apr-19,3593,3458,135,3.8
5237,CN3805900000000,38,59,"Morton County, ND",Apr-19,16115,15631,484,3.0
5238,CN3806100000000,38,61,"Mountrail County, ND",Apr-19,7110,7016,94,1.3
5239,CN3806300000000,38,63,"Nelson County, ND",Apr-19,1364,1320,44,3.2
5240,CN3806500000000,38,65,"Oliver County, ND",Apr-19,856,826,30,3.5
5241,CN3806700000000,38,67,"Pembina County, ND",Apr-19,3267,3158,109,3.3
5242,CN3806900000000,38,69,"Pierce County, ND",Apr-19,1738,1675,63,3.6
5243,CN3807100000000,38,71,"Ramsey County, ND",Apr-19,5540,5348,192,3.5
5244,CN3807300000000,38,73,"Ransom County, ND",Apr-19,2790,2735,55,2.0
5245,CN3807500000000,38,75,"Renville County, ND",Apr-19,1195,1161,34,2.8
5246,CN3807700000000,38,77,"Richland County, ND",Apr-19,8496,8293,203,2.4
5247,CN3807900000000,38,79,"Rolette County, ND",Apr-19,4544,4197,347,7.6
5248,CN3808100000000,38,81,"Sargent County, ND",Apr-19,2607,2557,50,1.9
5249,CN3808300000000,38,83,"Sheridan County, ND",Apr-19,686,654,32,4.7
5250,CN3808500000000,38,85,"Sioux County, ND",Apr-19,1220,1178,42,3.4
5251,CN3808700000000,38,87,"Slope County, ND",Apr-19,389,382,7,1.8
5252,CN3808900000000,38,89,"Stark County, ND",Apr-19,18419,18045,374,2.0
5253,CN3809100000000,38,91,"Steele County, ND",Apr-19,967,948,19,2.0
5254,CN3809300000000,38,93,"Stutsman County, ND",Apr-19,10233,9989,244,2.4
5255,CN3809500000000,38,95,"Towner County, ND",Apr-19,1145,1114,31,2.7
5256,CN3809700000000,38,97,"Traill County, ND",Apr-19,4344,4231,113,2.6
5257,CN3809900000000,38,99,"Walsh County, ND",Apr-19,5150,4977,173,3.4
5258,CN3810100000000,38,101,"Ward County, ND",Apr-19,31199,30318,881,2.8
5259,CN3810300000000,38,103,"Wells County, ND",Apr-19,1922,1857,65,3.4
5260,CN3810500000000,38,105,"Williams County, ND",Apr-19,23750,23307,443,1.9
5261,CN3900100000000,39,1,"Adams County, OH",Apr-19,10654,10027,627,5.9
5262,CN3900300000000,39,3,"Allen County, OH",Apr-19,47530,45975,1555,3.3
5263,CN3900500000000,39,5,"Ashland County, OH",Apr-19,26826,25910,916,3.4
5264,CN3900700000000,39,7,"Ashtabula County, OH",Apr-19,43923,42087,1836,4.2
5265,CN3900900000000,39,9,"Athens County, OH",Apr-19,29092,27972,1120,3.8
5266,CN3901100000000,39,11,"Auglaize County, OH",Apr-19,24857,24238,619,2.5
5267,CN3901300000000,39,13,"Belmont County, OH",Apr-19,29738,28297,1441,4.8
5268,CN3901500000000,39,15,"Brown County, OH",Apr-19,19300,18507,793,4.1
5269,CN3901700000000,39,17,"Butler County, OH",Apr-19,192326,186460,5866,3.1
5270,CN3901900000000,39,19,"Carroll County, OH",Apr-19,12889,12343,546,4.2
5271,CN3902100000000,39,21,"Champaign County, OH",Apr-19,20011,19418,593,3.0
5272,CN3902300000000,39,23,"Clark County, OH",Apr-19,62885,60697,2188,3.5
5273,CN3902500000000,39,25,"Clermont County, OH",Apr-19,105360,102088,3272,3.1
5274,CN3902700000000,39,27,"Clinton County, OH",Apr-19,17406,16718,688,4.0
5275,CN3902900000000,39,29,"Columbiana County, OH",Apr-19,46900,44956,1944,4.1
5276,CN3903100000000,39,31,"Coshocton County, OH",Apr-19,14324,13646,678,4.7
5277,CN3903300000000,39,33,"Crawford County, OH",Apr-19,18084,17399,685,3.8
5278,CN3903500000000,39,35,"Cuyahoga County, OH",Apr-19,613669,590505,23164,3.8
5279,CN3903700000000,39,37,"Darke County, OH",Apr-19,25733,24941,792,3.1
5280,CN3903900000000,39,39,"Defiance County, OH",Apr-19,17930,17301,629,3.5
5281,CN3904100000000,39,41,"Delaware County, OH",Apr-19,108421,105650,2771,2.6
5282,CN3904300000000,39,43,"Erie County, OH",Apr-19,36400,34687,1713,4.7
5283,CN3904500000000,39,45,"Fairfield County, OH",Apr-19,76816,74410,2406,3.1
5284,CN3904700000000,39,47,"Fayette County, OH",Apr-19,13748,13324,424,3.1
5285,CN3904900000000,39,49,"Franklin County, OH",Apr-19,685734,665178,20556,3.0
5286,CN3905100000000,39,51,"Fulton County, OH",Apr-19,22453,21681,772,3.4
5287,CN3905300000000,39,53,"Gallia County, OH",Apr-19,12303,11782,521,4.2
5288,CN3905500000000,39,55,"Geauga County, OH",Apr-19,49247,47722,1525,3.1
5289,CN3905700000000,39,57,"Greene County, OH",Apr-19,82222,79687,2535,3.1
5290,CN3905900000000,39,59,"Guernsey County, OH",Apr-19,18578,17695,883,4.8
5291,CN3906100000000,39,61,"Hamilton County, OH",Apr-19,410087,397223,12864,3.1
5292,CN3906300000000,39,63,"Hancock County, OH",Apr-19,41972,40896,1076,2.6
5293,CN3906500000000,39,65,"Hardin County, OH",Apr-19,14111,13654,457,3.2
5294,CN3906700000000,39,67,"Harrison County, OH",Apr-19,6806,6520,286,4.2
5295,CN3906900000000,39,69,"Henry County, OH",Apr-19,13180,12629,551,4.2
5296,CN3907100000000,39,71,"Highland County, OH",Apr-19,16927,16218,709,4.2
5297,CN3907300000000,39,73,"Hocking County, OH",Apr-19,12842,12330,512,4.0
5298,CN3907500000000,39,75,"Holmes County, OH",Apr-19,20801,20318,483,2.3
5299,CN3907700000000,39,77,"Huron County, OH",Apr-19,27881,26589,1292,4.6
5300,CN3907900000000,39,79,"Jackson County, OH",Apr-19,12648,11985,663,5.2
5301,CN3908100000000,39,81,"Jefferson County, OH",Apr-19,27461,26114,1347,4.9
5302,CN3908300000000,39,83,"Knox County, OH",Apr-19,31714,30686,1028,3.2
5303,CN3908500000000,39,85,"Lake County, OH",Apr-19,126610,122492,4118,3.3
5304,CN3908700000000,39,87,"Lawrence County, OH",Apr-19,23462,22447,1015,4.3
5305,CN3908900000000,39,89,"Licking County, OH",Apr-19,88998,86274,2724,3.1
5306,CN3909100000000,39,91,"Logan County, OH",Apr-19,22831,22161,670,2.9
5307,CN3909300000000,39,93,"Lorain County, OH",Apr-19,154030,148254,5776,3.7
5308,CN3909500000000,39,95,"Lucas County, OH",Apr-19,208926,200699,8227,3.9
5309,CN3909700000000,39,97,"Madison County, OH",Apr-19,20617,20008,609,3.0
5310,CN3909900000000,39,99,"Mahoning County, OH",Apr-19,102496,97074,5422,5.3
5311,CN3910100000000,39,101,"Marion County, OH",Apr-19,28420,27445,975,3.4
5312,CN3910300000000,39,103,"Medina County, OH",Apr-19,97846,94927,2919,3.0
5313,CN3910500000000,39,105,"Meigs County, OH",Apr-19,9146,8600,546,6.0
5314,CN3910700000000,39,107,"Mercer County, OH",Apr-19,23429,22948,481,2.1
5315,CN3910900000000,39,109,"Miami County, OH",Apr-19,53547,51885,1662,3.1
5316,CN3911100000000,39,111,"Monroe County, OH",Apr-19,5302,4901,401,7.6
5317,CN3911300000000,39,113,"Montgomery County, OH",Apr-19,249018,240238,8780,3.5
5318,CN3911500000000,39,115,"Morgan County, OH",Apr-19,6667,6298,369,5.5
5319,CN3911700000000,39,117,"Morrow County, OH",Apr-19,16524,15966,558,3.4
5320,CN3911900000000,39,119,"Muskingum County, OH",Apr-19,39202,37471,1731,4.4
5321,CN3912100000000,39,121,"Noble County, OH",Apr-19,4687,4413,274,5.8
5322,CN3912300000000,39,123,"Ottawa County, OH",Apr-19,20465,19385,1080,5.3
5323,CN3912500000000,39,125,"Paulding County, OH",Apr-19,8650,8393,257,3.0
5324,CN3912700000000,39,127,"Perry County, OH",Apr-19,15660,14962,698,4.5
5325,CN3912900000000,39,129,"Pickaway County, OH",Apr-19,26097,25205,892,3.4
5326,CN3913100000000,39,131,"Pike County, OH",Apr-19,10765,10204,561,5.2
5327,CN3913300000000,39,133,"Portage County, OH",Apr-19,86615,83553,3062,3.5
5328,CN3913500000000,39,135,"Preble County, OH",Apr-19,20908,20260,648,3.1
5329,CN3913700000000,39,137,"Putnam County, OH",Apr-19,18823,18326,497,2.6
5330,CN3913900000000,39,139,"Richland County, OH",Apr-19,51707,49734,1973,3.8
5331,CN3914100000000,39,141,"Ross County, OH",Apr-19,35205,33967,1238,3.5
5332,CN3914300000000,39,143,"Sandusky County, OH",Apr-19,30454,29283,1171,3.8
5333,CN3914500000000,39,145,"Scioto County, OH",Apr-19,28481,26981,1500,5.3
5334,CN3914700000000,39,147,"Seneca County, OH",Apr-19,27318,26397,921,3.4
5335,CN3914900000000,39,149,"Shelby County, OH",Apr-19,24071,23361,710,2.9
5336,CN3915100000000,39,151,"Stark County, OH",Apr-19,184530,177248,7282,3.9
5337,CN3915300000000,39,153,"Summit County, OH",Apr-19,270416,260412,10004,3.7
5338,CN3915500000000,39,155,"Trumbull County, OH",Apr-19,86251,81296,4955,5.7
5339,CN3915700000000,39,157,"Tuscarawas County, OH",Apr-19,44484,42868,1616,3.6
5340,CN3915900000000,39,159,"Union County, OH",Apr-19,28575,27857,718,2.5
5341,CN3916100000000,39,161,"Van Wert County, OH",Apr-19,14925,14531,394,2.6
5342,CN3916300000000,39,163,"Vinton County, OH",Apr-19,5527,5258,269,4.9
5343,CN3916500000000,39,165,"Warren County, OH",Apr-19,117625,114185,3440,2.9
5344,CN3916700000000,39,167,"Washington County, OH",Apr-19,27092,25841,1251,4.6
5345,CN3916900000000,39,169,"Wayne County, OH",Apr-19,62134,60503,1631,2.6
5346,CN3917100000000,39,171,"Williams County, OH",Apr-19,18769,18254,515,2.7
5347,CN3917300000000,39,173,"Wood County, OH",Apr-19,70904,68734,2170,3.1
5348,CN3917500000000,39,175,"Wyandot County, OH",Apr-19,12960,12649,311,2.4
5349,CN4000100000000,40,1,"Adair County, OK",Apr-19,7981,7689,292,3.7
5350,CN4000300000000,40,3,"Alfalfa County, OK",Apr-19,2799,2756,43,1.5
5351,CN4000500000000,40,5,"Atoka County, OK",Apr-19,4902,4721,181,3.7
5352,CN4000700000000,40,7,"Beaver County, OK",Apr-19,2806,2754,52,1.9
5353,CN4000900000000,40,9,"Beckham County, OK",Apr-19,10691,10431,260,2.4
5354,CN4001100000000,40,11,"Blaine County, OK",Apr-19,4764,4684,80,1.7
5355,CN4001300000000,40,13,"Bryan County, OK",Apr-19,20906,20361,545,2.6
5356,CN4001500000000,40,15,"Caddo County, OK",Apr-19,11680,11350,330,2.8
5357,CN4001700000000,40,17,"Canadian County, OK",Apr-19,73619,71865,1754,2.4
5358,CN4001900000000,40,19,"Carter County, OK",Apr-19,21774,21139,635,2.9
5359,CN4002100000000,40,21,"Cherokee County, OK",Apr-19,18572,17978,594,3.2
5360,CN4002300000000,40,23,"Choctaw County, OK",Apr-19,5368,5159,209,3.9
5361,CN4002500000000,40,25,"Cimarron County, OK",Apr-19,1278,1260,18,1.4
5362,CN4002700000000,40,27,"Cleveland County, OK",Apr-19,141954,138495,3459,2.4
5363,CN4002900000000,40,29,"Coal County, OK",Apr-19,2590,2521,69,2.7
5364,CN4003100000000,40,31,"Comanche County, OK",Apr-19,48054,46594,1460,3.0
5365,CN4003300000000,40,33,"Cotton County, OK",Apr-19,2690,2618,72,2.7
5366,CN4003500000000,40,35,"Craig County, OK",Apr-19,5858,5686,172,2.9
5367,CN4003700000000,40,37,"Creek County, OK",Apr-19,31329,30361,968,3.1
5368,CN4003900000000,40,39,"Custer County, OK",Apr-19,15756,15447,309,2.0
5369,CN4004100000000,40,41,"Delaware County, OK",Apr-19,17774,17176,598,3.4
5370,CN4004300000000,40,43,"Dewey County, OK",Apr-19,2938,2894,44,1.5
5371,CN4004500000000,40,45,"Ellis County, OK",Apr-19,2150,2106,44,2.0
5372,CN4004700000000,40,47,"Garfield County, OK",Apr-19,26948,26258,690,2.6
5373,CN4004900000000,40,49,"Garvin County, OK",Apr-19,12702,12369,333,2.6
5374,CN4005100000000,40,51,"Grady County, OK",Apr-19,26155,25508,647,2.5
5375,CN4005300000000,40,53,"Grant County, OK",Apr-19,2568,2518,50,1.9
5376,CN4005500000000,40,55,"Greer County, OK",Apr-19,1792,1725,67,3.7
5377,CN4005700000000,40,57,"Harmon County, OK",Apr-19,1185,1152,33,2.8
5378,CN4005900000000,40,59,"Harper County, OK",Apr-19,1719,1673,46,2.7
5379,CN4006100000000,40,61,"Haskell County, OK",Apr-19,4226,4064,162,3.8
5380,CN4006300000000,40,63,"Hughes County, OK",Apr-19,5336,5122,214,4.0
5381,CN4006500000000,40,65,"Jackson County, OK",Apr-19,10548,10285,263,2.5
5382,CN4006700000000,40,67,"Jefferson County, OK",Apr-19,2489,2422,67,2.7
5383,CN4006900000000,40,69,"Johnston County, OK",Apr-19,3694,3565,129,3.5
5384,CN4007100000000,40,71,"Kay County, OK",Apr-19,18253,17560,693,3.8
5385,CN4007300000000,40,73,"Kingfisher County, OK",Apr-19,9057,8909,148,1.6
5386,CN4007500000000,40,75,"Kiowa County, OK",Apr-19,3436,3331,105,3.1
5387,CN4007700000000,40,77,"Latimer County, OK",Apr-19,3082,2938,144,4.7
5388,CN4007900000000,40,79,"Le Flore County, OK",Apr-19,18830,18083,747,4.0
5389,CN4008100000000,40,81,"Lincoln County, OK",Apr-19,15599,15137,462,3.0
5390,CN4008300000000,40,83,"Logan County, OK",Apr-19,21885,21345,540,2.5
5391,CN4008500000000,40,85,"Love County, OK",Apr-19,6145,6028,117,1.9
5392,CN4008700000000,40,87,"McClain County, OK",Apr-19,19389,18962,427,2.2
5393,CN4008900000000,40,89,"McCurtain County, OK",Apr-19,13822,13224,598,4.3
5394,CN4009100000000,40,91,"McIntosh County, OK",Apr-19,6971,6649,322,4.6
5395,CN4009300000000,40,93,"Major County, OK",Apr-19,3881,3810,71,1.8
5396,CN4009500000000,40,95,"Marshall County, OK",Apr-19,6830,6628,202,3.0
5397,CN4009700000000,40,97,"Mayes County, OK",Apr-19,19322,18793,529,2.7
5398,CN4009900000000,40,99,"Murray County, OK",Apr-19,6312,6154,158,2.5
5399,CN4010100000000,40,101,"Muskogee County, OK",Apr-19,29140,28237,903,3.1
5400,CN4010300000000,40,103,"Noble County, OK",Apr-19,5648,5536,112,2.0
5401,CN4010500000000,40,105,"Nowata County, OK",Apr-19,4586,4445,141,3.1
5402,CN4010700000000,40,107,"Okfuskee County, OK",Apr-19,4631,4458,173,3.7
5403,CN4010900000000,40,109,"Oklahoma County, OK",Apr-19,382238,371798,10440,2.7
5404,CN4011100000000,40,111,"Okmulgee County, OK",Apr-19,15513,14865,648,4.2
5405,CN4011300000000,40,113,"Osage County, OK",Apr-19,20495,19822,673,3.3
5406,CN4011500000000,40,115,"Ottawa County, OK",Apr-19,14042,13631,411,2.9
5407,CN4011700000000,40,117,"Pawnee County, OK",Apr-19,7278,7032,246,3.4
5408,CN4011900000000,40,119,"Payne County, OK",Apr-19,38207,37295,912,2.4
5409,CN4012100000000,40,121,"Pittsburg County, OK",Apr-19,17200,16649,551,3.2
5410,CN4012300000000,40,123,"Pontotoc County, OK",Apr-19,18781,18336,445,2.4
5411,CN4012500000000,40,125,"Pottawatomie County, OK",Apr-19,32261,31247,1014,3.1
5412,CN4012700000000,40,127,"Pushmataha County, OK",Apr-19,4215,4037,178,4.2
5413,CN4012900000000,40,129,"Roger Mills County, OK",Apr-19,1870,1830,40,2.1
5414,CN4013100000000,40,131,"Rogers County, OK",Apr-19,44819,43625,1194,2.7
5415,CN4013300000000,40,133,"Seminole County, OK",Apr-19,9359,9006,353,3.8
5416,CN4013500000000,40,135,"Sequoyah County, OK",Apr-19,15992,15456,536,3.4
5417,CN4013700000000,40,137,"Stephens County, OK",Apr-19,18508,17888,620,3.3
5418,CN4013900000000,40,139,"Texas County, OK",Apr-19,10904,10712,192,1.8
5419,CN4014100000000,40,141,"Tillman County, OK",Apr-19,2954,2863,91,3.1
5420,CN4014300000000,40,143,"Tulsa County, OK",Apr-19,321335,312587,8748,2.7
5421,CN4014500000000,40,145,"Wagoner County, OK",Apr-19,37670,36691,979,2.6
5422,CN4014700000000,40,147,"Washington County, OK",Apr-19,22168,21512,656,3.0
5423,CN4014900000000,40,149,"Washita County, OK",Apr-19,5143,5010,133,2.6
5424,CN4015100000000,40,151,"Woods County, OK",Apr-19,4576,4496,80,1.7
5425,CN4015300000000,40,153,"Woodward County, OK",Apr-19,8998,8800,198,2.2
5426,CN4100100000000,41,1,"Baker County, OR",Apr-19,7039,6689,350,5.0
5427,CN4100300000000,41,3,"Benton County, OR",Apr-19,48457,47087,1370,2.8
5428,CN4100500000000,41,5,"Clackamas County, OR",Apr-19,218551,211039,7512,3.4
5429,CN4100700000000,41,7,"Clatsop County, OR",Apr-19,19217,18494,723,3.8
5430,CN4100900000000,41,9,"Columbia County, OR",Apr-19,24379,23274,1105,4.5
5431,CN4101100000000,41,11,"Coos County, OR",Apr-19,25966,24648,1318,5.1
5432,CN4101300000000,41,13,"Crook County, OR",Apr-19,9466,8964,502,5.3
5433,CN4101500000000,41,15,"Curry County, OR",Apr-19,8669,8186,483,5.6
5434,CN4101700000000,41,17,"Deschutes County, OR",Apr-19,95049,91298,3751,3.9
5435,CN4101900000000,41,19,"Douglas County, OR",Apr-19,45817,43424,2393,5.2
5436,CN4102100000000,41,21,"Gilliam County, OR",Apr-19,999,971,28,2.8
5437,CN4102300000000,41,23,"Grant County, OR",Apr-19,3116,2817,299,9.6
5438,CN4102500000000,41,25,"Harney County, OR",Apr-19,3548,3337,211,5.9
5439,CN4102700000000,41,27,"Hood River County, OR",Apr-19,14010,13567,443,3.2
5440,CN4102900000000,41,29,"Jackson County, OR",Apr-19,102912,98110,4802,4.7
5441,CN4103100000000,41,31,"Jefferson County, OR",Apr-19,10177,9641,536,5.3
5442,CN4103300000000,41,33,"Josephine County, OR",Apr-19,35518,33694,1824,5.1
5443,CN4103500000000,41,35,"Klamath County, OR",Apr-19,29281,27468,1813,6.2
5444,CN4103700000000,41,37,"Lake County, OR",Apr-19,3542,3316,226,6.4
5445,CN4103900000000,41,39,"Lane County, OR",Apr-19,180683,173107,7576,4.2
5446,CN4104100000000,41,41,"Lincoln County, OR",Apr-19,20720,19806,914,4.4
5447,CN4104300000000,41,43,"Linn County, OR",Apr-19,58968,56364,2604,4.4
5448,CN4104500000000,41,45,"Malheur County, OR",Apr-19,12334,11820,514,4.2
5449,CN4104700000000,41,47,"Marion County, OR",Apr-19,160261,153699,6562,4.1
5450,CN4104900000000,41,49,"Morrow County, OR",Apr-19,5696,5483,213,3.7
5451,CN4105100000000,41,51,"Multnomah County, OR",Apr-19,453268,438218,15050,3.3
5452,CN4105300000000,41,53,"Polk County, OR",Apr-19,39403,37775,1628,4.1
5453,CN4105500000000,41,55,"Sherman County, OR",Apr-19,906,874,32,3.5
5454,CN4105700000000,41,57,"Tillamook County, OR",Apr-19,11838,11395,443,3.7
5455,CN4105900000000,41,59,"Umatilla County, OR",Apr-19,36373,34755,1618,4.4
5456,CN4106100000000,41,61,"Union County, OR",Apr-19,11955,11364,591,4.9
5457,CN4106300000000,41,63,"Wallowa County, OR",Apr-19,3347,3079,268,8.0
5458,CN4106500000000,41,65,"Wasco County, OR",Apr-19,12504,11955,549,4.4
5459,CN4106700000000,41,67,"Washington County, OR",Apr-19,323441,313372,10069,3.1
5460,CN4106900000000,41,69,"Wheeler County, OR",Apr-19,720,690,30,4.2
5461,CN4107100000000,41,71,"Yamhill County, OR",Apr-19,54557,52674,1883,3.5
5462,CN4200100000000,42,1,"Adams County, PA",Apr-19,54909,53534,1375,2.5
5463,CN4200300000000,42,3,"Allegheny County, PA",Apr-19,642463,620691,21772,3.4
5464,CN4200500000000,42,5,"Armstrong County, PA",Apr-19,31697,30450,1247,3.9
5465,CN4200700000000,42,7,"Beaver County, PA",Apr-19,82931,80013,2918,3.5
5466,CN4200900000000,42,9,"Bedford County, PA",Apr-19,23128,22282,846,3.7
5467,CN4201100000000,42,11,"Berks County, PA",Apr-19,213185,205607,7578,3.6
5468,CN4201300000000,42,13,"Blair County, PA",Apr-19,58712,56686,2026,3.5
5469,CN4201500000000,42,15,"Bradford County, PA",Apr-19,28269,27277,992,3.5
5470,CN4201700000000,42,17,"Bucks County, PA",Apr-19,340874,330115,10759,3.2
5471,CN4201900000000,42,19,"Butler County, PA",Apr-19,98521,95547,2974,3.0
5472,CN4202100000000,42,21,"Cambria County, PA",Apr-19,57387,55047,2340,4.1
5473,CN4202300000000,42,23,"Cameron County, PA",Apr-19,2042,1953,89,4.4
5474,CN4202500000000,42,25,"Carbon County, PA",Apr-19,31725,30256,1469,4.6
5475,CN4202700000000,42,27,"Centre County, PA",Apr-19,80820,78737,2083,2.6
5476,CN4202900000000,42,29,"Chester County, PA",Apr-19,281207,273988,7219,2.6
5477,CN4203100000000,42,31,"Clarion County, PA",Apr-19,17058,16415,643,3.8
5478,CN4203300000000,42,33,"Clearfield County, PA",Apr-19,35373,33940,1433,4.1
5479,CN4203500000000,42,35,"Clinton County, PA",Apr-19,18109,17353,756,4.2
5480,CN4203700000000,42,37,"Columbia County, PA",Apr-19,33231,31969,1262,3.8
5481,CN4203900000000,42,39,"Crawford County, PA",Apr-19,38204,36746,1458,3.8
5482,CN4204100000000,42,41,"Cumberland County, PA",Apr-19,130317,126833,3484,2.7
5483,CN4204300000000,42,43,"Dauphin County, PA",Apr-19,142440,137819,4621,3.2
5484,CN4204500000000,42,45,"Delaware County, PA",Apr-19,296829,286903,9926,3.3
5485,CN4204700000000,42,47,"Elk County, PA",Apr-19,15422,14909,513,3.3
5486,CN4204900000000,42,49,"Erie County, PA",Apr-19,127485,122720,4765,3.7
5487,CN4205100000000,42,51,"Fayette County, PA",Apr-19,56265,53561,2704,4.8
5488,CN4205300000000,42,53,"Forest County, PA",Apr-19,1769,1672,97,5.5
5489,CN4205500000000,42,55,"Franklin County, PA",Apr-19,75919,73574,2345,3.1
5490,CN4205700000000,42,57,"Fulton County, PA",Apr-19,7684,7429,255,3.3
5491,CN4205900000000,42,59,"Greene County, PA",Apr-19,16484,15792,692,4.2
5492,CN4206100000000,42,61,"Huntingdon County, PA",Apr-19,19728,18848,880,4.5
5493,CN4206300000000,42,63,"Indiana County, PA",Apr-19,38662,37222,1440,3.7
5494,CN4206500000000,42,65,"Jefferson County, PA",Apr-19,20146,19432,714,3.5
5495,CN4206700000000,42,67,"Juniata County, PA",Apr-19,12229,11814,415,3.4
5496,CN4206900000000,42,69,"Lackawanna County, PA",Apr-19,104217,100030,4187,4.0
5497,CN4207100000000,42,71,"Lancaster County, PA",Apr-19,279779,272105,7674,2.7
5498,CN4207300000000,42,73,"Lawrence County, PA",Apr-19,40202,38519,1683,4.2
5499,CN4207500000000,42,75,"Lebanon County, PA",Apr-19,71019,68834,2185,3.1
5500,CN4207700000000,42,77,"Lehigh County, PA",Apr-19,190545,183236,7309,3.8
5501,CN4207900000000,42,79,"Luzerne County, PA",Apr-19,156005,148657,7348,4.7
5502,CN4208100000000,42,81,"Lycoming County, PA",Apr-19,56272,54071,2201,3.9
5503,CN4208300000000,42,83,"McKean County, PA",Apr-19,17038,16314,724,4.2
5504,CN4208500000000,42,85,"Mercer County, PA",Apr-19,48543,46692,1851,3.8
5505,CN4208700000000,42,87,"Mifflin County, PA",Apr-19,20680,19920,760,3.7
5506,CN4208900000000,42,89,"Monroe County, PA",Apr-19,81768,78048,3720,4.5
5507,CN4209100000000,42,91,"Montgomery County, PA",Apr-19,451085,438106,12979,2.9
5508,CN4209300000000,42,93,"Montour County, PA",Apr-19,9067,8799,268,3.0
5509,CN4209500000000,42,95,"Northampton County, PA",Apr-19,159379,153447,5932,3.7
5510,CN4209700000000,42,97,"Northumberland County, PA",Apr-19,42124,40139,1985,4.7
5511,CN4209900000000,42,99,"Perry County, PA",Apr-19,23961,23290,671,2.8
5512,CN4210100000000,42,101,"Philadelphia County/city, PA",Apr-19,714395,681917,32478,4.5
5513,CN4210300000000,42,103,"Pike County, PA",Apr-19,24806,23647,1159,4.7
5514,CN4210500000000,42,105,"Potter County, PA",Apr-19,7022,6672,350,5.0
5515,CN4210700000000,42,107,"Schuylkill County, PA",Apr-19,65186,62239,2947,4.5
5516,CN4210900000000,42,109,"Snyder County, PA",Apr-19,19936,19304,632,3.2
5517,CN4211100000000,42,111,"Somerset County, PA",Apr-19,32631,31289,1342,4.1
5518,CN4211300000000,42,113,"Sullivan County, PA",Apr-19,2579,2475,104,4.0
5519,CN4211500000000,42,115,"Susquehanna County, PA",Apr-19,20021,19276,745,3.7
5520,CN4211700000000,42,117,"Tioga County, PA",Apr-19,18661,17858,803,4.3
5521,CN4211900000000,42,119,"Union County, PA",Apr-19,19393,18812,581,3.0
5522,CN4212100000000,42,121,"Venango County, PA",Apr-19,22166,21341,825,3.7
5523,CN4212300000000,42,123,"Warren County, PA",Apr-19,18656,17966,690,3.7
5524,CN4212500000000,42,125,"Washington County, PA",Apr-19,105719,101955,3764,3.6
5525,CN4212700000000,42,127,"Wayne County, PA",Apr-19,21681,20792,889,4.1
5526,CN4212900000000,42,129,"Westmoreland County, PA",Apr-19,178778,172420,6358,3.6
5527,CN4213100000000,42,131,"Wyoming County, PA",Apr-19,13394,12865,529,3.9
5528,CN4213300000000,42,133,"York County, PA",Apr-19,232701,225598,7103,3.1
5529,CN4400100000000,44,1,"Bristol County, RI",Apr-19,25707,25008,699,2.7
5530,CN4400300000000,44,3,"Kent County, RI",Apr-19,89602,87053,2549,2.8
5531,CN4400500000000,44,5,"Newport County, RI",Apr-19,43828,42533,1295,3.0
5532,CN4400700000000,44,7,"Providence County, RI",Apr-19,321446,310215,11231,3.5
5533,CN4400900000000,44,9,"Washington County, RI",Apr-19,67832,65976,1856,2.7
5534,CN4500100000000,45,1,"Abbeville County, SC",Apr-19,10013,9733,280,2.8
5535,CN4500300000000,45,3,"Aiken County, SC",Apr-19,75655,73627,2028,2.7
5536,CN4500500000000,45,5,"Allendale County, SC",Apr-19,2677,2546,131,4.9
5537,CN4500700000000,45,7,"Anderson County, SC",Apr-19,90929,88764,2165,2.4
5538,CN4500900000000,45,9,"Bamberg County, SC",Apr-19,4990,4770,220,4.4
5539,CN4501100000000,45,11,"Barnwell County, SC",Apr-19,8322,7998,324,3.9
5540,CN4501300000000,45,13,"Beaufort County, SC",Apr-19,77218,75365,1853,2.4
5541,CN4501500000000,45,15,"Berkeley County, SC",Apr-19,103849,101456,2393,2.3
5542,CN4501700000000,45,17,"Calhoun County, SC",Apr-19,6542,6335,207,3.2
5543,CN4501900000000,45,19,"Charleston County, SC",Apr-19,211127,206705,4422,2.1
5544,CN4502100000000,45,21,"Cherokee County, SC",Apr-19,25153,24487,666,2.6
5545,CN4502300000000,45,23,"Chester County, SC",Apr-19,13307,12801,506,3.8
5546,CN4502500000000,45,25,"Chesterfield County, SC",Apr-19,22046,21480,566,2.6
5547,CN4502700000000,45,27,"Clarendon County, SC",Apr-19,12723,12296,427,3.4
5548,CN4502900000000,45,29,"Colleton County, SC",Apr-19,16774,16291,483,2.9
5549,CN4503100000000,45,31,"Darlington County, SC",Apr-19,30296,29372,924,3.0
5550,CN4503300000000,45,33,"Dillon County, SC",Apr-19,12925,12456,469,3.6
5551,CN4503500000000,45,35,"Dorchester County, SC",Apr-19,77988,76236,1752,2.2
5552,CN4503700000000,45,37,"Edgefield County, SC",Apr-19,10806,10532,274,2.5
5553,CN4503900000000,45,39,"Fairfield County, SC",Apr-19,9525,9150,375,3.9
5554,CN4504100000000,45,41,"Florence County, SC",Apr-19,66724,64951,1773,2.7
5555,CN4504300000000,45,43,"Georgetown County, SC",Apr-19,25711,24808,903,3.5
5556,CN4504500000000,45,45,"Greenville County, SC",Apr-19,254309,248739,5570,2.2
5557,CN4504700000000,45,47,"Greenwood County, SC",Apr-19,31338,30458,880,2.8
5558,CN4504900000000,45,49,"Hampton County, SC",Apr-19,8373,8172,201,2.4
5559,CN4505100000000,45,51,"Horry County, SC",Apr-19,148542,143713,4829,3.3
5560,CN4505300000000,45,53,"Jasper County, SC",Apr-19,12577,12283,294,2.3
5561,CN4505500000000,45,55,"Kershaw County, SC",Apr-19,29034,28294,740,2.5
5562,CN4505700000000,45,57,"Lancaster County, SC",Apr-19,40945,39684,1261,3.1
5563,CN4505900000000,45,59,"Laurens County, SC",Apr-19,30087,29286,801,2.7
5564,CN4506100000000,45,61,"Lee County, SC",Apr-19,6519,6303,216,3.3
5565,CN4506300000000,45,63,"Lexington County, SC",Apr-19,149204,146027,3177,2.1
5566,CN4506500000000,45,65,"McCormick County, SC",Apr-19,3411,3319,92,2.7
5567,CN4506700000000,45,67,"Marion County, SC",Apr-19,13085,12562,523,4.0
5568,CN4506900000000,45,69,"Marlboro County, SC",Apr-19,9142,8787,355,3.9
5569,CN4507100000000,45,71,"Newberry County, SC",Apr-19,19185,18753,432,2.3
5570,CN4507300000000,45,73,"Oconee County, SC",Apr-19,34785,33915,870,2.5
5571,CN4507500000000,45,75,"Orangeburg County, SC",Apr-19,34910,33554,1356,3.9
5572,CN4507700000000,45,77,"Pickens County, SC",Apr-19,57225,55849,1376,2.4
5573,CN4507900000000,45,79,"Richland County, SC",Apr-19,197612,192657,4955,2.5
5574,CN4508100000000,45,81,"Saluda County, SC",Apr-19,8834,8619,215,2.4
5575,CN4508300000000,45,83,"Spartanburg County, SC",Apr-19,152648,149195,3453,2.3
5576,CN4508500000000,45,85,"Sumter County, SC",Apr-19,43664,42352,1312,3.0
5577,CN4508700000000,45,87,"Union County, SC",Apr-19,11612,11245,367,3.2
5578,CN4508900000000,45,89,"Williamsburg County, SC",Apr-19,12102,11631,471,3.9
5579,CN4509100000000,45,91,"York County, SC",Apr-19,139190,135694,3496,2.5
5580,CN4600300000000,46,3,"Aurora County, SD",Apr-19,1509,1463,46,3.0
5581,CN4600500000000,46,5,"Beadle County, SD",Apr-19,9577,9256,321,3.4
5582,CN4600700000000,46,7,"Bennett County, SD",Apr-19,1075,1018,57,5.3
5583,CN4600900000000,46,9,"Bon Homme County, SD",Apr-19,2806,2714,92,3.3
5584,CN4601100000000,46,11,"Brookings County, SD",Apr-19,19152,18541,611,3.2
5585,CN4601300000000,46,13,"Brown County, SD",Apr-19,20795,20133,662,3.2
5586,CN4601500000000,46,15,"Brule County, SD",Apr-19,2427,2349,78,3.2
5587,CN4601700000000,46,17,"Buffalo County, SD",Apr-19,665,629,36,5.4
5588,CN4601900000000,46,19,"Butte County, SD",Apr-19,4999,4825,174,3.5
5589,CN4602100000000,46,21,"Campbell County, SD",Apr-19,759,729,30,4.0
5590,CN4602300000000,46,23,"Charles Mix County, SD",Apr-19,3671,3536,135,3.7
5591,CN4602500000000,46,25,"Clark County, SD",Apr-19,1852,1769,83,4.5
5592,CN4602700000000,46,27,"Clay County, SD",Apr-19,7776,7530,246,3.2
5593,CN4602900000000,46,29,"Codington County, SD",Apr-19,15434,14920,514,3.3
5594,CN4603100000000,46,31,"Corson County, SD",Apr-19,1339,1269,70,5.2
5595,CN4603300000000,46,33,"Custer County, SD",Apr-19,3961,3774,187,4.7
5596,CN4603500000000,46,35,"Davison County, SD",Apr-19,10998,10662,336,3.1
5597,CN4603700000000,46,37,"Day County, SD",Apr-19,2678,2536,142,5.3
5598,CN4603900000000,46,39,"Deuel County, SD",Apr-19,2149,2030,119,5.5
5599,CN4604100000000,46,41,"Dewey County, SD",Apr-19,2154,2038,116,5.4
5600,CN4604300000000,46,43,"Douglas County, SD",Apr-19,1548,1500,48,3.1
5601,CN4604500000000,46,45,"Edmunds County, SD",Apr-19,2029,1965,64,3.2
5602,CN4604700000000,46,47,"Fall River County, SD",Apr-19,2955,2829,126,4.3
5603,CN4604900000000,46,49,"Faulk County, SD",Apr-19,1023,989,34,3.3
5604,CN4605100000000,46,51,"Grant County, SD",Apr-19,4413,4235,178,4.0
5605,CN4605300000000,46,53,"Gregory County, SD",Apr-19,2021,1942,79,3.9
5606,CN4605500000000,46,55,"Haakon County, SD",Apr-19,1031,1000,31,3.0
5607,CN4605700000000,46,57,"Hamlin County, SD",Apr-19,3223,3101,122,3.8
5608,CN4605900000000,46,59,"Hand County, SD",Apr-19,1735,1686,49,2.8
5609,CN4606100000000,46,61,"Hanson County, SD",Apr-19,1707,1632,75,4.4
5610,CN4606300000000,46,63,"Harding County, SD",Apr-19,697,678,19,2.7
5611,CN4606500000000,46,65,"Hughes County, SD",Apr-19,9869,9594,275,2.8
5612,CN4606700000000,46,67,"Hutchinson County, SD",Apr-19,3554,3435,119,3.3
5613,CN4606900000000,46,69,"Hyde County, SD",Apr-19,673,647,26,3.9
5614,CN4607100000000,46,71,"Jackson County, SD",Apr-19,1235,1157,78,6.3
5615,CN4607300000000,46,73,"Jerauld County, SD",Apr-19,1098,1065,33,3.0
5616,CN4607500000000,46,75,"Jones County, SD",Apr-19,518,500,18,3.5
5617,CN4607700000000,46,77,"Kingsbury County, SD",Apr-19,2672,2584,88,3.3
5618,CN4607900000000,46,79,"Lake County, SD",Apr-19,6767,6529,238,3.5
5619,CN4608100000000,46,81,"Lawrence County, SD",Apr-19,13132,12684,448,3.4
5620,CN4608300000000,46,83,"Lincoln County, SD",Apr-19,34472,33566,906,2.6
5621,CN4608500000000,46,85,"Lyman County, SD",Apr-19,1624,1545,79,4.9
5622,CN4608700000000,46,87,"McCook County, SD",Apr-19,3065,2968,97,3.2
5623,CN4608900000000,46,89,"McPherson County, SD",Apr-19,977,937,40,4.1
5624,CN4609100000000,46,91,"Marshall County, SD",Apr-19,2283,2179,104,4.6
5625,CN4609300000000,46,93,"Meade County, SD",Apr-19,13948,13446,502,3.6
5626,CN4609500000000,46,95,"Mellette County, SD",Apr-19,730,689,41,5.6
5627,CN4609700000000,46,97,"Miner County, SD",Apr-19,1144,1108,36,3.1
5628,CN4609900000000,46,99,"Minnehaha County, SD",Apr-19,112624,109404,3220,2.9
5629,CN4610100000000,46,101,"Moody County, SD",Apr-19,3919,3799,120,3.1
5630,CN4610200000000,46,102,"Oglala Lakota County, SD",Apr-19,3497,3214,283,8.1
5631,CN4610300000000,46,103,"Pennington County, SD",Apr-19,55873,53979,1894,3.4
5632,CN4610500000000,46,105,"Perkins County, SD",Apr-19,1401,1356,45,3.2
5633,CN4610700000000,46,107,"Potter County, SD",Apr-19,1008,977,31,3.1
5634,CN4610900000000,46,109,"Roberts County, SD",Apr-19,4727,4499,228,4.8
5635,CN4611100000000,46,111,"Sanborn County, SD",Apr-19,1124,1091,33,2.9
5636,CN4611500000000,46,115,"Spink County, SD",Apr-19,3132,3014,118,3.8
5637,CN4611700000000,46,117,"Stanley County, SD",Apr-19,1809,1754,55,3.0
5638,CN4611900000000,46,119,"Sully County, SD",Apr-19,778,755,23,3.0
5639,CN4612100000000,46,121,"Todd County, SD",Apr-19,3170,2985,185,5.8
5640,CN4612300000000,46,123,"Tripp County, SD",Apr-19,2987,2901,86,2.9
5641,CN4612500000000,46,125,"Turner County, SD",Apr-19,4684,4545,139,3.0
5642,CN4612700000000,46,127,"Union County, SD",Apr-19,8471,8206,265,3.1
5643,CN4612900000000,46,129,"Walworth County, SD",Apr-19,2075,1944,131,6.3
5644,CN4613500000000,46,135,"Yankton County, SD",Apr-19,11986,11624,362,3.0
5645,CN4613700000000,46,137,"Ziebach County, SD",Apr-19,912,870,42,4.6
5646,CN4700100000000,47,1,"Anderson County, TN",Apr-19,34801,33746,1055,3.0
5647,CN4700300000000,47,3,"Bedford County, TN",Apr-19,21285,20613,672,3.2
5648,CN4700500000000,47,5,"Benton County, TN",Apr-19,6978,6716,262,3.8
5649,CN4700700000000,47,7,"Bledsoe County, TN",Apr-19,4235,4050,185,4.4
5650,CN4700900000000,47,9,"Blount County, TN",Apr-19,63725,62070,1655,2.6
5651,CN4701100000000,47,11,"Bradley County, TN",Apr-19,51180,49667,1513,3.0
5652,CN4701300000000,47,13,"Campbell County, TN",Apr-19,14885,14288,597,4.0
5653,CN4701500000000,47,15,"Cannon County, TN",Apr-19,6606,6439,167,2.5
5654,CN4701700000000,47,17,"Carroll County, TN",Apr-19,12205,11698,507,4.2
5655,CN4701900000000,47,19,"Carter County, TN",Apr-19,24315,23433,882,3.6
5656,CN4702100000000,47,21,"Cheatham County, TN",Apr-19,21981,21480,501,2.3
5657,CN4702300000000,47,23,"Chester County, TN",Apr-19,8593,8332,261,3.0
5658,CN4702500000000,47,25,"Claiborne County, TN",Apr-19,13179,12697,482,3.7
5659,CN4702700000000,47,27,"Clay County, TN",Apr-19,2723,2561,162,5.9
5660,CN4702900000000,47,29,"Cocke County, TN",Apr-19,15077,14495,582,3.9
5661,CN4703100000000,47,31,"Coffee County, TN",Apr-19,25567,24857,710,2.8
5662,CN4703300000000,47,33,"Crockett County, TN",Apr-19,6978,6768,210,3.0
5663,CN4703500000000,47,35,"Cumberland County, TN",Apr-19,23369,22532,837,3.6
5664,CN4703700000000,47,37,"Davidson County, TN",Apr-19,406749,397921,8828,2.2
5665,CN4703900000000,47,39,"Decatur County, TN",Apr-19,4548,4343,205,4.5
5666,CN4704100000000,47,41,"DeKalb County, TN",Apr-19,7841,7557,284,3.6
5667,CN4704300000000,47,43,"Dickson County, TN",Apr-19,27149,26464,685,2.5
5668,CN4704500000000,47,45,"Dyer County, TN",Apr-19,16545,15842,703,4.2
5669,CN4704700000000,47,47,"Fayette County, TN",Apr-19,19141,18537,604,3.2
5670,CN4704900000000,47,49,"Fentress County, TN",Apr-19,7456,7217,239,3.2
5671,CN4705100000000,47,51,"Franklin County, TN",Apr-19,20252,19700,552,2.7
5672,CN4705300000000,47,53,"Gibson County, TN",Apr-19,22066,21247,819,3.7
5673,CN4705500000000,47,55,"Giles County, TN",Apr-19,15110,14639,471,3.1
5674,CN4705700000000,47,57,"Grainger County, TN",Apr-19,9530,9192,338,3.5
5675,CN4705900000000,47,59,"Greene County, TN",Apr-19,29975,28785,1190,4.0
5676,CN4706100000000,47,61,"Grundy County, TN",Apr-19,5025,4856,169,3.4
5677,CN4706300000000,47,63,"Hamblen County, TN",Apr-19,28435,27463,972,3.4
5678,CN4706500000000,47,65,"Hamilton County, TN",Apr-19,184496,179439,5057,2.7
5679,CN4706700000000,47,67,"Hancock County, TN",Apr-19,2119,2011,108,5.1
5680,CN4706900000000,47,69,"Hardeman County, TN",Apr-19,9500,9081,419,4.4
5681,CN4707100000000,47,71,"Hardin County, TN",Apr-19,10364,9994,370,3.6
5682,CN4707300000000,47,73,"Hawkins County, TN",Apr-19,23956,23162,794,3.3
5683,CN4707500000000,47,75,"Haywood County, TN",Apr-19,7667,7327,340,4.4
5684,CN4707700000000,47,77,"Henderson County, TN",Apr-19,12263,11823,440,3.6
5685,CN4707900000000,47,79,"Henry County, TN",Apr-19,14210,13691,519,3.7
5686,CN4708100000000,47,81,"Hickman County, TN",Apr-19,11453,11165,288,2.5
5687,CN4708300000000,47,83,"Houston County, TN",Apr-19,3247,3128,119,3.7
5688,CN4708500000000,47,85,"Humphreys County, TN",Apr-19,8998,8707,291,3.2
5689,CN4708700000000,47,87,"Jackson County, TN",Apr-19,4675,4495,180,3.9
5690,CN4708900000000,47,89,"Jefferson County, TN",Apr-19,24808,24028,780,3.1
5691,CN4709100000000,47,91,"Johnson County, TN",Apr-19,7655,7418,237,3.1
5692,CN4709300000000,47,93,"Knox County, TN",Apr-19,245392,239336,6056,2.5
5693,CN4709500000000,47,95,"Lake County, TN",Apr-19,1762,1676,86,4.9
5694,CN4709700000000,47,97,"Lauderdale County, TN",Apr-19,9681,9212,469,4.8
5695,CN4709900000000,47,99,"Lawrence County, TN",Apr-19,19297,18566,731,3.8
5696,CN4710100000000,47,101,"Lewis County, TN",Apr-19,5140,4948,192,3.7
5697,CN4710300000000,47,103,"Lincoln County, TN",Apr-19,16822,16378,444,2.6
5698,CN4710500000000,47,105,"Loudon County, TN",Apr-19,23511,22830,681,2.9
5699,CN4710700000000,47,107,"McMinn County, TN",Apr-19,23592,22830,762,3.2
5700,CN4710900000000,47,109,"McNairy County, TN",Apr-19,8410,8029,381,4.5
5701,CN4711100000000,47,111,"Macon County, TN",Apr-19,11221,10932,289,2.6
5702,CN4711300000000,47,113,"Madison County, TN",Apr-19,49355,47802,1553,3.1
5703,CN4711500000000,47,115,"Marion County, TN",Apr-19,12512,12056,456,3.6
5704,CN4711700000000,47,117,"Marshall County, TN",Apr-19,15839,15386,453,2.9
5705,CN4711900000000,47,119,"Maury County, TN",Apr-19,49785,48337,1448,2.9
5706,CN4712100000000,47,121,"Meigs County, TN",Apr-19,5190,4991,199,3.8
5707,CN4712300000000,47,123,"Monroe County, TN",Apr-19,20240,19620,620,3.1
5708,CN4712500000000,47,125,"Montgomery County, TN",Apr-19,85636,82833,2803,3.3
5709,CN4712700000000,47,127,"Moore County, TN",Apr-19,3641,3558,83,2.3
5710,CN4712900000000,47,129,"Morgan County, TN",Apr-19,7903,7626,277,3.5
5711,CN4713100000000,47,131,"Obion County, TN",Apr-19,12563,12078,485,3.9
5712,CN4713300000000,47,133,"Overton County, TN",Apr-19,9803,9487,316,3.2
5713,CN4713500000000,47,135,"Perry County, TN",Apr-19,3193,3055,138,4.3
5714,CN4713700000000,47,137,"Pickett County, TN",Apr-19,2370,2273,97,4.1
5715,CN4713900000000,47,139,"Polk County, TN",Apr-19,7361,7124,237,3.2
5716,CN4714100000000,47,141,"Putnam County, TN",Apr-19,35102,34090,1012,2.9
5717,CN4714300000000,47,143,"Rhea County, TN",Apr-19,13240,12532,708,5.3
5718,CN4714500000000,47,145,"Roane County, TN",Apr-19,23470,22669,801,3.4
5719,CN4714700000000,47,147,"Robertson County, TN",Apr-19,38157,37174,983,2.6
5720,CN4714900000000,47,149,"Rutherford County, TN",Apr-19,185236,181195,4041,2.2
5721,CN4715100000000,47,151,"Scott County, TN",Apr-19,8398,8096,302,3.6
5722,CN4715300000000,47,153,"Sequatchie County, TN",Apr-19,6183,5975,208,3.4
5723,CN4715500000000,47,155,"Sevier County, TN",Apr-19,54532,53073,1459,2.7
5724,CN4715700000000,47,157,"Shelby County, TN",Apr-19,447453,431345,16108,3.6
5725,CN4715900000000,47,159,"Smith County, TN",Apr-19,9468,9234,234,2.5
5726,CN4716100000000,47,161,"Stewart County, TN",Apr-19,5539,5331,208,3.8
5727,CN4716300000000,47,163,"Sullivan County, TN",Apr-19,71103,68853,2250,3.2
5728,CN4716500000000,47,165,"Sumner County, TN",Apr-19,102959,100573,2386,2.3
5729,CN4716700000000,47,167,"Tipton County, TN",Apr-19,28218,27269,949,3.4
5730,CN4716900000000,47,169,"Trousdale County, TN",Apr-19,5452,5301,151,2.8
5731,CN4717100000000,47,171,"Unicoi County, TN",Apr-19,7158,6831,327,4.6
5732,CN4717300000000,47,173,"Union County, TN",Apr-19,7641,7380,261,3.4
5733,CN4717500000000,47,175,"Van Buren County, TN",Apr-19,2079,2002,77,3.7
5734,CN4717700000000,47,177,"Warren County, TN",Apr-19,16760,16198,562,3.4
5735,CN4717900000000,47,179,"Washington County, TN",Apr-19,61169,59370,1799,2.9
5736,CN4718100000000,47,181,"Wayne County, TN",Apr-19,6295,6052,243,3.9
5737,CN4718300000000,47,183,"Weakley County, TN",Apr-19,16433,15898,535,3.3
5738,CN4718500000000,47,185,"White County, TN",Apr-19,12301,11924,377,3.1
5739,CN4718700000000,47,187,"Williamson County, TN",Apr-19,129069,126411,2658,2.1
5740,CN4718900000000,47,189,"Wilson County, TN",Apr-19,77014,75262,1752,2.3
5741,CN4800100000000,48,1,"Anderson County, TX",Apr-19,23689,23107,582,2.5
5742,CN4800300000000,48,3,"Andrews County, TX",Apr-19,9863,9695,168,1.7
5743,CN4800500000000,48,5,"Angelina County, TX",Apr-19,35582,34370,1212,3.4
5744,CN4800700000000,48,7,"Aransas County, TX",Apr-19,9410,9060,350,3.7
5745,CN4800900000000,48,9,"Archer County, TX",Apr-19,4118,4018,100,2.4
5746,CN4801100000000,48,11,"Armstrong County, TX",Apr-19,926,905,21,2.3
5747,CN4801300000000,48,13,"Atascosa County, TX",Apr-19,21491,20834,657,3.1
5748,CN4801500000000,48,15,"Austin County, TX",Apr-19,13965,13566,399,2.9
5749,CN4801700000000,48,17,"Bailey County, TX",Apr-19,2510,2429,81,3.2
5750,CN4801900000000,48,19,"Bandera County, TX",Apr-19,9977,9700,277,2.8
5751,CN4802100000000,48,21,"Bastrop County, TX",Apr-19,42476,41437,1039,2.4
5752,CN4802300000000,48,23,"Baylor County, TX",Apr-19,1722,1689,33,1.9
5753,CN4802500000000,48,25,"Bee County, TX",Apr-19,9826,9462,364,3.7
5754,CN4802700000000,48,27,"Bell County, TX",Apr-19,142943,138318,4625,3.2
5755,CN4802900000000,48,29,"Bexar County, TX",Apr-19,940307,915453,24854,2.6
5756,CN4803100000000,48,31,"Blanco County, TX",Apr-19,6438,6305,133,2.1
5757,CN4803300000000,48,33,"Borden County, TX",Apr-19,394,386,8,2.0
5758,CN4803500000000,48,35,"Bosque County, TX",Apr-19,8296,8059,237,2.9
5759,CN4803700000000,48,37,"Bowie County, TX",Apr-19,39760,38238,1522,3.8
5760,CN4803900000000,48,39,"Brazoria County, TX",Apr-19,177500,171377,6123,3.4
5761,CN4804100000000,48,41,"Brazos County, TX",Apr-19,119124,116563,2561,2.1
5762,CN4804300000000,48,43,"Brewster County, TX",Apr-19,4253,4146,107,2.5
5763,CN4804500000000,48,45,"Briscoe County, TX",Apr-19,591,573,18,3.0
5764,CN4804700000000,48,47,"Brooks County, TX",Apr-19,2585,2480,105,4.1
5765,CN4804900000000,48,49,"Brown County, TX",Apr-19,15650,15187,463,3.0
5766,CN4805100000000,48,51,"Burleson County, TX",Apr-19,8370,8151,219,2.6
5767,CN4805300000000,48,53,"Burnet County, TX",Apr-19,23410,22877,533,2.3
5768,CN4805500000000,48,55,"Caldwell County, TX",Apr-19,19489,18932,557,2.9
5769,CN4805700000000,48,57,"Calhoun County, TX",Apr-19,12195,11884,311,2.6
5770,CN4805900000000,48,59,"Callahan County, TX",Apr-19,6059,5909,150,2.5
5771,CN4806100000000,48,61,"Cameron County, TX",Apr-19,165479,157712,7767,4.7
5772,CN4806300000000,48,63,"Camp County, TX",Apr-19,4928,4754,174,3.5
5773,CN4806500000000,48,65,"Carson County, TX",Apr-19,3008,2939,69,2.3
5774,CN4806700000000,48,67,"Cass County, TX",Apr-19,12409,11949,460,3.7
5775,CN4806900000000,48,69,"Castro County, TX",Apr-19,3448,3356,92,2.7
5776,CN4807100000000,48,71,"Chambers County, TX",Apr-19,19271,18536,735,3.8
5777,CN4807300000000,48,73,"Cherokee County, TX",Apr-19,20983,20310,673,3.2
5778,CN4807500000000,48,75,"Childress County, TX",Apr-19,2943,2880,63,2.1
5779,CN4807700000000,48,77,"Clay County, TX",Apr-19,4902,4777,125,2.5
5780,CN4807900000000,48,79,"Cochran County, TX",Apr-19,1117,1086,31,2.8
5781,CN4808100000000,48,81,"Coke County, TX",Apr-19,1447,1408,39,2.7
5782,CN4808300000000,48,83,"Coleman County, TX",Apr-19,2870,2773,97,3.4
5783,CN4808500000000,48,85,"Collin County, TX",Apr-19,556814,541714,15100,2.7
5784,CN4808700000000,48,87,"Collingsworth County, TX",Apr-19,1140,1112,28,2.5
5785,CN4808900000000,48,89,"Colorado County, TX",Apr-19,9721,9454,267,2.7
5786,CN4809100000000,48,91,"Comal County, TX",Apr-19,72649,70825,1824,2.5
5787,CN4809300000000,48,93,"Comanche County, TX",Apr-19,5536,5394,142,2.6
5788,CN4809500000000,48,95,"Concho County, TX",Apr-19,1098,1062,36,3.3
5789,CN4809700000000,48,97,"Cooke County, TX",Apr-19,19925,19470,455,2.3
5790,CN4809900000000,48,99,"Coryell County, TX",Apr-19,23962,23165,797,3.3
5791,CN4810100000000,48,101,"Cottle County, TX",Apr-19,553,535,18,3.3
5792,CN4810300000000,48,103,"Crane County, TX",Apr-19,1531,1485,46,3.0
5793,CN4810500000000,48,105,"Crockett County, TX",Apr-19,1654,1620,34,2.1
5794,CN4810700000000,48,107,"Crosby County, TX",Apr-19,2488,2408,80,3.2
5795,CN4810900000000,48,109,"Culberson County, TX",Apr-19,1025,974,51,5.0
5796,CN4811100000000,48,111,"Dallam County, TX",Apr-19,3903,3842,61,1.6
5797,CN4811300000000,48,113,"Dallas County, TX",Apr-19,1347592,1306468,41124,3.1
5798,CN4811500000000,48,115,"Dawson County, TX",Apr-19,4597,4445,152,3.3
5799,CN4811700000000,48,117,"Deaf Smith County, TX",Apr-19,8418,8220,198,2.4
5800,CN4811900000000,48,119,"Delta County, TX",Apr-19,2431,2360,71,2.9
5801,CN4812100000000,48,121,"Denton County, TX",Apr-19,488569,475935,12634,2.6
5802,CN4812300000000,48,123,"DeWitt County, TX",Apr-19,9732,9509,223,2.3
5803,CN4812500000000,48,125,"Dickens County, TX",Apr-19,684,659,25,3.7
5804,CN4812700000000,48,127,"Dimmit County, TX",Apr-19,7595,7440,155,2.0
5805,CN4812900000000,48,129,"Donley County, TX",Apr-19,1475,1439,36,2.4
5806,CN4813100000000,48,131,"Duval County, TX",Apr-19,4957,4775,182,3.7
5807,CN4813300000000,48,133,"Eastland County, TX",Apr-19,8424,8182,242,2.9
5808,CN4813500000000,48,135,"Ector County, TX",Apr-19,88227,86437,1790,2.0
5809,CN4813700000000,48,137,"Edwards County, TX",Apr-19,978,958,20,2.0
5810,CN4813900000000,48,139,"Ellis County, TX",Apr-19,91516,89074,2442,2.7
5811,CN4814100000000,48,141,"El Paso County, TX",Apr-19,360189,348323,11866,3.3
5812,CN4814300000000,48,143,"Erath County, TX",Apr-19,20576,20065,511,2.5
5813,CN4814500000000,48,145,"Falls County, TX",Apr-19,6525,6343,182,2.8
5814,CN4814700000000,48,147,"Fannin County, TX",Apr-19,17170,16768,402,2.3
5815,CN4814900000000,48,149,"Fayette County, TX",Apr-19,12426,12144,282,2.3
5816,CN4815100000000,48,151,"Fisher County, TX",Apr-19,1624,1586,38,2.3
5817,CN4815300000000,48,153,"Floyd County, TX",Apr-19,2570,2467,103,4.0
5818,CN4815500000000,48,155,"Foard County, TX",Apr-19,581,567,14,2.4
5819,CN4815700000000,48,157,"Fort Bend County, TX",Apr-19,388975,377271,11704,3.0
5820,CN4815900000000,48,159,"Franklin County, TX",Apr-19,4644,4499,145,3.1
5821,CN4816100000000,48,161,"Freestone County, TX",Apr-19,6314,6056,258,4.1
5822,CN4816300000000,48,163,"Frio County, TX",Apr-19,10499,10273,226,2.2
5823,CN4816500000000,48,165,"Gaines County, TX",Apr-19,9765,9573,192,2.0
5824,CN4816700000000,48,167,"Galveston County, TX",Apr-19,163840,158229,5611,3.4
5825,CN4816900000000,48,169,"Garza County, TX",Apr-19,2184,2131,53,2.4
5826,CN4817100000000,48,171,"Gillespie County, TX",Apr-19,13454,13167,287,2.1
5827,CN4817300000000,48,173,"Glasscock County, TX",Apr-19,789,775,14,1.8
5828,CN4817500000000,48,175,"Goliad County, TX",Apr-19,3245,3151,94,2.9
5829,CN4817700000000,48,177,"Gonzales County, TX",Apr-19,9515,9302,213,2.2
5830,CN4817900000000,48,179,"Gray County, TX",Apr-19,8013,7762,251,3.1
5831,CN4818100000000,48,181,"Grayson County, TX",Apr-19,63843,62210,1633,2.6
5832,CN4818300000000,48,183,"Gregg County, TX",Apr-19,58317,56414,1903,3.3
5833,CN4818500000000,48,185,"Grimes County, TX",Apr-19,11260,10888,372,3.3
5834,CN4818700000000,48,187,"Guadalupe County, TX",Apr-19,80728,78715,2013,2.5
5835,CN4818900000000,48,189,"Hale County, TX",Apr-19,12341,11880,461,3.7
5836,CN4819100000000,48,191,"Hall County, TX",Apr-19,1083,1045,38,3.5
5837,CN4819300000000,48,193,"Hamilton County, TX",Apr-19,3632,3543,89,2.5
5838,CN4819500000000,48,195,"Hansford County, TX",Apr-19,2761,2705,56,2.0
5839,CN4819700000000,48,197,"Hardeman County, TX",Apr-19,1715,1671,44,2.6
5840,CN4819900000000,48,199,"Hardin County, TX",Apr-19,25209,24258,951,3.8
5841,CN4820100000000,48,201,"Harris County, TX",Apr-19,2296434,2220622,75812,3.3
5842,CN4820300000000,48,203,"Harrison County, TX",Apr-19,29392,28406,986,3.4
5843,CN4820500000000,48,205,"Hartley County, TX",Apr-19,2786,2750,36,1.3
5844,CN4820700000000,48,207,"Haskell County, TX",Apr-19,2268,2195,73,3.2
5845,CN4820900000000,48,209,"Hays County, TX",Apr-19,118789,116086,2703,2.3
5846,CN4821100000000,48,211,"Hemphill County, TX",Apr-19,1951,1902,49,2.5
5847,CN4821300000000,48,213,"Henderson County, TX",Apr-19,36428,35334,1094,3.0
5848,CN4821500000000,48,215,"Hidalgo County, TX",Apr-19,349258,331640,17618,5.0
5849,CN4821700000000,48,217,"Hill County, TX",Apr-19,16234,15788,446,2.7
5850,CN4821900000000,48,219,"Hockley County, TX",Apr-19,11358,11077,281,2.5
5851,CN4822100000000,48,221,"Hood County, TX",Apr-19,27231,26446,785,2.9
5852,CN4822300000000,48,223,"Hopkins County, TX",Apr-19,17404,16940,464,2.7
5853,CN4822500000000,48,225,"Houston County, TX",Apr-19,10063,9807,256,2.5
5854,CN4822700000000,48,227,"Howard County, TX",Apr-19,13873,13515,358,2.6
5855,CN4822900000000,48,229,"Hudspeth County, TX",Apr-19,1811,1746,65,3.6
5856,CN4823100000000,48,231,"Hunt County, TX",Apr-19,42828,41524,1304,3.0
5857,CN4823300000000,48,233,"Hutchinson County, TX",Apr-19,8622,8309,313,3.6
5858,CN4823500000000,48,235,"Irion County, TX",Apr-19,760,745,15,2.0
5859,CN4823700000000,48,237,"Jack County, TX",Apr-19,3463,3373,90,2.6
5860,CN4823900000000,48,239,"Jackson County, TX",Apr-19,7500,7302,198,2.6
5861,CN4824100000000,48,241,"Jasper County, TX",Apr-19,12796,12132,664,5.2
5862,CN4824300000000,48,243,"Jeff Davis County, TX",Apr-19,1057,1033,24,2.3
5863,CN4824500000000,48,245,"Jefferson County, TX",Apr-19,106273,101151,5122,4.8
5864,CN4824700000000,48,247,"Jim Hogg County, TX",Apr-19,1911,1831,80,4.2
5865,CN4824900000000,48,249,"Jim Wells County, TX",Apr-19,16993,16327,666,3.9
5866,CN4825100000000,48,251,"Johnson County, TX",Apr-19,81143,78969,2174,2.7
5867,CN4825300000000,48,253,"Jones County, TX",Apr-19,5677,5479,198,3.5
5868,CN4825500000000,48,255,"Karnes County, TX",Apr-19,7101,6948,153,2.2
5869,CN4825700000000,48,257,"Kaufman County, TX",Apr-19,63728,61956,1772,2.8
5870,CN4825900000000,48,259,"Kendall County, TX",Apr-19,21943,21439,504,2.3
5871,CN4826100000000,48,261,"Kenedy County, TX",Apr-19,242,236,6,2.5
5872,CN4826300000000,48,263,"Kent County, TX",Apr-19,484,475,9,1.9
5873,CN4826500000000,48,265,"Kerr County, TX",Apr-19,22032,21489,543,2.5
5874,CN4826700000000,48,267,"Kimble County, TX",Apr-19,1857,1811,46,2.5
5875,CN4826900000000,48,269,"King County, TX",Apr-19,236,231,5,2.1
5876,CN4827100000000,48,271,"Kinney County, TX",Apr-19,1372,1326,46,3.4
5877,CN4827300000000,48,273,"Kleberg County, TX",Apr-19,13473,12988,485,3.6
5878,CN4827500000000,48,275,"Knox County, TX",Apr-19,1444,1403,41,2.8
5879,CN4827700000000,48,277,"Lamar County, TX",Apr-19,23910,23194,716,3.0
5880,CN4827900000000,48,279,"Lamb County, TX",Apr-19,5293,5115,178,3.4
5881,CN4828100000000,48,281,"Lampasas County, TX",Apr-19,9158,8906,252,2.8
5882,CN4828300000000,48,283,"La Salle County, TX",Apr-19,4351,4268,83,1.9
5883,CN4828500000000,48,285,"Lavaca County, TX",Apr-19,8604,8380,224,2.6
5884,CN4828700000000,48,287,"Lee County, TX",Apr-19,10413,10195,218,2.1
5885,CN4828900000000,48,289,"Leon County, TX",Apr-19,6239,6026,213,3.4
5886,CN4829100000000,48,291,"Liberty County, TX",Apr-19,32676,31318,1358,4.2
5887,CN4829300000000,48,293,"Limestone County, TX",Apr-19,8480,8197,283,3.3
5888,CN4829500000000,48,295,"Lipscomb County, TX",Apr-19,1700,1664,36,2.1
5889,CN4829700000000,48,297,"Live Oak County, TX",Apr-19,5433,5285,148,2.7
5890,CN4829900000000,48,299,"Llano County, TX",Apr-19,8501,8245,256,3.0
5891,CN4830100000000,48,301,"Loving County, TX",Apr-19,502,498,4,0.8
5892,CN4830300000000,48,303,"Lubbock County, TX",Apr-19,157842,154221,3621,2.3
5893,CN4830500000000,48,305,"Lynn County, TX",Apr-19,2773,2700,73,2.6
5894,CN4830700000000,48,307,"McCulloch County, TX",Apr-19,3552,3359,193,5.4
5895,CN4830900000000,48,309,"McLennan County, TX",Apr-19,118680,115415,3265,2.8
5896,CN4831100000000,48,311,"McMullen County, TX",Apr-19,772,761,11,1.4
5897,CN4831300000000,48,313,"Madison County, TX",Apr-19,4565,4411,154,3.4
5898,CN4831500000000,48,315,"Marion County, TX",Apr-19,4246,4092,154,3.6
5899,CN4831700000000,48,317,"Martin County, TX",Apr-19,2871,2818,53,1.8
5900,CN4831900000000,48,319,"Mason County, TX",Apr-19,1768,1719,49,2.8
5901,CN4832100000000,48,321,"Matagorda County, TX",Apr-19,16642,15867,775,4.7
5902,CN4832300000000,48,323,"Maverick County, TX",Apr-19,24085,22358,1727,7.2
5903,CN4832500000000,48,325,"Medina County, TX",Apr-19,21627,21047,580,2.7
5904,CN4832700000000,48,327,"Menard County, TX",Apr-19,851,825,26,3.1
5905,CN4832900000000,48,329,"Midland County, TX",Apr-19,107251,105471,1780,1.7
5906,CN4833100000000,48,331,"Milam County, TX",Apr-19,9735,9298,437,4.5
5907,CN4833300000000,48,333,"Mills County, TX",Apr-19,1861,1807,54,2.9
5908,CN4833500000000,48,335,"Mitchell County, TX",Apr-19,2313,2245,68,2.9
5909,CN4833700000000,48,337,"Montague County, TX",Apr-19,9222,8991,231,2.5
5910,CN4833900000000,48,339,"Montgomery County, TX",Apr-19,281540,273430,8110,2.9
5911,CN4834100000000,48,341,"Moore County, TX",Apr-19,10931,10725,206,1.9
5912,CN4834300000000,48,343,"Morris County, TX",Apr-19,4781,4562,219,4.6
5913,CN4834500000000,48,345,"Motley County, TX",Apr-19,483,469,14,2.9
5914,CN4834700000000,48,347,"Nacogdoches County, TX",Apr-19,28065,27233,832,3.0
5915,CN4834900000000,48,349,"Navarro County, TX",Apr-19,23559,22839,720,3.1
5916,CN4835100000000,48,351,"Newton County, TX",Apr-19,5140,4878,262,5.1
5917,CN4835300000000,48,353,"Nolan County, TX",Apr-19,6883,6716,167,2.4
5918,CN4835500000000,48,355,"Nueces County, TX",Apr-19,167053,161286,5767,3.5
5919,CN4835700000000,48,357,"Ochiltree County, TX",Apr-19,4311,4217,94,2.2
5920,CN4835900000000,48,359,"Oldham County, TX",Apr-19,914,891,23,2.5
5921,CN4836100000000,48,361,"Orange County, TX",Apr-19,36223,34660,1563,4.3
5922,CN4836300000000,48,363,"Palo Pinto County, TX",Apr-19,13529,13169,360,2.7
5923,CN4836500000000,48,365,"Panola County, TX",Apr-19,10236,9904,332,3.2
5924,CN4836700000000,48,367,"Parker County, TX",Apr-19,66556,64918,1638,2.5
5925,CN4836900000000,48,369,"Parmer County, TX",Apr-19,4873,4780,93,1.9
5926,CN4837100000000,48,371,"Pecos County, TX",Apr-19,6381,6202,179,2.8
5927,CN4837300000000,48,373,"Polk County, TX",Apr-19,17811,17122,689,3.9
5928,CN4837500000000,48,375,"Potter County, TX",Apr-19,55008,53788,1220,2.2
5929,CN4837700000000,48,377,"Presidio County, TX",Apr-19,3060,2905,155,5.1
5930,CN4837900000000,48,379,"Rains County, TX",Apr-19,6167,6012,155,2.5
5931,CN4838100000000,48,381,"Randall County, TX",Apr-19,71934,70480,1454,2.0
5932,CN4838300000000,48,383,"Reagan County, TX",Apr-19,1940,1904,36,1.9
5933,CN4838500000000,48,385,"Real County, TX",Apr-19,1059,1024,35,3.3
5934,CN4838700000000,48,387,"Red River County, TX",Apr-19,5097,4895,202,4.0
5935,CN4838900000000,48,389,"Reeves County, TX",Apr-19,10936,10774,162,1.5
5936,CN4839100000000,48,391,"Refugio County, TX",Apr-19,3154,3057,97,3.1
5937,CN4839300000000,48,393,"Roberts County, TX",Apr-19,405,392,13,3.2
5938,CN4839500000000,48,395,"Robertson County, TX",Apr-19,7660,7428,232,3.0
5939,CN4839700000000,48,397,"Rockwall County, TX",Apr-19,51427,50061,1366,2.7
5940,CN4839900000000,48,399,"Runnels County, TX",Apr-19,4585,4480,105,2.3
5941,CN4840100000000,48,401,"Rusk County, TX",Apr-19,23005,22341,664,2.9
5942,CN4840300000000,48,403,"Sabine County, TX",Apr-19,3723,3527,196,5.3
5943,CN4840500000000,48,405,"San Augustine County, TX",Apr-19,3395,3270,125,3.7
5944,CN4840700000000,48,407,"San Jacinto County, TX",Apr-19,11665,11229,436,3.7
5945,CN4840900000000,48,409,"San Patricio County, TX",Apr-19,29736,28411,1325,4.5
5946,CN4841100000000,48,411,"San Saba County, TX",Apr-19,2569,2504,65,2.5
5947,CN4841300000000,48,413,"Schleicher County, TX",Apr-19,1316,1288,28,2.1
5948,CN4841500000000,48,415,"Scurry County, TX",Apr-19,6677,6499,178,2.7
5949,CN4841700000000,48,417,"Shackelford County, TX",Apr-19,1906,1873,33,1.7
5950,CN4841900000000,48,419,"Shelby County, TX",Apr-19,11006,10650,356,3.2
5951,CN4842100000000,48,421,"Sherman County, TX",Apr-19,1370,1344,26,1.9
5952,CN4842300000000,48,423,"Smith County, TX",Apr-19,107114,104063,3051,2.8
5953,CN4842500000000,48,425,"Somervell County, TX",Apr-19,4307,4179,128,3.0
5954,CN4842700000000,48,427,"Starr County, TX",Apr-19,25222,23262,1960,7.8
5955,CN4842900000000,48,429,"Stephens County, TX",Apr-19,4167,4059,108,2.6
5956,CN4843100000000,48,431,"Sterling County, TX",Apr-19,578,560,18,3.1
5957,CN4843300000000,48,433,"Stonewall County, TX",Apr-19,581,566,15,2.6
5958,CN4843500000000,48,435,"Sutton County, TX",Apr-19,1507,1462,45,3.0
5959,CN4843700000000,48,437,"Swisher County, TX",Apr-19,2627,2544,83,3.2
5960,CN4843900000000,48,439,"Tarrant County, TX",Apr-19,1069781,1039477,30304,2.8
5961,CN4844100000000,48,441,"Taylor County, TX",Apr-19,66431,64819,1612,2.4
5962,CN4844300000000,48,443,"Terrell County, TX",Apr-19,376,366,10,2.7
5963,CN4844500000000,48,445,"Terry County, TX",Apr-19,5032,4867,165,3.3
5964,CN4844700000000,48,447,"Throckmorton County, TX",Apr-19,649,630,19,2.9
5965,CN4844900000000,48,449,"Titus County, TX",Apr-19,12887,12426,461,3.6
5966,CN4845100000000,48,451,"Tom Green County, TX",Apr-19,54546,53170,1376,2.5
5967,CN4845300000000,48,453,"Travis County, TX",Apr-19,735216,719042,16174,2.2
5968,CN4845500000000,48,455,"Trinity County, TX",Apr-19,5243,5037,206,3.9
5969,CN4845700000000,48,457,"Tyler County, TX",Apr-19,7072,6741,331,4.7
5970,CN4845900000000,48,459,"Upshur County, TX",Apr-19,17875,17321,554,3.1
5971,CN4846100000000,48,461,"Upton County, TX",Apr-19,1683,1638,45,2.7
5972,CN4846300000000,48,463,"Uvalde County, TX",Apr-19,11506,11129,377,3.3
5973,CN4846500000000,48,465,"Val Verde County, TX",Apr-19,22882,22238,644,2.8
5974,CN4846700000000,48,467,"Van Zandt County, TX",Apr-19,25937,25219,718,2.8
5975,CN4846900000000,48,469,"Victoria County, TX",Apr-19,42486,41241,1245,2.9
5976,CN4847100000000,48,471,"Walker County, TX",Apr-19,24005,23264,741,3.1
5977,CN4847300000000,48,473,"Waller County, TX",Apr-19,23218,22516,702,3.0
5978,CN4847500000000,48,475,"Ward County, TX",Apr-19,7453,7314,139,1.9
5979,CN4847700000000,48,477,"Washington County, TX",Apr-19,15030,14619,411,2.7
5980,CN4847900000000,48,479,"Webb County, TX",Apr-19,117804,114000,3804,3.2
5981,CN4848100000000,48,481,"Wharton County, TX",Apr-19,21529,20920,609,2.8
5982,CN4848300000000,48,483,"Wheeler County, TX",Apr-19,2240,2181,59,2.6
5983,CN4848500000000,48,485,"Wichita County, TX",Apr-19,55964,54464,1500,2.7
5984,CN4848700000000,48,487,"Wilbarger County, TX",Apr-19,4964,4821,143,2.9
5985,CN4848900000000,48,489,"Willacy County, TX",Apr-19,6558,6042,516,7.9
5986,CN4849100000000,48,491,"Williamson County, TX",Apr-19,311346,303834,7512,2.4
5987,CN4849300000000,48,493,"Wilson County, TX",Apr-19,24658,24063,595,2.4
5988,CN4849500000000,48,495,"Winkler County, TX",Apr-19,3918,3830,88,2.2
5989,CN4849700000000,48,497,"Wise County, TX",Apr-19,31488,30651,837,2.7
5990,CN4849900000000,48,499,"Wood County, TX",Apr-19,17504,16915,589,3.4
5991,CN4850100000000,48,501,"Yoakum County, TX",Apr-19,3756,3670,86,2.3
5992,CN4850300000000,48,503,"Young County, TX",Apr-19,8034,7837,197,2.5
5993,CN4850500000000,48,505,"Zapata County, TX",Apr-19,5265,5046,219,4.2
5994,CN4850700000000,48,507,"Zavala County, TX",Apr-19,3267,3034,233,7.1
5995,CN4900100000000,49,1,"Beaver County, UT",Apr-19,3006,2917,89,3.0
5996,CN4900300000000,49,3,"Box Elder County, UT",Apr-19,25806,25145,661,2.6
5997,CN4900500000000,49,5,"Cache County, UT",Apr-19,64806,63394,1412,2.2
5998,CN4900700000000,49,7,"Carbon County, UT",Apr-19,8437,8117,320,3.8
5999,CN4900900000000,49,9,"Daggett County, UT",Apr-19,407,391,16,3.9
6000,CN4901100000000,49,11,"Davis County, UT",Apr-19,171824,167620,4204,2.4
6001,CN4901300000000,49,13,"Duchesne County, UT",Apr-19,7709,7391,318,4.1
6002,CN4901500000000,49,15,"Emery County, UT",Apr-19,4310,4139,171,4.0
6003,CN4901700000000,49,17,"Garfield County, UT",Apr-19,2828,2679,149,5.3
6004,CN4901900000000,49,19,"Grand County, UT",Apr-19,6239,6059,180,2.9
6005,CN4902100000000,49,21,"Iron County, UT",Apr-19,24049,23341,708,2.9
6006,CN4902300000000,49,23,"Juab County, UT",Apr-19,5671,5537,134,2.4
6007,CN4902500000000,49,25,"Kane County, UT",Apr-19,3758,3646,112,3.0
6008,CN4902700000000,49,27,"Millard County, UT",Apr-19,6176,6003,173,2.8
6009,CN4902900000000,49,29,"Morgan County, UT",Apr-19,5518,5378,140,2.5
6010,CN4903100000000,49,31,"Piute County, UT",Apr-19,484,463,21,4.3
6011,CN4903300000000,49,33,"Rich County, UT",Apr-19,1062,1025,37,3.5
6012,CN4903500000000,49,35,"Salt Lake County, UT",Apr-19,626003,609598,16405,2.6
6013,CN4903700000000,49,37,"San Juan County, UT",Apr-19,5696,5431,265,4.7
6014,CN4903900000000,49,39,"Sanpete County, UT",Apr-19,12673,12285,388,3.1
6015,CN4904100000000,49,41,"Sevier County, UT",Apr-19,9729,9425,304,3.1
6016,CN4904300000000,49,43,"Summit County, UT",Apr-19,23492,22794,698,3.0
6017,CN4904500000000,49,45,"Tooele County, UT",Apr-19,33512,32558,954,2.8
6018,CN4904700000000,49,47,"Uintah County, UT",Apr-19,13587,13041,546,4.0
6019,CN4904900000000,49,49,"Utah County, UT",Apr-19,305180,297907,7273,2.4
6020,CN4905100000000,49,51,"Wasatch County, UT",Apr-19,15395,14944,451,2.9
6021,CN4905300000000,49,53,"Washington County, UT",Apr-19,75564,73339,2225,2.9
6022,CN4905500000000,49,55,"Wayne County, UT",Apr-19,1460,1395,65,4.5
6023,CN4905700000000,49,57,"Weber County, UT",Apr-19,126223,122540,3683,2.9
6024,CN5000100000000,50,1,"Addison County, VT",Apr-19,20438,19982,456,2.2
6025,CN5000300000000,50,3,"Bennington County, VT",Apr-19,17995,17451,544,3.0
6026,CN5000500000000,50,5,"Caledonia County, VT",Apr-19,14383,13893,490,3.4
6027,CN5000700000000,50,7,"Chittenden County, VT",Apr-19,96144,94627,1517,1.6
6028,CN5000900000000,50,9,"Essex County, VT",Apr-19,2669,2567,102,3.8
6029,CN5001100000000,50,11,"Franklin County, VT",Apr-19,27405,26735,670,2.4
6030,CN5001300000000,50,13,"Grand Isle County, VT",Apr-19,4047,3921,126,3.1
6031,CN5001500000000,50,15,"Lamoille County, VT",Apr-19,13774,13204,570,4.1
6032,CN5001700000000,50,17,"Orange County, VT",Apr-19,15826,15384,442,2.8
6033,CN5001900000000,50,19,"Orleans County, VT",Apr-19,13411,12682,729,5.4
6034,CN5002100000000,50,21,"Rutland County, VT",Apr-19,30148,29235,913,3.0
6035,CN5002300000000,50,23,"Washington County, VT",Apr-19,34134,33295,839,2.5
6036,CN5002500000000,50,25,"Windham County, VT",Apr-19,21808,21205,603,2.8
6037,CN5002700000000,50,27,"Windsor County, VT",Apr-19,28443,27792,651,2.3
6038,CN5100100000000,51,1,"Accomack County, VA",Apr-19,16491,15962,529,3.2
6039,CN5100300000000,51,3,"Albemarle County, VA",Apr-19,57982,56782,1200,2.1
6040,CN5100500000000,51,5,"Alleghany County, VA",Apr-19,6854,6661,193,2.8
6041,CN5100700000000,51,7,"Amelia County, VA",Apr-19,6235,6055,180,2.9
6042,CN5100900000000,51,9,"Amherst County, VA",Apr-19,15086,14690,396,2.6
6043,CN5101100000000,51,11,"Appomattox County, VA",Apr-19,7162,6963,199,2.8
6044,CN5101300000000,51,13,"Arlington County, VA",Apr-19,154287,151709,2578,1.7
6045,CN5101500000000,51,15,"Augusta County, VA",Apr-19,37491,36711,780,2.1
6046,CN5101700000000,51,17,"Bath County, VA",Apr-19,2409,2360,49,2.0
6047,CN5101900000000,51,19,"Bedford County, VA",Apr-19,38628,37701,927,2.4
6048,CN5102100000000,51,21,"Bland County, VA",Apr-19,2862,2799,63,2.2
6049,CN5102300000000,51,23,"Botetourt County, VA",Apr-19,17432,17059,373,2.1
6050,CN5102500000000,51,25,"Brunswick County, VA",Apr-19,6041,5790,251,4.2
6051,CN5102700000000,51,27,"Buchanan County, VA",Apr-19,6744,6442,302,4.5
6052,CN5102900000000,51,29,"Buckingham County, VA",Apr-19,6477,6248,229,3.5
6053,CN5103100000000,51,31,"Campbell County, VA",Apr-19,26148,25438,710,2.7
6054,CN5103300000000,51,33,"Caroline County, VA",Apr-19,15211,14791,420,2.8
6055,CN5103500000000,51,35,"Carroll County, VA",Apr-19,13230,12839,391,3.0
6056,CN5103600000000,51,36,"Charles City County, VA",Apr-19,3642,3530,112,3.1
6057,CN5103700000000,51,37,"Charlotte County, VA",Apr-19,5255,5100,155,2.9
6058,CN5104100000000,51,41,"Chesterfield County, VA",Apr-19,187487,182994,4493,2.4
6059,CN5104300000000,51,43,"Clarke County, VA",Apr-19,7536,7369,167,2.2
6060,CN5104500000000,51,45,"Craig County, VA",Apr-19,2296,2236,60,2.6
6061,CN5104700000000,51,47,"Culpeper County, VA",Apr-19,24441,23893,548,2.2
6062,CN5104900000000,51,49,"Cumberland County, VA",Apr-19,4648,4533,115,2.5
6063,CN5105100000000,51,51,"Dickenson County, VA",Apr-19,4658,4463,195,4.2
6064,CN5105300000000,51,53,"Dinwiddie County, VA",Apr-19,13605,13206,399,2.9
6065,CN5105700000000,51,57,"Essex County, VA",Apr-19,5495,5324,171,3.1
6066,CN5105900000000,51,59,"Fairfax County, VA",Apr-19,634283,621587,12696,2.0
6067,CN5106100000000,51,61,"Fauquier County, VA",Apr-19,36970,36193,777,2.1
6068,CN5106300000000,51,63,"Floyd County, VA",Apr-19,8271,8100,171,2.1
6069,CN5106500000000,51,65,"Fluvanna County, VA",Apr-19,14133,13852,281,2.0
6070,CN5106700000000,51,67,"Franklin County, VA",Apr-19,26369,25696,673,2.6
6071,CN5106900000000,51,69,"Frederick County, VA",Apr-19,47918,46888,1030,2.1
6072,CN5107100000000,51,71,"Giles County, VA",Apr-19,8042,7828,214,2.7
6073,CN5107300000000,51,73,"Gloucester County, VA",Apr-19,19529,19086,443,2.3
6074,CN5107500000000,51,75,"Goochland County, VA",Apr-19,11176,10905,271,2.4
6075,CN5107700000000,51,77,"Grayson County, VA",Apr-19,8082,7890,192,2.4
6076,CN5107900000000,51,79,"Greene County, VA",Apr-19,10635,10425,210,2.0
6077,CN5108100000000,51,81,"Greensville County, VA",Apr-19,4285,4152,133,3.1
6078,CN5108300000000,51,83,"Halifax County, VA",Apr-19,15830,15297,533,3.4
6079,CN5108500000000,51,85,"Hanover County, VA",Apr-19,59199,57946,1253,2.1
6080,CN5108700000000,51,87,"Henrico County, VA",Apr-19,182106,177650,4456,2.4
6081,CN5108900000000,51,89,"Henry County, VA",Apr-19,23925,23222,703,2.9
6082,CN5109100000000,51,91,"Highland County, VA",Apr-19,1206,1177,29,2.4
6083,CN5109300000000,51,93,"Isle of Wight County, VA",Apr-19,19388,18894,494,2.5
6084,CN5109500000000,51,95,"James City County, VA",Apr-19,36555,35713,842,2.3
6085,CN5109700000000,51,97,"King and Queen County, VA",Apr-19,3855,3758,97,2.5
6086,CN5109900000000,51,99,"King George County, VA",Apr-19,13271,12961,310,2.3
6087,CN5110100000000,51,101,"King William County, VA",Apr-19,9109,8903,206,2.3
6088,CN5110300000000,51,103,"Lancaster County, VA",Apr-19,5431,5179,252,4.6
6089,CN5110500000000,51,105,"Lee County, VA",Apr-19,8292,8036,256,3.1
6090,CN5110700000000,51,107,"Loudoun County, VA",Apr-19,222259,217737,4522,2.0
6091,CN5110900000000,51,109,"Louisa County, VA",Apr-19,19994,19539,455,2.3
6092,CN5111100000000,51,111,"Lunenburg County, VA",Apr-19,5359,5205,154,2.9
6093,CN5111300000000,51,113,"Madison County, VA",Apr-19,7320,7172,148,2.0
6094,CN5111500000000,51,115,"Mathews County, VA",Apr-19,4134,4026,108,2.6
6095,CN5111700000000,51,117,"Mecklenburg County, VA",Apr-19,12612,12182,430,3.4
6096,CN5111900000000,51,119,"Middlesex County, VA",Apr-19,5230,5113,117,2.2
6097,CN5112100000000,51,121,"Montgomery County, VA",Apr-19,51350,50187,1163,2.3
6098,CN5112500000000,51,125,"Nelson County, VA",Apr-19,7498,7313,185,2.5
6099,CN5112700000000,51,127,"New Kent County, VA",Apr-19,12459,12201,258,2.1
6100,CN5113100000000,51,131,"Northampton County, VA",Apr-19,5302,5063,239,4.5
6101,CN5113300000000,51,133,"Northumberland County, VA",Apr-19,5640,5374,266,4.7
6102,CN5113500000000,51,135,"Nottoway County, VA",Apr-19,7278,7101,177,2.4
6103,CN5113700000000,51,137,"Orange County, VA",Apr-19,17254,16806,448,2.6
6104,CN5113900000000,51,139,"Page County, VA",Apr-19,11959,11559,400,3.3
6105,CN5114100000000,51,141,"Patrick County, VA",Apr-19,7433,7205,228,3.1
6106,CN5114300000000,51,143,"Pittsylvania County, VA",Apr-19,30070,29164,906,3.0
6107,CN5114500000000,51,145,"Powhatan County, VA",Apr-19,14107,13811,296,2.1
6108,CN5114700000000,51,147,"Prince Edward County, VA",Apr-19,10480,10184,296,2.8
6109,CN5114900000000,51,149,"Prince George County, VA",Apr-19,15065,14625,440,2.9
6110,CN5115300000000,51,153,"Prince William County, VA",Apr-19,245221,239832,5389,2.2
6111,CN5115500000000,51,155,"Pulaski County, VA",Apr-19,16424,15981,443,2.7
6112,CN5115700000000,51,157,"Rappahannock County, VA",Apr-19,3654,3570,84,2.3
6113,CN5115900000000,51,159,"Richmond County, VA",Apr-19,4057,3949,108,2.7
6114,CN5116100000000,51,161,"Roanoke County, VA",Apr-19,49534,48466,1068,2.2
6115,CN5116300000000,51,163,"Rockbridge County, VA",Apr-19,10738,10495,243,2.3
6116,CN5116500000000,51,165,"Rockingham County, VA",Apr-19,42021,41139,882,2.1
6117,CN5116700000000,51,167,"Russell County, VA",Apr-19,11156,10768,388,3.5
6118,CN5116900000000,51,169,"Scott County, VA",Apr-19,9135,8876,259,2.8
6119,CN5117100000000,51,171,"Shenandoah County, VA",Apr-19,22143,21662,481,2.2
6120,CN5117300000000,51,173,"Smyth County, VA",Apr-19,13677,13259,418,3.1
6121,CN5117500000000,51,175,"Southampton County, VA",Apr-19,9044,8842,202,2.2
6122,CN5117700000000,51,177,"Spotsylvania County, VA",Apr-19,66864,65174,1690,2.5
6123,CN5117900000000,51,179,"Stafford County, VA",Apr-19,71955,70232,1723,2.4
6124,CN5118100000000,51,181,"Surry County, VA",Apr-19,3615,3514,101,2.8
6125,CN5118300000000,51,183,"Sussex County, VA",Apr-19,3738,3584,154,4.1
6126,CN5118500000000,51,185,"Tazewell County, VA",Apr-19,15981,15396,585,3.7
6127,CN5118700000000,51,187,"Warren County, VA",Apr-19,20362,19846,516,2.5
6128,CN5119100000000,51,191,"Washington County, VA",Apr-19,26741,25990,751,2.8
6129,CN5119300000000,51,193,"Westmoreland County, VA",Apr-19,9412,9113,299,3.2
6130,CN5119500000000,51,195,"Wise County, VA",Apr-19,13341,12806,535,4.0
6131,CN5119700000000,51,197,"Wythe County, VA",Apr-19,13672,13276,396,2.9
6132,CN5119900000000,51,199,"York County, VA",Apr-19,32763,32019,744,2.3
6133,CN5151000000000,51,510,"Alexandria city, VA",Apr-19,101273,99365,1908,1.9
6134,CN5152000000000,51,520,"Bristol city, VA",Apr-19,7197,6968,229,3.2
6135,CN5153000000000,51,530,"Buena Vista city, VA",Apr-19,3407,3332,75,2.2
6136,CN5154000000000,51,540,"Charlottesville city, VA",Apr-19,26866,26342,524,2.0
6137,CN5155000000000,51,550,"Chesapeake city, VA",Apr-19,122732,119624,3108,2.5
6138,CN5157000000000,51,570,"Colonial Heights city, VA",Apr-19,8797,8554,243,2.8
6139,CN5158000000000,51,580,"Covington city, VA",Apr-19,2367,2287,80,3.4
6140,CN5159000000000,51,590,"Danville city, VA",Apr-19,19129,18178,951,5.0
6141,CN5159500000000,51,595,"Emporia city, VA",Apr-19,2297,2183,114,5.0
6142,CN5160000000000,51,600,"Fairfax city, VA",Apr-19,13443,13180,263,2.0
6143,CN5161000000000,51,610,"Falls Church city, VA",Apr-19,8586,8435,151,1.8
6144,CN5162000000000,51,620,"Franklin city, VA",Apr-19,3566,3444,122,3.4
6145,CN5163000000000,51,630,"Fredericksburg city, VA",Apr-19,14123,13714,409,2.9
6146,CN5164000000000,51,640,"Galax city, VA",Apr-19,2924,2843,81,2.8
6147,CN5165000000000,51,650,"Hampton city, VA",Apr-19,64340,62193,2147,3.3
6148,CN5166000000000,51,660,"Harrisonburg city, VA",Apr-19,25156,24492,664,2.6
6149,CN5167000000000,51,670,"Hopewell city, VA",Apr-19,9662,9306,356,3.7
6150,CN5167800000000,51,678,"Lexington city, VA",Apr-19,2100,2023,77,3.7
6151,CN5168000000000,51,680,"Lynchburg city, VA",Apr-19,36495,35413,1082,3.0
6152,CN5168300000000,51,683,"Manassas city, VA",Apr-19,22020,21539,481,2.2
6153,CN5168500000000,51,685,"Manassas Park city, VA",Apr-19,9360,9154,206,2.2
6154,CN5169000000000,51,690,"Martinsville city, VA",Apr-19,5474,5281,193,3.5
6155,CN5170000000000,51,700,"Newport News city, VA",Apr-19,88840,86119,2721,3.1
6156,CN5171000000000,51,710,"Norfolk city, VA",Apr-19,111681,108251,3430,3.1
6157,CN5172000000000,51,720,"Norton city, VA",Apr-19,1663,1616,47,2.8
6158,CN5173000000000,51,730,"Petersburg city, VA",Apr-19,12988,12346,642,4.9
6159,CN5173500000000,51,735,"Poquoson city, VA",Apr-19,6367,6231,136,2.1
6160,CN5174000000000,51,740,"Portsmouth city, VA",Apr-19,44271,42730,1541,3.5
6161,CN5175000000000,51,750,"Radford city, VA",Apr-19,8850,8609,241,2.7
6162,CN5176000000000,51,760,"Richmond city, VA",Apr-19,118232,114840,3392,2.9
6163,CN5177000000000,51,770,"Roanoke city, VA",Apr-19,49324,48027,1297,2.6
6164,CN5177500000000,51,775,"Salem city, VA",Apr-19,13027,12721,306,2.3
6165,CN5179000000000,51,790,"Staunton city, VA",Apr-19,12288,12006,282,2.3
6166,CN5180000000000,51,800,"Suffolk city, VA",Apr-19,44621,43441,1180,2.6
6167,CN5181000000000,51,810,"Virginia Beach city, VA",Apr-19,233140,227587,5553,2.4
6168,CN5182000000000,51,820,"Waynesboro city, VA",Apr-19,10750,10479,271,2.5
6169,CN5183000000000,51,830,"Williamsburg city, VA",Apr-19,6663,6457,206,3.1
6170,CN5184000000000,51,840,"Winchester city, VA",Apr-19,14693,14328,365,2.5
6171,CN5300100000000,53,1,"Adams County, WA",Apr-19,9760,9213,547,5.6
6172,CN5300300000000,53,3,"Asotin County, WA",Apr-19,10320,9876,444,4.3
6173,CN5300500000000,53,5,"Benton County, WA",Apr-19,101508,96145,5363,5.3
6174,CN5300700000000,53,7,"Chelan County, WA",Apr-19,43038,40824,2214,5.1
6175,CN5300900000000,53,9,"Clallam County, WA",Apr-19,28501,26560,1941,6.8
6176,CN5301100000000,53,11,"Clark County, WA",Apr-19,239613,227833,11780,4.9
6177,CN5301300000000,53,13,"Columbia County, WA",Apr-19,1836,1738,98,5.3
6178,CN5301500000000,53,15,"Cowlitz County, WA",Apr-19,47578,44621,2957,6.2
6179,CN5301700000000,53,17,"Douglas County, WA",Apr-19,21479,20207,1272,5.9
6180,CN5301900000000,53,19,"Ferry County, WA",Apr-19,2525,2200,325,12.9
6181,CN5302100000000,53,21,"Franklin County, WA",Apr-19,42696,39974,2722,6.4
6182,CN5302300000000,53,23,"Garfield County, WA",Apr-19,890,843,47,5.3
6183,CN5302500000000,53,25,"Grant County, WA",Apr-19,45981,42767,3214,7.0
6184,CN5302700000000,53,27,"Grays Harbor County, WA",Apr-19,28686,26575,2111,7.4
6185,CN5302900000000,53,29,"Island County, WA",Apr-19,35525,33676,1849,5.2
6186,CN5303100000000,53,31,"Jefferson County, WA",Apr-19,12687,11926,761,6.0
6187,CN5303300000000,53,33,"King County, WA",Apr-19,1280932,1250940,29992,2.3
6188,CN5303500000000,53,35,"Kitsap County, WA",Apr-19,127232,121159,6073,4.8
6189,CN5303700000000,53,37,"Kittitas County, WA",Apr-19,23479,22194,1285,5.5
6190,CN5303900000000,53,39,"Klickitat County, WA",Apr-19,10096,9461,635,6.3
6191,CN5304100000000,53,41,"Lewis County, WA",Apr-19,34649,32464,2185,6.3
6192,CN5304300000000,53,43,"Lincoln County, WA",Apr-19,4962,4689,273,5.5
6193,CN5304500000000,53,45,"Mason County, WA",Apr-19,24661,23037,1624,6.6
6194,CN5304700000000,53,47,"Okanogan County, WA",Apr-19,19676,18193,1483,7.5
6195,CN5304900000000,53,49,"Pacific County, WA",Apr-19,8412,7775,637,7.6
6196,CN5305100000000,53,51,"Pend Oreille County, WA",Apr-19,5027,4627,400,8.0
6197,CN5305300000000,53,53,"Pierce County, WA",Apr-19,437615,414451,23164,5.3
6198,CN5305500000000,53,55,"San Juan County, WA",Apr-19,8181,7837,344,4.2
6199,CN5305700000000,53,57,"Skagit County, WA",Apr-19,62577,59226,3351,5.4
6200,CN5305900000000,53,59,"Skamania County, WA",Apr-19,5488,5195,293,5.3
6201,CN5306100000000,53,61,"Snohomish County, WA",Apr-19,435804,424878,10926,2.5
6202,CN5306300000000,53,63,"Spokane County, WA",Apr-19,253017,239380,13637,5.4
6203,CN5306500000000,53,65,"Stevens County, WA",Apr-19,19080,17567,1513,7.9
6204,CN5306700000000,53,67,"Thurston County, WA",Apr-19,141797,134643,7154,5.0
6205,CN5306900000000,53,69,"Wahkiakum County, WA",Apr-19,1353,1257,96,7.1
6206,CN5307100000000,53,71,"Walla Walla County, WA",Apr-19,29890,28428,1462,4.9
6207,CN5307300000000,53,73,"Whatcom County, WA",Apr-19,115201,109512,5689,4.9
6208,CN5307500000000,53,75,"Whitman County, WA",Apr-19,24692,23671,1021,4.1
6209,CN5307700000000,53,77,"Yakima County, WA",Apr-19,129058,119608,9450,7.3
6210,CN5400100000000,54,1,"Barbour County, WV",Apr-19,7187,6825,362,5.0
6211,CN5400300000000,54,3,"Berkeley County, WV",Apr-19,57642,55752,1890,3.3
6212,CN5400500000000,54,5,"Boone County, WV",Apr-19,7319,6979,340,4.6
6213,CN5400700000000,54,7,"Braxton County, WV",Apr-19,5176,4806,370,7.1
6214,CN5400900000000,54,9,"Brooke County, WV",Apr-19,9916,9476,440,4.4
6215,CN5401100000000,54,11,"Cabell County, WV",Apr-19,41201,39645,1556,3.8
6216,CN5401300000000,54,13,"Calhoun County, WV",Apr-19,2563,2236,327,12.8
6217,CN5401500000000,54,15,"Clay County, WV",Apr-19,3081,2850,231,7.5
6218,CN5401700000000,54,17,"Doddridge County, WV",Apr-19,3998,3840,158,4.0
6219,CN5401900000000,54,19,"Fayette County, WV",Apr-19,16024,15238,786,4.9
6220,CN5402100000000,54,21,"Gilmer County, WV",Apr-19,2413,2252,161,6.7
6221,CN5402300000000,54,23,"Grant County, WV",Apr-19,5896,5624,272,4.6
6222,CN5402500000000,54,25,"Greenbrier County, WV",Apr-19,15609,14957,652,4.2
6223,CN5402700000000,54,27,"Hampshire County, WV",Apr-19,10568,10212,356,3.4
6224,CN5402900000000,54,29,"Hancock County, WV",Apr-19,13027,12418,609,4.7
6225,CN5403100000000,54,31,"Hardy County, WV",Apr-19,5703,5438,265,4.6
6226,CN5403300000000,54,33,"Harrison County, WV",Apr-19,34642,33247,1395,4.0
6227,CN5403500000000,54,35,"Jackson County, WV",Apr-19,12999,12372,627,4.8
6228,CN5403700000000,54,37,"Jefferson County, WV",Apr-19,30419,29627,792,2.6
6229,CN5403900000000,54,39,"Kanawha County, WV",Apr-19,81543,78025,3518,4.3
6230,CN5404100000000,54,41,"Lewis County, WV",Apr-19,6720,6340,380,5.7
6231,CN5404300000000,54,43,"Lincoln County, WV",Apr-19,7111,6719,392,5.5
6232,CN5404500000000,54,45,"Logan County, WV",Apr-19,11026,10420,606,5.5
6233,CN5404700000000,54,47,"McDowell County, WV",Apr-19,4398,3981,417,9.5
6234,CN5404900000000,54,49,"Marion County, WV",Apr-19,25792,24595,1197,4.6
6235,CN5405100000000,54,51,"Marshall County, WV",Apr-19,14161,13249,912,6.4
6236,CN5405300000000,54,53,"Mason County, WV",Apr-19,10264,9753,511,5.0
6237,CN5405500000000,54,55,"Mercer County, WV",Apr-19,21035,20000,1035,4.9
6238,CN5405700000000,54,57,"Mineral County, WV",Apr-19,12537,11983,554,4.4
6239,CN5405900000000,54,59,"Mingo County, WV",Apr-19,6804,6414,390,5.7
6240,CN5406100000000,54,61,"Monongalia County, WV",Apr-19,54644,52863,1781,3.3
6241,CN5406300000000,54,63,"Monroe County, WV",Apr-19,5921,5689,232,3.9
6242,CN5406500000000,54,65,"Morgan County, WV",Apr-19,8076,7782,294,3.6
6243,CN5406700000000,54,67,"Nicholas County, WV",Apr-19,9422,8885,537,5.7
6244,CN5406900000000,54,69,"Ohio County, WV",Apr-19,21137,20231,906,4.3
6245,CN5407100000000,54,71,"Pendleton County, WV",Apr-19,3646,3506,140,3.8
6246,CN5407300000000,54,73,"Pleasants County, WV",Apr-19,2902,2708,194,6.7
6247,CN5407500000000,54,75,"Pocahontas County, WV",Apr-19,3746,3419,327,8.7
6248,CN5407700000000,54,77,"Preston County, WV",Apr-19,15528,14879,649,4.2
6249,CN5407900000000,54,79,"Putnam County, WV",Apr-19,26564,25455,1109,4.2
6250,CN5408100000000,54,81,"Raleigh County, WV",Apr-19,30172,28859,1313,4.4
6251,CN5408300000000,54,83,"Randolph County, WV",Apr-19,12367,11598,769,6.2
6252,CN5408500000000,54,85,"Ritchie County, WV",Apr-19,4351,4134,217,5.0
6253,CN5408700000000,54,87,"Roane County, WV",Apr-19,5141,4628,513,10.0
6254,CN5408900000000,54,89,"Summers County, WV",Apr-19,4286,4069,217,5.1
6255,CN5409100000000,54,91,"Taylor County, WV",Apr-19,7920,7576,344,4.3
6256,CN5409300000000,54,93,"Tucker County, WV",Apr-19,3229,3058,171,5.3
6257,CN5409500000000,54,95,"Tyler County, WV",Apr-19,3132,2904,228,7.3
6258,CN5409700000000,54,97,"Upshur County, WV",Apr-19,9683,9180,503,5.2
6259,CN5409900000000,54,99,"Wayne County, WV",Apr-19,15693,14890,803,5.1
6260,CN5410100000000,54,101,"Webster County, WV",Apr-19,3244,3074,170,5.2
6261,CN5410300000000,54,103,"Wetzel County, WV",Apr-19,6616,6150,466,7.0
6262,CN5410500000000,54,105,"Wirt County, WV",Apr-19,2269,2114,155,6.8
6263,CN5410700000000,54,107,"Wood County, WV",Apr-19,36656,34993,1663,4.5
6264,CN5410900000000,54,109,"Wyoming County, WV",Apr-19,6676,6234,442,6.6
6265,CN5500100000000,55,1,"Adams County, WI",Apr-19,8049,7656,393,4.9
6266,CN5500300000000,55,3,"Ashland County, WI",Apr-19,7660,7246,414,5.4
6267,CN5500500000000,55,5,"Barron County, WI",Apr-19,24365,23288,1077,4.4
6268,CN5500700000000,55,7,"Bayfield County, WI",Apr-19,7377,6867,510,6.9
6269,CN5500900000000,55,9,"Brown County, WI",Apr-19,140921,136875,4046,2.9
6270,CN5501100000000,55,11,"Buffalo County, WI",Apr-19,6461,6184,277,4.3
6271,CN5501300000000,55,13,"Burnett County, WI",Apr-19,7029,6619,410,5.8
6272,CN5501500000000,55,15,"Calumet County, WI",Apr-19,27319,26617,702,2.6
6273,CN5501700000000,55,17,"Chippewa County, WI",Apr-19,33334,32027,1307,3.9
6274,CN5501900000000,55,19,"Clark County, WI",Apr-19,17659,17073,586,3.3
6275,CN5502100000000,55,21,"Columbia County, WI",Apr-19,31366,30423,943,3.0
6276,CN5502300000000,55,23,"Crawford County, WI",Apr-19,7563,7218,345,4.6
6277,CN5502500000000,55,25,"Dane County, WI",Apr-19,319123,311900,7223,2.3
6278,CN5502700000000,55,27,"Dodge County, WI",Apr-19,46959,45684,1275,2.7
6279,CN5502900000000,55,29,"Door County, WI",Apr-19,14075,13457,618,4.4
6280,CN5503100000000,55,31,"Douglas County, WI",Apr-19,23099,22104,995,4.3
6281,CN5503300000000,55,33,"Dunn County, WI",Apr-19,24775,23891,884,3.6
6282,CN5503500000000,55,35,"Eau Claire County, WI",Apr-19,59087,57373,1714,2.9
6283,CN5503700000000,55,37,"Florence County, WI",Apr-19,2173,2067,106,4.9
6284,CN5503900000000,55,39,"Fond du Lac County, WI",Apr-19,56928,55486,1442,2.5
6285,CN5504100000000,55,41,"Forest County, WI",Apr-19,4005,3759,246,6.1
6286,CN5504300000000,55,43,"Grant County, WI",Apr-19,28439,27593,846,3.0
6287,CN5504500000000,55,45,"Green County, WI",Apr-19,20841,20285,556,2.7
6288,CN5504700000000,55,47,"Green Lake County, WI",Apr-19,9346,9020,326,3.5
6289,CN5504900000000,55,49,"Iowa County, WI",Apr-19,13594,13211,383,2.8
6290,CN5505100000000,55,51,"Iron County, WI",Apr-19,2458,2288,170,6.9
6291,CN5505300000000,55,53,"Jackson County, WI",Apr-19,10258,9857,401,3.9
6292,CN5505500000000,55,55,"Jefferson County, WI",Apr-19,45435,44147,1288,2.8
6293,CN5505700000000,55,57,"Juneau County, WI",Apr-19,13429,12989,440,3.3
6294,CN5505900000000,55,59,"Kenosha County, WI",Apr-19,88560,85290,3270,3.7
6295,CN5506100000000,55,61,"Kewaunee County, WI",Apr-19,10924,10609,315,2.9
6296,CN5506300000000,55,63,"La Crosse County, WI",Apr-19,66607,64828,1779,2.7
6297,CN5506500000000,55,65,"Lafayette County, WI",Apr-19,10113,9867,246,2.4
6298,CN5506700000000,55,67,"Langlade County, WI",Apr-19,9356,8984,372,4.0
6299,CN5506900000000,55,69,"Lincoln County, WI",Apr-19,14902,14313,589,4.0
6300,CN5507100000000,55,71,"Manitowoc County, WI",Apr-19,40837,39568,1269,3.1
6301,CN5507300000000,55,73,"Marathon County, WI",Apr-19,72817,70759,2058,2.8
6302,CN5507500000000,55,75,"Marinette County, WI",Apr-19,19361,18550,811,4.2
6303,CN5507700000000,55,77,"Marquette County, WI",Apr-19,7637,7352,285,3.7
6304,CN5507800000000,55,78,"Menominee County, WI",Apr-19,1627,1494,133,8.2
6305,CN5507900000000,55,79,"Milwaukee County, WI",Apr-19,462608,445937,16671,3.6
6306,CN5508100000000,55,81,"Monroe County, WI",Apr-19,23173,22539,634,2.7
6307,CN5508300000000,55,83,"Oconto County, WI",Apr-19,20422,19676,746,3.7
6308,CN5508500000000,55,85,"Oneida County, WI",Apr-19,17360,16495,865,5.0
6309,CN5508700000000,55,87,"Outagamie County, WI",Apr-19,102513,99509,3004,2.9
6310,CN5508900000000,55,89,"Ozaukee County, WI",Apr-19,48497,47222,1275,2.6
6311,CN5509100000000,55,91,"Pepin County, WI",Apr-19,4129,3964,165,4.0
6312,CN5509300000000,55,93,"Pierce County, WI",Apr-19,25133,24258,875,3.5
6313,CN5509500000000,55,95,"Polk County, WI",Apr-19,24347,23271,1076,4.4
6314,CN5509700000000,55,97,"Portage County, WI",Apr-19,38892,37696,1196,3.1
6315,CN5509900000000,55,99,"Price County, WI",Apr-19,6381,6110,271,4.2
6316,CN5510100000000,55,101,"Racine County, WI",Apr-19,98147,94459,3688,3.8
6317,CN5510300000000,55,103,"Richland County, WI",Apr-19,9203,8940,263,2.9
6318,CN5510500000000,55,105,"Rock County, WI",Apr-19,84888,82052,2836,3.3
6319,CN5510700000000,55,107,"Rusk County, WI",Apr-19,6811,6421,390,5.7
6320,CN5510900000000,55,109,"St. Croix County, WI",Apr-19,49985,48260,1725,3.5
6321,CN5511100000000,55,111,"Sauk County, WI",Apr-19,34852,33824,1028,2.9
6322,CN5511300000000,55,113,"Sawyer County, WI",Apr-19,7607,7154,453,6.0
6323,CN5511500000000,55,115,"Shawano County, WI",Apr-19,20838,20173,665,3.2
6324,CN5511700000000,55,117,"Sheboygan County, WI",Apr-19,61526,59991,1535,2.5
6325,CN5511900000000,55,119,"Taylor County, WI",Apr-19,10903,10463,440,4.0
6326,CN5512100000000,55,121,"Trempealeau County, WI",Apr-19,15940,15338,602,3.8
6327,CN5512300000000,55,123,"Vernon County, WI",Apr-19,15261,14768,493,3.2
6328,CN5512500000000,55,125,"Vilas County, WI",Apr-19,9480,8952,528,5.6
6329,CN5512700000000,55,127,"Walworth County, WI",Apr-19,57586,55870,1716,3.0
6330,CN5512900000000,55,129,"Washburn County, WI",Apr-19,7635,7304,331,4.3
6331,CN5513100000000,55,131,"Washington County, WI",Apr-19,76559,74536,2023,2.6
6332,CN5513300000000,55,133,"Waukesha County, WI",Apr-19,222865,216833,6032,2.7
6333,CN5513500000000,55,135,"Waupaca County, WI",Apr-19,25849,25009,840,3.2
6334,CN5513700000000,55,137,"Waushara County, WI",Apr-19,11253,10851,402,3.6
6335,CN5513900000000,55,139,"Winnebago County, WI",Apr-19,91093,88560,2533,2.8
6336,CN5514100000000,55,141,"Wood County, WI",Apr-19,34809,33534,1275,3.7
6337,CN5600100000000,56,1,"Albany County, WY",Apr-19,20830,20259,571,2.7
6338,CN5600300000000,56,3,"Big Horn County, WY",Apr-19,5162,4922,240,4.6
6339,CN5600500000000,56,5,"Campbell County, WY",Apr-19,23133,22410,723,3.1
6340,CN5600700000000,56,7,"Carbon County, WY",Apr-19,7537,7283,254,3.4
6341,CN5600900000000,56,9,"Converse County, WY",Apr-19,8404,8185,219,2.6
6342,CN5601100000000,56,11,"Crook County, WY",Apr-19,3547,3435,112,3.2
6343,CN5601300000000,56,13,"Fremont County, WY",Apr-19,18419,17679,740,4.0
6344,CN5601500000000,56,15,"Goshen County, WY",Apr-19,6518,6291,227,3.5
6345,CN5601700000000,56,17,"Hot Springs County, WY",Apr-19,2146,2079,67,3.1
6346,CN5601900000000,56,19,"Johnson County, WY",Apr-19,4054,3902,152,3.7
6347,CN5602100000000,56,21,"Laramie County, WY",Apr-19,48719,47143,1576,3.2
6348,CN5602300000000,56,23,"Lincoln County, WY",Apr-19,8580,8302,278,3.2
6349,CN5602500000000,56,25,"Natrona County, WY",Apr-19,39423,38000,1423,3.6
6350,CN5602700000000,56,27,"Niobrara County, WY",Apr-19,1205,1176,29,2.4
6351,CN5602900000000,56,29,"Park County, WY",Apr-19,14544,13964,580,4.0
6352,CN5603100000000,56,31,"Platte County, WY",Apr-19,4824,4680,144,3.0
6353,CN5603300000000,56,33,"Sheridan County, WY",Apr-19,15546,15031,515,3.3
6354,CN5603500000000,56,35,"Sublette County, WY",Apr-19,3923,3766,157,4.0
6355,CN5603700000000,56,37,"Sweetwater County, WY",Apr-19,21472,20684,788,3.7
6356,CN5603900000000,56,39,"Teton County, WY",Apr-19,13995,13434,561,4.0
6357,CN5604100000000,56,41,"Uinta County, WY",Apr-19,9030,8672,358,4.0
6358,CN5604300000000,56,43,"Washakie County, WY",Apr-19,3894,3745,149,3.8
6359,CN5604500000000,56,45,"Weston County, WY",Apr-19,3819,3701,118,3.1
6360,CN7200100000000,72,1,"Adjuntas Municipio, PR",Apr-19,4131,3490,641,15.5
6361,CN7200300000000,72,3,"Aguada Municipio, PR",Apr-19,11904,10756,1148,9.6
6362,CN7200500000000,72,5,"Aguadilla Municipio, PR",Apr-19,14459,13107,1352,9.4
6363,CN7200700000000,72,7,"Aguas Buenas Municipio, PR",Apr-19,6440,5894,546,8.5
6364,CN7200900000000,72,9,"Aibonito Municipio, PR",Apr-19,6379,5718,661,10.4
6365,CN7201100000000,72,11,"Anasco Municipio, PR",Apr-19,8801,8113,688,7.8
6366,CN7201300000000,72,13,"Arecibo Municipio, PR",Apr-19,23665,21588,2077,8.8
6367,CN7201500000000,72,15,"Arroyo Municipio, PR",Apr-19,4674,4090,584,12.5
6368,CN7201700000000,72,17,"Barceloneta Municipio, PR",Apr-19,5850,5215,635,10.9
6369,CN7201900000000,72,19,"Barranquitas Municipio, PR",Apr-19,7238,6641,597,8.2
6370,CN7202100000000,72,21,"Bayamon Municipio, PR",Apr-19,64513,60764,3749,5.8
6371,CN7202300000000,72,23,"Cabo Rojo Municipio, PR",Apr-19,13439,12337,1102,8.2
6372,CN7202500000000,72,25,"Caguas Municipio, PR",Apr-19,47177,44220,2957,6.3
6373,CN7202700000000,72,27,"Camuy Municipio, PR",Apr-19,9387,8661,726,7.7
6374,CN7202900000000,72,29,"Canovanas Municipio, PR",Apr-19,15828,14879,949,6.0
6375,CN7203100000000,72,31,"Carolina Municipio, PR",Apr-19,60694,57458,3236,5.3
6376,CN7203300000000,72,33,"Catano Municipio, PR",Apr-19,7740,7225,515,6.7
6377,CN7203500000000,72,35,"Cayey Municipio, PR",Apr-19,15912,14894,1018,6.4
6378,CN7203700000000,72,37,"Ceiba Municipio, PR",Apr-19,3698,3318,380,10.3
6379,CN7203900000000,72,39,"Ciales Municipio, PR",Apr-19,3621,3265,356,9.8
6380,CN7204100000000,72,41,"Cidra Municipio, PR",Apr-19,15336,14334,1002,6.5
6381,CN7204300000000,72,43,"Coamo Municipio, PR",Apr-19,9836,8703,1133,11.5
6382,CN7204500000000,72,45,"Comerio Municipio, PR",Apr-19,4814,4418,396,8.2
6383,CN7204700000000,72,47,"Corozal Municipio, PR",Apr-19,8782,8028,754,8.6
6384,CN7204900000000,72,49,"Culebra Municipio, PR",Apr-19,888,864,24,2.7
6385,CN7205100000000,72,51,"Dorado Municipio, PR",Apr-19,13002,12318,684,5.3
6386,CN7205300000000,72,53,"Fajardo Municipio, PR",Apr-19,10882,9747,1135,10.4
6387,CN7205400000000,72,54,"Florida Municipio, PR",Apr-19,3302,2937,365,11.1
6388,CN7205500000000,72,55,"Guanica Municipio, PR",Apr-19,3888,3362,526,13.5
6389,CN7205700000000,72,57,"Guayama Municipio, PR",Apr-19,11098,9844,1254,11.3
6390,CN7205900000000,72,59,"Guayanilla Municipio, PR",Apr-19,5179,4507,672,13.0
6391,CN7206100000000,72,61,"Guaynabo Municipio, PR",Apr-19,37248,35835,1413,3.8
6392,CN7206300000000,72,63,"Gurabo Municipio, PR",Apr-19,17862,16906,956,5.4
6393,CN7206500000000,72,65,"Hatillo Municipio, PR",Apr-19,13503,11866,1637,12.1
6394,CN7206700000000,72,67,"Hormigueros Municipio, PR",Apr-19,5356,4920,436,8.1
6395,CN7206900000000,72,69,"Humacao Municipio, PR",Apr-19,17001,15331,1670,9.8
6396,CN7207100000000,72,71,"Isabela Municipio, PR",Apr-19,12243,11199,1044,8.5
6397,CN7207300000000,72,73,"Jayuya Municipio, PR",Apr-19,4240,3641,599,14.1
6398,CN7207500000000,72,75,"Juana Diaz Municipio, PR",Apr-19,14871,13466,1405,9.4
6399,CN7207700000000,72,77,"Juncos Municipio, PR",Apr-19,12079,11148,931,7.7
6400,CN7207900000000,72,79,"Lajas Municipio, PR",Apr-19,5105,4494,611,12.0
6401,CN7208100000000,72,81,"Lares Municipio, PR",Apr-19,6795,5793,1002,14.7
6402,CN7208300000000,72,83,"Las Marias Municipio, PR",Apr-19,2657,2358,299,11.3
6403,CN7208500000000,72,85,"Las Piedras Municipio, PR",Apr-19,11121,10196,925,8.3
6404,CN7208700000000,72,87,"Loiza Municipio, PR",Apr-19,8270,7717,553,6.7
6405,CN7208900000000,72,89,"Luquillo Municipio, PR",Apr-19,6106,5575,531,8.7
6406,CN7209100000000,72,91,"Manati Municipio, PR",Apr-19,11305,10449,856,7.6
6407,CN7209300000000,72,93,"Maricao Municipio, PR",Apr-19,1906,1647,259,13.6
6408,CN7209500000000,72,95,"Maunabo Municipio, PR",Apr-19,2958,2489,469,15.9
6409,CN7209700000000,72,97,"Mayaguez Municipio, PR",Apr-19,21746,19578,2168,10.0
6410,CN7209900000000,72,99,"Moca Municipio, PR",Apr-19,10418,9403,1015,9.7
6411,CN7210100000000,72,101,"Morovis Municipio, PR",Apr-19,7848,7173,675,8.6
6412,CN7210300000000,72,103,"Naguabo Municipio, PR",Apr-19,8016,7357,659,8.2
6413,CN7210500000000,72,105,"Naranjito Municipio, PR",Apr-19,6947,6412,535,7.7
6414,CN7210700000000,72,107,"Orocovis Municipio, PR",Apr-19,4874,4407,467,9.6
6415,CN7210900000000,72,109,"Patillas Municipio, PR",Apr-19,4380,3690,690,15.8
6416,CN7211100000000,72,111,"Penuelas Municipio, PR",Apr-19,5857,5050,807,13.8
6417,CN7211300000000,72,113,"Ponce Municipio, PR",Apr-19,45231,41070,4161,9.2
6418,CN7211500000000,72,115,"Quebradillas Municipio, PR",Apr-19,6025,5359,666,11.1
6419,CN7211700000000,72,117,"Rincon Municipio, PR",Apr-19,4828,4127,701,14.5
6420,CN7211900000000,72,119,"Rio Grande Municipio, PR",Apr-19,16713,15549,1164,7.0
6421,CN7212100000000,72,121,"Sabana Grande Municipio, PR",Apr-19,6023,5271,752,12.5
6422,CN7212300000000,72,123,"Salinas Municipio, PR",Apr-19,7045,6109,936,13.3
6423,CN7212500000000,72,125,"San German Municipio, PR",Apr-19,9659,8606,1053,10.9
6424,CN7212700000000,72,127,"San Juan Municipio, PR",Apr-19,132727,125971,6756,5.1
6425,CN7212900000000,72,129,"San Lorenzo Municipio, PR",Apr-19,11523,10576,947,8.2
6426,CN7213100000000,72,131,"San Sebastian Municipio, PR",Apr-19,10202,8824,1378,13.5
6427,CN7213300000000,72,133,"Santa Isabel Municipio, PR",Apr-19,8495,7732,763,9.0
6428,CN7213500000000,72,135,"Toa Alta Municipio, PR",Apr-19,26793,25360,1433,5.3
6429,CN7213700000000,72,137,"Toa Baja Municipio, PR",Apr-19,28840,27292,1548,5.4
6430,CN7213900000000,72,139,"Trujillo Alto Municipio, PR",Apr-19,26761,25549,1212,4.5
6431,CN7214100000000,72,141,"Utuado Municipio, PR",Apr-19,6610,5898,712,10.8
6432,CN7214300000000,72,143,"Vega Alta Municipio, PR",Apr-19,9563,8853,710,7.4
6433,CN7214500000000,72,145,"Vega Baja Municipio, PR",Apr-19,13053,11878,1175,9.0
6434,CN7214700000000,72,147,"Vieques Municipio, PR",Apr-19,2690,2506,184,6.8
6435,CN7214900000000,72,149,"Villalba Municipio, PR",Apr-19,7492,6278,1214,16.2
6436,CN7215100000000,72,151,"Yabucoa Municipio, PR",Apr-19,8679,7622,1057,12.2
6437,CN7215300000000,72,153,"Yauco Municipio, PR",Apr-19,9706,8323,1383,14.2
6438,CN0100100000000,01,1,"Autauga County, AL",May-19,26271,25680,591,2.2
6439,CN0100300000000,01,3,"Baldwin County, AL",May-19,98311,96129,2182,2.2
6440,CN0100500000000,01,5,"Barbour County, AL",May-19,8416,8152,264,3.1
6441,CN0100700000000,01,7,"Bibb County, AL",May-19,8605,8391,214,2.5
6442,CN0100900000000,01,9,"Blount County, AL",May-19,25136,24589,547,2.2
6443,CN0101100000000,01,11,"Bullock County, AL",May-19,4748,4622,126,2.7
6444,CN0101300000000,01,13,"Butler County, AL",May-19,9403,9143,260,2.8
6445,CN0101500000000,01,15,"Calhoun County, AL",May-19,46092,44729,1363,3.0
6446,CN0101700000000,01,17,"Chambers County, AL",May-19,15612,15243,369,2.4
6447,CN0101900000000,01,19,"Cherokee County, AL",May-19,11644,11363,281,2.4
6448,CN0102100000000,01,21,"Chilton County, AL",May-19,19603,19175,428,2.2
6449,CN0102300000000,01,23,"Choctaw County, AL",May-19,4589,4420,169,3.7
6450,CN0102500000000,01,25,"Clarke County, AL",May-19,7544,7205,339,4.5
6451,CN0102700000000,01,27,"Clay County, AL",May-19,6019,5869,150,2.5
6452,CN0102900000000,01,29,"Cleburne County, AL",May-19,5757,5608,149,2.6
6453,CN0103100000000,01,31,"Coffee County, AL",May-19,21433,20923,510,2.4
6454,CN0103300000000,01,33,"Colbert County, AL",May-19,23572,22847,725,3.1
6455,CN0103500000000,01,35,"Conecuh County, AL",May-19,4501,4361,140,3.1
6456,CN0103700000000,01,37,"Coosa County, AL",May-19,4543,4435,108,2.4
6457,CN0103900000000,01,39,"Covington County, AL",May-19,15522,15100,422,2.7
6458,CN0104100000000,01,41,"Crenshaw County, AL",May-19,6492,6358,134,2.1
6459,CN0104300000000,01,43,"Cullman County, AL",May-19,38507,37672,835,2.2
6460,CN0104500000000,01,45,"Dale County, AL",May-19,20687,20158,529,2.6
6461,CN0104700000000,01,47,"Dallas County, AL",May-19,14564,13919,645,4.4
6462,CN0104900000000,01,49,"DeKalb County, AL",May-19,30909,30194,715,2.3
6463,CN0105100000000,01,51,"Elmore County, AL",May-19,37733,36939,794,2.1
6464,CN0105300000000,01,53,"Escambia County, AL",May-19,14653,14232,421,2.9
6465,CN0105500000000,01,55,"Etowah County, AL",May-19,42724,41553,1171,2.7
6466,CN0105700000000,01,57,"Fayette County, AL",May-19,6575,6403,172,2.6
6467,CN0105900000000,01,59,"Franklin County, AL",May-19,14645,14315,330,2.3
6468,CN0106100000000,01,61,"Geneva County, AL",May-19,10930,10668,262,2.4
6469,CN0106300000000,01,63,"Greene County, AL",May-19,2885,2743,142,4.9
6470,CN0106500000000,01,65,"Hale County, AL",May-19,5972,5777,195,3.3
6471,CN0106700000000,01,67,"Henry County, AL",May-19,6907,6698,209,3.0
6472,CN0106900000000,01,69,"Houston County, AL",May-19,45999,44834,1165,2.5
6473,CN0107100000000,01,71,"Jackson County, AL",May-19,23583,22952,631,2.7
6474,CN0107300000000,01,73,"Jefferson County, AL",May-19,316624,309094,7530,2.4
6475,CN0107500000000,01,75,"Lamar County, AL",May-19,5826,5683,143,2.5
6476,CN0107700000000,01,77,"Lauderdale County, AL",May-19,42572,41400,1172,2.8
6477,CN0107900000000,01,79,"Lawrence County, AL",May-19,14224,13858,366,2.6
6478,CN0108100000000,01,81,"Lee County, AL",May-19,75563,73850,1713,2.3
6479,CN0108300000000,01,83,"Limestone County, AL",May-19,43647,42690,957,2.2
6480,CN0108500000000,01,85,"Lowndes County, AL",May-19,3566,3393,173,4.9
6481,CN0108700000000,01,87,"Macon County, AL",May-19,7781,7494,287,3.7
6482,CN0108900000000,01,89,"Madison County, AL",May-19,184561,180683,3878,2.1
6483,CN0109100000000,01,91,"Marengo County, AL",May-19,7713,7497,216,2.8
6484,CN0109300000000,01,93,"Marion County, AL",May-19,12965,12589,376,2.9
6485,CN0109500000000,01,95,"Marshall County, AL",May-19,44139,43254,885,2.0
6486,CN0109700000000,01,97,"Mobile County, AL",May-19,187604,181808,5796,3.1
6487,CN0109900000000,01,99,"Monroe County, AL",May-19,7282,6992,290,4.0
6488,CN0110100000000,01,101,"Montgomery County, AL",May-19,106041,103365,2676,2.5
6489,CN0110300000000,01,103,"Morgan County, AL",May-19,58008,56803,1205,2.1
6490,CN0110500000000,01,105,"Perry County, AL",May-19,3360,3217,143,4.3
6491,CN0110700000000,01,107,"Pickens County, AL",May-19,7796,7567,229,2.9
6492,CN0110900000000,01,109,"Pike County, AL",May-19,15167,14754,413,2.7
6493,CN0111100000000,01,111,"Randolph County, AL",May-19,9574,9334,240,2.5
6494,CN0111300000000,01,113,"Russell County, AL",May-19,23877,23314,563,2.4
6495,CN0111500000000,01,115,"St. Clair County, AL",May-19,40277,39380,897,2.2
6496,CN0111700000000,01,117,"Shelby County, AL",May-19,115296,113240,2056,1.8
6497,CN0111900000000,01,119,"Sumter County, AL",May-19,4832,4648,184,3.8
6498,CN0112100000000,01,121,"Talladega County, AL",May-19,35577,34554,1023,2.9
6499,CN0112300000000,01,123,"Tallapoosa County, AL",May-19,18886,18451,435,2.3
6500,CN0112500000000,01,125,"Tuscaloosa County, AL",May-19,103958,101499,2459,2.4
6501,CN0112700000000,01,127,"Walker County, AL",May-19,25173,24512,661,2.6
6502,CN0112900000000,01,129,"Washington County, AL",May-19,6733,6476,257,3.8
6503,CN0113100000000,01,131,"Wilcox County, AL",May-19,2664,2510,154,5.8
6504,CN0113300000000,01,133,"Winston County, AL",May-19,9942,9667,275,2.8
6505,CN0201300000000,02,13,"Aleutians East Borough, AK",May-19,1380,1299,81,5.9
6506,CN0201600000000,02,16,"Aleutians West Census Area, AK",May-19,2659,2503,156,5.9
6507,CN0202000000000,02,20,"Anchorage Borough/municipality, AK",May-19,147570,140048,7522,5.1
6508,CN0205000000000,02,50,"Bethel Census Area, AK",May-19,6836,5944,892,13.0
6509,CN0206000000000,02,60,"Bristol Bay Borough, AK",May-19,427,407,20,4.7
6510,CN0206800000000,02,68,"Denali Borough, AK",May-19,1385,1317,68,4.9
6511,CN0207000000000,02,70,"Dillingham Census Area, AK",May-19,1842,1676,166,9.0
6512,CN0209000000000,02,90,"Fairbanks North Star Borough, AK",May-19,44943,42565,2378,5.3
6513,CN0210000000000,02,100,"Haines Borough, AK",May-19,1193,1113,80,6.7
6514,CN0210500000000,02,105,"Hoonah-Angoon Census Area, AK",May-19,1309,1209,100,7.6
6515,CN0211000000000,02,110,"Juneau Borough/city, AK",May-19,17692,16941,751,4.2
6516,CN0212200000000,02,122,"Kenai Peninsula Borough, AK",May-19,26697,25053,1644,6.2
6517,CN0213000000000,02,130,"Ketchikan Gateway Borough, AK",May-19,7095,6687,408,5.8
6518,CN0215000000000,02,150,"Kodiak Island Borough, AK",May-19,5726,5417,309,5.4
6519,CN0215800000000,02,158,"Kusilvak Census Area, AK",May-19,2703,2160,543,20.1
6520,CN0216400000000,02,164,"Lake and Peninsula Borough, AK",May-19,708,640,68,9.6
6521,CN0217000000000,02,170,"Matanuska-Susitna Borough, AK",May-19,47059,43893,3166,6.7
6522,CN0218000000000,02,180,"Nome Census Area, AK",May-19,3991,3543,448,11.2
6523,CN0218500000000,02,185,"North Slope Borough, AK",May-19,3394,3171,223,6.6
6524,CN0218800000000,02,188,"Northwest Arctic Borough, AK",May-19,2865,2452,413,14.4
6525,CN0219500000000,02,195,"Petersburg Borough, AK",May-19,1343,1234,109,8.1
6526,CN0219800000000,02,198,"Prince of Wales-Hyder Census Area, AK",May-19,2870,2610,260,9.1
6527,CN0222000000000,02,220,"Sitka Borough/city, AK",May-19,4507,4327,180,4.0
6528,CN0223000000000,02,230,"Skagway Municipality, AK",May-19,1018,981,37,3.6
6529,CN0224000000000,02,240,"Southeast Fairbanks Census Area, AK",May-19,2836,2603,233,8.2
6530,CN0226100000000,02,261,"Valdez-Cordova Census Area, AK",May-19,4797,4465,332,6.9
6531,CN0227500000000,02,275,"Wrangell Borough/city, AK",May-19,1042,972,70,6.7
6532,CN0228200000000,02,282,"Yakutat Borough/city, AK",May-19,260,244,16,6.2
6533,CN0229000000000,02,290,"Yukon-Koyukuk Census Area, AK",May-19,2470,2114,356,14.4
6534,CN0400100000000,04,1,"Apache County, AZ",May-19,20053,18237,1816,9.1
6535,CN0400300000000,04,3,"Cochise County, AZ",May-19,50168,47420,2748,5.5
6536,CN0400500000000,04,5,"Coconino County, AZ",May-19,76964,73090,3874,5.0
6537,CN0400700000000,04,7,"Gila County, AZ",May-19,21743,20613,1130,5.2
6538,CN0400900000000,04,9,"Graham County, AZ",May-19,15427,14709,718,4.7
6539,CN0401100000000,04,11,"Greenlee County, AZ",May-19,4440,4263,177,4.0
6540,CN0401200000000,04,12,"La Paz County, AZ",May-19,8854,8336,518,5.9
6541,CN0401300000000,04,13,"Maricopa County, AZ",May-19,2284186,2193969,90217,3.9
6542,CN0401500000000,04,15,"Mohave County, AZ",May-19,87815,83022,4793,5.5
6543,CN0401700000000,04,17,"Navajo County, AZ",May-19,40953,38198,2755,6.7
6544,CN0401900000000,04,19,"Pima County, AZ",May-19,497207,475787,21420,4.3
6545,CN0402100000000,04,21,"Pinal County, AZ",May-19,183927,175153,8774,4.8
6546,CN0402300000000,04,23,"Santa Cruz County, AZ",May-19,19495,18221,1274,6.5
6547,CN0402500000000,04,25,"Yavapai County, AZ",May-19,106679,102109,4570,4.3
6548,CN0402700000000,04,27,"Yuma County, AZ",May-19,96746,80115,16631,17.2
6549,CN0500100000000,05,1,"Arkansas County, AR",May-19,9449,9179,270,2.9
6550,CN0500300000000,05,3,"Ashley County, AR",May-19,7887,7508,379,4.8
6551,CN0500500000000,05,5,"Baxter County, AR",May-19,16433,15815,618,3.8
6552,CN0500700000000,05,7,"Benton County, AR",May-19,136599,133276,3323,2.4
6553,CN0500900000000,05,9,"Boone County, AR",May-19,16176,15700,476,2.9
6554,CN0501100000000,05,11,"Bradley County, AR",May-19,4473,4298,175,3.9
6555,CN0501300000000,05,13,"Calhoun County, AR",May-19,2462,2358,104,4.2
6556,CN0501500000000,05,15,"Carroll County, AR",May-19,12861,12513,348,2.7
6557,CN0501700000000,05,17,"Chicot County, AR",May-19,3277,3052,225,6.9
6558,CN0501900000000,05,19,"Clark County, AR",May-19,9659,9301,358,3.7
6559,CN0502100000000,05,21,"Clay County, AR",May-19,5714,5453,261,4.6
6560,CN0502300000000,05,23,"Cleburne County, AR",May-19,9348,8954,394,4.2
6561,CN0502500000000,05,25,"Cleveland County, AR",May-19,3219,3093,126,3.9
6562,CN0502700000000,05,27,"Columbia County, AR",May-19,9164,8735,429,4.7
6563,CN0502900000000,05,29,"Conway County, AR",May-19,8275,7906,369,4.5
6564,CN0503100000000,05,31,"Craighead County, AR",May-19,55421,53894,1527,2.8
6565,CN0503300000000,05,33,"Crawford County, AR",May-19,27017,26180,837,3.1
6566,CN0503500000000,05,35,"Crittenden County, AR",May-19,21344,20445,899,4.2
6567,CN0503700000000,05,37,"Cross County, AR",May-19,7365,7064,301,4.1
6568,CN0503900000000,05,39,"Dallas County, AR",May-19,2826,2698,128,4.5
6569,CN0504100000000,05,41,"Desha County, AR",May-19,5362,5129,233,4.3
6570,CN0504300000000,05,43,"Drew County, AR",May-19,7875,7483,392,5.0
6571,CN0504500000000,05,45,"Faulkner County, AR",May-19,62530,60711,1819,2.9
6572,CN0504700000000,05,47,"Franklin County, AR",May-19,7542,7313,229,3.0
6573,CN0504900000000,05,49,"Fulton County, AR",May-19,5060,4856,204,4.0
6574,CN0505100000000,05,51,"Garland County, AR",May-19,41357,39946,1411,3.4
6575,CN0505300000000,05,53,"Grant County, AR",May-19,8392,8139,253,3.0
6576,CN0505500000000,05,55,"Greene County, AR",May-19,20152,19501,651,3.2
6577,CN0505700000000,05,57,"Hempstead County, AR",May-19,9963,9603,360,3.6
6578,CN0505900000000,05,59,"Hot Spring County, AR",May-19,13956,13488,468,3.4
6579,CN0506100000000,05,61,"Howard County, AR",May-19,5643,5468,175,3.1
6580,CN0506300000000,05,63,"Independence County, AR",May-19,16656,16017,639,3.8
6581,CN0506500000000,05,65,"Izard County, AR",May-19,5010,4741,269,5.4
6582,CN0506700000000,05,67,"Jackson County, AR",May-19,5832,5459,373,6.4
6583,CN0506900000000,05,69,"Jefferson County, AR",May-19,27732,26218,1514,5.5
6584,CN0507100000000,05,71,"Johnson County, AR",May-19,10384,9920,464,4.5
6585,CN0507300000000,05,73,"Lafayette County, AR",May-19,2521,2409,112,4.4
6586,CN0507500000000,05,75,"Lawrence County, AR",May-19,6921,6654,267,3.9
6587,CN0507700000000,05,77,"Lee County, AR",May-19,2794,2687,107,3.8
6588,CN0507900000000,05,79,"Lincoln County, AR",May-19,3948,3781,167,4.2
6589,CN0508100000000,05,81,"Little River County, AR",May-19,5517,5304,213,3.9
6590,CN0508300000000,05,83,"Logan County, AR",May-19,8549,8208,341,4.0
6591,CN0508500000000,05,85,"Lonoke County, AR",May-19,34408,33411,997,2.9
6592,CN0508700000000,05,87,"Madison County, AR",May-19,7383,7216,167,2.3
6593,CN0508900000000,05,89,"Marion County, AR",May-19,6763,6519,244,3.6
6594,CN0509100000000,05,91,"Miller County, AR",May-19,19783,19065,718,3.6
6595,CN0509300000000,05,93,"Mississippi County, AR",May-19,17335,16538,797,4.6
6596,CN0509500000000,05,95,"Monroe County, AR",May-19,2743,2636,107,3.9
6597,CN0509700000000,05,97,"Montgomery County, AR",May-19,3035,2913,122,4.0
6598,CN0509900000000,05,99,"Nevada County, AR",May-19,3676,3534,142,3.9
6599,CN0510100000000,05,101,"Newton County, AR",May-19,3365,3256,109,3.2
6600,CN0510300000000,05,103,"Ouachita County, AR",May-19,9898,9399,499,5.0
6601,CN0510500000000,05,105,"Perry County, AR",May-19,4293,4114,179,4.2
6602,CN0510700000000,05,107,"Phillips County, AR",May-19,6415,6068,347,5.4
6603,CN0510900000000,05,109,"Pike County, AR",May-19,4297,4147,150,3.5
6604,CN0511100000000,05,111,"Poinsett County, AR",May-19,10207,9881,326,3.2
6605,CN0511300000000,05,113,"Polk County, AR",May-19,8100,7797,303,3.7
6606,CN0511500000000,05,115,"Pope County, AR",May-19,28977,27701,1276,4.4
6607,CN0511700000000,05,117,"Prairie County, AR",May-19,3605,3460,145,4.0
6608,CN0511900000000,05,119,"Pulaski County, AR",May-19,190237,184194,6043,3.2
6609,CN0512100000000,05,121,"Randolph County, AR",May-19,7296,7023,273,3.7
6610,CN0512300000000,05,123,"St. Francis County, AR",May-19,8219,7802,417,5.1
6611,CN0512500000000,05,125,"Saline County, AR",May-19,59089,57591,1498,2.5
6612,CN0512700000000,05,127,"Scott County, AR",May-19,4305,4179,126,2.9
6613,CN0512900000000,05,129,"Searcy County, AR",May-19,3058,2939,119,3.9
6614,CN0513100000000,05,131,"Sebastian County, AR",May-19,56895,55190,1705,3.0
6615,CN0513300000000,05,133,"Sevier County, AR",May-19,5491,5216,275,5.0
6616,CN0513500000000,05,135,"Sharp County, AR",May-19,5866,5612,254,4.3
6617,CN0513700000000,05,137,"Stone County, AR",May-19,4771,4549,222,4.7
6618,CN0513900000000,05,139,"Union County, AR",May-19,15868,15079,789,5.0
6619,CN0514100000000,05,141,"Van Buren County, AR",May-19,5842,5572,270,4.6
6620,CN0514300000000,05,143,"Washington County, AR",May-19,124555,121665,2890,2.3
6621,CN0514500000000,05,145,"White County, AR",May-19,34029,32527,1502,4.4
6622,CN0514700000000,05,147,"Woodruff County, AR",May-19,2767,2630,137,5.0
6623,CN0514900000000,05,149,"Yell County, AR",May-19,8438,8091,347,4.1
6624,CN0600100000000,06,1,"Alameda County, CA",May-19,837300,815557,21743,2.6
6625,CN0600300000000,06,3,"Alpine County, CA",May-19,472,444,28,5.9
6626,CN0600500000000,06,5,"Amador County, CA",May-19,14891,14399,492,3.3
6627,CN0600700000000,06,7,"Butte County, CA",May-19,99095,94664,4431,4.5
6628,CN0600900000000,06,9,"Calaveras County, CA",May-19,21147,20446,701,3.3
6629,CN0601100000000,06,11,"Colusa County, CA",May-19,11238,10073,1165,10.4
6630,CN0601300000000,06,13,"Contra Costa County, CA",May-19,556642,541593,15049,2.7
6631,CN0601500000000,06,15,"Del Norte County, CA",May-19,9585,9108,477,5.0
6632,CN0601700000000,06,17,"El Dorado County, CA",May-19,91073,88239,2834,3.1
6633,CN0601900000000,06,19,"Fresno County, CA",May-19,452032,422750,29282,6.5
6634,CN0602100000000,06,21,"Glenn County, CA",May-19,12841,12109,732,5.7
6635,CN0602300000000,06,23,"Humboldt County, CA",May-19,62535,60614,1921,3.1
6636,CN0602500000000,06,25,"Imperial County, CA",May-19,70532,58834,11698,16.6
6637,CN0602700000000,06,27,"Inyo County, CA",May-19,8673,8414,259,3.0
6638,CN0602900000000,06,29,"Kern County, CA",May-19,386497,358248,28249,7.3
6639,CN0603100000000,06,31,"Kings County, CA",May-19,57968,53989,3979,6.9
6640,CN0603300000000,06,33,"Lake County, CA",May-19,29222,27981,1241,4.2
6641,CN0603500000000,06,35,"Lassen County, CA",May-19,9650,9254,396,4.1
6642,CN0603700000000,06,37,"Los Angeles County, CA",May-19,5074586,4866672,207914,4.1
6643,CN0603900000000,06,39,"Madera County, CA",May-19,62272,58400,3872,6.2
6644,CN0604100000000,06,41,"Marin County, CA",May-19,138325,135596,2729,2.0
6645,CN0604300000000,06,43,"Mariposa County, CA",May-19,7713,7425,288,3.7
6646,CN0604500000000,06,45,"Mendocino County, CA",May-19,38878,37600,1278,3.3
6647,CN0604700000000,06,47,"Merced County, CA",May-19,117247,108752,8495,7.2
6648,CN0604900000000,06,49,"Modoc County, CA",May-19,3222,3042,180,5.6
6649,CN0605100000000,06,51,"Mono County, CA",May-19,7970,7694,276,3.5
6650,CN0605300000000,06,53,"Monterey County, CA",May-19,229342,218256,11086,4.8
6651,CN0605500000000,06,55,"Napa County, CA",May-19,74257,72527,1730,2.3
6652,CN0605700000000,06,57,"Nevada County, CA",May-19,47800,46369,1431,3.0
6653,CN0605900000000,06,59,"Orange County, CA",May-19,1611417,1572297,39120,2.4
6654,CN0606100000000,06,61,"Placer County, CA",May-19,186176,181039,5137,2.8
6655,CN0606300000000,06,63,"Plumas County, CA",May-19,8015,7508,507,6.3
6656,CN0606500000000,06,65,"Riverside County, CA",May-19,1089545,1050068,39477,3.6
6657,CN0606700000000,06,67,"Sacramento County, CA",May-19,705580,682600,22980,3.3
6658,CN0606900000000,06,69,"San Benito County, CA",May-19,31120,29720,1400,4.5
6659,CN0607100000000,06,71,"San Bernardino County, CA",May-19,955749,923281,32468,3.4
6660,CN0607300000000,06,73,"San Diego County, CA",May-19,1576186,1532045,44141,2.8
6661,CN0607500000000,06,75,"San Francisco County/city, CA",May-19,575524,564369,11155,1.9
6662,CN0607700000000,06,77,"San Joaquin County, CA",May-19,327709,310812,16897,5.2
6663,CN0607900000000,06,79,"San Luis Obispo County, CA",May-19,141818,138368,3450,2.4
6664,CN0608100000000,06,81,"San Mateo County, CA",May-19,453903,445781,8122,1.8
6665,CN0608300000000,06,83,"Santa Barbara County, CA",May-19,219150,212709,6441,2.9
6666,CN0608500000000,06,85,"Santa Clara County, CA",May-19,1043374,1020669,22705,2.2
6667,CN0608700000000,06,87,"Santa Cruz County, CA",May-19,142122,136390,5732,4.0
6668,CN0608900000000,06,89,"Shasta County, CA",May-19,73885,70901,2984,4.0
6669,CN0609100000000,06,91,"Sierra County, CA",May-19,1337,1272,65,4.9
6670,CN0609300000000,06,93,"Siskiyou County, CA",May-19,17011,16082,929,5.5
6671,CN0609500000000,06,95,"Solano County, CA",May-19,208198,201310,6888,3.3
6672,CN0609700000000,06,97,"Sonoma County, CA",May-19,256524,250476,6048,2.4
6673,CN0609900000000,06,99,"Stanislaus County, CA",May-19,242732,229126,13606,5.6
6674,CN0610100000000,06,101,"Sutter County, CA",May-19,45347,42264,3083,6.8
6675,CN0610300000000,06,103,"Tehama County, CA",May-19,25362,24084,1278,5.0
6676,CN0610500000000,06,105,"Trinity County, CA",May-19,4780,4564,216,4.5
6677,CN0610700000000,06,107,"Tulare County, CA",May-19,205833,188501,17332,8.4
6678,CN0610900000000,06,109,"Tuolumne County, CA",May-19,21078,20245,833,4.0
6679,CN0611100000000,06,111,"Ventura County, CA",May-19,422230,409498,12732,3.0
6680,CN0611300000000,06,113,"Yolo County, CA",May-19,107660,103986,3674,3.4
6681,CN0611500000000,06,115,"Yuba County, CA",May-19,29415,27822,1593,5.4
6682,CN0800100000000,08,1,"Adams County, CO",May-19,273338,265933,7405,2.7
6683,CN0800300000000,08,3,"Alamosa County, CO",May-19,8780,8505,275,3.1
6684,CN0800500000000,08,5,"Arapahoe County, CO",May-19,365831,356530,9301,2.5
6685,CN0800700000000,08,7,"Archuleta County, CO",May-19,6906,6710,196,2.8
6686,CN0800900000000,08,9,"Baca County, CO",May-19,2180,2147,33,1.5
6687,CN0801100000000,08,11,"Bent County, CO",May-19,1927,1873,54,2.8
6688,CN0801300000000,08,13,"Boulder County, CO",May-19,197793,193618,4175,2.1
6689,CN0801400000000,08,14,"Broomfield County/city, CO",May-19,40255,39324,931,2.3
6690,CN0801500000000,08,15,"Chaffee County, CO",May-19,9697,9491,206,2.1
6691,CN0801700000000,08,17,"Cheyenne County, CO",May-19,1161,1145,16,1.4
6692,CN0801900000000,08,19,"Clear Creek County, CO",May-19,6066,5924,142,2.3
6693,CN0802100000000,08,21,"Conejos County, CO",May-19,4183,4048,135,3.2
6694,CN0802300000000,08,23,"Costilla County, CO",May-19,1854,1781,73,3.9
6695,CN0802500000000,08,25,"Crowley County, CO",May-19,1510,1443,67,4.4
6696,CN0802700000000,08,27,"Custer County, CO",May-19,2074,2011,63,3.0
6697,CN0802900000000,08,29,"Delta County, CO",May-19,14319,13870,449,3.1
6698,CN0803100000000,08,31,"Denver County/city, CO",May-19,418255,407655,10600,2.5
6699,CN0803300000000,08,33,"Dolores County, CO",May-19,1147,1114,33,2.9
6700,CN0803500000000,08,35,"Douglas County, CO",May-19,194805,190524,4281,2.2
6701,CN0803700000000,08,37,"Eagle County, CO",May-19,33503,32402,1101,3.3
6702,CN0803900000000,08,39,"Elbert County, CO",May-19,15222,14914,308,2.0
6703,CN0804100000000,08,41,"El Paso County, CO",May-19,341844,331428,10416,3.0
6704,CN0804300000000,08,43,"Fremont County, CO",May-19,15367,14731,636,4.1
6705,CN0804500000000,08,45,"Garfield County, CO",May-19,30614,29793,821,2.7
6706,CN0804700000000,08,47,"Gilpin County, CO",May-19,3793,3708,85,2.2
6707,CN0804900000000,08,49,"Grand County, CO",May-19,8761,8566,195,2.2
6708,CN0805100000000,08,51,"Gunnison County, CO",May-19,10838,10573,265,2.4
6709,CN0805300000000,08,53,"Hinsdale County, CO",May-19,424,409,15,3.5
6710,CN0805500000000,08,55,"Huerfano County, CO",May-19,2530,2409,121,4.8
6711,CN0805700000000,08,57,"Jackson County, CO",May-19,990,963,27,2.7
6712,CN0805900000000,08,59,"Jefferson County, CO",May-19,336141,328190,7951,2.4
6713,CN0806100000000,08,61,"Kiowa County, CO",May-19,957,942,15,1.6
6714,CN0806300000000,08,63,"Kit Carson County, CO",May-19,4388,4325,63,1.4
6715,CN0806500000000,08,65,"Lake County, CO",May-19,4605,4457,148,3.2
6716,CN0806700000000,08,67,"La Plata County, CO",May-19,31956,31242,714,2.2
6717,CN0806900000000,08,69,"Larimer County, CO",May-19,206087,201769,4318,2.1
6718,CN0807100000000,08,71,"Las Animas County, CO",May-19,6634,6402,232,3.5
6719,CN0807300000000,08,73,"Lincoln County, CO",May-19,2437,2385,52,2.1
6720,CN0807500000000,08,75,"Logan County, CO",May-19,11170,10934,236,2.1
6721,CN0807700000000,08,77,"Mesa County, CO",May-19,76735,74449,2286,3.0
6722,CN0807900000000,08,79,"Mineral County, CO",May-19,433,420,13,3.0
6723,CN0808100000000,08,81,"Moffat County, CO",May-19,7325,7099,226,3.1
6724,CN0808300000000,08,83,"Montezuma County, CO",May-19,12989,12528,461,3.5
6725,CN0808500000000,08,85,"Montrose County, CO",May-19,21825,21174,651,3.0
6726,CN0808700000000,08,87,"Morgan County, CO",May-19,16484,16073,411,2.5
6727,CN0808900000000,08,89,"Otero County, CO",May-19,8367,8051,316,3.8
6728,CN0809100000000,08,91,"Ouray County, CO",May-19,2364,2294,70,3.0
6729,CN0809300000000,08,93,"Park County, CO",May-19,11201,10926,275,2.5
6730,CN0809500000000,08,95,"Phillips County, CO",May-19,2620,2583,37,1.4
6731,CN0809700000000,08,97,"Pitkin County, CO",May-19,10958,10270,688,6.3
6732,CN0809900000000,08,99,"Prowers County, CO",May-19,6406,6258,148,2.3
6733,CN0810100000000,08,101,"Pueblo County, CO",May-19,76192,73312,2880,3.8
6734,CN0810300000000,08,103,"Rio Blanco County, CO",May-19,3030,2931,99,3.3
6735,CN0810500000000,08,105,"Rio Grande County, CO",May-19,5510,5329,181,3.3
6736,CN0810700000000,08,107,"Routt County, CO",May-19,14965,14543,422,2.8
6737,CN0810900000000,08,109,"Saguache County, CO",May-19,3595,3484,111,3.1
6738,CN0811100000000,08,111,"San Juan County, CO",May-19,522,509,13,2.5
6739,CN0811300000000,08,113,"San Miguel County, CO",May-19,4807,4449,358,7.4
6740,CN0811500000000,08,115,"Sedgwick County, CO",May-19,1227,1202,25,2.0
6741,CN0811700000000,08,117,"Summit County, CO",May-19,19981,19453,528,2.6
6742,CN0811900000000,08,119,"Teller County, CO",May-19,12769,12405,364,2.9
6743,CN0812100000000,08,121,"Washington County, CO",May-19,3029,2972,57,1.9
6744,CN0812300000000,08,123,"Weld County, CO",May-19,169182,165383,3799,2.2
6745,CN0812500000000,08,125,"Yuma County, CO",May-19,6620,6538,82,1.2
6746,CN0900100000000,09,1,"Fairfield County, CT",May-19,479615,462831,16784,3.5
6747,CN0900300000000,09,3,"Hartford County, CT",May-19,481198,463467,17731,3.7
6748,CN0900500000000,09,5,"Litchfield County, CT",May-19,104539,101200,3339,3.2
6749,CN0900700000000,09,7,"Middlesex County, CT",May-19,93170,90440,2730,2.9
6750,CN0900900000000,09,9,"New Haven County, CT",May-19,459416,442036,17380,3.8
6751,CN0901100000000,09,11,"New London County, CT",May-19,137028,132279,4749,3.5
6752,CN0901300000000,09,13,"Tolland County, CT",May-19,86713,84011,2702,3.1
6753,CN0901500000000,09,15,"Windham County, CT",May-19,63934,61453,2481,3.9
6754,CN1000100000000,10,1,"Kent County, DE",May-19,78676,75742,2934,3.7
6755,CN1000300000000,10,3,"New Castle County, DE",May-19,298507,288526,9981,3.3
6756,CN1000500000000,10,5,"Sussex County, DE",May-19,107694,104351,3343,3.1
6757,CN1100100000000,11,1,District of Columbia,May-19,408260,386959,21301,5.2
6758,CN1200100000000,12,1,"Alachua County, FL",May-19,137177,133331,3846,2.8
6759,CN1200300000000,12,3,"Baker County, FL",May-19,11761,11396,365,3.1
6760,CN1200500000000,12,5,"Bay County, FL",May-19,85129,81931,3198,3.8
6761,CN1200700000000,12,7,"Bradford County, FL",May-19,10936,10606,330,3.0
6762,CN1200900000000,12,9,"Brevard County, FL",May-19,282542,273791,8751,3.1
6763,CN1201100000000,12,11,"Broward County, FL",May-19,1038920,1007986,30934,3.0
6764,CN1201300000000,12,13,"Calhoun County, FL",May-19,4874,4694,180,3.7
6765,CN1201500000000,12,15,"Charlotte County, FL",May-19,71663,69107,2556,3.6
6766,CN1201700000000,12,17,"Citrus County, FL",May-19,47445,45204,2241,4.7
6767,CN1201900000000,12,19,"Clay County, FL",May-19,106837,103752,3085,2.9
6768,CN1202100000000,12,21,"Collier County, FL",May-19,179247,174167,5080,2.8
6769,CN1202300000000,12,23,"Columbia County, FL",May-19,29421,28468,953,3.2
6770,CN1202700000000,12,27,"DeSoto County, FL",May-19,14465,14013,452,3.1
6771,CN1202900000000,12,29,"Dixie County, FL",May-19,5817,5616,201,3.5
6772,CN1203100000000,12,31,"Duval County, FL",May-19,488009,472465,15544,3.2
6773,CN1203300000000,12,33,"Escambia County, FL",May-19,145824,141392,4432,3.0
6774,CN1203500000000,12,35,"Flagler County, FL",May-19,47046,45286,1760,3.7
6775,CN1203700000000,12,37,"Franklin County, FL",May-19,4803,4641,162,3.4
6776,CN1203900000000,12,39,"Gadsden County, FL",May-19,18666,17919,747,4.0
6777,CN1204100000000,12,41,"Gilchrist County, FL",May-19,7037,6801,236,3.4
6778,CN1204300000000,12,43,"Glades County, FL",May-19,5682,5478,204,3.6
6779,CN1204500000000,12,45,"Gulf County, FL",May-19,5838,5557,281,4.8
6780,CN1204700000000,12,47,"Hamilton County, FL",May-19,4327,4161,166,3.8
6781,CN1204900000000,12,49,"Hardee County, FL",May-19,8493,8091,402,4.7
6782,CN1205100000000,12,51,"Hendry County, FL",May-19,15853,15122,731,4.6
6783,CN1205300000000,12,53,"Hernando County, FL",May-19,71543,68603,2940,4.1
6784,CN1205500000000,12,55,"Highlands County, FL",May-19,36326,34736,1590,4.4
6785,CN1205700000000,12,57,"Hillsborough County, FL",May-19,745993,723555,22438,3.0
6786,CN1205900000000,12,59,"Holmes County, FL",May-19,7004,6765,239,3.4
6787,CN1206100000000,12,61,"Indian River County, FL",May-19,65226,62813,2413,3.7
6788,CN1206300000000,12,63,"Jackson County, FL",May-19,17402,16789,613,3.5
6789,CN1206500000000,12,65,"Jefferson County, FL",May-19,5588,5403,185,3.3
6790,CN1206700000000,12,67,"Lafayette County, FL",May-19,2888,2806,82,2.8
6791,CN1206900000000,12,69,"Lake County, FL",May-19,158321,153421,4900,3.1
6792,CN1207100000000,12,71,"Lee County, FL",May-19,345234,334730,10504,3.0
6793,CN1207300000000,12,73,"Leon County, FL",May-19,154069,149589,4480,2.9
6794,CN1207500000000,12,75,"Levy County, FL",May-19,16723,16110,613,3.7
6795,CN1207700000000,12,77,"Liberty County, FL",May-19,2653,2557,96,3.6
6796,CN1207900000000,12,79,"Madison County, FL",May-19,7475,7210,265,3.5
6797,CN1208100000000,12,81,"Manatee County, FL",May-19,180133,174784,5349,3.0
6798,CN1208300000000,12,83,"Marion County, FL",May-19,137269,132133,5136,3.7
6799,CN1208500000000,12,85,"Martin County, FL",May-19,74285,72052,2233,3.0
6800,CN1208600000000,12,86,"Miami-Dade County, FL",May-19,1374809,1341271,33538,2.4
6801,CN1208700000000,12,87,"Monroe County, FL",May-19,46864,45935,929,2.0
6802,CN1208900000000,12,89,"Nassau County, FL",May-19,40861,39721,1140,2.8
6803,CN1209100000000,12,91,"Okaloosa County, FL",May-19,98049,95563,2486,2.5
6804,CN1209300000000,12,93,"Okeechobee County, FL",May-19,17948,17370,578,3.2
6805,CN1209500000000,12,95,"Orange County, FL",May-19,759130,737766,21364,2.8
6806,CN1209700000000,12,97,"Osceola County, FL",May-19,183323,177628,5695,3.1
6807,CN1209900000000,12,99,"Palm Beach County, FL",May-19,733666,710891,22775,3.1
6808,CN1210100000000,12,101,"Pasco County, FL",May-19,236718,228674,8044,3.4
6809,CN1210300000000,12,103,"Pinellas County, FL",May-19,491818,477355,14463,2.9
6810,CN1210500000000,12,105,"Polk County, FL",May-19,303558,292715,10843,3.6
6811,CN1210700000000,12,107,"Putnam County, FL",May-19,26801,25677,1124,4.2
6812,CN1210900000000,12,109,"St. Johns County, FL",May-19,131605,128292,3313,2.5
6813,CN1211100000000,12,111,"St. Lucie County, FL",May-19,145475,139904,5571,3.8
6814,CN1211300000000,12,113,"Santa Rosa County, FL",May-19,82808,80500,2308,2.8
6815,CN1211500000000,12,115,"Sarasota County, FL",May-19,189243,183569,5674,3.0
6816,CN1211700000000,12,117,"Seminole County, FL",May-19,254496,247241,7255,2.9
6817,CN1211900000000,12,119,"Sumter County, FL",May-19,32657,31168,1489,4.6
6818,CN1212100000000,12,121,"Suwannee County, FL",May-19,18071,17493,578,3.2
6819,CN1212300000000,12,123,"Taylor County, FL",May-19,8335,8056,279,3.3
6820,CN1212500000000,12,125,"Union County, FL",May-19,4646,4520,126,2.7
6821,CN1212700000000,12,127,"Volusia County, FL",May-19,254288,245737,8551,3.4
6822,CN1212900000000,12,129,"Wakulla County, FL",May-19,14776,14355,421,2.8
6823,CN1213100000000,12,131,"Walton County, FL",May-19,31979,31129,850,2.7
6824,CN1213300000000,12,133,"Washington County, FL",May-19,9783,9476,307,3.1
6825,CN1300100000000,13,1,"Appling County, GA",May-19,9159,8803,356,3.9
6826,CN1300300000000,13,3,"Atkinson County, GA",May-19,4663,4529,134,2.9
6827,CN1300500000000,13,5,"Bacon County, GA",May-19,5082,4910,172,3.4
6828,CN1300700000000,13,7,"Baker County, GA",May-19,1145,1092,53,4.6
6829,CN1300900000000,13,9,"Baldwin County, GA",May-19,17393,16714,679,3.9
6830,CN1301100000000,13,11,"Banks County, GA",May-19,9595,9344,251,2.6
6831,CN1301300000000,13,13,"Barrow County, GA",May-19,40150,39037,1113,2.8
6832,CN1301500000000,13,15,"Bartow County, GA",May-19,50177,48614,1563,3.1
6833,CN1301700000000,13,17,"Ben Hill County, GA",May-19,5288,5015,273,5.2
6834,CN1301900000000,13,19,"Berrien County, GA",May-19,7433,7180,253,3.4
6835,CN1302100000000,13,21,"Bibb County, GA",May-19,67578,65015,2563,3.8
6836,CN1302300000000,13,23,"Bleckley County, GA",May-19,4567,4353,214,4.7
6837,CN1302500000000,13,25,"Brantley County, GA",May-19,7252,6973,279,3.8
6838,CN1302700000000,13,27,"Brooks County, GA",May-19,6834,6615,219,3.2
6839,CN1302900000000,13,29,"Bryan County, GA",May-19,18274,17763,511,2.8
6840,CN1303100000000,13,31,"Bulloch County, GA",May-19,36749,35482,1267,3.4
6841,CN1303300000000,13,33,"Burke County, GA",May-19,9119,8669,450,4.9
6842,CN1303500000000,13,35,"Butts County, GA",May-19,10676,10319,357,3.3
6843,CN1303700000000,13,37,"Calhoun County, GA",May-19,2162,2085,77,3.6
6844,CN1303900000000,13,39,"Camden County, GA",May-19,20922,20195,727,3.5
6845,CN1304300000000,13,43,"Candler County, GA",May-19,5559,5412,147,2.6
6846,CN1304500000000,13,45,"Carroll County, GA",May-19,54840,53017,1823,3.3
6847,CN1304700000000,13,47,"Catoosa County, GA",May-19,33270,32360,910,2.7
6848,CN1304900000000,13,49,"Charlton County, GA",May-19,4760,4581,179,3.8
6849,CN1305100000000,13,51,"Chatham County, GA",May-19,139720,135309,4411,3.2
6850,CN1305300000000,13,53,"Chattahoochee County, GA",May-19,1999,1910,89,4.5
6851,CN1305500000000,13,55,"Chattooga County, GA",May-19,10155,9811,344,3.4
6852,CN1305700000000,13,57,"Cherokee County, GA",May-19,135001,131402,3599,2.7
6853,CN1305900000000,13,59,"Clarke County, GA",May-19,58755,56782,1973,3.4
6854,CN1306100000000,13,61,"Clay County, GA",May-19,845,788,57,6.7
6855,CN1306300000000,13,63,"Clayton County, GA",May-19,136902,131296,5606,4.1
6856,CN1306500000000,13,65,"Clinch County, GA",May-19,2823,2734,89,3.2
6857,CN1306700000000,13,67,"Cobb County, GA",May-19,422650,410393,12257,2.9
6858,CN1306900000000,13,69,"Coffee County, GA",May-19,18913,18199,714,3.8
6859,CN1307100000000,13,71,"Colquitt County, GA",May-19,21273,20622,651,3.1
6860,CN1307300000000,13,73,"Columbia County, GA",May-19,74945,72789,2156,2.9
6861,CN1307500000000,13,75,"Cook County, GA",May-19,7943,7700,243,3.1
6862,CN1307700000000,13,77,"Coweta County, GA",May-19,74148,72023,2125,2.9
6863,CN1307900000000,13,79,"Crawford County, GA",May-19,5579,5375,204,3.7
6864,CN1308100000000,13,81,"Crisp County, GA",May-19,9442,9101,341,3.6
6865,CN1308300000000,13,83,"Dade County, GA",May-19,8141,7888,253,3.1
6866,CN1308500000000,13,85,"Dawson County, GA",May-19,12243,11894,349,2.9
6867,CN1308700000000,13,87,"Decatur County, GA",May-19,11451,11024,427,3.7
6868,CN1308900000000,13,89,"DeKalb County, GA",May-19,397135,383704,13431,3.4
6869,CN1309100000000,13,91,"Dodge County, GA",May-19,7180,6763,417,5.8
6870,CN1309300000000,13,93,"Dooly County, GA",May-19,4981,4793,188,3.8
6871,CN1309500000000,13,95,"Dougherty County, GA",May-19,38095,36368,1727,4.5
6872,CN1309700000000,13,97,"Douglas County, GA",May-19,72764,70270,2494,3.4
6873,CN1309900000000,13,99,"Early County, GA",May-19,4302,4145,157,3.6
6874,CN1310100000000,13,101,"Echols County, GA",May-19,1887,1837,50,2.6
6875,CN1310300000000,13,103,"Effingham County, GA",May-19,30917,30060,857,2.8
6876,CN1310500000000,13,105,"Elbert County, GA",May-19,7570,7302,268,3.5
6877,CN1310700000000,13,107,"Emanuel County, GA",May-19,8306,7948,358,4.3
6878,CN1310900000000,13,109,"Evans County, GA",May-19,4778,4615,163,3.4
6879,CN1311100000000,13,111,"Fannin County, GA",May-19,11497,11133,364,3.2
6880,CN1311300000000,13,113,"Fayette County, GA",May-19,57640,55966,1674,2.9
6881,CN1311500000000,13,115,"Floyd County, GA",May-19,43562,42044,1518,3.5
6882,CN1311700000000,13,117,"Forsyth County, GA",May-19,121329,118092,3237,2.7
6883,CN1311900000000,13,119,"Franklin County, GA",May-19,9875,9531,344,3.5
6884,CN1312100000000,13,121,"Fulton County, GA",May-19,553683,534754,18929,3.4
6885,CN1312300000000,13,123,"Gilmer County, GA",May-19,11788,11387,401,3.4
6886,CN1312500000000,13,125,"Glascock County, GA",May-19,1270,1222,48,3.8
6887,CN1312700000000,13,127,"Glynn County, GA",May-19,39511,38270,1241,3.1
6888,CN1312900000000,13,129,"Gordon County, GA",May-19,28005,27174,831,3.0
6889,CN1313100000000,13,131,"Grady County, GA",May-19,10377,10043,334,3.2
6890,CN1313300000000,13,133,"Greene County, GA",May-19,6983,6718,265,3.8
6891,CN1313500000000,13,135,"Gwinnett County, GA",May-19,486567,472308,14259,2.9
6892,CN1313700000000,13,137,"Habersham County, GA",May-19,19087,18483,604,3.2
6893,CN1313900000000,13,139,"Hall County, GA",May-19,101369,98617,2752,2.7
6894,CN1314100000000,13,141,"Hancock County, GA",May-19,2423,2304,119,4.9
6895,CN1314300000000,13,143,"Haralson County, GA",May-19,12472,12073,399,3.2
6896,CN1314500000000,13,145,"Harris County, GA",May-19,16686,16187,499,3.0
6897,CN1314700000000,13,147,"Hart County, GA",May-19,11500,11138,362,3.1
6898,CN1314900000000,13,149,"Heard County, GA",May-19,5208,5041,167,3.2
6899,CN1315100000000,13,151,"Henry County, GA",May-19,114824,110858,3966,3.5
6900,CN1315300000000,13,153,"Houston County, GA",May-19,70322,68064,2258,3.2
6901,CN1315500000000,13,155,"Irwin County, GA",May-19,3290,3148,142,4.3
6902,CN1315700000000,13,157,"Jackson County, GA",May-19,36161,35234,927,2.6
6903,CN1315900000000,13,159,"Jasper County, GA",May-19,6893,6681,212,3.1
6904,CN1316100000000,13,161,"Jeff Davis County, GA",May-19,6068,5801,267,4.4
6905,CN1316300000000,13,163,"Jefferson County, GA",May-19,6484,6193,291,4.5
6906,CN1316500000000,13,165,"Jenkins County, GA",May-19,3143,2990,153,4.9
6907,CN1316700000000,13,167,"Johnson County, GA",May-19,4084,3937,147,3.6
6908,CN1316900000000,13,169,"Jones County, GA",May-19,13628,13202,426,3.1
6909,CN1317100000000,13,171,"Lamar County, GA",May-19,8165,7869,296,3.6
6910,CN1317300000000,13,173,"Lanier County, GA",May-19,3725,3591,134,3.6
6911,CN1317500000000,13,175,"Laurens County, GA",May-19,19330,18529,801,4.1
6912,CN1317700000000,13,177,"Lee County, GA",May-19,14636,14210,426,2.9
6913,CN1317900000000,13,179,"Liberty County, GA",May-19,26108,25120,988,3.8
6914,CN1318100000000,13,181,"Lincoln County, GA",May-19,3533,3403,130,3.7
6915,CN1318300000000,13,183,"Long County, GA",May-19,8125,7819,306,3.8
6916,CN1318500000000,13,185,"Lowndes County, GA",May-19,50970,49322,1648,3.2
6917,CN1318700000000,13,187,"Lumpkin County, GA",May-19,16572,16081,491,3.0
6918,CN1318900000000,13,189,"McDuffie County, GA",May-19,8795,8396,399,4.5
6919,CN1319100000000,13,191,"McIntosh County, GA",May-19,6180,5965,215,3.5
6920,CN1319300000000,13,193,"Macon County, GA",May-19,4707,4497,210,4.5
6921,CN1319500000000,13,195,"Madison County, GA",May-19,13211,12820,391,3.0
6922,CN1319700000000,13,197,"Marion County, GA",May-19,3309,3171,138,4.2
6923,CN1319900000000,13,199,"Meriwether County, GA",May-19,8827,8453,374,4.2
6924,CN1320100000000,13,201,"Miller County, GA",May-19,2740,2656,84,3.1
6925,CN1320500000000,13,205,"Mitchell County, GA",May-19,8264,7918,346,4.2
6926,CN1320700000000,13,207,"Monroe County, GA",May-19,12926,12512,414,3.2
6927,CN1320900000000,13,209,"Montgomery County, GA",May-19,3802,3607,195,5.1
6928,CN1321100000000,13,211,"Morgan County, GA",May-19,9149,8882,267,2.9
6929,CN1321300000000,13,213,"Murray County, GA",May-19,15334,14691,643,4.2
6930,CN1321500000000,13,215,"Muscogee County, GA",May-19,77696,74282,3414,4.4
6931,CN1321700000000,13,217,"Newton County, GA",May-19,51853,49911,1942,3.7
6932,CN1321900000000,13,219,"Oconee County, GA",May-19,19410,18928,482,2.5
6933,CN1322100000000,13,221,"Oglethorpe County, GA",May-19,6889,6667,222,3.2
6934,CN1322300000000,13,223,"Paulding County, GA",May-19,85392,82957,2435,2.9
6935,CN1322500000000,13,225,"Peach County, GA",May-19,11780,11325,455,3.9
6936,CN1322700000000,13,227,"Pickens County, GA",May-19,15169,14738,431,2.8
6937,CN1322900000000,13,229,"Pierce County, GA",May-19,8700,8419,281,3.2
6938,CN1323100000000,13,231,"Pike County, GA",May-19,8829,8577,252,2.9
6939,CN1323300000000,13,233,"Polk County, GA",May-19,18335,17682,653,3.6
6940,CN1323500000000,13,235,"Pulaski County, GA",May-19,4050,3887,163,4.0
6941,CN1323700000000,13,237,"Putnam County, GA",May-19,8141,7804,337,4.1
6942,CN1323900000000,13,239,"Quitman County, GA",May-19,798,757,41,5.1
6943,CN1324100000000,13,241,"Rabun County, GA",May-19,7158,6917,241,3.4
6944,CN1324300000000,13,243,"Randolph County, GA",May-19,2512,2398,114,4.5
6945,CN1324500000000,13,245,"Richmond County, GA",May-19,84899,81213,3686,4.3
6946,CN1324700000000,13,247,"Rockdale County, GA",May-19,44495,42834,1661,3.7
6947,CN1324900000000,13,249,"Schley County, GA",May-19,2208,2124,84,3.8
6948,CN1325100000000,13,251,"Screven County, GA",May-19,5059,4823,236,4.7
6949,CN1325300000000,13,253,"Seminole County, GA",May-19,3046,2913,133,4.4
6950,CN1325500000000,13,255,"Spalding County, GA",May-19,28499,27378,1121,3.9
6951,CN1325700000000,13,257,"Stephens County, GA",May-19,10682,10291,391,3.7
6952,CN1325900000000,13,259,"Stewart County, GA",May-19,2407,2305,102,4.2
6953,CN1326100000000,13,261,"Sumter County, GA",May-19,12706,12126,580,4.6
6954,CN1326300000000,13,263,"Talbot County, GA",May-19,2828,2699,129,4.6
6955,CN1326500000000,13,265,"Taliaferro County, GA",May-19,557,536,21,3.8
6956,CN1326700000000,13,267,"Tattnall County, GA",May-19,9438,9082,356,3.8
6957,CN1326900000000,13,269,"Taylor County, GA",May-19,3119,3004,115,3.7
6958,CN1327100000000,13,271,"Telfair County, GA",May-19,4340,3894,446,10.3
6959,CN1327300000000,13,273,"Terrell County, GA",May-19,3494,3316,178,5.1
6960,CN1327500000000,13,275,"Thomas County, GA",May-19,16205,15591,614,3.8
6961,CN1327700000000,13,277,"Tift County, GA",May-19,19584,18980,604,3.1
6962,CN1327900000000,13,279,"Toombs County, GA",May-19,11594,11074,520,4.5
6963,CN1328100000000,13,281,"Towns County, GA",May-19,3920,3744,176,4.5
6964,CN1328300000000,13,283,"Treutlen County, GA",May-19,2667,2549,118,4.4
6965,CN1328500000000,13,285,"Troup County, GA",May-19,37327,36209,1118,3.0
6966,CN1328700000000,13,287,"Turner County, GA",May-19,3137,3011,126,4.0
6967,CN1328900000000,13,289,"Twiggs County, GA",May-19,2858,2712,146,5.1
6968,CN1329100000000,13,291,"Union County, GA",May-19,10358,10038,320,3.1
6969,CN1329300000000,13,293,"Upson County, GA",May-19,11213,10838,375,3.3
6970,CN1329500000000,13,295,"Walker County, GA",May-19,31037,30084,953,3.1
6971,CN1329700000000,13,297,"Walton County, GA",May-19,45756,44363,1393,3.0
6972,CN1329900000000,13,299,"Ware County, GA",May-19,15543,15024,519,3.3
6973,CN1330100000000,13,301,"Warren County, GA",May-19,2795,2676,119,4.3
6974,CN1330300000000,13,303,"Washington County, GA",May-19,6976,6699,277,4.0
6975,CN1330500000000,13,305,"Wayne County, GA",May-19,11421,11000,421,3.7
6976,CN1330700000000,13,307,"Webster County, GA",May-19,1000,950,50,5.0
6977,CN1330900000000,13,309,"Wheeler County, GA",May-19,1628,1507,121,7.4
6978,CN1331100000000,13,311,"White County, GA",May-19,16235,15828,407,2.5
6979,CN1331300000000,13,313,"Whitfield County, GA",May-19,43160,41571,1589,3.7
6980,CN1331500000000,13,315,"Wilcox County, GA",May-19,2688,2555,133,4.9
6981,CN1331700000000,13,317,"Wilkes County, GA",May-19,3792,3629,163,4.3
6982,CN1331900000000,13,319,"Wilkinson County, GA",May-19,4004,3843,161,4.0
6983,CN1332100000000,13,321,"Worth County, GA",May-19,8847,8502,345,3.9
6984,CN1500100000000,15,1,"Hawaii County, HI",May-19,91401,88436,2965,3.2
6985,CN1500300000000,15,3,"Honolulu County/city, HI",May-19,447027,435908,11119,2.5
6986,CN1500700000000,15,7,"Kauai County, HI",May-19,36400,35525,875,2.4
6987,CN1500900000000,15,9,"Maui County, HI",May-19,85892,83776,2116,2.5
6988,CN1600100000000,16,1,"Ada County, ID",May-19,253247,247441,5806,2.3
6989,CN1600300000000,16,3,"Adams County, ID",May-19,1693,1574,119,7.0
6990,CN1600500000000,16,5,"Bannock County, ID",May-19,43094,42007,1087,2.5
6991,CN1600700000000,16,7,"Bear Lake County, ID",May-19,3009,2940,69,2.3
6992,CN1600900000000,16,9,"Benewah County, ID",May-19,4065,3873,192,4.7
6993,CN1601100000000,16,11,"Bingham County, ID",May-19,23926,23399,527,2.2
6994,CN1601300000000,16,13,"Blaine County, ID",May-19,11796,11479,317,2.7
6995,CN1601500000000,16,15,"Boise County, ID",May-19,3484,3353,131,3.8
6996,CN1601700000000,16,17,"Bonner County, ID",May-19,19783,19046,737,3.7
6997,CN1601900000000,16,19,"Bonneville County, ID",May-19,56889,55657,1232,2.2
6998,CN1602100000000,16,21,"Boundary County, ID",May-19,5482,5275,207,3.8
6999,CN1602300000000,16,23,"Butte County, ID",May-19,1405,1376,29,2.1
7000,CN1602500000000,16,25,"Camas County, ID",May-19,681,663,18,2.6
7001,CN1602700000000,16,27,"Canyon County, ID",May-19,103538,100624,2914,2.8
7002,CN1602900000000,16,29,"Caribou County, ID",May-19,4172,4090,82,2.0
7003,CN1603100000000,16,31,"Cassia County, ID",May-19,12222,11930,292,2.4
7004,CN1603300000000,16,33,"Clark County, ID",May-19,386,375,11,2.8
7005,CN1603500000000,16,35,"Clearwater County, ID",May-19,2878,2698,180,6.3
7006,CN1603700000000,16,37,"Custer County, ID",May-19,2271,2197,74,3.3
7007,CN1603900000000,16,39,"Elmore County, ID",May-19,11618,11272,346,3.0
7008,CN1604100000000,16,41,"Franklin County, ID",May-19,7152,7011,141,2.0
7009,CN1604300000000,16,43,"Fremont County, ID",May-19,8026,7875,151,1.9
7010,CN1604500000000,16,45,"Gem County, ID",May-19,8262,8011,251,3.0
7011,CN1604700000000,16,47,"Gooding County, ID",May-19,8225,8041,184,2.2
7012,CN1604900000000,16,49,"Idaho County, ID",May-19,6683,6417,266,4.0
7013,CN1605100000000,16,51,"Jefferson County, ID",May-19,14075,13788,287,2.0
7014,CN1605300000000,16,53,"Jerome County, ID",May-19,12170,11890,280,2.3
7015,CN1605500000000,16,55,"Kootenai County, ID",May-19,80622,78274,2348,2.9
7016,CN1605700000000,16,57,"Latah County, ID",May-19,20328,19818,510,2.5
7017,CN1605900000000,16,59,"Lemhi County, ID",May-19,3550,3415,135,3.8
7018,CN1606100000000,16,61,"Lewis County, ID",May-19,1690,1623,67,4.0
7019,CN1606300000000,16,63,"Lincoln County, ID",May-19,2613,2535,78,3.0
7020,CN1606500000000,16,65,"Madison County, ID",May-19,22353,21961,392,1.8
7021,CN1606700000000,16,67,"Minidoka County, ID",May-19,11505,11233,272,2.4
7022,CN1606900000000,16,69,"Nez Perce County, ID",May-19,20989,20486,503,2.4
7023,CN1607100000000,16,71,"Oneida County, ID",May-19,2335,2291,44,1.9
7024,CN1607300000000,16,73,"Owyhee County, ID",May-19,5488,5331,157,2.9
7025,CN1607500000000,16,75,"Payette County, ID",May-19,11583,11224,359,3.1
7026,CN1607700000000,16,77,"Power County, ID",May-19,4120,4020,100,2.4
7027,CN1607900000000,16,79,"Shoshone County, ID",May-19,5051,4777,274,5.4
7028,CN1608100000000,16,81,"Teton County, ID",May-19,6466,6318,148,2.3
7029,CN1608300000000,16,83,"Twin Falls County, ID",May-19,41064,40010,1054,2.6
7030,CN1608500000000,16,85,"Valley County, ID",May-19,5339,5144,195,3.7
7031,CN1608700000000,16,87,"Washington County, ID",May-19,4576,4410,166,3.6
7032,CN1700100000000,17,1,"Adams County, IL",May-19,32354,31453,901,2.8
7033,CN1700300000000,17,3,"Alexander County, IL",May-19,2043,1940,103,5.0
7034,CN1700500000000,17,5,"Bond County, IL",May-19,7871,7633,238,3.0
7035,CN1700700000000,17,7,"Boone County, IL",May-19,26116,24912,1204,4.6
7036,CN1700900000000,17,9,"Brown County, IL",May-19,3010,2949,61,2.0
7037,CN1701100000000,17,11,"Bureau County, IL",May-19,17671,17038,633,3.6
7038,CN1701300000000,17,13,"Calhoun County, IL",May-19,2348,2252,96,4.1
7039,CN1701500000000,17,15,"Carroll County, IL",May-19,7359,7124,235,3.2
7040,CN1701700000000,17,17,"Cass County, IL",May-19,6205,5988,217,3.5
7041,CN1701900000000,17,19,"Champaign County, IL",May-19,109337,105800,3537,3.2
7042,CN1702100000000,17,21,"Christian County, IL",May-19,14831,14252,579,3.9
7043,CN1702300000000,17,23,"Clark County, IL",May-19,7823,7538,285,3.6
7044,CN1702500000000,17,25,"Clay County, IL",May-19,6633,6372,261,3.9
7045,CN1702700000000,17,27,"Clinton County, IL",May-19,20589,20072,517,2.5
7046,CN1702900000000,17,29,"Coles County, IL",May-19,23121,22314,807,3.5
7047,CN1703100000000,17,31,"Cook County, IL",May-19,2577163,2487042,90121,3.5
7048,CN1703300000000,17,33,"Crawford County, IL",May-19,8747,8409,338,3.9
7049,CN1703500000000,17,35,"Cumberland County, IL",May-19,6170,6008,162,2.6
7050,CN1703700000000,17,37,"DeKalb County, IL",May-19,55303,53399,1904,3.4
7051,CN1703900000000,17,39,"De Witt County, IL",May-19,7525,7258,267,3.5
7052,CN1704100000000,17,41,"Douglas County, IL",May-19,10305,10010,295,2.9
7053,CN1704300000000,17,43,"DuPage County, IL",May-19,504588,491146,13442,2.7
7054,CN1704500000000,17,45,"Edgar County, IL",May-19,9139,8845,294,3.2
7055,CN1704700000000,17,47,"Edwards County, IL",May-19,2738,2652,86,3.1
7056,CN1704900000000,17,49,"Effingham County, IL",May-19,19444,18910,534,2.7
7057,CN1705100000000,17,51,"Fayette County, IL",May-19,10197,9837,360,3.5
7058,CN1705300000000,17,53,"Ford County, IL",May-19,6612,6392,220,3.3
7059,CN1705500000000,17,55,"Franklin County, IL",May-19,16514,15752,762,4.6
7060,CN1705700000000,17,57,"Fulton County, IL",May-19,15346,14663,683,4.5
7061,CN1705900000000,17,59,"Gallatin County, IL",May-19,2411,2311,100,4.1
7062,CN1706100000000,17,61,"Greene County, IL",May-19,6153,5929,224,3.6
7063,CN1706300000000,17,63,"Grundy County, IL",May-19,25281,24283,998,3.9
7064,CN1706500000000,17,65,"Hamilton County, IL",May-19,4531,4396,135,3.0
7065,CN1706700000000,17,67,"Hancock County, IL",May-19,8612,8295,317,3.7
7066,CN1706900000000,17,69,"Hardin County, IL",May-19,1315,1239,76,5.8
7067,CN1707100000000,17,71,"Henderson County, IL",May-19,3714,3562,152,4.1
7068,CN1707300000000,17,73,"Henry County, IL",May-19,25280,24288,992,3.9
7069,CN1707500000000,17,75,"Iroquois County, IL",May-19,14657,14173,484,3.3
7070,CN1707700000000,17,77,"Jackson County, IL",May-19,27867,26976,891,3.2
7071,CN1707900000000,17,79,"Jasper County, IL",May-19,4805,4641,164,3.4
7072,CN1708100000000,17,81,"Jefferson County, IL",May-19,17309,16636,673,3.9
7073,CN1708300000000,17,83,"Jersey County, IL",May-19,11024,10598,426,3.9
7074,CN1708500000000,17,85,"Jo Daviess County, IL",May-19,11134,10839,295,2.6
7075,CN1708700000000,17,87,"Johnson County, IL",May-19,4133,3931,202,4.9
7076,CN1708900000000,17,89,"Kane County, IL",May-19,272469,262868,9601,3.5
7077,CN1709100000000,17,91,"Kankakee County, IL",May-19,55598,53373,2225,4.0
7078,CN1709300000000,17,93,"Kendall County, IL",May-19,68171,66187,1984,2.9
7079,CN1709500000000,17,95,"Knox County, IL",May-19,22178,21274,904,4.1
7080,CN1709700000000,17,97,"Lake County, IL",May-19,375261,362928,12333,3.3
7081,CN1709900000000,17,99,"LaSalle County, IL",May-19,54892,52514,2378,4.3
7082,CN1710100000000,17,101,"Lawrence County, IL",May-19,5935,5669,266,4.5
7083,CN1710300000000,17,103,"Lee County, IL",May-19,17658,17047,611,3.5
7084,CN1710500000000,17,105,"Livingston County, IL",May-19,16827,16252,575,3.4
7085,CN1710700000000,17,107,"Logan County, IL",May-19,12910,12423,487,3.8
7086,CN1710900000000,17,109,"McDonough County, IL",May-19,13834,13315,519,3.8
7087,CN1711100000000,17,111,"McHenry County, IL",May-19,164558,159721,4837,2.9
7088,CN1711300000000,17,113,"McLean County, IL",May-19,88117,85371,2746,3.1
7089,CN1711500000000,17,115,"Macon County, IL",May-19,49294,47176,2118,4.3
7090,CN1711700000000,17,117,"Macoupin County, IL",May-19,23108,22311,797,3.4
7091,CN1711900000000,17,119,"Madison County, IL",May-19,134165,129775,4390,3.3
7092,CN1712100000000,17,121,"Marion County, IL",May-19,17762,17073,689,3.9
7093,CN1712300000000,17,123,"Marshall County, IL",May-19,5419,5208,211,3.9
7094,CN1712500000000,17,125,"Mason County, IL",May-19,6443,6163,280,4.3
7095,CN1712700000000,17,127,"Massac County, IL",May-19,5639,5360,279,4.9
7096,CN1712900000000,17,129,"Menard County, IL",May-19,6556,6358,198,3.0
7097,CN1713100000000,17,131,"Mercer County, IL",May-19,8202,7892,310,3.8
7098,CN1713300000000,17,133,"Monroe County, IL",May-19,18829,18354,475,2.5
7099,CN1713500000000,17,135,"Montgomery County, IL",May-19,11919,11439,480,4.0
7100,CN1713700000000,17,137,"Morgan County, IL",May-19,16686,16146,540,3.2
7101,CN1713900000000,17,139,"Moultrie County, IL",May-19,7631,7413,218,2.9
7102,CN1714100000000,17,141,"Ogle County, IL",May-19,25250,24231,1019,4.0
7103,CN1714300000000,17,143,"Peoria County, IL",May-19,85192,81568,3624,4.3
7104,CN1714500000000,17,145,"Perry County, IL",May-19,8454,8093,361,4.3
7105,CN1714700000000,17,147,"Piatt County, IL",May-19,8722,8470,252,2.9
7106,CN1714900000000,17,149,"Pike County, IL",May-19,7278,7037,241,3.3
7107,CN1715100000000,17,151,"Pope County, IL",May-19,1725,1641,84,4.9
7108,CN1715300000000,17,153,"Pulaski County, IL",May-19,1996,1889,107,5.4
7109,CN1715500000000,17,155,"Putnam County, IL",May-19,3058,2936,122,4.0
7110,CN1715700000000,17,157,"Randolph County, IL",May-19,14397,13967,430,3.0
7111,CN1715900000000,17,159,"Richland County, IL",May-19,7351,7102,249,3.4
7112,CN1716100000000,17,161,"Rock Island County, IL",May-19,71566,68578,2988,4.2
7113,CN1716300000000,17,163,"St. Clair County, IL",May-19,126456,121668,4788,3.8
7114,CN1716500000000,17,165,"Saline County, IL",May-19,9738,9300,438,4.5
7115,CN1716700000000,17,167,"Sangamon County, IL",May-19,101270,97921,3349,3.3
7116,CN1716900000000,17,169,"Schuyler County, IL",May-19,3366,3273,93,2.8
7117,CN1717100000000,17,171,"Scott County, IL",May-19,2542,2454,88,3.5
7118,CN1717300000000,17,173,"Shelby County, IL",May-19,10891,10546,345,3.2
7119,CN1717500000000,17,175,"Stark County, IL",May-19,2600,2478,122,4.7
7120,CN1717700000000,17,177,"Stephenson County, IL",May-19,22122,21311,811,3.7
7121,CN1717900000000,17,179,"Tazewell County, IL",May-19,64109,61872,2237,3.5
7122,CN1718100000000,17,181,"Union County, IL",May-19,7527,7167,360,4.8
7123,CN1718300000000,17,183,"Vermilion County, IL",May-19,33026,31630,1396,4.2
7124,CN1718500000000,17,185,"Wabash County, IL",May-19,5865,5670,195,3.3
7125,CN1718700000000,17,187,"Warren County, IL",May-19,8740,8416,324,3.7
7126,CN1718900000000,17,189,"Washington County, IL",May-19,10366,10168,198,1.9
7127,CN1719100000000,17,191,"Wayne County, IL",May-19,7157,6872,285,4.0
7128,CN1719300000000,17,193,"White County, IL",May-19,6715,6499,216,3.2
7129,CN1719500000000,17,195,"Whiteside County, IL",May-19,28859,27877,982,3.4
7130,CN1719700000000,17,197,"Will County, IL",May-19,354714,342512,12202,3.4
7131,CN1719900000000,17,199,"Williamson County, IL",May-19,31799,30665,1134,3.6
7132,CN1720100000000,17,201,"Winnebago County, IL",May-19,139169,132018,7151,5.1
7133,CN1720300000000,17,203,"Woodford County, IL",May-19,18955,18373,582,3.1
7134,CN1800100000000,18,1,"Adams County, IN",May-19,17349,16944,405,2.3
7135,CN1800300000000,18,3,"Allen County, IN",May-19,185976,180812,5164,2.8
7136,CN1800500000000,18,5,"Bartholomew County, IN",May-19,44899,43871,1028,2.3
7137,CN1800700000000,18,7,"Benton County, IN",May-19,4662,4531,131,2.8
7138,CN1800900000000,18,9,"Blackford County, IN",May-19,5037,4873,164,3.3
7139,CN1801100000000,18,11,"Boone County, IN",May-19,36470,35640,830,2.3
7140,CN1801300000000,18,13,"Brown County, IN",May-19,7746,7538,208,2.7
7141,CN1801500000000,18,15,"Carroll County, IN",May-19,10379,10111,268,2.6
7142,CN1801700000000,18,17,"Cass County, IN",May-19,18314,17767,547,3.0
7143,CN1801900000000,18,19,"Clark County, IN",May-19,61410,59537,1873,3.0
7144,CN1802100000000,18,21,"Clay County, IN",May-19,12149,11774,375,3.1
7145,CN1802300000000,18,23,"Clinton County, IN",May-19,17283,16876,407,2.4
7146,CN1802500000000,18,25,"Crawford County, IN",May-19,4834,4673,161,3.3
7147,CN1802700000000,18,27,"Daviess County, IN",May-19,16827,16428,399,2.4
7148,CN1802900000000,18,29,"Dearborn County, IN",May-19,25839,25013,826,3.2
7149,CN1803100000000,18,31,"Decatur County, IN",May-19,15314,14924,390,2.5
7150,CN1803300000000,18,33,"DeKalb County, IN",May-19,22742,22180,562,2.5
7151,CN1803500000000,18,35,"Delaware County, IN",May-19,53492,51612,1880,3.5
7152,CN1803700000000,18,37,"Dubois County, IN",May-19,23252,22750,502,2.2
7153,CN1803900000000,18,39,"Elkhart County, IN",May-19,113356,110266,3090,2.7
7154,CN1804100000000,18,41,"Fayette County, IN",May-19,8815,8465,350,4.0
7155,CN1804300000000,18,43,"Floyd County, IN",May-19,41490,40293,1197,2.9
7156,CN1804500000000,18,45,"Fountain County, IN",May-19,8154,7901,253,3.1
7157,CN1804700000000,18,47,"Franklin County, IN",May-19,11596,11257,339,2.9
7158,CN1804900000000,18,49,"Fulton County, IN",May-19,10043,9776,267,2.7
7159,CN1805100000000,18,51,"Gibson County, IN",May-19,19354,18912,442,2.3
7160,CN1805300000000,18,53,"Grant County, IN",May-19,32091,31054,1037,3.2
7161,CN1805500000000,18,55,"Greene County, IN",May-19,13806,13315,491,3.6
7162,CN1805700000000,18,57,"Hamilton County, IN",May-19,184182,179855,4327,2.3
7163,CN1805900000000,18,59,"Hancock County, IN",May-19,40417,39356,1061,2.6
7164,CN1806100000000,18,61,"Harrison County, IN",May-19,20239,19659,580,2.9
7165,CN1806300000000,18,63,"Hendricks County, IN",May-19,90077,87849,2228,2.5
7166,CN1806500000000,18,65,"Henry County, IN",May-19,22032,21375,657,3.0
7167,CN1806700000000,18,67,"Howard County, IN",May-19,36160,34947,1213,3.4
7168,CN1806900000000,18,69,"Huntington County, IN",May-19,18289,17758,531,2.9
7169,CN1807100000000,18,71,"Jackson County, IN",May-19,22861,22294,567,2.5
7170,CN1807300000000,18,73,"Jasper County, IN",May-19,16493,16002,491,3.0
7171,CN1807500000000,18,75,"Jay County, IN",May-19,9491,9232,259,2.7
7172,CN1807700000000,18,77,"Jefferson County, IN",May-19,15143,14686,457,3.0
7173,CN1807900000000,18,79,"Jennings County, IN",May-19,13441,13054,387,2.9
7174,CN1808100000000,18,81,"Johnson County, IN",May-19,83177,81136,2041,2.5
7175,CN1808300000000,18,83,"Knox County, IN",May-19,18314,17802,512,2.8
7176,CN1808500000000,18,85,"Kosciusko County, IN",May-19,42705,41651,1054,2.5
7177,CN1808700000000,18,87,"LaGrange County, IN",May-19,20426,19918,508,2.5
7178,CN1808900000000,18,89,"Lake County, IN",May-19,231078,221552,9526,4.1
7179,CN1809100000000,18,91,"LaPorte County, IN",May-19,48002,46245,1757,3.7
7180,CN1809300000000,18,93,"Lawrence County, IN",May-19,21270,20581,689,3.2
7181,CN1809500000000,18,95,"Madison County, IN",May-19,59239,57311,1928,3.3
7182,CN1809700000000,18,97,"Marion County, IN",May-19,490841,476103,14738,3.0
7183,CN1809900000000,18,99,"Marshall County, IN",May-19,23450,22805,645,2.8
7184,CN1810100000000,18,101,"Martin County, IN",May-19,5384,5250,134,2.5
7185,CN1810300000000,18,103,"Miami County, IN",May-19,15629,15124,505,3.2
7186,CN1810500000000,18,105,"Monroe County, IN",May-19,70883,68756,2127,3.0
7187,CN1810700000000,18,107,"Montgomery County, IN",May-19,18852,18334,518,2.7
7188,CN1810900000000,18,109,"Morgan County, IN",May-19,36471,35445,1026,2.8
7189,CN1811100000000,18,111,"Newton County, IN",May-19,7061,6836,225,3.2
7190,CN1811300000000,18,113,"Noble County, IN",May-19,23807,23168,639,2.7
7191,CN1811500000000,18,115,"Ohio County, IN",May-19,3180,3084,96,3.0
7192,CN1811700000000,18,117,"Orange County, IN",May-19,8597,8323,274,3.2
7193,CN1811900000000,18,119,"Owen County, IN",May-19,9509,9180,329,3.5
7194,CN1812100000000,18,121,"Parke County, IN",May-19,7259,7019,240,3.3
7195,CN1812300000000,18,123,"Perry County, IN",May-19,9255,8988,267,2.9
7196,CN1812500000000,18,125,"Pike County, IN",May-19,6120,5936,184,3.0
7197,CN1812700000000,18,127,"Porter County, IN",May-19,87313,84513,2800,3.2
7198,CN1812900000000,18,129,"Posey County, IN",May-19,13625,13289,336,2.5
7199,CN1813100000000,18,131,"Pulaski County, IN",May-19,6645,6466,179,2.7
7200,CN1813300000000,18,133,"Putnam County, IN",May-19,16866,16337,529,3.1
7201,CN1813500000000,18,135,"Randolph County, IN",May-19,11522,11160,362,3.1
7202,CN1813700000000,18,137,"Ripley County, IN",May-19,14331,13926,405,2.8
7203,CN1813900000000,18,139,"Rush County, IN",May-19,9148,8931,217,2.4
7204,CN1814100000000,18,141,"St. Joseph County, IN",May-19,136585,132205,4380,3.2
7205,CN1814300000000,18,143,"Scott County, IN",May-19,10535,10178,357,3.4
7206,CN1814500000000,18,145,"Shelby County, IN",May-19,23240,22636,604,2.6
7207,CN1814700000000,18,147,"Spencer County, IN",May-19,11451,11148,303,2.6
7208,CN1814900000000,18,149,"Starke County, IN",May-19,10098,9727,371,3.7
7209,CN1815100000000,18,151,"Steuben County, IN",May-19,20269,19784,485,2.4
7210,CN1815300000000,18,153,"Sullivan County, IN",May-19,8499,8167,332,3.9
7211,CN1815500000000,18,155,"Switzerland County, IN",May-19,5040,4894,146,2.9
7212,CN1815700000000,18,157,"Tippecanoe County, IN",May-19,99035,96399,2636,2.7
7213,CN1815900000000,18,159,"Tipton County, IN",May-19,9458,9235,223,2.4
7214,CN1816100000000,18,161,"Union County, IN",May-19,3577,3476,101,2.8
7215,CN1816300000000,18,163,"Vanderburgh County, IN",May-19,93951,91303,2648,2.8
7216,CN1816500000000,18,165,"Vermillion County, IN",May-19,7068,6742,326,4.6
7217,CN1816700000000,18,167,"Vigo County, IN",May-19,48406,46561,1845,3.8
7218,CN1816900000000,18,169,"Wabash County, IN",May-19,15276,14857,419,2.7
7219,CN1817100000000,18,171,"Warren County, IN",May-19,4279,4166,113,2.6
7220,CN1817300000000,18,173,"Warrick County, IN",May-19,32891,32012,879,2.7
7221,CN1817500000000,18,175,"Washington County, IN",May-19,13796,13401,395,2.9
7222,CN1817700000000,18,177,"Wayne County, IN",May-19,31113,30117,996,3.2
7223,CN1817900000000,18,179,"Wells County, IN",May-19,14555,14211,344,2.4
7224,CN1818100000000,18,181,"White County, IN",May-19,13786,13463,323,2.3
7225,CN1818300000000,18,183,"Whitley County, IN",May-19,17860,17388,472,2.6
7226,CN1900100000000,19,1,"Adair County, IA",May-19,4286,4199,87,2.0
7227,CN1900300000000,19,3,"Adams County, IA",May-19,2225,2188,37,1.7
7228,CN1900500000000,19,5,"Allamakee County, IA",May-19,7402,7204,198,2.7
7229,CN1900700000000,19,7,"Appanoose County, IA",May-19,6072,5896,176,2.9
7230,CN1900900000000,19,9,"Audubon County, IA",May-19,3149,3084,65,2.1
7231,CN1901100000000,19,11,"Benton County, IA",May-19,13583,13255,328,2.4
7232,CN1901300000000,19,13,"Black Hawk County, IA",May-19,70007,68157,1850,2.6
7233,CN1901500000000,19,15,"Boone County, IA",May-19,15117,14786,331,2.2
7234,CN1901700000000,19,17,"Bremer County, IA",May-19,14053,13768,285,2.0
7235,CN1901900000000,19,19,"Buchanan County, IA",May-19,11357,11096,261,2.3
7236,CN1902100000000,19,21,"Buena Vista County, IA",May-19,11887,11657,230,1.9
7237,CN1902300000000,19,23,"Butler County, IA",May-19,7952,7746,206,2.6
7238,CN1902500000000,19,25,"Calhoun County, IA",May-19,4365,4256,109,2.5
7239,CN1902700000000,19,27,"Carroll County, IA",May-19,11014,10805,209,1.9
7240,CN1902900000000,19,29,"Cass County, IA",May-19,6987,6821,166,2.4
7241,CN1903100000000,19,31,"Cedar County, IA",May-19,11001,10767,234,2.1
7242,CN1903300000000,19,33,"Cerro Gordo County, IA",May-19,23846,23263,583,2.4
7243,CN1903500000000,19,35,"Cherokee County, IA",May-19,6151,6000,151,2.5
7244,CN1903700000000,19,37,"Chickasaw County, IA",May-19,6520,6366,154,2.4
7245,CN1903900000000,19,39,"Clarke County, IA",May-19,4872,4744,128,2.6
7246,CN1904100000000,19,41,"Clay County, IA",May-19,8534,8322,212,2.5
7247,CN1904300000000,19,43,"Clayton County, IA",May-19,10230,9976,254,2.5
7248,CN1904500000000,19,45,"Clinton County, IA",May-19,22941,22237,704,3.1
7249,CN1904700000000,19,47,"Crawford County, IA",May-19,8139,7905,234,2.9
7250,CN1904900000000,19,49,"Dallas County, IA",May-19,49996,49067,929,1.9
7251,CN1905100000000,19,51,"Davis County, IA",May-19,4184,4091,93,2.2
7252,CN1905300000000,19,53,"Decatur County, IA",May-19,4425,4333,92,2.1
7253,CN1905500000000,19,55,"Delaware County, IA",May-19,10665,10461,204,1.9
7254,CN1905700000000,19,57,"Des Moines County, IA",May-19,19681,18974,707,3.6
7255,CN1905900000000,19,59,"Dickinson County, IA",May-19,10218,9983,235,2.3
7256,CN1906100000000,19,61,"Dubuque County, IA",May-19,56823,55638,1185,2.1
7257,CN1906300000000,19,63,"Emmet County, IA",May-19,5290,5169,121,2.3
7258,CN1906500000000,19,65,"Fayette County, IA",May-19,10834,10516,318,2.9
7259,CN1906700000000,19,67,"Floyd County, IA",May-19,8900,8677,223,2.5
7260,CN1906900000000,19,69,"Franklin County, IA",May-19,5789,5672,117,2.0
7261,CN1907100000000,19,71,"Fremont County, IA",May-19,3640,3529,111,3.0
7262,CN1907300000000,19,73,"Greene County, IA",May-19,5453,5314,139,2.5
7263,CN1907500000000,19,75,"Grundy County, IA",May-19,6567,6410,157,2.4
7264,CN1907700000000,19,77,"Guthrie County, IA",May-19,5612,5465,147,2.6
7265,CN1907900000000,19,79,"Hamilton County, IA",May-19,7003,6823,180,2.6
7266,CN1908100000000,19,81,"Hancock County, IA",May-19,5936,5805,131,2.2
7267,CN1908300000000,19,83,"Hardin County, IA",May-19,8121,7882,239,2.9
7268,CN1908500000000,19,85,"Harrison County, IA",May-19,7382,7224,158,2.1
7269,CN1908700000000,19,87,"Henry County, IA",May-19,9926,9698,228,2.3
7270,CN1908900000000,19,89,"Howard County, IA",May-19,5192,5075,117,2.3
7271,CN1909100000000,19,91,"Humboldt County, IA",May-19,5136,5015,121,2.4
7272,CN1909300000000,19,93,"Ida County, IA",May-19,4145,4077,68,1.6
7273,CN1909500000000,19,95,"Iowa County, IA",May-19,10534,10332,202,1.9
7274,CN1909700000000,19,97,"Jackson County, IA",May-19,11153,10870,283,2.5
7275,CN1909900000000,19,99,"Jasper County, IA",May-19,19974,19453,521,2.6
7276,CN1910100000000,19,101,"Jefferson County, IA",May-19,10244,10012,232,2.3
7277,CN1910300000000,19,103,"Johnson County, IA",May-19,86388,84691,1697,2.0
7278,CN1910500000000,19,105,"Jones County, IA",May-19,10700,10443,257,2.4
7279,CN1910700000000,19,107,"Keokuk County, IA",May-19,5246,5109,137,2.6
7280,CN1910900000000,19,109,"Kossuth County, IA",May-19,8466,8312,154,1.8
7281,CN1911100000000,19,111,"Lee County, IA",May-19,16135,15596,539,3.3
7282,CN1911300000000,19,113,"Linn County, IA",May-19,123295,120177,3118,2.5
7283,CN1911500000000,19,115,"Louisa County, IA",May-19,6050,5891,159,2.6
7284,CN1911700000000,19,117,"Lucas County, IA",May-19,4679,4595,84,1.8
7285,CN1911900000000,19,119,"Lyon County, IA",May-19,7126,7024,102,1.4
7286,CN1912100000000,19,121,"Madison County, IA",May-19,8598,8336,262,3.0
7287,CN1912300000000,19,123,"Mahaska County, IA",May-19,12006,11728,278,2.3
7288,CN1912500000000,19,125,"Marion County, IA",May-19,18586,18230,356,1.9
7289,CN1912700000000,19,127,"Marshall County, IA",May-19,17945,17310,635,3.5
7290,CN1912900000000,19,129,"Mills County, IA",May-19,7441,7273,168,2.3
7291,CN1913100000000,19,131,"Mitchell County, IA",May-19,6950,6844,106,1.5
7292,CN1913300000000,19,133,"Monona County, IA",May-19,4480,4377,103,2.3
7293,CN1913500000000,19,135,"Monroe County, IA",May-19,3996,3899,97,2.4
7294,CN1913700000000,19,137,"Montgomery County, IA",May-19,5093,4977,116,2.3
7295,CN1913900000000,19,139,"Muscatine County, IA",May-19,21898,21357,541,2.5
7296,CN1914100000000,19,141,"O'Brien County, IA",May-19,8285,8127,158,1.9
7297,CN1914300000000,19,143,"Osceola County, IA",May-19,3576,3511,65,1.8
7298,CN1914500000000,19,145,"Page County, IA",May-19,6485,6329,156,2.4
7299,CN1914700000000,19,147,"Palo Alto County, IA",May-19,4814,4720,94,2.0
7300,CN1914900000000,19,149,"Plymouth County, IA",May-19,14792,14516,276,1.9
7301,CN1915100000000,19,151,"Pocahontas County, IA",May-19,4404,4321,83,1.9
7302,CN1915300000000,19,153,"Polk County, IA",May-19,271284,264440,6844,2.5
7303,CN1915500000000,19,155,"Pottawattamie County, IA",May-19,48863,47787,1076,2.2
7304,CN1915700000000,19,157,"Poweshiek County, IA",May-19,10682,10458,224,2.1
7305,CN1915900000000,19,159,"Ringgold County, IA",May-19,2477,2415,62,2.5
7306,CN1916100000000,19,161,"Sac County, IA",May-19,5330,5225,105,2.0
7307,CN1916300000000,19,163,"Scott County, IA",May-19,89892,87324,2568,2.9
7308,CN1916500000000,19,165,"Shelby County, IA",May-19,6734,6600,134,2.0
7309,CN1916700000000,19,167,"Sioux County, IA",May-19,21372,21030,342,1.6
7310,CN1916900000000,19,169,"Story County, IA",May-19,59824,58817,1007,1.7
7311,CN1917100000000,19,171,"Tama County, IA",May-19,9490,9271,219,2.3
7312,CN1917300000000,19,173,"Taylor County, IA",May-19,3220,3163,57,1.8
7313,CN1917500000000,19,175,"Union County, IA",May-19,6302,6125,177,2.8
7314,CN1917700000000,19,177,"Van Buren County, IA",May-19,3712,3625,87,2.3
7315,CN1917900000000,19,179,"Wapello County, IA",May-19,17808,17265,543,3.0
7316,CN1918100000000,19,181,"Warren County, IA",May-19,28514,27875,639,2.2
7317,CN1918300000000,19,183,"Washington County, IA",May-19,11950,11691,259,2.2
7318,CN1918500000000,19,185,"Wayne County, IA",May-19,2817,2751,66,2.3
7319,CN1918700000000,19,187,"Webster County, IA",May-19,19566,19036,530,2.7
7320,CN1918900000000,19,189,"Winnebago County, IA",May-19,5103,4974,129,2.5
7321,CN1919100000000,19,191,"Winneshiek County, IA",May-19,12204,11956,248,2.0
7322,CN1919300000000,19,193,"Woodbury County, IA",May-19,55812,54540,1272,2.3
7323,CN1919500000000,19,195,"Worth County, IA",May-19,4182,4084,98,2.3
7324,CN1919700000000,19,197,"Wright County, IA",May-19,7134,6954,180,2.5
7325,CN2000100000000,20,1,"Allen County, KS",May-19,6558,6348,210,3.2
7326,CN2000300000000,20,3,"Anderson County, KS",May-19,4109,3984,125,3.0
7327,CN2000500000000,20,5,"Atchison County, KS",May-19,6803,6467,336,4.9
7328,CN2000700000000,20,7,"Barber County, KS",May-19,2233,2187,46,2.1
7329,CN2000900000000,20,9,"Barton County, KS",May-19,13303,12929,374,2.8
7330,CN2001100000000,20,11,"Bourbon County, KS",May-19,6691,6434,257,3.8
7331,CN2001300000000,20,13,"Brown County, KS",May-19,5286,5114,172,3.3
7332,CN2001500000000,20,15,"Butler County, KS",May-19,32302,31316,986,3.1
7333,CN2001700000000,20,17,"Chase County, KS",May-19,1557,1518,39,2.5
7334,CN2001900000000,20,19,"Chautauqua County, KS",May-19,1405,1354,51,3.6
7335,CN2002100000000,20,21,"Cherokee County, KS",May-19,10090,9748,342,3.4
7336,CN2002300000000,20,23,"Cheyenne County, KS",May-19,1253,1223,30,2.4
7337,CN2002500000000,20,25,"Clark County, KS",May-19,1027,1000,27,2.6
7338,CN2002700000000,20,27,"Clay County, KS",May-19,3683,3573,110,3.0
7339,CN2002900000000,20,29,"Cloud County, KS",May-19,3765,3650,115,3.1
7340,CN2003100000000,20,31,"Coffey County, KS",May-19,3845,3678,167,4.3
7341,CN2003300000000,20,33,"Comanche County, KS",May-19,870,850,20,2.3
7342,CN2003500000000,20,35,"Cowley County, KS",May-19,16178,15662,516,3.2
7343,CN2003700000000,20,37,"Crawford County, KS",May-19,18662,17967,695,3.7
7344,CN2003900000000,20,39,"Decatur County, KS",May-19,1162,1130,32,2.8
7345,CN2004100000000,20,41,"Dickinson County, KS",May-19,8823,8546,277,3.1
7346,CN2004300000000,20,43,"Doniphan County, KS",May-19,4060,3938,122,3.0
7347,CN2004500000000,20,45,"Douglas County, KS",May-19,65900,64130,1770,2.7
7348,CN2004700000000,20,47,"Edwards County, KS",May-19,1409,1372,37,2.6
7349,CN2004900000000,20,49,"Elk County, KS",May-19,1109,1070,39,3.5
7350,CN2005100000000,20,51,"Ellis County, KS",May-19,16840,16465,375,2.2
7351,CN2005300000000,20,53,"Ellsworth County, KS",May-19,2778,2709,69,2.5
7352,CN2005500000000,20,55,"Finney County, KS",May-19,20274,19796,478,2.4
7353,CN2005700000000,20,57,"Ford County, KS",May-19,16865,16471,394,2.3
7354,CN2005900000000,20,59,"Franklin County, KS",May-19,13820,13382,438,3.2
7355,CN2006100000000,20,61,"Geary County, KS",May-19,11295,10849,446,3.9
7356,CN2006300000000,20,63,"Gove County, KS",May-19,1421,1394,27,1.9
7357,CN2006500000000,20,65,"Graham County, KS",May-19,1086,1056,30,2.8
7358,CN2006700000000,20,67,"Grant County, KS",May-19,3139,3051,88,2.8
7359,CN2006900000000,20,69,"Gray County, KS",May-19,3131,3072,59,1.9
7360,CN2007100000000,20,71,"Greeley County, KS",May-19,763,748,15,2.0
7361,CN2007300000000,20,73,"Greenwood County, KS",May-19,3157,3061,96,3.0
7362,CN2007500000000,20,75,"Hamilton County, KS",May-19,1547,1517,30,1.9
7363,CN2007700000000,20,77,"Harper County, KS",May-19,2918,2844,74,2.5
7364,CN2007900000000,20,79,"Harvey County, KS",May-19,16867,16407,460,2.7
7365,CN2008100000000,20,81,"Haskell County, KS",May-19,2135,2079,56,2.6
7366,CN2008300000000,20,83,"Hodgeman County, KS",May-19,942,922,20,2.1
7367,CN2008500000000,20,85,"Jackson County, KS",May-19,7093,6904,189,2.7
7368,CN2008700000000,20,87,"Jefferson County, KS",May-19,9970,9699,271,2.7
7369,CN2008900000000,20,89,"Jewell County, KS",May-19,1277,1241,36,2.8
7370,CN2009100000000,20,91,"Johnson County, KS",May-19,336057,327266,8791,2.6
7371,CN2009300000000,20,93,"Kearny County, KS",May-19,1979,1930,49,2.5
7372,CN2009500000000,20,95,"Kingman County, KS",May-19,3361,3253,108,3.2
7373,CN2009700000000,20,97,"Kiowa County, KS",May-19,1304,1275,29,2.2
7374,CN2009900000000,20,99,"Labette County, KS",May-19,9956,9571,385,3.9
7375,CN2010100000000,20,101,"Lane County, KS",May-19,746,729,17,2.3
7376,CN2010300000000,20,103,"Leavenworth County, KS",May-19,36091,34960,1131,3.1
7377,CN2010500000000,20,105,"Lincoln County, KS",May-19,1606,1569,37,2.3
7378,CN2010700000000,20,107,"Linn County, KS",May-19,4348,4116,232,5.3
7379,CN2010900000000,20,109,"Logan County, KS",May-19,1580,1548,32,2.0
7380,CN2011100000000,20,111,"Lyon County, KS",May-19,16529,16005,524,3.2
7381,CN2011300000000,20,113,"McPherson County, KS",May-19,17054,16691,363,2.1
7382,CN2011500000000,20,115,"Marion County, KS",May-19,5911,5750,161,2.7
7383,CN2011700000000,20,117,"Marshall County, KS",May-19,5339,5195,144,2.7
7384,CN2011900000000,20,119,"Meade County, KS",May-19,2085,2036,49,2.4
7385,CN2012100000000,20,121,"Miami County, KS",May-19,17295,16769,526,3.0
7386,CN2012300000000,20,123,"Mitchell County, KS",May-19,3322,3246,76,2.3
7387,CN2012500000000,20,125,"Montgomery County, KS",May-19,14703,14143,560,3.8
7388,CN2012700000000,20,127,"Morris County, KS",May-19,2927,2856,71,2.4
7389,CN2012900000000,20,129,"Morton County, KS",May-19,1110,1081,29,2.6
7390,CN2013100000000,20,131,"Nemaha County, KS",May-19,5253,5123,130,2.5
7391,CN2013300000000,20,133,"Neosho County, KS",May-19,5993,5738,255,4.3
7392,CN2013500000000,20,135,"Ness County, KS",May-19,1292,1262,30,2.3
7393,CN2013700000000,20,137,"Norton County, KS",May-19,2638,2584,54,2.0
7394,CN2013900000000,20,139,"Osage County, KS",May-19,7853,7615,238,3.0
7395,CN2014100000000,20,141,"Osborne County, KS",May-19,1994,1957,37,1.9
7396,CN2014300000000,20,143,"Ottawa County, KS",May-19,2955,2882,73,2.5
7397,CN2014500000000,20,145,"Pawnee County, KS",May-19,2737,2664,73,2.7
7398,CN2014700000000,20,147,"Phillips County, KS",May-19,2592,2528,64,2.5
7399,CN2014900000000,20,149,"Pottawatomie County, KS",May-19,12552,12216,336,2.7
7400,CN2015100000000,20,151,"Pratt County, KS",May-19,4835,4708,127,2.6
7401,CN2015300000000,20,153,"Rawlins County, KS",May-19,1390,1356,34,2.4
7402,CN2015500000000,20,155,"Reno County, KS",May-19,29648,28519,1129,3.8
7403,CN2015700000000,20,157,"Republic County, KS",May-19,2200,2148,52,2.4
7404,CN2015900000000,20,159,"Rice County, KS",May-19,5161,5016,145,2.8
7405,CN2016100000000,20,161,"Riley County, KS",May-19,35570,34650,920,2.6
7406,CN2016300000000,20,163,"Rooks County, KS",May-19,2516,2406,110,4.4
7407,CN2016500000000,20,165,"Rush County, KS",May-19,1603,1554,49,3.1
7408,CN2016700000000,20,167,"Russell County, KS",May-19,3249,3161,88,2.7
7409,CN2016900000000,20,169,"Saline County, KS",May-19,30057,29247,810,2.7
7410,CN2017100000000,20,171,"Scott County, KS",May-19,2675,2626,49,1.8
7411,CN2017300000000,20,173,"Sedgwick County, KS",May-19,250210,242059,8151,3.3
7412,CN2017500000000,20,175,"Seward County, KS",May-19,9540,9253,287,3.0
7413,CN2017700000000,20,177,"Shawnee County, KS",May-19,89829,87066,2763,3.1
7414,CN2017900000000,20,179,"Sheridan County, KS",May-19,1319,1292,27,2.0
7415,CN2018100000000,20,181,"Sherman County, KS",May-19,2784,2711,73,2.6
7416,CN2018300000000,20,183,"Smith County, KS",May-19,1914,1868,46,2.4
7417,CN2018500000000,20,185,"Stafford County, KS",May-19,1930,1878,52,2.7
7418,CN2018700000000,20,187,"Stanton County, KS",May-19,929,905,24,2.6
7419,CN2018900000000,20,189,"Stevens County, KS",May-19,2462,2399,63,2.6
7420,CN2019100000000,20,191,"Sumner County, KS",May-19,10781,10436,345,3.2
7421,CN2019300000000,20,193,"Thomas County, KS",May-19,4186,4091,95,2.3
7422,CN2019500000000,20,195,"Trego County, KS",May-19,1363,1331,32,2.3
7423,CN2019700000000,20,197,"Wabaunsee County, KS",May-19,3561,3460,101,2.8
7424,CN2019900000000,20,199,"Wallace County, KS",May-19,786,764,22,2.8
7425,CN2020100000000,20,201,"Washington County, KS",May-19,2853,2784,69,2.4
7426,CN2020300000000,20,203,"Wichita County, KS",May-19,1494,1469,25,1.7
7427,CN2020500000000,20,205,"Wilson County, KS",May-19,3920,3770,150,3.8
7428,CN2020700000000,20,207,"Woodson County, KS",May-19,1656,1593,63,3.8
7429,CN2020900000000,20,209,"Wyandotte County, KS",May-19,76398,73399,2999,3.9
7430,CN2100100000000,21,1,"Adair County, KY",May-19,7260,6893,367,5.1
7431,CN2100300000000,21,3,"Allen County, KY",May-19,9225,8862,363,3.9
7432,CN2100500000000,21,5,"Anderson County, KY",May-19,11838,11417,421,3.6
7433,CN2100700000000,21,7,"Ballard County, KY",May-19,3520,3335,185,5.3
7434,CN2100900000000,21,9,"Barren County, KY",May-19,18947,18128,819,4.3
7435,CN2101100000000,21,11,"Bath County, KY",May-19,4685,4414,271,5.8
7436,CN2101300000000,21,13,"Bell County, KY",May-19,8413,7951,462,5.5
7437,CN2101500000000,21,15,"Boone County, KY",May-19,71141,68810,2331,3.3
7438,CN2101700000000,21,17,"Bourbon County, KY",May-19,10125,9776,349,3.4
7439,CN2101900000000,21,19,"Boyd County, KY",May-19,17793,16824,969,5.4
7440,CN2102100000000,21,21,"Boyle County, KY",May-19,12693,12138,555,4.4
7441,CN2102300000000,21,23,"Bracken County, KY",May-19,3860,3679,181,4.7
7442,CN2102500000000,21,25,"Breathitt County, KY",May-19,3567,3329,238,6.7
7443,CN2102700000000,21,27,"Breckinridge County, KY",May-19,8048,7655,393,4.9
7444,CN2102900000000,21,29,"Bullitt County, KY",May-19,42850,41121,1729,4.0
7445,CN2103100000000,21,31,"Butler County, KY",May-19,5170,4937,233,4.5
7446,CN2103300000000,21,33,"Caldwell County, KY",May-19,5548,5282,266,4.8
7447,CN2103500000000,21,35,"Calloway County, KY",May-19,18735,17972,763,4.1
7448,CN2103700000000,21,37,"Campbell County, KY",May-19,50923,49183,1740,3.4
7449,CN2103900000000,21,39,"Carlisle County, KY",May-19,2250,2166,84,3.7
7450,CN2104100000000,21,41,"Carroll County, KY",May-19,5345,5143,202,3.8
7451,CN2104300000000,21,43,"Carter County, KY",May-19,9700,8958,742,7.6
7452,CN2104500000000,21,45,"Casey County, KY",May-19,6743,6480,263,3.9
7453,CN2104700000000,21,47,"Christian County, KY",May-19,25083,23678,1405,5.6
7454,CN2104900000000,21,49,"Clark County, KY",May-19,17355,16691,664,3.8
7455,CN2105100000000,21,51,"Clay County, KY",May-19,5175,4821,354,6.8
7456,CN2105300000000,21,53,"Clinton County, KY",May-19,4118,3906,212,5.1
7457,CN2105500000000,21,55,"Crittenden County, KY",May-19,3851,3673,178,4.6
7458,CN2105700000000,21,57,"Cumberland County, KY",May-19,3236,3105,131,4.0
7459,CN2105900000000,21,59,"Daviess County, KY",May-19,47562,45731,1831,3.8
7460,CN2106100000000,21,61,"Edmonson County, KY",May-19,4860,4637,223,4.6
7461,CN2106300000000,21,63,"Elliott County, KY",May-19,2034,1890,144,7.1
7462,CN2106500000000,21,65,"Estill County, KY",May-19,5375,5130,245,4.6
7463,CN2106700000000,21,67,"Fayette County, KY",May-19,176856,170978,5878,3.3
7464,CN2106900000000,21,69,"Fleming County, KY",May-19,6382,6058,324,5.1
7465,CN2107100000000,21,71,"Floyd County, KY",May-19,11158,10454,704,6.3
7466,CN2107300000000,21,73,"Franklin County, KY",May-19,24841,23919,922,3.7
7467,CN2107500000000,21,75,"Fulton County, KY",May-19,2065,1955,110,5.3
7468,CN2107700000000,21,77,"Gallatin County, KY",May-19,4128,3970,158,3.8
7469,CN2107900000000,21,79,"Garrard County, KY",May-19,7787,7441,346,4.4
7470,CN2108100000000,21,81,"Grant County, KY",May-19,11781,11319,462,3.9
7471,CN2108300000000,21,83,"Graves County, KY",May-19,15952,15257,695,4.4
7472,CN2108500000000,21,85,"Grayson County, KY",May-19,11045,10520,525,4.8
7473,CN2108700000000,21,87,"Green County, KY",May-19,5209,4982,227,4.4
7474,CN2108900000000,21,89,"Greenup County, KY",May-19,13362,12551,811,6.1
7475,CN2109100000000,21,91,"Hancock County, KY",May-19,3987,3841,146,3.7
7476,CN2109300000000,21,93,"Hardin County, KY",May-19,49198,47252,1946,4.0
7477,CN2109500000000,21,95,"Harlan County, KY",May-19,6768,6295,473,7.0
7478,CN2109700000000,21,97,"Harrison County, KY",May-19,8876,8492,384,4.3
7479,CN2109900000000,21,99,"Hart County, KY",May-19,8124,7784,340,4.2
7480,CN2110100000000,21,101,"Henderson County, KY",May-19,22047,21215,832,3.8
7481,CN2110300000000,21,103,"Henry County, KY",May-19,8319,8030,289,3.5
7482,CN2110500000000,21,105,"Hickman County, KY",May-19,1876,1799,77,4.1
7483,CN2110700000000,21,107,"Hopkins County, KY",May-19,18541,17710,831,4.5
7484,CN2110900000000,21,109,"Jackson County, KY",May-19,4118,3861,257,6.2
7485,CN2111100000000,21,111,"Jefferson County, KY",May-19,400753,384593,16160,4.0
7486,CN2111300000000,21,113,"Jessamine County, KY",May-19,26754,25829,925,3.5
7487,CN2111500000000,21,115,"Johnson County, KY",May-19,6780,6342,438,6.5
7488,CN2111700000000,21,117,"Kenton County, KY",May-19,88004,84981,3023,3.4
7489,CN2111900000000,21,119,"Knott County, KY",May-19,4543,4251,292,6.4
7490,CN2112100000000,21,121,"Knox County, KY",May-19,9912,9343,569,5.7
7491,CN2112300000000,21,123,"Larue County, KY",May-19,6037,5778,259,4.3
7492,CN2112500000000,21,125,"Laurel County, KY",May-19,24602,23449,1153,4.7
7493,CN2112700000000,21,127,"Lawrence County, KY",May-19,5193,4836,357,6.9
7494,CN2112900000000,21,129,"Lee County, KY",May-19,2040,1932,108,5.3
7495,CN2113100000000,21,131,"Leslie County, KY",May-19,2694,2518,176,6.5
7496,CN2113300000000,21,133,"Letcher County, KY",May-19,6224,5831,393,6.3
7497,CN2113500000000,21,135,"Lewis County, KY",May-19,4679,4298,381,8.1
7498,CN2113700000000,21,137,"Lincoln County, KY",May-19,9451,8992,459,4.9
7499,CN2113900000000,21,139,"Livingston County, KY",May-19,3648,3452,196,5.4
7500,CN2114100000000,21,141,"Logan County, KY",May-19,12753,12258,495,3.9
7501,CN2114300000000,21,143,"Lyon County, KY",May-19,3124,2990,134,4.3
7502,CN2114500000000,21,145,"McCracken County, KY",May-19,29080,27708,1372,4.7
7503,CN2114700000000,21,147,"McCreary County, KY",May-19,4696,4427,269,5.7
7504,CN2114900000000,21,149,"McLean County, KY",May-19,4280,4093,187,4.4
7505,CN2115100000000,21,151,"Madison County, KY",May-19,47629,45805,1824,3.8
7506,CN2115300000000,21,153,"Magoffin County, KY",May-19,3084,2804,280,9.1
7507,CN2115500000000,21,155,"Marion County, KY",May-19,9854,9475,379,3.8
7508,CN2115700000000,21,157,"Marshall County, KY",May-19,15201,14542,659,4.3
7509,CN2115900000000,21,159,"Martin County, KY",May-19,2794,2613,181,6.5
7510,CN2116100000000,21,161,"Mason County, KY",May-19,7180,6802,378,5.3
7511,CN2116300000000,21,163,"Meade County, KY",May-19,12342,11799,543,4.4
7512,CN2116500000000,21,165,"Menifee County, KY",May-19,2314,2171,143,6.2
7513,CN2116700000000,21,167,"Mercer County, KY",May-19,10184,9739,445,4.4
7514,CN2116900000000,21,169,"Metcalfe County, KY",May-19,4165,3983,182,4.4
7515,CN2117100000000,21,171,"Monroe County, KY",May-19,4745,4567,178,3.8
7516,CN2117300000000,21,173,"Montgomery County, KY",May-19,11722,11119,603,5.1
7517,CN2117500000000,21,175,"Morgan County, KY",May-19,4625,4414,211,4.6
7518,CN2117700000000,21,177,"Muhlenberg County, KY",May-19,10743,10120,623,5.8
7519,CN2117900000000,21,179,"Nelson County, KY",May-19,23351,22308,1043,4.5
7520,CN2118100000000,21,181,"Nicholas County, KY",May-19,3320,3183,137,4.1
7521,CN2118300000000,21,183,"Ohio County, KY",May-19,9826,9350,476,4.8
7522,CN2118500000000,21,185,"Oldham County, KY",May-19,33417,32341,1076,3.2
7523,CN2118700000000,21,187,"Owen County, KY",May-19,5198,4960,238,4.6
7524,CN2118900000000,21,189,"Owsley County, KY",May-19,1142,1065,77,6.7
7525,CN2119100000000,21,191,"Pendleton County, KY",May-19,7027,6771,256,3.6
7526,CN2119300000000,21,193,"Perry County, KY",May-19,8337,7884,453,5.4
7527,CN2119500000000,21,195,"Pike County, KY",May-19,20046,18783,1263,6.3
7528,CN2119700000000,21,197,"Powell County, KY",May-19,5030,4785,245,4.9
7529,CN2119900000000,21,199,"Pulaski County, KY",May-19,26744,25527,1217,4.6
7530,CN2120100000000,21,201,"Robertson County, KY",May-19,827,786,41,5.0
7531,CN2120300000000,21,203,"Rockcastle County, KY",May-19,6722,6411,311,4.6
7532,CN2120500000000,21,205,"Rowan County, KY",May-19,10535,10028,507,4.8
7533,CN2120700000000,21,207,"Russell County, KY",May-19,6331,5992,339,5.4
7534,CN2120900000000,21,209,"Scott County, KY",May-19,29442,28437,1005,3.4
7535,CN2121100000000,21,211,"Shelby County, KY",May-19,25722,24870,852,3.3
7536,CN2121300000000,21,213,"Simpson County, KY",May-19,8991,8615,376,4.2
7537,CN2121500000000,21,215,"Spencer County, KY",May-19,10224,9879,345,3.4
7538,CN2121700000000,21,217,"Taylor County, KY",May-19,12722,12168,554,4.4
7539,CN2121900000000,21,219,"Todd County, KY",May-19,5465,5265,200,3.7
7540,CN2122100000000,21,221,"Trigg County, KY",May-19,6051,5788,263,4.3
7541,CN2122300000000,21,223,"Trimble County, KY",May-19,3920,3747,173,4.4
7542,CN2122500000000,21,225,"Union County, KY",May-19,6199,5942,257,4.1
7543,CN2122700000000,21,227,"Warren County, KY",May-19,65515,63113,2402,3.7
7544,CN2122900000000,21,229,"Washington County, KY",May-19,6370,6141,229,3.6
7545,CN2123100000000,21,231,"Wayne County, KY",May-19,7559,7129,430,5.7
7546,CN2123300000000,21,233,"Webster County, KY",May-19,5917,5685,232,3.9
7547,CN2123500000000,21,235,"Whitley County, KY",May-19,13685,12994,691,5.0
7548,CN2123700000000,21,237,"Wolfe County, KY",May-19,1988,1866,122,6.1
7549,CN2123900000000,21,239,"Woodford County, KY",May-19,15378,14930,448,2.9
7550,CN2200100000000,22,1,"Acadia Parish, LA",May-19,23794,22645,1149,4.8
7551,CN2200300000000,22,3,"Allen Parish, LA",May-19,8819,8378,441,5.0
7552,CN2200500000000,22,5,"Ascension Parish, LA",May-19,63517,61187,2330,3.7
7553,CN2200700000000,22,7,"Assumption Parish, LA",May-19,8830,8356,474,5.4
7554,CN2200900000000,22,9,"Avoyelles Parish, LA",May-19,15057,14327,730,4.8
7555,CN2201100000000,22,11,"Beauregard Parish, LA",May-19,14652,13980,672,4.6
7556,CN2201300000000,22,13,"Bienville Parish, LA",May-19,5494,5199,295,5.4
7557,CN2201500000000,22,15,"Bossier Parish, LA",May-19,57266,55014,2252,3.9
7558,CN2201700000000,22,17,"Caddo Parish, LA",May-19,102546,97632,4914,4.8
7559,CN2201900000000,22,19,"Calcasieu Parish, LA",May-19,106696,102837,3859,3.6
7560,CN2202100000000,22,21,"Caldwell Parish, LA",May-19,3760,3576,184,4.9
7561,CN2202300000000,22,23,"Cameron Parish, LA",May-19,3957,3830,127,3.2
7562,CN2202500000000,22,25,"Catahoula Parish, LA",May-19,3315,3131,184,5.6
7563,CN2202700000000,22,27,"Claiborne Parish, LA",May-19,5775,5503,272,4.7
7564,CN2202900000000,22,29,"Concordia Parish, LA",May-19,6961,6572,389,5.6
7565,CN2203100000000,22,31,"De Soto Parish, LA",May-19,10756,10188,568,5.3
7566,CN2203300000000,22,33,"East Baton Rouge Parish, LA",May-19,228772,219849,8923,3.9
7567,CN2203500000000,22,35,"East Carroll Parish, LA",May-19,1849,1672,177,9.6
7568,CN2203700000000,22,37,"East Feliciana Parish, LA",May-19,7922,7595,327,4.1
7569,CN2203900000000,22,39,"Evangeline Parish, LA",May-19,11946,11325,621,5.2
7570,CN2204100000000,22,41,"Franklin Parish, LA",May-19,7293,6847,446,6.1
7571,CN2204300000000,22,43,"Grant Parish, LA",May-19,8073,7679,394,4.9
7572,CN2204500000000,22,45,"Iberia Parish, LA",May-19,28038,26637,1401,5.0
7573,CN2204700000000,22,47,"Iberville Parish, LA",May-19,13915,13199,716,5.1
7574,CN2204900000000,22,49,"Jackson Parish, LA",May-19,6807,6527,280,4.1
7575,CN2205100000000,22,51,"Jefferson Parish, LA",May-19,212810,204783,8027,3.8
7576,CN2205300000000,22,53,"Jefferson Davis Parish, LA",May-19,13301,12763,538,4.0
7577,CN2205500000000,22,55,"Lafayette Parish, LA",May-19,113198,108741,4457,3.9
7578,CN2205700000000,22,57,"Lafourche Parish, LA",May-19,41857,40126,1731,4.1
7579,CN2205900000000,22,59,"LaSalle Parish, LA",May-19,6636,6387,249,3.8
7580,CN2206100000000,22,61,"Lincoln Parish, LA",May-19,22350,21274,1076,4.8
7581,CN2206300000000,22,63,"Livingston Parish, LA",May-19,68319,65795,2524,3.7
7582,CN2206500000000,22,65,"Madison Parish, LA",May-19,3461,3219,242,7.0
7583,CN2206700000000,22,67,"Morehouse Parish, LA",May-19,9943,9255,688,6.9
7584,CN2206900000000,22,69,"Natchitoches Parish, LA",May-19,16310,15487,823,5.0
7585,CN2207100000000,22,71,"Orleans Parish, LA",May-19,177750,170119,7631,4.3
7586,CN2207300000000,22,73,"Ouachita Parish, LA",May-19,69828,66473,3355,4.8
7587,CN2207500000000,22,75,"Plaquemines Parish, LA",May-19,10032,9649,383,3.8
7588,CN2207700000000,22,77,"Pointe Coupee Parish, LA",May-19,9804,9347,457,4.7
7589,CN2207900000000,22,79,"Rapides Parish, LA",May-19,54606,52132,2474,4.5
7590,CN2208100000000,22,81,"Red River Parish, LA",May-19,3705,3540,165,4.5
7591,CN2208300000000,22,83,"Richland Parish, LA",May-19,8202,7751,451,5.5
7592,CN2208500000000,22,85,"Sabine Parish, LA",May-19,9183,8764,419,4.6
7593,CN2208700000000,22,87,"St. Bernard Parish, LA",May-19,19784,18901,883,4.5
7594,CN2208900000000,22,89,"St. Charles Parish, LA",May-19,25030,24053,977,3.9
7595,CN2209100000000,22,91,"St. Helena Parish, LA",May-19,4230,4009,221,5.2
7596,CN2209300000000,22,93,"St. James Parish, LA",May-19,9167,8684,483,5.3
7597,CN2209500000000,22,95,"St. John the Baptist Parish, LA",May-19,19503,18544,959,4.9
7598,CN2209700000000,22,97,"St. Landry Parish, LA",May-19,31657,29898,1759,5.6
7599,CN2209900000000,22,99,"St. Martin Parish, LA",May-19,22102,21094,1008,4.6
7600,CN2210100000000,22,101,"St. Mary Parish, LA",May-19,19586,18543,1043,5.3
7601,CN2210300000000,22,103,"St. Tammany Parish, LA",May-19,118839,114344,4495,3.8
7602,CN2210500000000,22,105,"Tangipahoa Parish, LA",May-19,53707,51074,2633,4.9
7603,CN2210700000000,22,107,"Tensas Parish, LA",May-19,1390,1280,110,7.9
7604,CN2210900000000,22,109,"Terrebonne Parish, LA",May-19,46111,44174,1937,4.2
7605,CN2211100000000,22,111,"Union Parish, LA",May-19,9081,8613,468,5.2
7606,CN2211300000000,22,113,"Vermilion Parish, LA",May-19,24010,22911,1099,4.6
7607,CN2211500000000,22,115,"Vernon Parish, LA",May-19,15647,14801,846,5.4
7608,CN2211700000000,22,117,"Washington Parish, LA",May-19,16747,15844,903,5.4
7609,CN2211900000000,22,119,"Webster Parish, LA",May-19,14368,13582,786,5.5
7610,CN2212100000000,22,121,"West Baton Rouge Parish, LA",May-19,13560,12998,562,4.1
7611,CN2212300000000,22,123,"West Carroll Parish, LA",May-19,3612,3293,319,8.8
7612,CN2212500000000,22,125,"West Feliciana Parish, LA",May-19,5343,5154,189,3.5
7613,CN2212700000000,22,127,"Winn Parish, LA",May-19,4833,4557,276,5.7
7614,CN2300100000000,23,1,"Androscoggin County, ME",May-19,54929,53340,1589,2.9
7615,CN2300300000000,23,3,"Aroostook County, ME",May-19,30132,28457,1675,5.6
7616,CN2300500000000,23,5,"Cumberland County, ME",May-19,163940,160004,3936,2.4
7617,CN2300700000000,23,7,"Franklin County, ME",May-19,13807,13202,605,4.4
7618,CN2300900000000,23,9,"Hancock County, ME",May-19,28960,28052,908,3.1
7619,CN2301100000000,23,11,"Kennebec County, ME",May-19,61521,59788,1733,2.8
7620,CN2301300000000,23,13,"Knox County, ME",May-19,20060,19503,557,2.8
7621,CN2301500000000,23,15,"Lincoln County, ME",May-19,16673,16190,483,2.9
7622,CN2301700000000,23,17,"Oxford County, ME",May-19,25716,24778,938,3.6
7623,CN2301900000000,23,19,"Penobscot County, ME",May-19,76372,73925,2447,3.2
7624,CN2302100000000,23,21,"Piscataquis County, ME",May-19,7242,6961,281,3.9
7625,CN2302300000000,23,23,"Sagadahoc County, ME",May-19,19373,18930,443,2.3
7626,CN2302500000000,23,25,"Somerset County, ME",May-19,22325,21358,967,4.3
7627,CN2302700000000,23,27,"Waldo County, ME",May-19,20458,19841,617,3.0
7628,CN2302900000000,23,29,"Washington County, ME",May-19,13580,12916,664,4.9
7629,CN2303100000000,23,31,"York County, ME",May-19,112993,110198,2795,2.5
7630,CN2400100000000,24,1,"Allegany County, MD",May-19,32451,30996,1455,4.5
7631,CN2400300000000,24,3,"Anne Arundel County, MD",May-19,316806,307393,9413,3.0
7632,CN2400500000000,24,5,"Baltimore County, MD",May-19,456075,439672,16403,3.6
7633,CN2400900000000,24,9,"Calvert County, MD",May-19,50115,48591,1524,3.0
7634,CN2401100000000,24,11,"Caroline County, MD",May-19,18161,17570,591,3.3
7635,CN2401300000000,24,13,"Carroll County, MD",May-19,96179,93553,2626,2.7
7636,CN2401500000000,24,15,"Cecil County, MD",May-19,53266,51309,1957,3.7
7637,CN2401700000000,24,17,"Charles County, MD",May-19,87457,84511,2946,3.4
7638,CN2401900000000,24,19,"Dorchester County, MD",May-19,15876,15170,706,4.4
7639,CN2402100000000,24,21,"Frederick County, MD",May-19,135029,130896,4133,3.1
7640,CN2402300000000,24,23,"Garrett County, MD",May-19,15769,15182,587,3.7
7641,CN2402500000000,24,25,"Harford County, MD",May-19,141802,137212,4590,3.2
7642,CN2402700000000,24,27,"Howard County, MD",May-19,188488,183478,5010,2.7
7643,CN2402900000000,24,29,"Kent County, MD",May-19,10325,9982,343,3.3
7644,CN2403100000000,24,31,"Montgomery County, MD",May-19,560827,544690,16137,2.9
7645,CN2403300000000,24,33,"Prince George's County, MD",May-19,510349,491927,18422,3.6
7646,CN2403500000000,24,35,"Queen Anne's County, MD",May-19,28033,27210,823,2.9
7647,CN2403700000000,24,37,"St. Mary's County, MD",May-19,57083,55326,1757,3.1
7648,CN2403900000000,24,39,"Somerset County, MD",May-19,9364,8866,498,5.3
7649,CN2404100000000,24,41,"Talbot County, MD",May-19,19215,18597,618,3.2
7650,CN2404300000000,24,43,"Washington County, MD",May-19,74529,71794,2735,3.7
7651,CN2404500000000,24,45,"Wicomico County, MD",May-19,52028,49939,2089,4.0
7652,CN2404700000000,24,47,"Worcester County, MD",May-19,25636,24180,1456,5.7
7653,CN2451000000000,24,510,"Baltimore city, MD",May-19,289733,275498,14235,4.9
7654,CN2500100000000,25,1,"Barnstable County, MA",May-19,114572,110723,3849,3.4
7655,CN2500300000000,25,3,"Berkshire County, MA",May-19,64590,62426,2164,3.4
7656,CN2500500000000,25,5,"Bristol County, MA",May-19,302177,291532,10645,3.5
7657,CN2500700000000,25,7,"Dukes County, MA",May-19,9472,9140,332,3.5
7658,CN2500900000000,25,9,"Essex County, MA",May-19,426862,414146,12716,3.0
7659,CN2501100000000,25,11,"Franklin County, MA",May-19,41234,40145,1089,2.6
7660,CN2501300000000,25,13,"Hampden County, MA",May-19,229259,220032,9227,4.0
7661,CN2501500000000,25,15,"Hampshire County, MA",May-19,90600,88189,2411,2.7
7662,CN2501700000000,25,17,"Middlesex County, MA",May-19,922680,900731,21949,2.4
7663,CN2501900000000,25,19,"Nantucket County/town, MA",May-19,7607,7399,208,2.7
7664,CN2502100000000,25,21,"Norfolk County, MA",May-19,392176,382063,10113,2.6
7665,CN2502300000000,25,23,"Plymouth County, MA",May-19,284232,275975,8257,2.9
7666,CN2502500000000,25,25,"Suffolk County, MA",May-19,457442,445055,12387,2.7
7667,CN2502700000000,25,27,"Worcester County, MA",May-19,447824,434002,13822,3.1
7668,CN2600100000000,26,1,"Alcona County, MI",May-19,3985,3766,219,5.5
7669,CN2600300000000,26,3,"Alger County, MI",May-19,3166,2914,252,8.0
7670,CN2600500000000,26,5,"Allegan County, MI",May-19,62719,60933,1786,2.8
7671,CN2600700000000,26,7,"Alpena County, MI",May-19,13410,12879,531,4.0
7672,CN2600900000000,26,9,"Antrim County, MI",May-19,10396,9927,469,4.5
7673,CN2601100000000,26,11,"Arenac County, MI",May-19,6162,5817,345,5.6
7674,CN2601300000000,26,13,"Baraga County, MI",May-19,3238,3032,206,6.4
7675,CN2601500000000,26,15,"Barry County, MI",May-19,31759,30828,931,2.9
7676,CN2601700000000,26,17,"Bay County, MI",May-19,50110,47976,2134,4.3
7677,CN2601900000000,26,19,"Benzie County, MI",May-19,8865,8478,387,4.4
7678,CN2602100000000,26,21,"Berrien County, MI",May-19,74374,71576,2798,3.8
7679,CN2602300000000,26,23,"Branch County, MI",May-19,19488,18791,697,3.6
7680,CN2602500000000,26,25,"Calhoun County, MI",May-19,62580,60160,2420,3.9
7681,CN2602700000000,26,27,"Cass County, MI",May-19,24688,23692,996,4.0
7682,CN2602900000000,26,29,"Charlevoix County, MI",May-19,12980,12458,522,4.0
7683,CN2603100000000,26,31,"Cheboygan County, MI",May-19,10523,10092,431,4.1
7684,CN2603300000000,26,33,"Chippewa County, MI",May-19,15929,15041,888,5.6
7685,CN2603500000000,26,35,"Clare County, MI",May-19,11861,11224,637,5.4
7686,CN2603700000000,26,37,"Clinton County, MI",May-19,41601,40506,1095,2.6
7687,CN2603900000000,26,39,"Crawford County, MI",May-19,5679,5403,276,4.9
7688,CN2604100000000,26,41,"Delta County, MI",May-19,17229,16394,835,4.8
7689,CN2604300000000,26,43,"Dickinson County, MI",May-19,12278,11818,460,3.7
7690,CN2604500000000,26,45,"Eaton County, MI",May-19,57823,56093,1730,3.0
7691,CN2604700000000,26,47,"Emmet County, MI",May-19,17877,17065,812,4.5
7692,CN2604900000000,26,49,"Genesee County, MI",May-19,181436,171221,10215,5.6
7693,CN2605100000000,26,51,"Gladwin County, MI",May-19,10019,9500,519,5.2
7694,CN2605300000000,26,53,"Gogebic County, MI",May-19,5961,5661,300,5.0
7695,CN2605500000000,26,55,"Grand Traverse County, MI",May-19,49882,48349,1533,3.1
7696,CN2605700000000,26,57,"Gratiot County, MI",May-19,18094,17420,674,3.7
7697,CN2605900000000,26,59,"Hillsdale County, MI",May-19,20488,19688,800,3.9
7698,CN2606100000000,26,61,"Houghton County, MI",May-19,15411,14631,780,5.1
7699,CN2606300000000,26,63,"Huron County, MI",May-19,15502,14885,617,4.0
7700,CN2606500000000,26,65,"Ingham County, MI",May-19,152963,148050,4913,3.2
7701,CN2606700000000,26,67,"Ionia County, MI",May-19,30410,29494,916,3.0
7702,CN2606900000000,26,69,"Iosco County, MI",May-19,10257,9726,531,5.2
7703,CN2607100000000,26,71,"Iron County, MI",May-19,5143,4875,268,5.2
7704,CN2607300000000,26,73,"Isabella County, MI",May-19,34786,33545,1241,3.6
7705,CN2607500000000,26,75,"Jackson County, MI",May-19,74728,72195,2533,3.4
7706,CN2607700000000,26,77,"Kalamazoo County, MI",May-19,133510,129306,4204,3.1
7707,CN2607900000000,26,79,"Kalkaska County, MI",May-19,7887,7525,362,4.6
7708,CN2608100000000,26,81,"Kent County, MI",May-19,361569,351533,10036,2.8
7709,CN2608300000000,26,83,"Keweenaw County, MI",May-19,850,786,64,7.5
7710,CN2608500000000,26,85,"Lake County, MI",May-19,3679,3460,219,6.0
7711,CN2608700000000,26,87,"Lapeer County, MI",May-19,41041,39143,1898,4.6
7712,CN2608900000000,26,89,"Leelanau County, MI",May-19,10546,10202,344,3.3
7713,CN2609100000000,26,91,"Lenawee County, MI",May-19,46593,44949,1644,3.5
7714,CN2609300000000,26,93,"Livingston County, MI",May-19,103435,100407,3028,2.9
7715,CN2609500000000,26,95,"Luce County, MI",May-19,2245,2107,138,6.1
7716,CN2609700000000,26,97,"Mackinac County, MI",May-19,5414,5208,206,3.8
7717,CN2609900000000,26,99,"Macomb County, MI",May-19,447083,430327,16756,3.7
7718,CN2610100000000,26,101,"Manistee County, MI",May-19,10594,10088,506,4.8
7719,CN2610300000000,26,103,"Marquette County, MI",May-19,31833,30293,1540,4.8
7720,CN2610500000000,26,105,"Mason County, MI",May-19,13866,13292,574,4.1
7721,CN2610700000000,26,107,"Mecosta County, MI",May-19,18214,17437,777,4.3
7722,CN2610900000000,26,109,"Menominee County, MI",May-19,11125,10748,377,3.4
7723,CN2611100000000,26,111,"Midland County, MI",May-19,40752,39371,1381,3.4
7724,CN2611300000000,26,113,"Missaukee County, MI",May-19,6992,6721,271,3.9
7725,CN2611500000000,26,115,"Monroe County, MI",May-19,76340,73249,3091,4.0
7726,CN2611700000000,26,117,"Montcalm County, MI",May-19,28380,27355,1025,3.6
7727,CN2611900000000,26,119,"Montmorency County, MI",May-19,3040,2826,214,7.0
7728,CN2612100000000,26,121,"Muskegon County, MI",May-19,77086,74039,3047,4.0
7729,CN2612300000000,26,123,"Newaygo County, MI",May-19,23648,22741,907,3.8
7730,CN2612500000000,26,125,"Oakland County, MI",May-19,675493,654555,20938,3.1
7731,CN2612700000000,26,127,"Oceana County, MI",May-19,12251,11628,623,5.1
7732,CN2612900000000,26,129,"Ogemaw County, MI",May-19,8111,7653,458,5.6
7733,CN2613100000000,26,131,"Ontonagon County, MI",May-19,2090,1942,148,7.1
7734,CN2613300000000,26,133,"Osceola County, MI",May-19,11150,10751,399,3.6
7735,CN2613500000000,26,135,"Oscoda County, MI",May-19,3169,2987,182,5.7
7736,CN2613700000000,26,137,"Otsego County, MI",May-19,11847,11313,534,4.5
7737,CN2613900000000,26,139,"Ottawa County, MI",May-19,161829,157615,4214,2.6
7738,CN2614100000000,26,141,"Presque Isle County, MI",May-19,4994,4708,286,5.7
7739,CN2614300000000,26,143,"Roscommon County, MI",May-19,7917,7414,503,6.4
7740,CN2614500000000,26,145,"Saginaw County, MI",May-19,86642,82672,3970,4.6
7741,CN2614700000000,26,147,"St. Clair County, MI",May-19,75426,72288,3138,4.2
7742,CN2614900000000,26,149,"St. Joseph County, MI",May-19,28215,27040,1175,4.2
7743,CN2615100000000,26,151,"Sanilac County, MI",May-19,19595,18775,820,4.2
7744,CN2615300000000,26,153,"Schoolcraft County, MI",May-19,3355,3149,206,6.1
7745,CN2615500000000,26,155,"Shiawassee County, MI",May-19,33711,32358,1353,4.0
7746,CN2615700000000,26,157,"Tuscola County, MI",May-19,23907,22729,1178,4.9
7747,CN2615900000000,26,159,"Van Buren County, MI",May-19,35079,33620,1459,4.2
7748,CN2616100000000,26,161,"Washtenaw County, MI",May-19,197099,191487,5612,2.8
7749,CN2616300000000,26,163,"Wayne County, MI",May-19,797188,760664,36524,4.6
7750,CN2616500000000,26,165,"Wexford County, MI",May-19,14932,14355,577,3.9
7751,CN2700100000000,27,1,"Aitkin County, MN",May-19,7265,6953,312,4.3
7752,CN2700300000000,27,3,"Anoka County, MN",May-19,197531,192360,5171,2.6
7753,CN2700500000000,27,5,"Becker County, MN",May-19,19120,18614,506,2.6
7754,CN2700700000000,27,7,"Beltrami County, MN",May-19,24252,23424,828,3.4
7755,CN2700900000000,27,9,"Benton County, MN",May-19,21959,21351,608,2.8
7756,CN2701100000000,27,11,"Big Stone County, MN",May-19,2574,2503,71,2.8
7757,CN2701300000000,27,13,"Blue Earth County, MN",May-19,40793,39775,1018,2.5
7758,CN2701500000000,27,15,"Brown County, MN",May-19,14565,14151,414,2.8
7759,CN2701700000000,27,17,"Carlton County, MN",May-19,17856,17219,637,3.6
7760,CN2701900000000,27,19,"Carver County, MN",May-19,58710,57308,1402,2.4
7761,CN2702100000000,27,21,"Cass County, MN",May-19,14481,13944,537,3.7
7762,CN2702300000000,27,23,"Chippewa County, MN",May-19,7000,6791,209,3.0
7763,CN2702500000000,27,25,"Chisago County, MN",May-19,29838,28998,840,2.8
7764,CN2702700000000,27,27,"Clay County, MN",May-19,36321,35375,946,2.6
7765,CN2702900000000,27,29,"Clearwater County, MN",May-19,4391,4135,256,5.8
7766,CN2703100000000,27,31,"Cook County, MN",May-19,3108,3014,94,3.0
7767,CN2703300000000,27,33,"Cottonwood County, MN",May-19,6018,5852,166,2.8
7768,CN2703500000000,27,35,"Crow Wing County, MN",May-19,32555,31547,1008,3.1
7769,CN2703700000000,27,37,"Dakota County, MN",May-19,241701,235621,6080,2.5
7770,CN2703900000000,27,39,"Dodge County, MN",May-19,11899,11605,294,2.5
7771,CN2704100000000,27,41,"Douglas County, MN",May-19,21261,20752,509,2.4
7772,CN2704300000000,27,43,"Faribault County, MN",May-19,7102,6871,231,3.3
7773,CN2704500000000,27,45,"Fillmore County, MN",May-19,11650,11392,258,2.2
7774,CN2704700000000,27,47,"Freeborn County, MN",May-19,16318,15893,425,2.6
7775,CN2704900000000,27,49,"Goodhue County, MN",May-19,27167,26487,680,2.5
7776,CN2705100000000,27,51,"Grant County, MN",May-19,3381,3278,103,3.0
7777,CN2705300000000,27,53,"Hennepin County, MN",May-19,706676,688980,17696,2.5
7778,CN2705500000000,27,55,"Houston County, MN",May-19,10442,10205,237,2.3
7779,CN2705700000000,27,57,"Hubbard County, MN",May-19,10083,9695,388,3.8
7780,CN2705900000000,27,59,"Isanti County, MN",May-19,21151,20559,592,2.8
7781,CN2706100000000,27,61,"Itasca County, MN",May-19,22007,20931,1076,4.9
7782,CN2706300000000,27,63,"Jackson County, MN",May-19,5876,5739,137,2.3
7783,CN2706500000000,27,65,"Kanabec County, MN",May-19,8949,8616,333,3.7
7784,CN2706700000000,27,67,"Kandiyohi County, MN",May-19,24429,23779,650,2.7
7785,CN2706900000000,27,69,"Kittson County, MN",May-19,2445,2383,62,2.5
7786,CN2707100000000,27,71,"Koochiching County, MN",May-19,6085,5723,362,5.9
7787,CN2707300000000,27,73,"Lac qui Parle County, MN",May-19,3673,3566,107,2.9
7788,CN2707500000000,27,75,"Lake County, MN",May-19,5539,5388,151,2.7
7789,CN2707700000000,27,77,"Lake of the Woods County, MN",May-19,2471,2380,91,3.7
7790,CN2707900000000,27,79,"Le Sueur County, MN",May-19,16067,15591,476,3.0
7791,CN2708100000000,27,81,"Lincoln County, MN",May-19,3370,3286,84,2.5
7792,CN2708300000000,27,83,"Lyon County, MN",May-19,14935,14560,375,2.5
7793,CN2708500000000,27,85,"McLeod County, MN",May-19,19396,18857,539,2.8
7794,CN2708700000000,27,87,"Mahnomen County, MN",May-19,2336,2259,77,3.3
7795,CN2708900000000,27,89,"Marshall County, MN",May-19,5528,5314,214,3.9
7796,CN2709100000000,27,91,"Martin County, MN",May-19,10289,9993,296,2.9
7797,CN2709300000000,27,93,"Meeker County, MN",May-19,13416,13066,350,2.6
7798,CN2709500000000,27,95,"Mille Lacs County, MN",May-19,12776,12319,457,3.6
7799,CN2709700000000,27,97,"Morrison County, MN",May-19,17695,17152,543,3.1
7800,CN2709900000000,27,99,"Mower County, MN",May-19,20536,20011,525,2.6
7801,CN2710100000000,27,101,"Murray County, MN",May-19,4991,4873,118,2.4
7802,CN2710300000000,27,103,"Nicollet County, MN",May-19,21072,20606,466,2.2
7803,CN2710500000000,27,105,"Nobles County, MN",May-19,11389,11121,268,2.4
7804,CN2710700000000,27,107,"Norman County, MN",May-19,3356,3236,120,3.6
7805,CN2710900000000,27,109,"Olmsted County, MN",May-19,88457,86409,2048,2.3
7806,CN2711100000000,27,111,"Otter Tail County, MN",May-19,31903,31000,903,2.8
7807,CN2711300000000,27,113,"Pennington County, MN",May-19,8750,8506,244,2.8
7808,CN2711500000000,27,115,"Pine County, MN",May-19,14969,14378,591,3.9
7809,CN2711700000000,27,117,"Pipestone County, MN",May-19,5036,4914,122,2.4
7810,CN2711900000000,27,119,"Polk County, MN",May-19,16813,16184,629,3.7
7811,CN2712100000000,27,121,"Pope County, MN",May-19,6640,6486,154,2.3
7812,CN2712300000000,27,123,"Ramsey County, MN",May-19,289708,281940,7768,2.7
7813,CN2712500000000,27,125,"Red Lake County, MN",May-19,2235,2147,88,3.9
7814,CN2712700000000,27,127,"Redwood County, MN",May-19,7750,7523,227,2.9
7815,CN2712900000000,27,129,"Renville County, MN",May-19,8809,8479,330,3.7
7816,CN2713100000000,27,131,"Rice County, MN",May-19,37234,36318,916,2.5
7817,CN2713300000000,27,133,"Rock County, MN",May-19,5802,5696,106,1.8
7818,CN2713500000000,27,135,"Roseau County, MN",May-19,7920,7693,227,2.9
7819,CN2713700000000,27,137,"St. Louis County, MN",May-19,102292,98757,3535,3.5
7820,CN2713900000000,27,139,"Scott County, MN",May-19,83559,81575,1984,2.4
7821,CN2714100000000,27,141,"Sherburne County, MN",May-19,52275,50863,1412,2.7
7822,CN2714300000000,27,143,"Sibley County, MN",May-19,8703,8460,243,2.8
7823,CN2714500000000,27,145,"Stearns County, MN",May-19,91082,88687,2395,2.6
7824,CN2714700000000,27,147,"Steele County, MN",May-19,20973,20419,554,2.6
7825,CN2714900000000,27,149,"Stevens County, MN",May-19,5694,5579,115,2.0
7826,CN2715100000000,27,151,"Swift County, MN",May-19,4973,4837,136,2.7
7827,CN2715300000000,27,153,"Todd County, MN",May-19,13572,13147,425,3.1
7828,CN2715500000000,27,155,"Traverse County, MN",May-19,1867,1813,54,2.9
7829,CN2715700000000,27,157,"Wabasha County, MN",May-19,12435,12109,326,2.6
7830,CN2715900000000,27,159,"Wadena County, MN",May-19,5922,5684,238,4.0
7831,CN2716100000000,27,161,"Waseca County, MN",May-19,9073,8817,256,2.8
7832,CN2716300000000,27,163,"Washington County, MN",May-19,143516,139937,3579,2.5
7833,CN2716500000000,27,165,"Watonwan County, MN",May-19,6712,6503,209,3.1
7834,CN2716700000000,27,167,"Wilkin County, MN",May-19,3589,3498,91,2.5
7835,CN2716900000000,27,169,"Winona County, MN",May-19,29107,28351,756,2.6
7836,CN2717100000000,27,171,"Wright County, MN",May-19,75507,73626,1881,2.5
7837,CN2717300000000,27,173,"Yellow Medicine County, MN",May-19,5476,5297,179,3.3
7838,CN2800100000000,28,1,"Adams County, MS",May-19,11334,10596,738,6.5
7839,CN2800300000000,28,3,"Alcorn County, MS",May-19,16209,15460,749,4.6
7840,CN2800500000000,28,5,"Amite County, MS",May-19,4471,4190,281,6.3
7841,CN2800700000000,28,7,"Attala County, MS",May-19,7096,6652,444,6.3
7842,CN2800900000000,28,9,"Benton County, MS",May-19,3048,2865,183,6.0
7843,CN2801100000000,28,11,"Bolivar County, MS",May-19,12384,11596,788,6.4
7844,CN2801300000000,28,13,"Calhoun County, MS",May-19,5746,5451,295,5.1
7845,CN2801500000000,28,15,"Carroll County, MS",May-19,3471,3257,214,6.2
7846,CN2801700000000,28,17,"Chickasaw County, MS",May-19,6943,6549,394,5.7
7847,CN2801900000000,28,19,"Choctaw County, MS",May-19,3745,3550,195,5.2
7848,CN2802100000000,28,21,"Claiborne County, MS",May-19,3024,2702,322,10.6
7849,CN2802300000000,28,23,"Clarke County, MS",May-19,5906,5546,360,6.1
7850,CN2802500000000,28,25,"Clay County, MS",May-19,7785,7238,547,7.0
7851,CN2802700000000,28,27,"Coahoma County, MS",May-19,8439,7870,569,6.7
7852,CN2802900000000,28,29,"Copiah County, MS",May-19,11258,10522,736,6.5
7853,CN2803100000000,28,31,"Covington County, MS",May-19,8114,7722,392,4.8
7854,CN2803300000000,28,33,"DeSoto County, MS",May-19,91185,87215,3970,4.4
7855,CN2803500000000,28,35,"Forrest County, MS",May-19,33072,31357,1715,5.2
7856,CN2803700000000,28,37,"Franklin County, MS",May-19,2862,2685,177,6.2
7857,CN2803900000000,28,39,"George County, MS",May-19,8916,8306,610,6.8
7858,CN2804100000000,28,41,"Greene County, MS",May-19,4395,4065,330,7.5
7859,CN2804300000000,28,43,"Grenada County, MS",May-19,9636,9181,455,4.7
7860,CN2804500000000,28,45,"Hancock County, MS",May-19,18762,17746,1016,5.4
7861,CN2804700000000,28,47,"Harrison County, MS",May-19,86547,82196,4351,5.0
7862,CN2804900000000,28,49,"Hinds County, MS",May-19,107030,101428,5602,5.2
7863,CN2805100000000,28,51,"Holmes County, MS",May-19,5666,5059,607,10.7
7864,CN2805300000000,28,53,"Humphreys County, MS",May-19,2264,2062,202,8.9
7865,CN2805500000000,28,55,"Issaquena County, MS",May-19,388,340,48,12.4
7866,CN2805700000000,28,57,"Itawamba County, MS",May-19,10513,10019,494,4.7
7867,CN2805900000000,28,59,"Jackson County, MS",May-19,58634,55188,3446,5.9
7868,CN2806100000000,28,61,"Jasper County, MS",May-19,6191,5783,408,6.6
7869,CN2806300000000,28,63,"Jefferson County, MS",May-19,2035,1735,300,14.7
7870,CN2806500000000,28,65,"Jefferson Davis County, MS",May-19,4116,3852,264,6.4
7871,CN2806700000000,28,67,"Jones County, MS",May-19,26280,24860,1420,5.4
7872,CN2806900000000,28,69,"Kemper County, MS",May-19,3578,3287,291,8.1
7873,CN2807100000000,28,71,"Lafayette County, MS",May-19,28228,26841,1387,4.9
7874,CN2807300000000,28,73,"Lamar County, MS",May-19,30484,29210,1274,4.2
7875,CN2807500000000,28,75,"Lauderdale County, MS",May-19,30432,28744,1688,5.5
7876,CN2807700000000,28,77,"Lawrence County, MS",May-19,4638,4361,277,6.0
7877,CN2807900000000,28,79,"Leake County, MS",May-19,8095,7670,425,5.3
7878,CN2808100000000,28,81,"Lee County, MS",May-19,40940,39231,1709,4.2
7879,CN2808300000000,28,83,"Leflore County, MS",May-19,9958,9256,702,7.0
7880,CN2808500000000,28,85,"Lincoln County, MS",May-19,14688,13902,786,5.4
7881,CN2808700000000,28,87,"Lowndes County, MS",May-19,25436,24093,1343,5.3
7882,CN2808900000000,28,89,"Madison County, MS",May-19,53256,50952,2304,4.3
7883,CN2809100000000,28,91,"Marion County, MS",May-19,9982,9465,517,5.2
7884,CN2809300000000,28,93,"Marshall County, MS",May-19,14465,13657,808,5.6
7885,CN2809500000000,28,95,"Monroe County, MS",May-19,15510,14660,850,5.5
7886,CN2809700000000,28,97,"Montgomery County, MS",May-19,4041,3803,238,5.9
7887,CN2809900000000,28,99,"Neshoba County, MS",May-19,10402,9797,605,5.8
7888,CN2810100000000,28,101,"Newton County, MS",May-19,8895,8395,500,5.6
7889,CN2810300000000,28,103,"Noxubee County, MS",May-19,3837,3567,270,7.0
7890,CN2810500000000,28,105,"Oktibbeha County, MS",May-19,22959,21575,1384,6.0
7891,CN2810700000000,28,107,"Panola County, MS",May-19,12658,11811,847,6.7
7892,CN2810900000000,28,109,"Pearl River County, MS",May-19,23875,22687,1188,5.0
7893,CN2811100000000,28,111,"Perry County, MS",May-19,4261,3986,275,6.5
7894,CN2811300000000,28,113,"Pike County, MS",May-19,14653,13759,894,6.1
7895,CN2811500000000,28,115,"Pontotoc County, MS",May-19,14706,14084,622,4.2
7896,CN2811700000000,28,117,"Prentiss County, MS",May-19,11390,10844,546,4.8
7897,CN2811900000000,28,119,"Quitman County, MS",May-19,2417,2231,186,7.7
7898,CN2812100000000,28,121,"Rankin County, MS",May-19,76120,73165,2955,3.9
7899,CN2812300000000,28,123,"Scott County, MS",May-19,12814,12259,555,4.3
7900,CN2812500000000,28,125,"Sharkey County, MS",May-19,1594,1469,125,7.8
7901,CN2812700000000,28,127,"Simpson County, MS",May-19,10780,10233,547,5.1
7902,CN2812900000000,28,129,"Smith County, MS",May-19,6848,6504,344,5.0
7903,CN2813100000000,28,131,"Stone County, MS",May-19,6950,6493,457,6.6
7904,CN2813300000000,28,133,"Sunflower County, MS",May-19,7831,7237,594,7.6
7905,CN2813500000000,28,135,"Tallahatchie County, MS",May-19,5380,5111,269,5.0
7906,CN2813700000000,28,137,"Tate County, MS",May-19,12419,11714,705,5.7
7907,CN2813900000000,28,139,"Tippah County, MS",May-19,9459,8979,480,5.1
7908,CN2814100000000,28,141,"Tishomingo County, MS",May-19,8686,8275,411,4.7
7909,CN2814300000000,28,143,"Tunica County, MS",May-19,4468,4210,258,5.8
7910,CN2814500000000,28,145,"Union County, MS",May-19,14174,13597,577,4.1
7911,CN2814700000000,28,147,"Walthall County, MS",May-19,4977,4646,331,6.7
7912,CN2814900000000,28,149,"Warren County, MS",May-19,20235,19048,1187,5.9
7913,CN2815100000000,28,151,"Washington County, MS",May-19,17030,15846,1184,7.0
7914,CN2815300000000,28,153,"Wayne County, MS",May-19,7504,7066,438,5.8
7915,CN2815500000000,28,155,"Webster County, MS",May-19,4011,3778,233,5.8
7916,CN2815700000000,28,157,"Wilkinson County, MS",May-19,2803,2550,253,9.0
7917,CN2815900000000,28,159,"Winston County, MS",May-19,7462,7015,447,6.0
7918,CN2816100000000,28,161,"Yalobusha County, MS",May-19,4922,4636,286,5.8
7919,CN2816300000000,28,163,"Yazoo County, MS",May-19,9467,8884,583,6.2
7920,CN2900100000000,29,1,"Adair County, MO",May-19,10483,10067,416,4.0
7921,CN2900300000000,29,3,"Andrew County, MO",May-19,9707,9460,247,2.5
7922,CN2900500000000,29,5,"Atchison County, MO",May-19,2802,2698,104,3.7
7923,CN2900700000000,29,7,"Audrain County, MO",May-19,10841,10481,360,3.3
7924,CN2900900000000,29,9,"Barry County, MO",May-19,15730,15283,447,2.8
7925,CN2901100000000,29,11,"Barton County, MO",May-19,5332,5151,181,3.4
7926,CN2901300000000,29,13,"Bates County, MO",May-19,7902,7623,279,3.5
7927,CN2901500000000,29,15,"Benton County, MO",May-19,7298,7001,297,4.1
7928,CN2901700000000,29,17,"Bollinger County, MO",May-19,5511,5316,195,3.5
7929,CN2901900000000,29,19,"Boone County, MO",May-19,98620,96399,2221,2.3
7930,CN2902100000000,29,21,"Buchanan County, MO",May-19,44268,43035,1233,2.8
7931,CN2902300000000,29,23,"Butler County, MO",May-19,18149,17187,962,5.3
7932,CN2902500000000,29,25,"Caldwell County, MO",May-19,4388,4258,130,3.0
7933,CN2902700000000,29,27,"Callaway County, MO",May-19,21366,20788,578,2.7
7934,CN2902900000000,29,29,"Camden County, MO",May-19,19104,18396,708,3.7
7935,CN2903100000000,29,31,"Cape Girardeau County, MO",May-19,40845,39742,1103,2.7
7936,CN2903300000000,29,33,"Carroll County, MO",May-19,4740,4608,132,2.8
7937,CN2903500000000,29,35,"Carter County, MO",May-19,2589,2468,121,4.7
7938,CN2903700000000,29,37,"Cass County, MO",May-19,54457,52991,1466,2.7
7939,CN2903900000000,29,39,"Cedar County, MO",May-19,5825,5628,197,3.4
7940,CN2904100000000,29,41,"Chariton County, MO",May-19,3806,3710,96,2.5
7941,CN2904300000000,29,43,"Christian County, MO",May-19,44656,43612,1044,2.3
7942,CN2904500000000,29,45,"Clark County, MO",May-19,3270,3173,97,3.0
7943,CN2904700000000,29,47,"Clay County, MO",May-19,135436,131974,3462,2.6
7944,CN2904900000000,29,49,"Clinton County, MO",May-19,10690,10424,266,2.5
7945,CN2905100000000,29,51,"Cole County, MO",May-19,38876,37986,890,2.3
7946,CN2905300000000,29,53,"Cooper County, MO",May-19,7536,7314,222,2.9
7947,CN2905500000000,29,55,"Crawford County, MO",May-19,10950,10591,359,3.3
7948,CN2905700000000,29,57,"Dade County, MO",May-19,3665,3564,101,2.8
7949,CN2905900000000,29,59,"Dallas County, MO",May-19,7111,6804,307,4.3
7950,CN2906100000000,29,61,"Daviess County, MO",May-19,4253,4137,116,2.7
7951,CN2906300000000,29,63,"DeKalb County, MO",May-19,4837,4716,121,2.5
7952,CN2906500000000,29,65,"Dent County, MO",May-19,6331,6128,203,3.2
7953,CN2906700000000,29,67,"Douglas County, MO",May-19,5136,4950,186,3.6
7954,CN2906900000000,29,69,"Dunklin County, MO",May-19,11830,11244,586,5.0
7955,CN2907100000000,29,71,"Franklin County, MO",May-19,52824,51281,1543,2.9
7956,CN2907300000000,29,73,"Gasconade County, MO",May-19,7808,7566,242,3.1
7957,CN2907500000000,29,75,"Gentry County, MO",May-19,3676,3580,96,2.6
7958,CN2907700000000,29,77,"Greene County, MO",May-19,150934,147157,3777,2.5
7959,CN2907900000000,29,79,"Grundy County, MO",May-19,4498,4360,138,3.1
7960,CN2908100000000,29,81,"Harrison County, MO",May-19,3928,3823,105,2.7
7961,CN2908300000000,29,83,"Henry County, MO",May-19,9920,9528,392,4.0
7962,CN2908500000000,29,85,"Hickory County, MO",May-19,3888,3758,130,3.3
7963,CN2908700000000,29,87,"Holt County, MO",May-19,2684,2613,71,2.6
7964,CN2908900000000,29,89,"Howard County, MO",May-19,4936,4802,134,2.7
7965,CN2909100000000,29,91,"Howell County, MO",May-19,16437,15886,551,3.4
7966,CN2909300000000,29,93,"Iron County, MO",May-19,3563,3416,147,4.1
7967,CN2909500000000,29,95,"Jackson County, MO",May-19,359802,347643,12159,3.4
7968,CN2909700000000,29,97,"Jasper County, MO",May-19,56765,55148,1617,2.8
7969,CN2909900000000,29,99,"Jefferson County, MO",May-19,116881,113675,3206,2.7
7970,CN2910100000000,29,101,"Johnson County, MO",May-19,23062,22295,767,3.3
7971,CN2910300000000,29,103,"Knox County, MO",May-19,1804,1756,48,2.7
7972,CN2910500000000,29,105,"Laclede County, MO",May-19,17988,16487,1501,8.3
7973,CN2910700000000,29,107,"Lafayette County, MO",May-19,16824,16369,455,2.7
7974,CN2910900000000,29,109,"Lawrence County, MO",May-19,18047,17531,516,2.9
7975,CN2911100000000,29,111,"Lewis County, MO",May-19,5113,4969,144,2.8
7976,CN2911300000000,29,113,"Lincoln County, MO",May-19,28230,27422,808,2.9
7977,CN2911500000000,29,115,"Linn County, MO",May-19,5197,4976,221,4.3
7978,CN2911700000000,29,117,"Livingston County, MO",May-19,7387,7225,162,2.2
7979,CN2911900000000,29,119,"McDonald County, MO",May-19,10615,10278,337,3.2
7980,CN2912100000000,29,121,"Macon County, MO",May-19,7593,7379,214,2.8
7981,CN2912300000000,29,123,"Madison County, MO",May-19,5536,5363,173,3.1
7982,CN2912500000000,29,125,"Maries County, MO",May-19,3934,3822,112,2.8
7983,CN2912700000000,29,127,"Marion County, MO",May-19,14519,14096,423,2.9
7984,CN2912900000000,29,129,"Mercer County, MO",May-19,1964,1917,47,2.4
7985,CN2913100000000,29,131,"Miller County, MO",May-19,12525,12162,363,2.9
7986,CN2913300000000,29,133,"Mississippi County, MO",May-19,5908,5705,203,3.4
7987,CN2913500000000,29,135,"Moniteau County, MO",May-19,7371,7185,186,2.5
7988,CN2913700000000,29,137,"Monroe County, MO",May-19,3941,3804,137,3.5
7989,CN2913900000000,29,139,"Montgomery County, MO",May-19,5818,5658,160,2.8
7990,CN2914100000000,29,141,"Morgan County, MO",May-19,8198,7913,285,3.5
7991,CN2914300000000,29,143,"New Madrid County, MO",May-19,8384,8077,307,3.7
7992,CN2914500000000,29,145,"Newton County, MO",May-19,27231,26380,851,3.1
7993,CN2914700000000,29,147,"Nodaway County, MO",May-19,10679,10361,318,3.0
7994,CN2914900000000,29,149,"Oregon County, MO",May-19,4017,3873,144,3.6
7995,CN2915100000000,29,151,"Osage County, MO",May-19,7140,6982,158,2.2
7996,CN2915300000000,29,153,"Ozark County, MO",May-19,3574,3408,166,4.6
7997,CN2915500000000,29,155,"Pemiscot County, MO",May-19,6461,6182,279,4.3
7998,CN2915700000000,29,157,"Perry County, MO",May-19,10102,9873,229,2.3
7999,CN2915900000000,29,159,"Pettis County, MO",May-19,20914,20259,655,3.1
8000,CN2916100000000,29,161,"Phelps County, MO",May-19,19910,19315,595,3.0
8001,CN2916300000000,29,163,"Pike County, MO",May-19,7582,7344,238,3.1
8002,CN2916500000000,29,165,"Platte County, MO",May-19,58360,56954,1406,2.4
8003,CN2916700000000,29,167,"Polk County, MO",May-19,14533,14085,448,3.1
8004,CN2916900000000,29,169,"Pulaski County, MO",May-19,14699,14110,589,4.0
8005,CN2917100000000,29,171,"Putnam County, MO",May-19,2353,2279,74,3.1
8006,CN2917300000000,29,173,"Ralls County, MO",May-19,5667,5504,163,2.9
8007,CN2917500000000,29,175,"Randolph County, MO",May-19,10428,10087,341,3.3
8008,CN2917700000000,29,177,"Ray County, MO",May-19,10932,10600,332,3.0
8009,CN2917900000000,29,179,"Reynolds County, MO",May-19,3108,3009,99,3.2
8010,CN2918100000000,29,181,"Ripley County, MO",May-19,5167,4827,340,6.6
8011,CN2918300000000,29,183,"St. Charles County, MO",May-19,225606,220332,5274,2.3
8012,CN2918500000000,29,185,"St. Clair County, MO",May-19,3863,3703,160,4.1
8013,CN2918600000000,29,186,"Ste. Genevieve County, MO",May-19,9237,9036,201,2.2
8014,CN2918700000000,29,187,"St. Francois County, MO",May-19,26621,25769,852,3.2
8015,CN2918900000000,29,189,"St. Louis County, MO",May-19,528571,513492,15079,2.9
8016,CN2919500000000,29,195,"Saline County, MO",May-19,10723,10401,322,3.0
8017,CN2919700000000,29,197,"Schuyler County, MO",May-19,1978,1911,67,3.4
8018,CN2919900000000,29,199,"Scotland County, MO",May-19,2434,2360,74,3.0
8019,CN2920100000000,29,201,"Scott County, MO",May-19,20141,19518,623,3.1
8020,CN2920300000000,29,203,"Shannon County, MO",May-19,3289,3137,152,4.6
8021,CN2920500000000,29,205,"Shelby County, MO",May-19,3141,3071,70,2.2
8022,CN2920700000000,29,207,"Stoddard County, MO",May-19,13323,12745,578,4.3
8023,CN2920900000000,29,209,"Stone County, MO",May-19,13851,13343,508,3.7
8024,CN2921100000000,29,211,"Sullivan County, MO",May-19,2750,2669,81,2.9
8025,CN2921300000000,29,213,"Taney County, MO",May-19,27057,26121,936,3.5
8026,CN2921500000000,29,215,"Texas County, MO",May-19,9259,8886,373,4.0
8027,CN2921700000000,29,217,"Vernon County, MO",May-19,9657,9358,299,3.1
8028,CN2921900000000,29,219,"Warren County, MO",May-19,17864,17386,478,2.7
8029,CN2922100000000,29,221,"Washington County, MO",May-19,10259,9856,403,3.9
8030,CN2922300000000,29,223,"Wayne County, MO",May-19,5336,5077,259,4.9
8031,CN2922500000000,29,225,"Webster County, MO",May-19,17285,16747,538,3.1
8032,CN2922700000000,29,227,"Worth County, MO",May-19,1224,1199,25,2.0
8033,CN2922900000000,29,229,"Wright County, MO",May-19,7651,7319,332,4.3
8034,CN2951000000000,29,510,"St. Louis city, MO",May-19,151574,146231,5343,3.5
8035,CN3000100000000,30,1,"Beaverhead County, MT",May-19,5058,4935,123,2.4
8036,CN3000300000000,30,3,"Big Horn County, MT",May-19,4826,4507,319,6.6
8037,CN3000500000000,30,5,"Blaine County, MT",May-19,2505,2440,65,2.6
8038,CN3000700000000,30,7,"Broadwater County, MT",May-19,2573,2480,93,3.6
8039,CN3000900000000,30,9,"Carbon County, MT",May-19,5456,5302,154,2.8
8040,CN3001100000000,30,11,"Carter County, MT",May-19,622,603,19,3.1
8041,CN3001300000000,30,13,"Cascade County, MT",May-19,38071,37010,1061,2.8
8042,CN3001500000000,30,15,"Chouteau County, MT",May-19,2449,2395,54,2.2
8043,CN3001700000000,30,17,"Custer County, MT",May-19,6165,6037,128,2.1
8044,CN3001900000000,30,19,"Daniels County, MT",May-19,888,876,12,1.4
8045,CN3002100000000,30,21,"Dawson County, MT",May-19,4597,4507,90,2.0
8046,CN3002300000000,30,23,"Deer Lodge County, MT",May-19,5040,4908,132,2.6
8047,CN3002500000000,30,25,"Fallon County, MT",May-19,1706,1685,21,1.2
8048,CN3002700000000,30,27,"Fergus County, MT",May-19,6064,5934,130,2.1
8049,CN3002900000000,30,29,"Flathead County, MT",May-19,47572,45732,1840,3.9
8050,CN3003100000000,30,31,"Gallatin County, MT",May-19,67561,66059,1502,2.2
8051,CN3003300000000,30,33,"Garfield County, MT",May-19,730,719,11,1.5
8052,CN3003500000000,30,35,"Glacier County, MT",May-19,5601,5258,343,6.1
8053,CN3003700000000,30,37,"Golden Valley County, MT",May-19,363,349,14,3.9
8054,CN3003900000000,30,39,"Granite County, MT",May-19,1640,1562,78,4.8
8055,CN3004100000000,30,41,"Hill County, MT",May-19,7648,7433,215,2.8
8056,CN3004300000000,30,43,"Jefferson County, MT",May-19,5667,5530,137,2.4
8057,CN3004500000000,30,45,"Judith Basin County, MT",May-19,922,902,20,2.2
8058,CN3004700000000,30,47,"Lake County, MT",May-19,13337,12884,453,3.4
8059,CN3004900000000,30,49,"Lewis and Clark County, MT",May-19,35797,34970,827,2.3
8060,CN3005100000000,30,51,"Liberty County, MT",May-19,928,909,19,2.0
8061,CN3005300000000,30,53,"Lincoln County, MT",May-19,8097,7643,454,5.6
8062,CN3005500000000,30,55,"McCone County, MT",May-19,937,923,14,1.5
8063,CN3005700000000,30,57,"Madison County, MT",May-19,4445,4330,115,2.6
8064,CN3005900000000,30,59,"Meagher County, MT",May-19,896,869,27,3.0
8065,CN3006100000000,30,61,"Mineral County, MT",May-19,1801,1727,74,4.1
8066,CN3006300000000,30,63,"Missoula County, MT",May-19,64193,62547,1646,2.6
8067,CN3006500000000,30,65,"Musselshell County, MT",May-19,2235,2172,63,2.8
8068,CN3006700000000,30,67,"Park County, MT",May-19,8938,8677,261,2.9
8069,CN3006900000000,30,69,"Petroleum County, MT",May-19,270,264,6,2.2
8070,CN3007100000000,30,71,"Phillips County, MT",May-19,1841,1795,46,2.5
8071,CN3007300000000,30,73,"Pondera County, MT",May-19,2695,2610,85,3.2
8072,CN3007500000000,30,75,"Powder River County, MT",May-19,942,927,15,1.6
8073,CN3007700000000,30,77,"Powell County, MT",May-19,2975,2870,105,3.5
8074,CN3007900000000,30,79,"Prairie County, MT",May-19,472,457,15,3.2
8075,CN3008100000000,30,81,"Ravalli County, MT",May-19,20337,19679,658,3.2
8076,CN3008300000000,30,83,"Richland County, MT",May-19,5822,5689,133,2.3
8077,CN3008500000000,30,85,"Roosevelt County, MT",May-19,4554,4395,159,3.5
8078,CN3008700000000,30,87,"Rosebud County, MT",May-19,3822,3669,153,4.0
8079,CN3008900000000,30,89,"Sanders County, MT",May-19,4879,4659,220,4.5
8080,CN3009100000000,30,91,"Sheridan County, MT",May-19,1739,1707,32,1.8
8081,CN3009300000000,30,93,"Silver Bow County, MT",May-19,17086,16575,511,3.0
8082,CN3009500000000,30,95,"Stillwater County, MT",May-19,5153,5017,136,2.6
8083,CN3009700000000,30,97,"Sweet Grass County, MT",May-19,1778,1734,44,2.5
8084,CN3009900000000,30,99,"Teton County, MT",May-19,2753,2683,70,2.5
8085,CN3010100000000,30,101,"Toole County, MT",May-19,2112,2068,44,2.1
8086,CN3010300000000,30,103,"Treasure County, MT",May-19,331,324,7,2.1
8087,CN3010500000000,30,105,"Valley County, MT",May-19,4096,4007,89,2.2
8088,CN3010700000000,30,107,"Wheatland County, MT",May-19,777,756,21,2.7
8089,CN3010900000000,30,109,"Wibaux County, MT",May-19,459,448,11,2.4
8090,CN3011100000000,30,111,"Yellowstone County, MT",May-19,81792,79672,2120,2.6
8091,CN3100100000000,31,1,"Adams County, NE",May-19,16807,16318,489,2.9
8092,CN3100300000000,31,3,"Antelope County, NE",May-19,3635,3546,89,2.4
8093,CN3100500000000,31,5,"Arthur County, NE",May-19,227,218,9,4.0
8094,CN3100700000000,31,7,"Banner County, NE",May-19,374,362,12,3.2
8095,CN3100900000000,31,9,"Blaine County, NE",May-19,264,253,11,4.2
8096,CN3101100000000,31,11,"Boone County, NE",May-19,3042,2968,74,2.4
8097,CN3101300000000,31,13,"Box Butte County, NE",May-19,5458,5275,183,3.4
8098,CN3101500000000,31,15,"Boyd County, NE",May-19,1090,1056,34,3.1
8099,CN3101700000000,31,17,"Brown County, NE",May-19,1432,1384,48,3.4
8100,CN3101900000000,31,19,"Buffalo County, NE",May-19,27973,27210,763,2.7
8101,CN3102100000000,31,21,"Burt County, NE",May-19,3573,3468,105,2.9
8102,CN3102300000000,31,23,"Butler County, NE",May-19,4676,4554,122,2.6
8103,CN3102500000000,31,25,"Cass County, NE",May-19,13549,13117,432,3.2
8104,CN3102700000000,31,27,"Cedar County, NE",May-19,4602,4480,122,2.7
8105,CN3102900000000,31,29,"Chase County, NE",May-19,2321,2267,54,2.3
8106,CN3103100000000,31,31,"Cherry County, NE",May-19,3478,3392,86,2.5
8107,CN3103300000000,31,33,"Cheyenne County, NE",May-19,4423,4268,155,3.5
8108,CN3103500000000,31,35,"Clay County, NE",May-19,3343,3243,100,3.0
8109,CN3103700000000,31,37,"Colfax County, NE",May-19,5625,5477,148,2.6
8110,CN3103900000000,31,39,"Cuming County, NE",May-19,4831,4706,125,2.6
8111,CN3104100000000,31,41,"Custer County, NE",May-19,6550,6395,155,2.4
8112,CN3104300000000,31,43,"Dakota County, NE",May-19,10685,10342,343,3.2
8113,CN3104500000000,31,45,"Dawes County, NE",May-19,5040,4889,151,3.0
8114,CN3104700000000,31,47,"Dawson County, NE",May-19,13046,12680,366,2.8
8115,CN3104900000000,31,49,"Deuel County, NE",May-19,976,948,28,2.9
8116,CN3105100000000,31,51,"Dixon County, NE",May-19,3055,2957,98,3.2
8117,CN3105300000000,31,53,"Dodge County, NE",May-19,19437,18879,558,2.9
8118,CN3105500000000,31,55,"Douglas County, NE",May-19,298676,289191,9485,3.2
8119,CN3105700000000,31,57,"Dundy County, NE",May-19,1192,1163,29,2.4
8120,CN3105900000000,31,59,"Fillmore County, NE",May-19,3221,3138,83,2.6
8121,CN3106100000000,31,61,"Franklin County, NE",May-19,1490,1442,48,3.2
8122,CN3106300000000,31,63,"Frontier County, NE",May-19,1648,1599,49,3.0
8123,CN3106500000000,31,65,"Furnas County, NE",May-19,2663,2592,71,2.7
8124,CN3106700000000,31,67,"Gage County, NE",May-19,11084,10741,343,3.1
8125,CN3106900000000,31,69,"Garden County, NE",May-19,1121,1089,32,2.9
8126,CN3107100000000,31,71,"Garfield County, NE",May-19,1182,1140,42,3.6
8127,CN3107300000000,31,73,"Gosper County, NE",May-19,1130,1098,32,2.8
8128,CN3107500000000,31,75,"Grant County, NE",May-19,430,419,11,2.6
8129,CN3107700000000,31,77,"Greeley County, NE",May-19,1272,1232,40,3.1
8130,CN3107900000000,31,79,"Hall County, NE",May-19,31981,31015,966,3.0
8131,CN3108100000000,31,81,"Hamilton County, NE",May-19,4815,4678,137,2.8
8132,CN3108300000000,31,83,"Harlan County, NE",May-19,1858,1807,51,2.7
8133,CN3108500000000,31,85,"Hayes County, NE",May-19,626,612,14,2.2
8134,CN3108700000000,31,87,"Hitchcock County, NE",May-19,1273,1231,42,3.3
8135,CN3108900000000,31,89,"Holt County, NE",May-19,5903,5755,148,2.5
8136,CN3109100000000,31,91,"Hooker County, NE",May-19,460,448,12,2.6
8137,CN3109300000000,31,93,"Howard County, NE",May-19,3379,3281,98,2.9
8138,CN3109500000000,31,95,"Jefferson County, NE",May-19,4199,4091,108,2.6
8139,CN3109700000000,31,97,"Johnson County, NE",May-19,2091,2023,68,3.3
8140,CN3109900000000,31,99,"Kearney County, NE",May-19,3844,3749,95,2.5
8141,CN3110100000000,31,101,"Keith County, NE",May-19,4693,4561,132,2.8
8142,CN3110300000000,31,103,"Keya Paha County, NE",May-19,608,593,15,2.5
8143,CN3110500000000,31,105,"Kimball County, NE",May-19,2036,1976,60,2.9
8144,CN3110700000000,31,107,"Knox County, NE",May-19,4707,4581,126,2.7
8145,CN3110900000000,31,109,"Lancaster County, NE",May-19,176840,171920,4920,2.8
8146,CN3111100000000,31,111,"Lincoln County, NE",May-19,18413,17816,597,3.2
8147,CN3111300000000,31,113,"Logan County, NE",May-19,486,472,14,2.9
8148,CN3111500000000,31,115,"Loup County, NE",May-19,414,400,14,3.4
8149,CN3111700000000,31,117,"McPherson County, NE",May-19,447,436,11,2.5
8150,CN3111900000000,31,119,"Madison County, NE",May-19,19717,19180,537,2.7
8151,CN3112100000000,31,121,"Merrick County, NE",May-19,4046,3928,118,2.9
8152,CN3112300000000,31,123,"Morrill County, NE",May-19,2634,2562,72,2.7
8153,CN3112500000000,31,125,"Nance County, NE",May-19,2018,1963,55,2.7
8154,CN3112700000000,31,127,"Nemaha County, NE",May-19,3684,3544,140,3.8
8155,CN3112900000000,31,129,"Nuckolls County, NE",May-19,2394,2331,63,2.6
8156,CN3113100000000,31,131,"Otoe County, NE",May-19,8490,8201,289,3.4
8157,CN3113300000000,31,133,"Pawnee County, NE",May-19,1515,1472,43,2.8
8158,CN3113500000000,31,135,"Perkins County, NE",May-19,1844,1799,45,2.4
8159,CN3113700000000,31,137,"Phelps County, NE",May-19,5046,4912,134,2.7
8160,CN3113900000000,31,139,"Pierce County, NE",May-19,4151,4048,103,2.5
8161,CN3114100000000,31,141,"Platte County, NE",May-19,17696,17170,526,3.0
8162,CN3114300000000,31,143,"Polk County, NE",May-19,2985,2905,80,2.7
8163,CN3114500000000,31,145,"Red Willow County, NE",May-19,5858,5695,163,2.8
8164,CN3114700000000,31,147,"Richardson County, NE",May-19,4325,4190,135,3.1
8165,CN3114900000000,31,149,"Rock County, NE",May-19,880,854,26,3.0
8166,CN3115100000000,31,151,"Saline County, NE",May-19,7476,7262,214,2.9
8167,CN3115300000000,31,153,"Sarpy County, NE",May-19,96362,93570,2792,2.9
8168,CN3115500000000,31,155,"Saunders County, NE",May-19,11198,10886,312,2.8
8169,CN3115700000000,31,157,"Scotts Bluff County, NE",May-19,18344,17699,645,3.5
8170,CN3115900000000,31,159,"Seward County, NE",May-19,8978,8701,277,3.1
8171,CN3116100000000,31,161,"Sheridan County, NE",May-19,2709,2631,78,2.9
8172,CN3116300000000,31,163,"Sherman County, NE",May-19,1728,1676,52,3.0
8173,CN3116500000000,31,165,"Sioux County, NE",May-19,747,725,22,2.9
8174,CN3116700000000,31,167,"Stanton County, NE",May-19,3506,3418,88,2.5
8175,CN3116900000000,31,169,"Thayer County, NE",May-19,2832,2760,72,2.5
8176,CN3117100000000,31,171,"Thomas County, NE",May-19,434,420,14,3.2
8177,CN3117300000000,31,173,"Thurston County, NE",May-19,3026,2903,123,4.1
8178,CN3117500000000,31,175,"Valley County, NE",May-19,2160,2089,71,3.3
8179,CN3117700000000,31,177,"Washington County, NE",May-19,11262,10948,314,2.8
8180,CN3117900000000,31,179,"Wayne County, NE",May-19,5775,5621,154,2.7
8181,CN3118100000000,31,181,"Webster County, NE",May-19,1709,1647,62,3.6
8182,CN3118300000000,31,183,"Wheeler County, NE",May-19,605,590,15,2.5
8183,CN3118500000000,31,185,"York County, NE",May-19,7319,7122,197,2.7
8184,CN3200100000000,32,1,"Churchill County, NV",May-19,10960,10575,385,3.5
8185,CN3200300000000,32,3,"Clark County, NV",May-19,1129068,1083724,45344,4.0
8186,CN3200500000000,32,5,"Douglas County, NV",May-19,23033,22113,920,4.0
8187,CN3200700000000,32,7,"Elko County, NV",May-19,27727,26966,761,2.7
8188,CN3200900000000,32,9,"Esmeralda County, NV",May-19,409,397,12,2.9
8189,CN3201100000000,32,11,"Eureka County, NV",May-19,1041,1017,24,2.3
8190,CN3201300000000,32,13,"Humboldt County, NV",May-19,8105,7887,218,2.7
8191,CN3201500000000,32,15,"Lander County, NV",May-19,3184,3094,90,2.8
8192,CN3201700000000,32,17,"Lincoln County, NV",May-19,2043,1963,80,3.9
8193,CN3201900000000,32,19,"Lyon County, NV",May-19,23521,22494,1027,4.4
8194,CN3202100000000,32,21,"Mineral County, NV",May-19,2045,1958,87,4.3
8195,CN3202300000000,32,23,"Nye County, NV",May-19,17216,16332,884,5.1
8196,CN3202700000000,32,27,"Pershing County, NV",May-19,2479,2386,93,3.8
8197,CN3202900000000,32,29,"Storey County, NV",May-19,2028,1953,75,3.7
8198,CN3203100000000,32,31,"Washoe County, NV",May-19,254713,246796,7917,3.1
8199,CN3203300000000,32,33,"White Pine County, NV",May-19,4573,4440,133,2.9
8200,CN3251000000000,32,510,"Carson City, NV",May-19,26393,25380,1013,3.8
8201,CN3300100000000,33,1,"Belknap County, NH",May-19,31360,30604,756,2.4
8202,CN3300300000000,33,3,"Carroll County, NH",May-19,23058,22462,596,2.6
8203,CN3300500000000,33,5,"Cheshire County, NH",May-19,40798,39804,994,2.4
8204,CN3300700000000,33,7,"Coos County, NH",May-19,14473,14005,468,3.2
8205,CN3300900000000,33,9,"Grafton County, NH",May-19,48979,47934,1045,2.1
8206,CN3301100000000,33,11,"Hillsborough County, NH",May-19,241922,235916,6006,2.5
8207,CN3301300000000,33,13,"Merrimack County, NH",May-19,83272,81486,1786,2.1
8208,CN3301500000000,33,15,"Rockingham County, NH",May-19,187235,182487,4748,2.5
8209,CN3301700000000,33,17,"Strafford County, NH",May-19,74743,73148,1595,2.1
8210,CN3301900000000,33,19,"Sullivan County, NH",May-19,22958,22444,514,2.2
8211,CN3400100000000,34,1,"Atlantic County, NJ",May-19,118905,113924,4981,4.2
8212,CN3400300000000,34,3,"Bergen County, NJ",May-19,475708,463823,11885,2.5
8213,CN3400500000000,34,5,"Burlington County, NJ",May-19,228810,222498,6312,2.8
8214,CN3400700000000,34,7,"Camden County, NJ",May-19,250146,241616,8530,3.4
8215,CN3400900000000,34,9,"Cape May County, NJ",May-19,45722,43420,2302,5.0
8216,CN3401100000000,34,11,"Cumberland County, NJ",May-19,66272,63414,2858,4.3
8217,CN3401300000000,34,13,"Essex County, NJ",May-19,363798,349937,13861,3.8
8218,CN3401500000000,34,15,"Gloucester County, NJ",May-19,148228,143675,4553,3.1
8219,CN3401700000000,34,17,"Hudson County, NJ",May-19,356257,346126,10131,2.8
8220,CN3401900000000,34,19,"Hunterdon County, NJ",May-19,64294,62802,1492,2.3
8221,CN3402100000000,34,21,"Mercer County, NJ",May-19,200414,195107,5307,2.6
8222,CN3402300000000,34,23,"Middlesex County, NJ",May-19,434190,422701,11489,2.6
8223,CN3402500000000,34,25,"Monmouth County, NJ",May-19,325339,316581,8758,2.7
8224,CN3402700000000,34,27,"Morris County, NJ",May-19,254079,247938,6141,2.4
8225,CN3402900000000,34,29,"Ocean County, NJ",May-19,271491,263213,8278,3.0
8226,CN3403100000000,34,31,"Passaic County, NJ",May-19,238429,229862,8567,3.6
8227,CN3403300000000,34,33,"Salem County, NJ",May-19,29366,28226,1140,3.9
8228,CN3403500000000,34,35,"Somerset County, NJ",May-19,169680,165297,4383,2.6
8229,CN3403700000000,34,37,"Sussex County, NJ",May-19,73338,71275,2063,2.8
8230,CN3403900000000,34,39,"Union County, NJ",May-19,272862,264372,8490,3.1
8231,CN3404100000000,34,41,"Warren County, NJ",May-19,56014,54496,1518,2.7
8232,CN3500100000000,35,1,"Bernalillo County, NM",May-19,330378,316802,13576,4.1
8233,CN3500300000000,35,3,"Catron County, NM",May-19,1143,1083,60,5.2
8234,CN3500500000000,35,5,"Chaves County, NM",May-19,26927,25736,1191,4.4
8235,CN3500600000000,35,6,"Cibola County, NM",May-19,8999,8506,493,5.5
8236,CN3500700000000,35,7,"Colfax County, NM",May-19,5187,4939,248,4.8
8237,CN3500900000000,35,9,"Curry County, NM",May-19,21645,20828,817,3.8
8238,CN3501100000000,35,11,"De Baca County, NM",May-19,781,752,29,3.7
8239,CN3501300000000,35,13,"Dona Ana County, NM",May-19,97165,91993,5172,5.3
8240,CN3501500000000,35,15,"Eddy County, NM",May-19,33603,32661,942,2.8
8241,CN3501700000000,35,17,"Grant County, NM",May-19,12138,11614,524,4.3
8242,CN3501900000000,35,19,"Guadalupe County, NM",May-19,1556,1474,82,5.3
8243,CN3502100000000,35,21,"Harding County, NM",May-19,269,258,11,4.1
8244,CN3502300000000,35,23,"Hidalgo County, NM",May-19,2161,2083,78,3.6
8245,CN3502500000000,35,25,"Lea County, NM",May-19,30562,29471,1091,3.6
8246,CN3502700000000,35,27,"Lincoln County, NM",May-19,9178,8817,361,3.9
8247,CN3502800000000,35,28,"Los Alamos County, NM",May-19,9353,9076,277,3.0
8248,CN3502900000000,35,29,"Luna County, NM",May-19,10336,9189,1147,11.1
8249,CN3503100000000,35,31,"McKinley County, NM",May-19,24006,22521,1485,6.2
8250,CN3503300000000,35,33,"Mora County, NM",May-19,2207,2096,111,5.0
8251,CN3503500000000,35,35,"Otero County, NM",May-19,24574,23451,1123,4.6
8252,CN3503700000000,35,37,"Quay County, NM",May-19,3238,3080,158,4.9
8253,CN3503900000000,35,39,"Rio Arriba County, NM",May-19,16795,16022,773,4.6
8254,CN3504100000000,35,41,"Roosevelt County, NM",May-19,7971,7647,324,4.1
8255,CN3504300000000,35,43,"Sandoval County, NM",May-19,65743,62842,2901,4.4
8256,CN3504500000000,35,45,"San Juan County, NM",May-19,51710,49183,2527,4.9
8257,CN3504700000000,35,47,"San Miguel County, NM",May-19,10534,9964,570,5.4
8258,CN3504900000000,35,49,"Santa Fe County, NM",May-19,74140,71375,2765,3.7
8259,CN3505100000000,35,51,"Sierra County, NM",May-19,3802,3543,259,6.8
8260,CN3505300000000,35,53,"Socorro County, NM",May-19,6397,6063,334,5.2
8261,CN3505500000000,35,55,"Taos County, NM",May-19,14437,13573,864,6.0
8262,CN3505700000000,35,57,"Torrance County, NM",May-19,5561,5225,336,6.0
8263,CN3505900000000,35,59,"Union County, NM",May-19,1839,1781,58,3.2
8264,CN3506100000000,35,61,"Valencia County, NM",May-19,30341,28867,1474,4.9
8265,CN3600100000000,36,1,"Albany County, NY",May-19,156369,151216,5153,3.3
8266,CN3600300000000,36,3,"Allegany County, NY",May-19,18788,17882,906,4.8
8267,CN3600500000000,36,5,"Bronx County, NY",May-19,593792,563604,30188,5.1
8268,CN3600700000000,36,7,"Broome County, NY",May-19,83571,80202,3369,4.0
8269,CN3600900000000,36,9,"Cattaraugus County, NY",May-19,32798,31356,1442,4.4
8270,CN3601100000000,36,11,"Cayuga County, NY",May-19,35254,33919,1335,3.8
8271,CN3601300000000,36,13,"Chautauqua County, NY",May-19,53789,51590,2199,4.1
8272,CN3601500000000,36,15,"Chemung County, NY",May-19,34843,33505,1338,3.8
8273,CN3601700000000,36,17,"Chenango County, NY",May-19,21531,20720,811,3.8
8274,CN3601900000000,36,19,"Clinton County, NY",May-19,35916,34502,1414,3.9
8275,CN3602100000000,36,21,"Columbia County, NY",May-19,30633,29745,888,2.9
8276,CN3602300000000,36,23,"Cortland County, NY",May-19,22520,21637,883,3.9
8277,CN3602500000000,36,25,"Delaware County, NY",May-19,18565,17818,747,4.0
8278,CN3602700000000,36,27,"Dutchess County, NY",May-19,143341,138631,4710,3.3
8279,CN3602900000000,36,29,"Erie County, NY",May-19,438920,422597,16323,3.7
8280,CN3603100000000,36,31,"Essex County, NY",May-19,16060,15390,670,4.2
8281,CN3603300000000,36,33,"Franklin County, NY",May-19,19058,18217,841,4.4
8282,CN3603500000000,36,35,"Fulton County, NY",May-19,22476,21513,963,4.3
8283,CN3603700000000,36,37,"Genesee County, NY",May-19,29264,28278,986,3.4
8284,CN3603900000000,36,39,"Greene County, NY",May-19,19754,18932,822,4.2
8285,CN3604100000000,36,41,"Hamilton County, NY",May-19,2148,2045,103,4.8
8286,CN3604300000000,36,43,"Herkimer County, NY",May-19,27554,26416,1138,4.1
8287,CN3604500000000,36,45,"Jefferson County, NY",May-19,43684,41687,1997,4.6
8288,CN3604700000000,36,47,"Kings County, NY",May-19,1193721,1146523,47198,4.0
8289,CN3604900000000,36,49,"Lewis County, NY",May-19,11139,10623,516,4.6
8290,CN3605100000000,36,51,"Livingston County, NY",May-19,30104,29019,1085,3.6
8291,CN3605300000000,36,53,"Madison County, NY",May-19,32048,30840,1208,3.8
8292,CN3605500000000,36,55,"Monroe County, NY",May-19,360232,346738,13494,3.7
8293,CN3605700000000,36,57,"Montgomery County, NY",May-19,21923,20959,964,4.4
8294,CN3605900000000,36,59,"Nassau County, NY",May-19,705819,683602,22217,3.1
8295,CN3606100000000,36,61,"New York County, NY",May-19,908821,877586,31235,3.4
8296,CN3606300000000,36,63,"Niagara County, NY",May-19,97773,93645,4128,4.2
8297,CN3606500000000,36,65,"Oneida County, NY",May-19,100665,96819,3846,3.8
8298,CN3606700000000,36,67,"Onondaga County, NY",May-19,219017,211357,7660,3.5
8299,CN3606900000000,36,69,"Ontario County, NY",May-19,54831,52925,1906,3.5
8300,CN3607100000000,36,71,"Orange County, NY",May-19,183648,177295,6353,3.5
8301,CN3607300000000,36,73,"Orleans County, NY",May-19,17054,16380,674,4.0
8302,CN3607500000000,36,75,"Oswego County, NY",May-19,52342,49806,2536,4.8
8303,CN3607700000000,36,77,"Otsego County, NY",May-19,27561,26596,965,3.5
8304,CN3607900000000,36,79,"Putnam County, NY",May-19,51119,49415,1704,3.3
8305,CN3608100000000,36,81,"Queens County, NY",May-19,1134869,1096753,38116,3.4
8306,CN3608300000000,36,83,"Rensselaer County, NY",May-19,80450,77708,2742,3.4
8307,CN3608500000000,36,85,"Richmond County, NY",May-19,221299,213068,8231,3.7
8308,CN3608700000000,36,87,"Rockland County, NY",May-19,154867,149875,4992,3.2
8309,CN3608900000000,36,89,"St. Lawrence County, NY",May-19,42661,40561,2100,4.9
8310,CN3609100000000,36,91,"Saratoga County, NY",May-19,117895,114354,3541,3.0
8311,CN3609300000000,36,93,"Schenectady County, NY",May-19,75509,72865,2644,3.5
8312,CN3609500000000,36,95,"Schoharie County, NY",May-19,14240,13696,544,3.8
8313,CN3609700000000,36,97,"Schuyler County, NY",May-19,7992,7697,295,3.7
8314,CN3609900000000,36,99,"Seneca County, NY",May-19,15719,15200,519,3.3
8315,CN3610100000000,36,101,"Steuben County, NY",May-19,41809,40121,1688,4.0
8316,CN3610300000000,36,103,"Suffolk County, NY",May-19,773165,748168,24997,3.2
8317,CN3610500000000,36,105,"Sullivan County, NY",May-19,35767,34486,1281,3.6
8318,CN3610700000000,36,107,"Tioga County, NY",May-19,22671,21851,820,3.6
8319,CN3610900000000,36,109,"Tompkins County, NY",May-19,49179,47577,1602,3.3
8320,CN3611100000000,36,111,"Ulster County, NY",May-19,87373,84431,2942,3.4
8321,CN3611300000000,36,113,"Warren County, NY",May-19,30925,29720,1205,3.9
8322,CN3611500000000,36,115,"Washington County, NY",May-19,27109,26162,947,3.5
8323,CN3611700000000,36,117,"Wayne County, NY",May-19,42983,41477,1506,3.5
8324,CN3611900000000,36,119,"Westchester County, NY",May-19,483414,466951,16463,3.4
8325,CN3612100000000,36,121,"Wyoming County, NY",May-19,17475,16864,611,3.5
8326,CN3612300000000,36,123,"Yates County, NY",May-19,11354,10991,363,3.2
8327,CN3700100000000,37,1,"Alamance County, NC",May-19,82382,79241,3141,3.8
8328,CN3700300000000,37,3,"Alexander County, NC",May-19,18229,17604,625,3.4
8329,CN3700500000000,37,5,"Alleghany County, NC",May-19,4471,4266,205,4.6
8330,CN3700700000000,37,7,"Anson County, NC",May-19,10863,10431,432,4.0
8331,CN3700900000000,37,9,"Ashe County, NC",May-19,12998,12523,475,3.7
8332,CN3701100000000,37,11,"Avery County, NC",May-19,7537,7255,282,3.7
8333,CN3701300000000,37,13,"Beaufort County, NC",May-19,19720,18824,896,4.5
8334,CN3701500000000,37,15,"Bertie County, NC",May-19,7865,7493,372,4.7
8335,CN3701700000000,37,17,"Bladen County, NC",May-19,14834,14158,676,4.6
8336,CN3701900000000,37,19,"Brunswick County, NC",May-19,55192,52409,2783,5.0
8337,CN3702100000000,37,21,"Buncombe County, NC",May-19,141587,137318,4269,3.0
8338,CN3702300000000,37,23,"Burke County, NC",May-19,41334,39802,1532,3.7
8339,CN3702500000000,37,25,"Cabarrus County, NC",May-19,109427,105551,3876,3.5
8340,CN3702700000000,37,27,"Caldwell County, NC",May-19,36881,35367,1514,4.1
8341,CN3702900000000,37,29,"Camden County, NC",May-19,4710,4533,177,3.8
8342,CN3703100000000,37,31,"Carteret County, NC",May-19,32760,31436,1324,4.0
8343,CN3703300000000,37,33,"Caswell County, NC",May-19,9931,9479,452,4.6
8344,CN3703500000000,37,35,"Catawba County, NC",May-19,79553,76706,2847,3.6
8345,CN3703700000000,37,37,"Chatham County, NC",May-19,35821,34600,1221,3.4
8346,CN3703900000000,37,39,"Cherokee County, NC",May-19,11304,10816,488,4.3
8347,CN3704100000000,37,41,"Chowan County, NC",May-19,5602,5331,271,4.8
8348,CN3704300000000,37,43,"Clay County, NC",May-19,4209,4019,190,4.5
8349,CN3704500000000,37,45,"Cleveland County, NC",May-19,48663,46778,1885,3.9
8350,CN3704700000000,37,47,"Columbus County, NC",May-19,22917,21802,1115,4.9
8351,CN3704900000000,37,49,"Craven County, NC",May-19,42079,40359,1720,4.1
8352,CN3705100000000,37,51,"Cumberland County, NC",May-19,129505,123017,6488,5.0
8353,CN3705300000000,37,53,"Currituck County, NC",May-19,14036,13545,491,3.5
8354,CN3705500000000,37,55,"Dare County, NC",May-19,21133,20291,842,4.0
8355,CN3705700000000,37,57,"Davidson County, NC",May-19,81773,78796,2977,3.6
8356,CN3705900000000,37,59,"Davie County, NC",May-19,20911,20201,710,3.4
8357,CN3706100000000,37,61,"Duplin County, NC",May-19,25753,24713,1040,4.0
8358,CN3706300000000,37,63,"Durham County, NC",May-19,172081,166083,5998,3.5
8359,CN3706500000000,37,65,"Edgecombe County, NC",May-19,21397,20141,1256,5.9
8360,CN3706700000000,37,67,"Forsyth County, NC",May-19,189926,182800,7126,3.8
8361,CN3706900000000,37,69,"Franklin County, NC",May-19,31454,30192,1262,4.0
8362,CN3707100000000,37,71,"Gaston County, NC",May-19,111389,107114,4275,3.8
8363,CN3707300000000,37,73,"Gates County, NC",May-19,5365,5144,221,4.1
8364,CN3707500000000,37,75,"Graham County, NC",May-19,3306,3129,177,5.4
8365,CN3707700000000,37,77,"Granville County, NC",May-19,30429,29390,1039,3.4
8366,CN3707900000000,37,79,"Greene County, NC",May-19,9789,9407,382,3.9
8367,CN3708100000000,37,81,"Guilford County, NC",May-19,265923,255082,10841,4.1
8368,CN3708300000000,37,83,"Halifax County, NC",May-19,20624,19497,1127,5.5
8369,CN3708500000000,37,85,"Harnett County, NC",May-19,53717,51190,2527,4.7
8370,CN3708700000000,37,87,"Haywood County, NC",May-19,30233,29193,1040,3.4
8371,CN3708900000000,37,89,"Henderson County, NC",May-19,55688,53786,1902,3.4
8372,CN3709100000000,37,91,"Hertford County, NC",May-19,9289,8805,484,5.2
8373,CN3709300000000,37,93,"Hoke County, NC",May-19,20418,19431,987,4.8
8374,CN3709500000000,37,95,"Hyde County, NC",May-19,2091,1956,135,6.5
8375,CN3709700000000,37,97,"Iredell County, NC",May-19,89816,86587,3229,3.6
8376,CN3709900000000,37,99,"Jackson County, NC",May-19,20102,19260,842,4.2
8377,CN3710100000000,37,101,"Johnston County, NC",May-19,99689,96066,3623,3.6
8378,CN3710300000000,37,103,"Jones County, NC",May-19,4470,4300,170,3.8
8379,CN3710500000000,37,105,"Lee County, NC",May-19,26242,25053,1189,4.5
8380,CN3710700000000,37,107,"Lenoir County, NC",May-19,28370,27299,1071,3.8
8381,CN3710900000000,37,109,"Lincoln County, NC",May-19,43619,42077,1542,3.5
8382,CN3711100000000,37,111,"McDowell County, NC",May-19,21053,20281,772,3.7
8383,CN3711300000000,37,113,"Macon County, NC",May-19,15697,15089,608,3.9
8384,CN3711500000000,37,115,"Madison County, NC",May-19,10281,9894,387,3.8
8385,CN3711700000000,37,117,"Martin County, NC",May-19,9189,8717,472,5.1
8386,CN3711900000000,37,119,"Mecklenburg County, NC",May-19,623436,600751,22685,3.6
8387,CN3712100000000,37,121,"Mitchell County, NC",May-19,6065,5784,281,4.6
8388,CN3712300000000,37,123,"Montgomery County, NC",May-19,11750,11297,453,3.9
8389,CN3712500000000,37,125,"Moore County, NC",May-19,43355,41728,1627,3.8
8390,CN3712700000000,37,127,"Nash County, NC",May-19,43497,41360,2137,4.9
8391,CN3712900000000,37,129,"New Hanover County, NC",May-19,125380,120911,4469,3.6
8392,CN3713100000000,37,131,"Northampton County, NC",May-19,7853,7465,388,4.9
8393,CN3713300000000,37,133,"Onslow County, NC",May-19,65820,62796,3024,4.6
8394,CN3713500000000,37,135,"Orange County, NC",May-19,79200,76525,2675,3.4
8395,CN3713700000000,37,137,"Pamlico County, NC",May-19,5400,5195,205,3.8
8396,CN3713900000000,37,139,"Pasquotank County, NC",May-19,16893,16148,745,4.4
8397,CN3714100000000,37,141,"Pender County, NC",May-19,29276,28137,1139,3.9
8398,CN3714300000000,37,143,"Perquimans County, NC",May-19,5048,4795,253,5.0
8399,CN3714500000000,37,145,"Person County, NC",May-19,18562,17786,776,4.2
8400,CN3714700000000,37,147,"Pitt County, NC",May-19,91057,87152,3905,4.3
8401,CN3714900000000,37,149,"Polk County, NC",May-19,9155,8805,350,3.8
8402,CN3715100000000,37,151,"Randolph County, NC",May-19,67201,64690,2511,3.7
8403,CN3715300000000,37,153,"Richmond County, NC",May-19,16914,16059,855,5.1
8404,CN3715500000000,37,155,"Robeson County, NC",May-19,50438,47748,2690,5.3
8405,CN3715700000000,37,157,"Rockingham County, NC",May-19,40689,38909,1780,4.4
8406,CN3715900000000,37,159,"Rowan County, NC",May-19,66398,63788,2610,3.9
8407,CN3716100000000,37,161,"Rutherford County, NC",May-19,25805,24584,1221,4.7
8408,CN3716300000000,37,163,"Sampson County, NC",May-19,29815,28699,1116,3.7
8409,CN3716500000000,37,165,"Scotland County, NC",May-19,11603,10878,725,6.2
8410,CN3716700000000,37,167,"Stanly County, NC",May-19,30510,29383,1127,3.7
8411,CN3716900000000,37,169,"Stokes County, NC",May-19,21939,21153,786,3.6
8412,CN3717100000000,37,171,"Surry County, NC",May-19,34403,33155,1248,3.6
8413,CN3717300000000,37,173,"Swain County, NC",May-19,7117,6846,271,3.8
8414,CN3717500000000,37,175,"Transylvania County, NC",May-19,14809,14252,557,3.8
8415,CN3717700000000,37,177,"Tyrrell County, NC",May-19,1587,1499,88,5.5
8416,CN3717900000000,37,179,"Union County, NC",May-19,124344,119994,4350,3.5
8417,CN3718100000000,37,181,"Vance County, NC",May-19,17663,16692,971,5.5
8418,CN3718300000000,37,183,"Wake County, NC",May-19,598255,577937,20318,3.4
8419,CN3718500000000,37,185,"Warren County, NC",May-19,6718,6340,378,5.6
8420,CN3718700000000,37,187,"Washington County, NC",May-19,4534,4281,253,5.6
8421,CN3718900000000,37,189,"Watauga County, NC",May-19,29420,28349,1071,3.6
8422,CN3719100000000,37,191,"Wayne County, NC",May-19,52968,50774,2194,4.1
8423,CN3719300000000,37,193,"Wilkes County, NC",May-19,29530,28343,1187,4.0
8424,CN3719500000000,37,195,"Wilson County, NC",May-19,35160,33079,2081,5.9
8425,CN3719700000000,37,197,"Yadkin County, NC",May-19,17998,17373,625,3.5
8426,CN3719900000000,37,199,"Yancey County, NC",May-19,8527,8213,314,3.7
8427,CN3800100000000,38,1,"Adams County, ND",May-19,1031,1012,19,1.8
8428,CN3800300000000,38,3,"Barnes County, ND",May-19,5160,5022,138,2.7
8429,CN3800500000000,38,5,"Benson County, ND",May-19,2250,2161,89,4.0
8430,CN3800700000000,38,7,"Billings County, ND",May-19,415,407,8,1.9
8431,CN3800900000000,38,9,"Bottineau County, ND",May-19,2994,2912,82,2.7
8432,CN3801100000000,38,11,"Bowman County, ND",May-19,1717,1694,23,1.3
8433,CN3801300000000,38,13,"Burke County, ND",May-19,1084,1062,22,2.0
8434,CN3801500000000,38,15,"Burleigh County, ND",May-19,49190,48193,997,2.0
8435,CN3801700000000,38,17,"Cass County, ND",May-19,102622,100795,1827,1.8
8436,CN3801900000000,38,19,"Cavalier County, ND",May-19,1934,1890,44,2.3
8437,CN3802100000000,38,21,"Dickey County, ND",May-19,2308,2268,40,1.7
8438,CN3802300000000,38,23,"Divide County, ND",May-19,1464,1444,20,1.4
8439,CN3802500000000,38,25,"Dunn County, ND",May-19,3179,3131,48,1.5
8440,CN3802700000000,38,27,"Eddy County, ND",May-19,1252,1196,56,4.5
8441,CN3802900000000,38,29,"Emmons County, ND",May-19,1450,1397,53,3.7
8442,CN3803100000000,38,31,"Foster County, ND",May-19,1528,1492,36,2.4
8443,CN3803300000000,38,33,"Golden Valley County, ND",May-19,850,836,14,1.6
8444,CN3803500000000,38,35,"Grand Forks County, ND",May-19,37080,36371,709,1.9
8445,CN3803700000000,38,37,"Grant County, ND",May-19,1176,1149,27,2.3
8446,CN3803900000000,38,39,"Griggs County, ND",May-19,1030,1008,22,2.1
8447,CN3804100000000,38,41,"Hettinger County, ND",May-19,1384,1364,20,1.4
8448,CN3804300000000,38,43,"Kidder County, ND",May-19,1244,1197,47,3.8
8449,CN3804500000000,38,45,"LaMoure County, ND",May-19,2095,2055,40,1.9
8450,CN3804700000000,38,47,"Logan County, ND",May-19,859,840,19,2.2
8451,CN3804900000000,38,49,"McHenry County, ND",May-19,3071,2988,83,2.7
8452,CN3805100000000,38,51,"McIntosh County, ND",May-19,1126,1093,33,2.9
8453,CN3805300000000,38,53,"McKenzie County, ND",May-19,10417,10286,131,1.3
8454,CN3805500000000,38,55,"McLean County, ND",May-19,4771,4647,124,2.6
8455,CN3805700000000,38,57,"Mercer County, ND",May-19,3909,3787,122,3.1
8456,CN3805900000000,38,59,"Morton County, ND",May-19,16138,15764,374,2.3
8457,CN3806100000000,38,61,"Mountrail County, ND",May-19,7266,7186,80,1.1
8458,CN3806300000000,38,63,"Nelson County, ND",May-19,1395,1359,36,2.6
8459,CN3806500000000,38,65,"Oliver County, ND",May-19,855,829,26,3.0
8460,CN3806700000000,38,67,"Pembina County, ND",May-19,3330,3222,108,3.2
8461,CN3806900000000,38,69,"Pierce County, ND",May-19,1758,1711,47,2.7
8462,CN3807100000000,38,71,"Ramsey County, ND",May-19,5568,5420,148,2.7
8463,CN3807300000000,38,73,"Ransom County, ND",May-19,2779,2737,42,1.5
8464,CN3807500000000,38,75,"Renville County, ND",May-19,1205,1175,30,2.5
8465,CN3807700000000,38,77,"Richland County, ND",May-19,8528,8351,177,2.1
8466,CN3807900000000,38,79,"Rolette County, ND",May-19,4487,4215,272,6.1
8467,CN3808100000000,38,81,"Sargent County, ND",May-19,2577,2537,40,1.6
8468,CN3808300000000,38,83,"Sheridan County, ND",May-19,692,674,18,2.6
8469,CN3808500000000,38,85,"Sioux County, ND",May-19,1235,1185,50,4.0
8470,CN3808700000000,38,87,"Slope County, ND",May-19,386,378,8,2.1
8471,CN3808900000000,38,89,"Stark County, ND",May-19,18609,18286,323,1.7
8472,CN3809100000000,38,91,"Steele County, ND",May-19,969,949,20,2.1
8473,CN3809300000000,38,93,"Stutsman County, ND",May-19,10229,10024,205,2.0
8474,CN3809500000000,38,95,"Towner County, ND",May-19,1183,1156,27,2.3
8475,CN3809700000000,38,97,"Traill County, ND",May-19,4366,4249,117,2.7
8476,CN3809900000000,38,99,"Walsh County, ND",May-19,5181,5032,149,2.9
8477,CN3810100000000,38,101,"Ward County, ND",May-19,31527,30846,681,2.2
8478,CN3810300000000,38,103,"Wells County, ND",May-19,1927,1878,49,2.5
8479,CN3810500000000,38,105,"Williams County, ND",May-19,24122,23736,386,1.6
8480,CN3900100000000,39,1,"Adams County, OH",May-19,10643,10063,580,5.4
8481,CN3900300000000,39,3,"Allen County, OH",May-19,47927,46296,1631,3.4
8482,CN3900500000000,39,5,"Ashland County, OH",May-19,26601,25675,926,3.5
8483,CN3900700000000,39,7,"Ashtabula County, OH",May-19,44478,42758,1720,3.9
8484,CN3900900000000,39,9,"Athens County, OH",May-19,25784,24580,1204,4.7
8485,CN3901100000000,39,11,"Auglaize County, OH",May-19,25079,24417,662,2.6
8486,CN3901300000000,39,13,"Belmont County, OH",May-19,29966,28614,1352,4.5
8487,CN3901500000000,39,15,"Brown County, OH",May-19,19413,18636,777,4.0
8488,CN3901700000000,39,17,"Butler County, OH",May-19,193937,187606,6331,3.3
8489,CN3901900000000,39,19,"Carroll County, OH",May-19,12980,12408,572,4.4
8490,CN3902100000000,39,21,"Champaign County, OH",May-19,20144,19529,615,3.1
8491,CN3902300000000,39,23,"Clark County, OH",May-19,63202,60959,2243,3.5
8492,CN3902500000000,39,25,"Clermont County, OH",May-19,106197,102769,3428,3.2
8493,CN3902700000000,39,27,"Clinton County, OH",May-19,17477,16759,718,4.1
8494,CN3902900000000,39,29,"Columbiana County, OH",May-19,47278,45296,1982,4.2
8495,CN3903100000000,39,31,"Coshocton County, OH",May-19,14465,13711,754,5.2
8496,CN3903300000000,39,33,"Crawford County, OH",May-19,18315,17597,718,3.9
8497,CN3903500000000,39,35,"Cuyahoga County, OH",May-19,610757,586088,24669,4.0
8498,CN3903700000000,39,37,"Darke County, OH",May-19,26076,25285,791,3.0
8499,CN3903900000000,39,39,"Defiance County, OH",May-19,18042,17387,655,3.6
8500,CN3904100000000,39,41,"Delaware County, OH",May-19,109530,106485,3045,2.8
8501,CN3904300000000,39,43,"Erie County, OH",May-19,37862,36402,1460,3.9
8502,CN3904500000000,39,45,"Fairfield County, OH",May-19,77484,74935,2549,3.3
8503,CN3904700000000,39,47,"Fayette County, OH",May-19,13850,13376,474,3.4
8504,CN3904900000000,39,49,"Franklin County, OH",May-19,692216,670275,21941,3.2
8505,CN3905100000000,39,51,"Fulton County, OH",May-19,22541,21732,809,3.6
8506,CN3905300000000,39,53,"Gallia County, OH",May-19,11962,11431,531,4.4
8507,CN3905500000000,39,55,"Geauga County, OH",May-19,48949,47411,1538,3.1
8508,CN3905700000000,39,57,"Greene County, OH",May-19,82835,80088,2747,3.3
8509,CN3905900000000,39,59,"Guernsey County, OH",May-19,18604,17800,804,4.3
8510,CN3906100000000,39,61,"Hamilton County, OH",May-19,413795,399880,13915,3.4
8511,CN3906300000000,39,63,"Hancock County, OH",May-19,41692,40488,1204,2.9
8512,CN3906500000000,39,65,"Hardin County, OH",May-19,14141,13629,512,3.6
8513,CN3906700000000,39,67,"Harrison County, OH",May-19,6791,6506,285,4.2
8514,CN3906900000000,39,69,"Henry County, OH",May-19,13242,12749,493,3.7
8515,CN3907100000000,39,71,"Highland County, OH",May-19,17039,16311,728,4.3
8516,CN3907300000000,39,73,"Hocking County, OH",May-19,12920,12432,488,3.8
8517,CN3907500000000,39,75,"Holmes County, OH",May-19,21082,20541,541,2.6
8518,CN3907700000000,39,77,"Huron County, OH",May-19,28018,26824,1194,4.3
8519,CN3907900000000,39,79,"Jackson County, OH",May-19,12729,12071,658,5.2
8520,CN3908100000000,39,81,"Jefferson County, OH",May-19,27453,26107,1346,4.9
8521,CN3908300000000,39,83,"Knox County, OH",May-19,31360,30324,1036,3.3
8522,CN3908500000000,39,85,"Lake County, OH",May-19,125860,121538,4322,3.4
8523,CN3908700000000,39,87,"Lawrence County, OH",May-19,23573,22520,1053,4.5
8524,CN3908900000000,39,89,"Licking County, OH",May-19,89826,86927,2899,3.2
8525,CN3909100000000,39,91,"Logan County, OH",May-19,22952,22259,693,3.0
8526,CN3909300000000,39,93,"Lorain County, OH",May-19,152990,147055,5935,3.9
8527,CN3909500000000,39,95,"Lucas County, OH",May-19,213172,201455,11717,5.5
8528,CN3909700000000,39,97,"Madison County, OH",May-19,20725,20118,607,2.9
8529,CN3909900000000,39,99,"Mahoning County, OH",May-19,103061,97695,5366,5.2
8530,CN3910100000000,39,101,"Marion County, OH",May-19,28782,27770,1012,3.5
8531,CN3910300000000,39,103,"Medina County, OH",May-19,97318,94180,3138,3.2
8532,CN3910500000000,39,105,"Meigs County, OH",May-19,8927,8397,530,5.9
8533,CN3910700000000,39,107,"Mercer County, OH",May-19,23770,23234,536,2.3
8534,CN3910900000000,39,109,"Miami County, OH",May-19,53848,52119,1729,3.2
8535,CN3911100000000,39,111,"Monroe County, OH",May-19,5325,4947,378,7.1
8536,CN3911300000000,39,113,"Montgomery County, OH",May-19,251188,241531,9657,3.8
8537,CN3911500000000,39,115,"Morgan County, OH",May-19,6753,6416,337,5.0
8538,CN3911700000000,39,117,"Morrow County, OH",May-19,16653,16088,565,3.4
8539,CN3911900000000,39,119,"Muskingum County, OH",May-19,39318,37742,1576,4.0
8540,CN3912100000000,39,121,"Noble County, OH",May-19,4695,4426,269,5.7
8541,CN3912300000000,39,123,"Ottawa County, OH",May-19,21407,20521,886,4.1
8542,CN3912500000000,39,125,"Paulding County, OH",May-19,8694,8409,285,3.3
8543,CN3912700000000,39,127,"Perry County, OH",May-19,15717,15062,655,4.2
8544,CN3912900000000,39,129,"Pickaway County, OH",May-19,26279,25375,904,3.4
8545,CN3913100000000,39,131,"Pike County, OH",May-19,10824,10290,534,4.9
8546,CN3913300000000,39,133,"Portage County, OH",May-19,86732,83673,3059,3.5
8547,CN3913500000000,39,135,"Preble County, OH",May-19,21046,20362,684,3.3
8548,CN3913700000000,39,137,"Putnam County, OH",May-19,19010,18526,484,2.5
8549,CN3913900000000,39,139,"Richland County, OH",May-19,52363,50390,1973,3.8
8550,CN3914100000000,39,141,"Ross County, OH",May-19,35309,34062,1247,3.5
8551,CN3914300000000,39,143,"Sandusky County, OH",May-19,30456,29402,1054,3.5
8552,CN3914500000000,39,145,"Scioto County, OH",May-19,28744,27209,1535,5.3
8553,CN3914700000000,39,147,"Seneca County, OH",May-19,27373,26304,1069,3.9
8554,CN3914900000000,39,149,"Shelby County, OH",May-19,24258,23512,746,3.1
8555,CN3915100000000,39,151,"Stark County, OH",May-19,185679,178255,7424,4.0
8556,CN3915300000000,39,153,"Summit County, OH",May-19,270730,260755,9975,3.7
8557,CN3915500000000,39,155,"Trumbull County, OH",May-19,86618,81845,4773,5.5
8558,CN3915700000000,39,157,"Tuscarawas County, OH",May-19,45193,43514,1679,3.7
8559,CN3915900000000,39,159,"Union County, OH",May-19,28848,28045,803,2.8
8560,CN3916100000000,39,161,"Van Wert County, OH",May-19,15128,14716,412,2.7
8561,CN3916300000000,39,163,"Vinton County, OH",May-19,5563,5316,247,4.4
8562,CN3916500000000,39,165,"Warren County, OH",May-19,118589,114921,3668,3.1
8563,CN3916700000000,39,167,"Washington County, OH",May-19,27281,26047,1234,4.5
8564,CN3916900000000,39,169,"Wayne County, OH",May-19,62160,60443,1717,2.8
8565,CN3917100000000,39,171,"Williams County, OH",May-19,18933,18414,519,2.7
8566,CN3917300000000,39,173,"Wood County, OH",May-19,71488,68968,2520,3.5
8567,CN3917500000000,39,175,"Wyandot County, OH",May-19,13108,12631,477,3.6
8568,CN4000100000000,40,1,"Adair County, OK",May-19,8038,7708,330,4.1
8569,CN4000300000000,40,3,"Alfalfa County, OK",May-19,2853,2802,51,1.8
8570,CN4000500000000,40,5,"Atoka County, OK",May-19,4896,4686,210,4.3
8571,CN4000700000000,40,7,"Beaver County, OK",May-19,2892,2834,58,2.0
8572,CN4000900000000,40,9,"Beckham County, OK",May-19,10687,10404,283,2.6
8573,CN4001100000000,40,11,"Blaine County, OK",May-19,4780,4692,88,1.8
8574,CN4001300000000,40,13,"Bryan County, OK",May-19,21291,20640,651,3.1
8575,CN4001500000000,40,15,"Caddo County, OK",May-19,11710,11319,391,3.3
8576,CN4001700000000,40,17,"Canadian County, OK",May-19,73747,71743,2004,2.7
8577,CN4001900000000,40,19,"Carter County, OK",May-19,21688,20973,715,3.3
8578,CN4002100000000,40,21,"Cherokee County, OK",May-19,18938,18198,740,3.9
8579,CN4002300000000,40,23,"Choctaw County, OK",May-19,5415,5162,253,4.7
8580,CN4002500000000,40,25,"Cimarron County, OK",May-19,1291,1270,21,1.6
8581,CN4002700000000,40,27,"Cleveland County, OK",May-19,142229,138221,4008,2.8
8582,CN4002900000000,40,29,"Coal County, OK",May-19,2634,2545,89,3.4
8583,CN4003100000000,40,31,"Comanche County, OK",May-19,48114,46429,1685,3.5
8584,CN4003300000000,40,33,"Cotton County, OK",May-19,2704,2621,83,3.1
8585,CN4003500000000,40,35,"Craig County, OK",May-19,5921,5719,202,3.4
8586,CN4003700000000,40,37,"Creek County, OK",May-19,31480,30361,1119,3.6
8587,CN4003900000000,40,39,"Custer County, OK",May-19,15721,15355,366,2.3
8588,CN4004100000000,40,41,"Delaware County, OK",May-19,18039,17382,657,3.6
8589,CN4004300000000,40,43,"Dewey County, OK",May-19,2985,2935,50,1.7
8590,CN4004500000000,40,45,"Ellis County, OK",May-19,2180,2130,50,2.3
8591,CN4004700000000,40,47,"Garfield County, OK",May-19,27053,26271,782,2.9
8592,CN4004900000000,40,49,"Garvin County, OK",May-19,12559,12173,386,3.1
8593,CN4005100000000,40,51,"Grady County, OK",May-19,26272,25510,762,2.9
8594,CN4005300000000,40,53,"Grant County, OK",May-19,2641,2581,60,2.3
8595,CN4005500000000,40,55,"Greer County, OK",May-19,1813,1745,68,3.8
8596,CN4005700000000,40,57,"Harmon County, OK",May-19,1153,1119,34,2.9
8597,CN4005900000000,40,59,"Harper County, OK",May-19,1721,1670,51,3.0
8598,CN4006100000000,40,61,"Haskell County, OK",May-19,4240,4047,193,4.6
8599,CN4006300000000,40,63,"Hughes County, OK",May-19,5355,5101,254,4.7
8600,CN4006500000000,40,65,"Jackson County, OK",May-19,10589,10283,306,2.9
8601,CN4006700000000,40,67,"Jefferson County, OK",May-19,2500,2424,76,3.0
8602,CN4006900000000,40,69,"Johnston County, OK",May-19,3766,3618,148,3.9
8603,CN4007100000000,40,71,"Kay County, OK",May-19,18349,17565,784,4.3
8604,CN4007300000000,40,73,"Kingfisher County, OK",May-19,9150,8961,189,2.1
8605,CN4007500000000,40,75,"Kiowa County, OK",May-19,3466,3341,125,3.6
8606,CN4007700000000,40,77,"Latimer County, OK",May-19,3151,2979,172,5.5
8607,CN4007900000000,40,79,"Le Flore County, OK",May-19,19040,18178,862,4.5
8608,CN4008100000000,40,81,"Lincoln County, OK",May-19,15691,15152,539,3.4
8609,CN4008300000000,40,83,"Logan County, OK",May-19,21957,21329,628,2.9
8610,CN4008500000000,40,85,"Love County, OK",May-19,6168,6034,134,2.2
8611,CN4008700000000,40,87,"McClain County, OK",May-19,19477,18981,496,2.5
8612,CN4008900000000,40,89,"McCurtain County, OK",May-19,14126,13363,763,5.4
8613,CN4009100000000,40,91,"McIntosh County, OK",May-19,7172,6802,370,5.2
8614,CN4009300000000,40,93,"Major County, OK",May-19,3863,3786,77,2.0
8615,CN4009500000000,40,95,"Marshall County, OK",May-19,6861,6634,227,3.3
8616,CN4009700000000,40,97,"Mayes County, OK",May-19,19469,18854,615,3.2
8617,CN4009900000000,40,99,"Murray County, OK",May-19,6377,6201,176,2.8
8618,CN4010100000000,40,101,"Muskogee County, OK",May-19,29291,28180,1111,3.8
8619,CN4010300000000,40,103,"Noble County, OK",May-19,5689,5551,138,2.4
8620,CN4010500000000,40,105,"Nowata County, OK",May-19,4595,4432,163,3.5
8621,CN4010700000000,40,107,"Okfuskee County, OK",May-19,4673,4468,205,4.4
8622,CN4010900000000,40,109,"Oklahoma County, OK",May-19,382977,371217,11760,3.1
8623,CN4011100000000,40,111,"Okmulgee County, OK",May-19,15620,14867,753,4.8
8624,CN4011300000000,40,113,"Osage County, OK",May-19,20579,19813,766,3.7
8625,CN4011500000000,40,115,"Ottawa County, OK",May-19,14157,13664,493,3.5
8626,CN4011700000000,40,117,"Pawnee County, OK",May-19,7322,7043,279,3.8
8627,CN4011900000000,40,119,"Payne County, OK",May-19,38202,37051,1151,3.0
8628,CN4012100000000,40,121,"Pittsburg County, OK",May-19,17287,16629,658,3.8
8629,CN4012300000000,40,123,"Pontotoc County, OK",May-19,19093,18550,543,2.8
8630,CN4012500000000,40,125,"Pottawatomie County, OK",May-19,32350,31181,1169,3.6
8631,CN4012700000000,40,127,"Pushmataha County, OK",May-19,4249,4050,199,4.7
8632,CN4012900000000,40,129,"Roger Mills County, OK",May-19,1884,1837,47,2.5
8633,CN4013100000000,40,131,"Rogers County, OK",May-19,44923,43555,1368,3.0
8634,CN4013300000000,40,133,"Seminole County, OK",May-19,9391,8977,414,4.4
8635,CN4013500000000,40,135,"Sequoyah County, OK",May-19,16158,15546,612,3.8
8636,CN4013700000000,40,137,"Stephens County, OK",May-19,18458,17725,733,4.0
8637,CN4013900000000,40,139,"Texas County, OK",May-19,10992,10766,226,2.1
8638,CN4014100000000,40,141,"Tillman County, OK",May-19,2966,2865,101,3.4
8639,CN4014300000000,40,143,"Tulsa County, OK",May-19,322365,312440,9925,3.1
8640,CN4014500000000,40,145,"Wagoner County, OK",May-19,37788,36667,1121,3.0
8641,CN4014700000000,40,147,"Washington County, OK",May-19,22177,21443,734,3.3
8642,CN4014900000000,40,149,"Washita County, OK",May-19,5190,5034,156,3.0
8643,CN4015100000000,40,151,"Woods County, OK",May-19,4595,4498,97,2.1
8644,CN4015300000000,40,153,"Woodward County, OK",May-19,9083,8855,228,2.5
8645,CN4100100000000,41,1,"Baker County, OR",May-19,7083,6796,287,4.1
8646,CN4100300000000,41,3,"Benton County, OR",May-19,48453,47186,1267,2.6
8647,CN4100500000000,41,5,"Clackamas County, OR",May-19,217809,210914,6895,3.2
8648,CN4100700000000,41,7,"Clatsop County, OR",May-19,19465,18806,659,3.4
8649,CN4100900000000,41,9,"Columbia County, OR",May-19,24246,23232,1014,4.2
8650,CN4101100000000,41,11,"Coos County, OR",May-19,26244,25057,1187,4.5
8651,CN4101300000000,41,13,"Crook County, OR",May-19,9536,9081,455,4.8
8652,CN4101500000000,41,15,"Curry County, OR",May-19,8832,8425,407,4.6
8653,CN4101700000000,41,17,"Deschutes County, OR",May-19,95754,92455,3299,3.4
8654,CN4101900000000,41,19,"Douglas County, OR",May-19,45903,43868,2035,4.4
8655,CN4102100000000,41,21,"Gilliam County, OR",May-19,995,963,32,3.2
8656,CN4102300000000,41,23,"Grant County, OR",May-19,3158,2978,180,5.7
8657,CN4102500000000,41,25,"Harney County, OR",May-19,3594,3431,163,4.5
8658,CN4102700000000,41,27,"Hood River County, OR",May-19,13665,13253,412,3.0
8659,CN4102900000000,41,29,"Jackson County, OR",May-19,102918,98748,4170,4.1
8660,CN4103100000000,41,31,"Jefferson County, OR",May-19,10269,9838,431,4.2
8661,CN4103300000000,41,33,"Josephine County, OR",May-19,35781,34163,1618,4.5
8662,CN4103500000000,41,35,"Klamath County, OR",May-19,29449,27955,1494,5.1
8663,CN4103700000000,41,37,"Lake County, OR",May-19,3587,3417,170,4.7
8664,CN4103900000000,41,39,"Lane County, OR",May-19,180388,173668,6720,3.7
8665,CN4104100000000,41,41,"Lincoln County, OR",May-19,21018,20216,802,3.8
8666,CN4104300000000,41,43,"Linn County, OR",May-19,58533,56217,2316,4.0
8667,CN4104500000000,41,45,"Malheur County, OR",May-19,12240,11801,439,3.6
8668,CN4104700000000,41,47,"Marion County, OR",May-19,160870,154969,5901,3.7
8669,CN4104900000000,41,49,"Morrow County, OR",May-19,5713,5523,190,3.3
8670,CN4105100000000,41,51,"Multnomah County, OR",May-19,451939,437953,13986,3.1
8671,CN4105300000000,41,53,"Polk County, OR",May-19,39515,38032,1483,3.8
8672,CN4105500000000,41,55,"Sherman County, OR",May-19,908,880,28,3.1
8673,CN4105700000000,41,57,"Tillamook County, OR",May-19,11896,11483,413,3.5
8674,CN4105900000000,41,59,"Umatilla County, OR",May-19,37004,35565,1439,3.9
8675,CN4106100000000,41,61,"Union County, OR",May-19,11989,11508,481,4.0
8676,CN4106300000000,41,63,"Wallowa County, OR",May-19,3446,3263,183,5.3
8677,CN4106500000000,41,65,"Wasco County, OR",May-19,12620,12138,482,3.8
8678,CN4106700000000,41,67,"Washington County, OR",May-19,322589,313340,9249,2.9
8679,CN4106900000000,41,69,"Wheeler County, OR",May-19,734,703,31,4.2
8680,CN4107100000000,41,71,"Yamhill County, OR",May-19,54433,52761,1672,3.1
8681,CN4200100000000,42,1,"Adams County, PA",May-19,55202,53566,1636,3.0
8682,CN4200300000000,42,3,"Allegheny County, PA",May-19,645320,620491,24829,3.8
8683,CN4200500000000,42,5,"Armstrong County, PA",May-19,31858,30589,1269,4.0
8684,CN4200700000000,42,7,"Beaver County, PA",May-19,83546,80074,3472,4.2
8685,CN4200900000000,42,9,"Bedford County, PA",May-19,23747,22883,864,3.6
8686,CN4201100000000,42,11,"Berks County, PA",May-19,215269,206516,8753,4.1
8687,CN4201300000000,42,13,"Blair County, PA",May-19,59231,56970,2261,3.8
8688,CN4201500000000,42,15,"Bradford County, PA",May-19,29000,27937,1063,3.7
8689,CN4201700000000,42,17,"Bucks County, PA",May-19,342764,330483,12281,3.6
8690,CN4201900000000,42,19,"Butler County, PA",May-19,99167,95769,3398,3.4
8691,CN4202100000000,42,21,"Cambria County, PA",May-19,57872,55196,2676,4.6
8692,CN4202300000000,42,23,"Cameron County, PA",May-19,2093,1992,101,4.8
8693,CN4202500000000,42,25,"Carbon County, PA",May-19,31940,30430,1510,4.7
8694,CN4202700000000,42,27,"Centre County, PA",May-19,80537,77900,2637,3.3
8695,CN4202900000000,42,29,"Chester County, PA",May-19,285817,277199,8618,3.0
8696,CN4203100000000,42,31,"Clarion County, PA",May-19,16940,16217,723,4.3
8697,CN4203300000000,42,33,"Clearfield County, PA",May-19,35633,34139,1494,4.2
8698,CN4203500000000,42,35,"Clinton County, PA",May-19,18151,17272,879,4.8
8699,CN4203700000000,42,37,"Columbia County, PA",May-19,33102,31567,1535,4.6
8700,CN4203900000000,42,39,"Crawford County, PA",May-19,38918,37277,1641,4.2
8701,CN4204100000000,42,41,"Cumberland County, PA",May-19,131431,127290,4141,3.2
8702,CN4204300000000,42,43,"Dauphin County, PA",May-19,143294,137960,5334,3.7
8703,CN4204500000000,42,45,"Delaware County, PA",May-19,297218,285654,11564,3.9
8704,CN4204700000000,42,47,"Elk County, PA",May-19,15676,15031,645,4.1
8705,CN4204900000000,42,49,"Erie County, PA",May-19,127955,122691,5264,4.1
8706,CN4205100000000,42,51,"Fayette County, PA",May-19,56464,53688,2776,4.9
8707,CN4205300000000,42,53,"Forest County, PA",May-19,1810,1717,93,5.1
8708,CN4205500000000,42,55,"Franklin County, PA",May-19,77185,74508,2677,3.5
8709,CN4205700000000,42,57,"Fulton County, PA",May-19,7842,7566,276,3.5
8710,CN4205900000000,42,59,"Greene County, PA",May-19,16461,15698,763,4.6
8711,CN4206100000000,42,61,"Huntingdon County, PA",May-19,19954,19062,892,4.5
8712,CN4206300000000,42,63,"Indiana County, PA",May-19,39078,37378,1700,4.4
8713,CN4206500000000,42,65,"Jefferson County, PA",May-19,20572,19776,796,3.9
8714,CN4206700000000,42,67,"Juniata County, PA",May-19,12517,12057,460,3.7
8715,CN4206900000000,42,69,"Lackawanna County, PA",May-19,104226,99529,4697,4.5
8716,CN4207100000000,42,71,"Lancaster County, PA",May-19,283772,274746,9026,3.2
8717,CN4207300000000,42,73,"Lawrence County, PA",May-19,40604,38837,1767,4.4
8718,CN4207500000000,42,75,"Lebanon County, PA",May-19,72444,69914,2530,3.5
8719,CN4207700000000,42,77,"Lehigh County, PA",May-19,192177,183998,8179,4.3
8720,CN4207900000000,42,79,"Luzerne County, PA",May-19,156061,147935,8126,5.2
8721,CN4208100000000,42,81,"Lycoming County, PA",May-19,56285,53845,2440,4.3
8722,CN4208300000000,42,83,"McKean County, PA",May-19,17351,16570,781,4.5
8723,CN4208500000000,42,85,"Mercer County, PA",May-19,49226,47049,2177,4.4
8724,CN4208700000000,42,87,"Mifflin County, PA",May-19,21008,20195,813,3.9
8725,CN4208900000000,42,89,"Monroe County, PA",May-19,82569,78455,4114,5.0
8726,CN4209100000000,42,91,"Montgomery County, PA",May-19,453174,438252,14922,3.3
8727,CN4209300000000,42,93,"Montour County, PA",May-19,8991,8691,300,3.3
8728,CN4209500000000,42,95,"Northampton County, PA",May-19,160818,154093,6725,4.2
8729,CN4209700000000,42,97,"Northumberland County, PA",May-19,43542,41369,2173,5.0
8730,CN4209900000000,42,99,"Perry County, PA",May-19,24355,23585,770,3.2
8731,CN4210100000000,42,101,"Philadelphia County/city, PA",May-19,714610,677228,37382,5.2
8732,CN4210300000000,42,103,"Pike County, PA",May-19,25064,23794,1270,5.1
8733,CN4210500000000,42,105,"Potter County, PA",May-19,7242,6899,343,4.7
8734,CN4210700000000,42,107,"Schuylkill County, PA",May-19,66167,62985,3182,4.8
8735,CN4210900000000,42,109,"Snyder County, PA",May-19,20507,19220,1287,6.3
8736,CN4211100000000,42,111,"Somerset County, PA",May-19,33343,31922,1421,4.3
8737,CN4211300000000,42,113,"Sullivan County, PA",May-19,2670,2561,109,4.1
8738,CN4211500000000,42,115,"Susquehanna County, PA",May-19,20557,19790,767,3.7
8739,CN4211700000000,42,117,"Tioga County, PA",May-19,19139,18271,868,4.5
8740,CN4211900000000,42,119,"Union County, PA",May-19,20159,19323,836,4.1
8741,CN4212100000000,42,121,"Venango County, PA",May-19,22490,21541,949,4.2
8742,CN4212300000000,42,123,"Warren County, PA",May-19,18969,18221,748,3.9
8743,CN4212500000000,42,125,"Washington County, PA",May-19,106350,102099,4251,4.0
8744,CN4212700000000,42,127,"Wayne County, PA",May-19,22071,21187,884,4.0
8745,CN4212900000000,42,129,"Westmoreland County, PA",May-19,179556,172627,6929,3.9
8746,CN4213100000000,42,131,"Wyoming County, PA",May-19,13504,12909,595,4.4
8747,CN4213300000000,42,133,"York County, PA",May-19,234833,226589,8244,3.5
8748,CN4400100000000,44,1,"Bristol County, RI",May-19,25770,25061,709,2.8
8749,CN4400300000000,44,3,"Kent County, RI",May-19,89848,87243,2605,2.9
8750,CN4400500000000,44,5,"Newport County, RI",May-19,43814,42625,1189,2.7
8751,CN4400700000000,44,7,"Providence County, RI",May-19,322636,310889,11747,3.6
8752,CN4400900000000,44,9,"Washington County, RI",May-19,68246,66345,1901,2.8
8753,CN4500100000000,45,1,"Abbeville County, SC",May-19,10063,9750,313,3.1
8754,CN4500300000000,45,3,"Aiken County, SC",May-19,75187,73008,2179,2.9
8755,CN4500500000000,45,5,"Allendale County, SC",May-19,2736,2604,132,4.8
8756,CN4500700000000,45,7,"Anderson County, SC",May-19,91292,88883,2409,2.6
8757,CN4500900000000,45,9,"Bamberg County, SC",May-19,5059,4800,259,5.1
8758,CN4501100000000,45,11,"Barnwell County, SC",May-19,8310,7975,335,4.0
8759,CN4501300000000,45,13,"Beaufort County, SC",May-19,78297,76246,2051,2.6
8760,CN4501500000000,45,15,"Berkeley County, SC",May-19,104410,101831,2579,2.5
8761,CN4501700000000,45,17,"Calhoun County, SC",May-19,6600,6386,214,3.2
8762,CN4501900000000,45,19,"Charleston County, SC",May-19,212703,207919,4784,2.2
8763,CN4502100000000,45,21,"Cherokee County, SC",May-19,25139,24400,739,2.9
8764,CN4502300000000,45,23,"Chester County, SC",May-19,13379,12862,517,3.9
8765,CN4502500000000,45,25,"Chesterfield County, SC",May-19,22389,21789,600,2.7
8766,CN4502700000000,45,27,"Clarendon County, SC",May-19,12952,12481,471,3.6
8767,CN4502900000000,45,29,"Colleton County, SC",May-19,16933,16426,507,3.0
8768,CN4503100000000,45,31,"Darlington County, SC",May-19,30620,29624,996,3.3
8769,CN4503300000000,45,33,"Dillon County, SC",May-19,13058,12574,484,3.7
8770,CN4503500000000,45,35,"Dorchester County, SC",May-19,78487,76563,1924,2.5
8771,CN4503700000000,45,37,"Edgefield County, SC",May-19,10825,10529,296,2.7
8772,CN4503900000000,45,39,"Fairfield County, SC",May-19,9587,9195,392,4.1
8773,CN4504100000000,45,41,"Florence County, SC",May-19,67211,65322,1889,2.8
8774,CN4504300000000,45,43,"Georgetown County, SC",May-19,26337,25460,877,3.3
8775,CN4504500000000,45,45,"Greenville County, SC",May-19,255031,248920,6111,2.4
8776,CN4504700000000,45,47,"Greenwood County, SC",May-19,31492,30540,952,3.0
8777,CN4504900000000,45,49,"Hampton County, SC",May-19,8569,8350,219,2.6
8778,CN4505100000000,45,51,"Horry County, SC",May-19,151028,146195,4833,3.2
8779,CN4505300000000,45,53,"Jasper County, SC",May-19,12822,12503,319,2.5
8780,CN4505500000000,45,55,"Kershaw County, SC",May-19,29229,28423,806,2.8
8781,CN4505700000000,45,57,"Lancaster County, SC",May-19,41173,39866,1307,3.2
8782,CN4505900000000,45,59,"Laurens County, SC",May-19,30265,29392,873,2.9
8783,CN4506100000000,45,61,"Lee County, SC",May-19,6579,6347,232,3.5
8784,CN4506300000000,45,63,"Lexington County, SC",May-19,149887,146427,3460,2.3
8785,CN4506500000000,45,65,"McCormick County, SC",May-19,3403,3311,92,2.7
8786,CN4506700000000,45,67,"Marion County, SC",May-19,13165,12665,500,3.8
8787,CN4506900000000,45,69,"Marlboro County, SC",May-19,9143,8763,380,4.2
8788,CN4507100000000,45,71,"Newberry County, SC",May-19,19445,18957,488,2.5
8789,CN4507300000000,45,73,"Oconee County, SC",May-19,35142,34195,947,2.7
8790,CN4507500000000,45,75,"Orangeburg County, SC",May-19,34808,33376,1432,4.1
8791,CN4507700000000,45,77,"Pickens County, SC",May-19,57511,55921,1590,2.8
8792,CN4507900000000,45,79,"Richland County, SC",May-19,197929,192519,5410,2.7
8793,CN4508100000000,45,81,"Saluda County, SC",May-19,9063,8832,231,2.5
8794,CN4508300000000,45,83,"Spartanburg County, SC",May-19,153077,149286,3791,2.5
8795,CN4508500000000,45,85,"Sumter County, SC",May-19,43736,42343,1393,3.2
8796,CN4508700000000,45,87,"Union County, SC",May-19,11649,11259,390,3.3
8797,CN4508900000000,45,89,"Williamsburg County, SC",May-19,12184,11699,485,4.0
8798,CN4509100000000,45,91,"York County, SC",May-19,139825,136106,3719,2.7
8799,CN4600300000000,46,3,"Aurora County, SD",May-19,1532,1492,40,2.6
8800,CN4600500000000,46,5,"Beadle County, SD",May-19,9730,9443,287,2.9
8801,CN4600700000000,46,7,"Bennett County, SD",May-19,1074,1018,56,5.2
8802,CN4600900000000,46,9,"Bon Homme County, SD",May-19,2837,2752,85,3.0
8803,CN4601100000000,46,11,"Brookings County, SD",May-19,18957,18334,623,3.3
8804,CN4601300000000,46,13,"Brown County, SD",May-19,20925,20309,616,2.9
8805,CN4601500000000,46,15,"Brule County, SD",May-19,2462,2386,76,3.1
8806,CN4601700000000,46,17,"Buffalo County, SD",May-19,678,641,37,5.5
8807,CN4601900000000,46,19,"Butte County, SD",May-19,5019,4855,164,3.3
8808,CN4602100000000,46,21,"Campbell County, SD",May-19,764,735,29,3.8
8809,CN4602300000000,46,23,"Charles Mix County, SD",May-19,3802,3662,140,3.7
8810,CN4602500000000,46,25,"Clark County, SD",May-19,1903,1835,68,3.6
8811,CN4602700000000,46,27,"Clay County, SD",May-19,7060,6819,241,3.4
8812,CN4602900000000,46,29,"Codington County, SD",May-19,15468,14999,469,3.0
8813,CN4603100000000,46,31,"Corson County, SD",May-19,1357,1270,87,6.4
8814,CN4603300000000,46,33,"Custer County, SD",May-19,3986,3827,159,4.0
8815,CN4603500000000,46,35,"Davison County, SD",May-19,11112,10805,307,2.8
8816,CN4603700000000,46,37,"Day County, SD",May-19,2785,2681,104,3.7
8817,CN4603900000000,46,39,"Deuel County, SD",May-19,2185,2094,91,4.2
8818,CN4604100000000,46,41,"Dewey County, SD",May-19,2135,2018,117,5.5
8819,CN4604300000000,46,43,"Douglas County, SD",May-19,1579,1539,40,2.5
8820,CN4604500000000,46,45,"Edmunds County, SD",May-19,2041,1982,59,2.9
8821,CN4604700000000,46,47,"Fall River County, SD",May-19,3056,2935,121,4.0
8822,CN4604900000000,46,49,"Faulk County, SD",May-19,1037,1004,33,3.2
8823,CN4605100000000,46,51,"Grant County, SD",May-19,4436,4318,118,2.7
8824,CN4605300000000,46,53,"Gregory County, SD",May-19,2061,1993,68,3.3
8825,CN4605500000000,46,55,"Haakon County, SD",May-19,1042,1012,30,2.9
8826,CN4605700000000,46,57,"Hamlin County, SD",May-19,3284,3187,97,3.0
8827,CN4605900000000,46,59,"Hand County, SD",May-19,1792,1746,46,2.6
8828,CN4606100000000,46,61,"Hanson County, SD",May-19,1721,1656,65,3.8
8829,CN4606300000000,46,63,"Harding County, SD",May-19,712,692,20,2.8
8830,CN4606500000000,46,65,"Hughes County, SD",May-19,10137,9885,252,2.5
8831,CN4606700000000,46,67,"Hutchinson County, SD",May-19,3566,3465,101,2.8
8832,CN4606900000000,46,69,"Hyde County, SD",May-19,664,642,22,3.3
8833,CN4607100000000,46,71,"Jackson County, SD",May-19,1324,1265,59,4.5
8834,CN4607300000000,46,73,"Jerauld County, SD",May-19,1105,1075,30,2.7
8835,CN4607500000000,46,75,"Jones County, SD",May-19,550,534,16,2.9
8836,CN4607700000000,46,77,"Kingsbury County, SD",May-19,2683,2611,72,2.7
8837,CN4607900000000,46,79,"Lake County, SD",May-19,6755,6526,229,3.4
8838,CN4608100000000,46,81,"Lawrence County, SD",May-19,13292,12871,421,3.2
8839,CN4608300000000,46,83,"Lincoln County, SD",May-19,34548,33684,864,2.5
8840,CN4608500000000,46,85,"Lyman County, SD",May-19,1676,1607,69,4.1
8841,CN4608700000000,46,87,"McCook County, SD",May-19,3058,2977,81,2.6
8842,CN4608900000000,46,89,"McPherson County, SD",May-19,977,941,36,3.7
8843,CN4609100000000,46,91,"Marshall County, SD",May-19,2411,2329,82,3.4
8844,CN4609300000000,46,93,"Meade County, SD",May-19,14153,13669,484,3.4
8845,CN4609500000000,46,95,"Mellette County, SD",May-19,732,699,33,4.5
8846,CN4609700000000,46,97,"Miner County, SD",May-19,1166,1134,32,2.7
8847,CN4609900000000,46,99,"Minnehaha County, SD",May-19,112808,109796,3012,2.7
8848,CN4610100000000,46,101,"Moody County, SD",May-19,4005,3906,99,2.5
8849,CN4610200000000,46,102,"Oglala Lakota County, SD",May-19,3486,3209,277,7.9
8850,CN4610300000000,46,103,"Pennington County, SD",May-19,56795,54959,1836,3.2
8851,CN4610500000000,46,105,"Perkins County, SD",May-19,1436,1391,45,3.1
8852,CN4610700000000,46,107,"Potter County, SD",May-19,1042,1010,32,3.1
8853,CN4610900000000,46,109,"Roberts County, SD",May-19,4769,4587,182,3.8
8854,CN4611100000000,46,111,"Sanborn County, SD",May-19,1136,1099,37,3.3
8855,CN4611500000000,46,115,"Spink County, SD",May-19,3198,3094,104,3.3
8856,CN4611700000000,46,117,"Stanley County, SD",May-19,1852,1803,49,2.6
8857,CN4611900000000,46,119,"Sully County, SD",May-19,796,773,23,2.9
8858,CN4612100000000,46,121,"Todd County, SD",May-19,3155,2981,174,5.5
8859,CN4612300000000,46,123,"Tripp County, SD",May-19,3010,2929,81,2.7
8860,CN4612500000000,46,125,"Turner County, SD",May-19,4677,4549,128,2.7
8861,CN4612700000000,46,127,"Union County, SD",May-19,8395,8138,257,3.1
8862,CN4612900000000,46,129,"Walworth County, SD",May-19,2108,2004,104,4.9
8863,CN4613500000000,46,135,"Yankton County, SD",May-19,12085,11749,336,2.8
8864,CN4613700000000,46,137,"Ziebach County, SD",May-19,909,864,45,5.0
8865,CN4700100000000,47,1,"Anderson County, TN",May-19,34922,33779,1143,3.3
8866,CN4700300000000,47,3,"Bedford County, TN",May-19,21331,20609,722,3.4
8867,CN4700500000000,47,5,"Benton County, TN",May-19,7013,6737,276,3.9
8868,CN4700700000000,47,7,"Bledsoe County, TN",May-19,4294,4078,216,5.0
8869,CN4700900000000,47,9,"Blount County, TN",May-19,63933,62104,1829,2.9
8870,CN4701100000000,47,11,"Bradley County, TN",May-19,51293,49638,1655,3.2
8871,CN4701300000000,47,13,"Campbell County, TN",May-19,14927,14299,628,4.2
8872,CN4701500000000,47,15,"Cannon County, TN",May-19,6637,6448,189,2.8
8873,CN4701700000000,47,17,"Carroll County, TN",May-19,12178,11608,570,4.7
8874,CN4701900000000,47,19,"Carter County, TN",May-19,24155,23202,953,3.9
8875,CN4702100000000,47,21,"Cheatham County, TN",May-19,22106,21558,548,2.5
8876,CN4702300000000,47,23,"Chester County, TN",May-19,8608,8334,274,3.2
8877,CN4702500000000,47,25,"Claiborne County, TN",May-19,13212,12709,503,3.8
8878,CN4702700000000,47,27,"Clay County, TN",May-19,2794,2644,150,5.4
8879,CN4702900000000,47,29,"Cocke County, TN",May-19,15225,14654,571,3.8
8880,CN4703100000000,47,31,"Coffee County, TN",May-19,25748,24959,789,3.1
8881,CN4703300000000,47,33,"Crockett County, TN",May-19,6970,6751,219,3.1
8882,CN4703500000000,47,35,"Cumberland County, TN",May-19,23635,22725,910,3.9
8883,CN4703700000000,47,37,"Davidson County, TN",May-19,408924,399165,9759,2.4
8884,CN4703900000000,47,39,"Decatur County, TN",May-19,4590,4368,222,4.8
8885,CN4704100000000,47,41,"DeKalb County, TN",May-19,7885,7592,293,3.7
8886,CN4704300000000,47,43,"Dickson County, TN",May-19,27297,26528,769,2.8
8887,CN4704500000000,47,45,"Dyer County, TN",May-19,16412,15609,803,4.9
8888,CN4704700000000,47,47,"Fayette County, TN",May-19,19205,18560,645,3.4
8889,CN4704900000000,47,49,"Fentress County, TN",May-19,7495,7235,260,3.5
8890,CN4705100000000,47,51,"Franklin County, TN",May-19,20077,19451,626,3.1
8891,CN4705300000000,47,53,"Gibson County, TN",May-19,22200,21350,850,3.8
8892,CN4705500000000,47,55,"Giles County, TN",May-19,15076,14545,531,3.5
8893,CN4705700000000,47,57,"Grainger County, TN",May-19,9546,9191,355,3.7
8894,CN4705900000000,47,59,"Greene County, TN",May-19,30198,29025,1173,3.9
8895,CN4706100000000,47,61,"Grundy County, TN",May-19,5008,4831,177,3.5
8896,CN4706300000000,47,63,"Hamblen County, TN",May-19,28444,27437,1007,3.5
8897,CN4706500000000,47,65,"Hamilton County, TN",May-19,184908,179358,5550,3.0
8898,CN4706700000000,47,67,"Hancock County, TN",May-19,2136,2025,111,5.2
8899,CN4706900000000,47,69,"Hardeman County, TN",May-19,9463,9064,399,4.2
8900,CN4707100000000,47,71,"Hardin County, TN",May-19,10485,10092,393,3.7
8901,CN4707300000000,47,73,"Hawkins County, TN",May-19,24034,23138,896,3.7
8902,CN4707500000000,47,75,"Haywood County, TN",May-19,7674,7326,348,4.5
8903,CN4707700000000,47,77,"Henderson County, TN",May-19,12412,11944,468,3.8
8904,CN4707900000000,47,79,"Henry County, TN",May-19,14316,13779,537,3.8
8905,CN4708100000000,47,81,"Hickman County, TN",May-19,11520,11197,323,2.8
8906,CN4708300000000,47,83,"Houston County, TN",May-19,3258,3126,132,4.1
8907,CN4708500000000,47,85,"Humphreys County, TN",May-19,9063,8751,312,3.4
8908,CN4708700000000,47,87,"Jackson County, TN",May-19,4687,4502,185,3.9
8909,CN4708900000000,47,89,"Jefferson County, TN",May-19,24867,24009,858,3.5
8910,CN4709100000000,47,91,"Johnson County, TN",May-19,7721,7474,247,3.2
8911,CN4709300000000,47,93,"Knox County, TN",May-19,246242,239507,6735,2.7
8912,CN4709500000000,47,95,"Lake County, TN",May-19,1753,1664,89,5.1
8913,CN4709700000000,47,97,"Lauderdale County, TN",May-19,9800,9326,474,4.8
8914,CN4709900000000,47,99,"Lawrence County, TN",May-19,19351,18625,726,3.8
8915,CN4710100000000,47,101,"Lewis County, TN",May-19,5199,5014,185,3.6
8916,CN4710300000000,47,103,"Lincoln County, TN",May-19,16881,16396,485,2.9
8917,CN4710500000000,47,105,"Loudon County, TN",May-19,23563,22802,761,3.2
8918,CN4710700000000,47,107,"McMinn County, TN",May-19,23660,22816,844,3.6
8919,CN4710900000000,47,109,"McNairy County, TN",May-19,8490,8091,399,4.7
8920,CN4711100000000,47,111,"Macon County, TN",May-19,11266,10914,352,3.1
8921,CN4711300000000,47,113,"Madison County, TN",May-19,49515,47909,1606,3.2
8922,CN4711500000000,47,115,"Marion County, TN",May-19,12518,12053,465,3.7
8923,CN4711700000000,47,117,"Marshall County, TN",May-19,15874,15400,474,3.0
8924,CN4711900000000,47,119,"Maury County, TN",May-19,49749,48456,1293,2.6
8925,CN4712100000000,47,121,"Meigs County, TN",May-19,5265,5043,222,4.2
8926,CN4712300000000,47,123,"Monroe County, TN",May-19,20377,19693,684,3.4
8927,CN4712500000000,47,125,"Montgomery County, TN",May-19,85927,82874,3053,3.6
8928,CN4712700000000,47,127,"Moore County, TN",May-19,3642,3550,92,2.5
8929,CN4712900000000,47,129,"Morgan County, TN",May-19,7912,7616,296,3.7
8930,CN4713100000000,47,131,"Obion County, TN",May-19,12604,12042,562,4.5
8931,CN4713300000000,47,133,"Overton County, TN",May-19,9813,9472,341,3.5
8932,CN4713500000000,47,135,"Perry County, TN",May-19,3159,3034,125,4.0
8933,CN4713700000000,47,137,"Pickett County, TN",May-19,2394,2295,99,4.1
8934,CN4713900000000,47,139,"Polk County, TN",May-19,7388,7117,271,3.7
8935,CN4714100000000,47,141,"Putnam County, TN",May-19,35083,33931,1152,3.3
8936,CN4714300000000,47,143,"Rhea County, TN",May-19,13302,12560,742,5.6
8937,CN4714500000000,47,145,"Roane County, TN",May-19,23571,22666,905,3.8
8938,CN4714700000000,47,147,"Robertson County, TN",May-19,38268,37211,1057,2.8
8939,CN4714900000000,47,149,"Rutherford County, TN",May-19,186137,181653,4484,2.4
8940,CN4715100000000,47,151,"Scott County, TN",May-19,8475,8162,313,3.7
8941,CN4715300000000,47,153,"Sequatchie County, TN",May-19,6201,5976,225,3.6
8942,CN4715500000000,47,155,"Sevier County, TN",May-19,55529,54079,1450,2.6
8943,CN4715700000000,47,157,"Shelby County, TN",May-19,449602,432943,16659,3.7
8944,CN4715900000000,47,159,"Smith County, TN",May-19,9511,9250,261,2.7
8945,CN4716100000000,47,161,"Stewart County, TN",May-19,5535,5310,225,4.1
8946,CN4716300000000,47,163,"Sullivan County, TN",May-19,71307,68827,2480,3.5
8947,CN4716500000000,47,165,"Sumner County, TN",May-19,103449,100891,2558,2.5
8948,CN4716700000000,47,167,"Tipton County, TN",May-19,28348,27341,1007,3.6
8949,CN4716900000000,47,169,"Trousdale County, TN",May-19,5470,5309,161,2.9
8950,CN4717100000000,47,171,"Unicoi County, TN",May-19,7066,6736,330,4.7
8951,CN4717300000000,47,173,"Union County, TN",May-19,7682,7392,290,3.8
8952,CN4717500000000,47,175,"Van Buren County, TN",May-19,2120,2039,81,3.8
8953,CN4717700000000,47,177,"Warren County, TN",May-19,16956,16342,614,3.6
8954,CN4717900000000,47,179,"Washington County, TN",May-19,60715,58705,2010,3.3
8955,CN4718100000000,47,181,"Wayne County, TN",May-19,6330,6079,251,4.0
8956,CN4718300000000,47,183,"Weakley County, TN",May-19,16162,15580,582,3.6
8957,CN4718500000000,47,185,"White County, TN",May-19,12329,11919,410,3.3
8958,CN4718700000000,47,187,"Williamson County, TN",May-19,129758,126830,2928,2.3
8959,CN4718900000000,47,189,"Wilson County, TN",May-19,77375,75430,1945,2.5
8960,CN4800100000000,48,1,"Anderson County, TX",May-19,23658,23062,596,2.5
8961,CN4800300000000,48,3,"Andrews County, TX",May-19,9918,9733,185,1.9
8962,CN4800500000000,48,5,"Angelina County, TX",May-19,35464,34203,1261,3.6
8963,CN4800700000000,48,7,"Aransas County, TX",May-19,9392,9033,359,3.8
8964,CN4800900000000,48,9,"Archer County, TX",May-19,4122,4021,101,2.5
8965,CN4801100000000,48,11,"Armstrong County, TX",May-19,935,912,23,2.5
8966,CN4801300000000,48,13,"Atascosa County, TX",May-19,21532,20831,701,3.3
8967,CN4801500000000,48,15,"Austin County, TX",May-19,14008,13585,423,3.0
8968,CN4801700000000,48,17,"Bailey County, TX",May-19,2579,2489,90,3.5
8969,CN4801900000000,48,19,"Bandera County, TX",May-19,9979,9693,286,2.9
8970,CN4802100000000,48,21,"Bastrop County, TX",May-19,42481,41399,1082,2.5
8971,CN4802300000000,48,23,"Baylor County, TX",May-19,1773,1740,33,1.9
8972,CN4802500000000,48,25,"Bee County, TX",May-19,9832,9458,374,3.8
8973,CN4802700000000,48,27,"Bell County, TX",May-19,142794,137938,4856,3.4
8974,CN4802900000000,48,29,"Bexar County, TX",May-19,939530,913425,26105,2.8
8975,CN4803100000000,48,31,"Blanco County, TX",May-19,6420,6279,141,2.2
8976,CN4803300000000,48,33,"Borden County, TX",May-19,428,418,10,2.3
8977,CN4803500000000,48,35,"Bosque County, TX",May-19,8310,8058,252,3.0
8978,CN4803700000000,48,37,"Bowie County, TX",May-19,39869,38290,1579,4.0
8979,CN4803900000000,48,39,"Brazoria County, TX",May-19,177805,171291,6514,3.7
8980,CN4804100000000,48,41,"Brazos County, TX",May-19,118688,115826,2862,2.4
8981,CN4804300000000,48,43,"Brewster County, TX",May-19,4264,4158,106,2.5
8982,CN4804500000000,48,45,"Briscoe County, TX",May-19,599,581,18,3.0
8983,CN4804700000000,48,47,"Brooks County, TX",May-19,2579,2474,105,4.1
8984,CN4804900000000,48,49,"Brown County, TX",May-19,15567,15072,495,3.2
8985,CN4805100000000,48,51,"Burleson County, TX",May-19,8337,8115,222,2.7
8986,CN4805300000000,48,53,"Burnet County, TX",May-19,23470,22905,565,2.4
8987,CN4805500000000,48,55,"Caldwell County, TX",May-19,19492,18911,581,3.0
8988,CN4805700000000,48,57,"Calhoun County, TX",May-19,12303,11957,346,2.8
8989,CN4805900000000,48,59,"Callahan County, TX",May-19,6062,5898,164,2.7
8990,CN4806100000000,48,61,"Cameron County, TX",May-19,165540,157496,8044,4.9
8991,CN4806300000000,48,63,"Camp County, TX",May-19,4949,4768,181,3.7
8992,CN4806500000000,48,65,"Carson County, TX",May-19,3030,2960,70,2.3
8993,CN4806700000000,48,67,"Cass County, TX",May-19,12385,11901,484,3.9
8994,CN4806900000000,48,69,"Castro County, TX",May-19,3494,3406,88,2.5
8995,CN4807100000000,48,71,"Chambers County, TX",May-19,19305,18521,784,4.1
8996,CN4807300000000,48,73,"Cherokee County, TX",May-19,20878,20205,673,3.2
8997,CN4807500000000,48,75,"Childress County, TX",May-19,2979,2911,68,2.3
8998,CN4807700000000,48,77,"Clay County, TX",May-19,4921,4784,137,2.8
8999,CN4807900000000,48,79,"Cochran County, TX",May-19,1140,1108,32,2.8
9000,CN4808100000000,48,81,"Coke County, TX",May-19,1433,1388,45,3.1
9001,CN4808300000000,48,83,"Coleman County, TX",May-19,2878,2779,99,3.4
9002,CN4808500000000,48,85,"Collin County, TX",May-19,557130,541551,15579,2.8
9003,CN4808700000000,48,87,"Collingsworth County, TX",May-19,1153,1122,31,2.7
9004,CN4808900000000,48,89,"Colorado County, TX",May-19,9769,9490,279,2.9
9005,CN4809100000000,48,91,"Comal County, TX",May-19,72552,70660,1892,2.6
9006,CN4809300000000,48,93,"Comanche County, TX",May-19,5557,5402,155,2.8
9007,CN4809500000000,48,95,"Concho County, TX",May-19,1194,1154,40,3.4
9008,CN4809700000000,48,97,"Cooke County, TX",May-19,19839,19366,473,2.4
9009,CN4809900000000,48,99,"Coryell County, TX",May-19,23947,23105,842,3.5
9010,CN4810100000000,48,101,"Cottle County, TX",May-19,561,542,19,3.4
9011,CN4810300000000,48,103,"Crane County, TX",May-19,1570,1516,54,3.4
9012,CN4810500000000,48,105,"Crockett County, TX",May-19,1652,1614,38,2.3
9013,CN4810700000000,48,107,"Crosby County, TX",May-19,2526,2439,87,3.4
9014,CN4810900000000,48,109,"Culberson County, TX",May-19,1046,1002,44,4.2
9015,CN4811100000000,48,111,"Dallam County, TX",May-19,3942,3879,63,1.6
9016,CN4811300000000,48,113,"Dallas County, TX",May-19,1348169,1305837,42332,3.1
9017,CN4811500000000,48,115,"Dawson County, TX",May-19,4647,4475,172,3.7
9018,CN4811700000000,48,117,"Deaf Smith County, TX",May-19,8525,8323,202,2.4
9019,CN4811900000000,48,119,"Delta County, TX",May-19,2432,2359,73,3.0
9020,CN4812100000000,48,121,"Denton County, TX",May-19,488831,475839,12992,2.7
9021,CN4812300000000,48,123,"DeWitt County, TX",May-19,9693,9469,224,2.3
9022,CN4812500000000,48,125,"Dickens County, TX",May-19,692,666,26,3.8
9023,CN4812700000000,48,127,"Dimmit County, TX",May-19,7532,7368,164,2.2
9024,CN4812900000000,48,129,"Donley County, TX",May-19,1484,1443,41,2.8
9025,CN4813100000000,48,131,"Duval County, TX",May-19,4976,4794,182,3.7
9026,CN4813300000000,48,133,"Eastland County, TX",May-19,8399,8140,259,3.1
9027,CN4813500000000,48,135,"Ector County, TX",May-19,87802,85848,1954,2.2
9028,CN4813700000000,48,137,"Edwards County, TX",May-19,1015,994,21,2.1
9029,CN4813900000000,48,139,"Ellis County, TX",May-19,91616,89066,2550,2.8
9030,CN4814100000000,48,141,"El Paso County, TX",May-19,359618,347269,12349,3.4
9031,CN4814300000000,48,143,"Erath County, TX",May-19,21119,20553,566,2.7
9032,CN4814500000000,48,145,"Falls County, TX",May-19,6552,6358,194,3.0
9033,CN4814700000000,48,147,"Fannin County, TX",May-19,17290,16866,424,2.5
9034,CN4814900000000,48,149,"Fayette County, TX",May-19,12490,12186,304,2.4
9035,CN4815100000000,48,151,"Fisher County, TX",May-19,1638,1597,41,2.5
9036,CN4815300000000,48,153,"Floyd County, TX",May-19,2614,2506,108,4.1
9037,CN4815500000000,48,155,"Foard County, TX",May-19,576,558,18,3.1
9038,CN4815700000000,48,157,"Fort Bend County, TX",May-19,389097,376950,12147,3.1
9039,CN4815900000000,48,159,"Franklin County, TX",May-19,4678,4528,150,3.2
9040,CN4816100000000,48,161,"Freestone County, TX",May-19,6344,6077,267,4.2
9041,CN4816300000000,48,163,"Frio County, TX",May-19,10545,10305,240,2.3
9042,CN4816500000000,48,165,"Gaines County, TX",May-19,9910,9705,205,2.1
9043,CN4816700000000,48,167,"Galveston County, TX",May-19,163966,158141,5825,3.6
9044,CN4816900000000,48,169,"Garza County, TX",May-19,2172,2123,49,2.3
9045,CN4817100000000,48,171,"Gillespie County, TX",May-19,13529,13232,297,2.2
9046,CN4817300000000,48,173,"Glasscock County, TX",May-19,804,790,14,1.7
9047,CN4817500000000,48,175,"Goliad County, TX",May-19,3251,3160,91,2.8
9048,CN4817700000000,48,177,"Gonzales County, TX",May-19,9614,9390,224,2.3
9049,CN4817900000000,48,179,"Gray County, TX",May-19,8039,7784,255,3.2
9050,CN4818100000000,48,181,"Grayson County, TX",May-19,63849,62095,1754,2.7
9051,CN4818300000000,48,183,"Gregg County, TX",May-19,58114,56193,1921,3.3
9052,CN4818500000000,48,185,"Grimes County, TX",May-19,11295,10904,391,3.5
9053,CN4818700000000,48,187,"Guadalupe County, TX",May-19,80696,78578,2118,2.6
9054,CN4818900000000,48,189,"Hale County, TX",May-19,12380,11871,509,4.1
9055,CN4819100000000,48,191,"Hall County, TX",May-19,1091,1053,38,3.5
9056,CN4819300000000,48,193,"Hamilton County, TX",May-19,3623,3531,92,2.5
9057,CN4819500000000,48,195,"Hansford County, TX",May-19,2787,2729,58,2.1
9058,CN4819700000000,48,197,"Hardeman County, TX",May-19,1722,1676,46,2.7
9059,CN4819900000000,48,199,"Hardin County, TX",May-19,25175,24146,1029,4.1
9060,CN4820100000000,48,201,"Harris County, TX",May-19,2297242,2218425,78817,3.4
9061,CN4820300000000,48,203,"Harrison County, TX",May-19,29206,28149,1057,3.6
9062,CN4820500000000,48,205,"Hartley County, TX",May-19,2813,2775,38,1.4
9063,CN4820700000000,48,207,"Haskell County, TX",May-19,2298,2228,70,3.0
9064,CN4820900000000,48,209,"Hays County, TX",May-19,118708,115883,2825,2.4
9065,CN4821100000000,48,211,"Hemphill County, TX",May-19,1958,1899,59,3.0
9066,CN4821300000000,48,213,"Henderson County, TX",May-19,36335,35223,1112,3.1
9067,CN4821500000000,48,215,"Hidalgo County, TX",May-19,349154,330272,18882,5.4
9068,CN4821700000000,48,217,"Hill County, TX",May-19,16315,15845,470,2.9
9069,CN4821900000000,48,219,"Hockley County, TX",May-19,11314,11006,308,2.7
9070,CN4822100000000,48,221,"Hood County, TX",May-19,27284,26477,807,3.0
9071,CN4822300000000,48,223,"Hopkins County, TX",May-19,17556,17081,475,2.7
9072,CN4822500000000,48,225,"Houston County, TX",May-19,10233,9963,270,2.6
9073,CN4822700000000,48,227,"Howard County, TX",May-19,13916,13544,372,2.7
9074,CN4822900000000,48,229,"Hudspeth County, TX",May-19,1834,1762,72,3.9
9075,CN4823100000000,48,231,"Hunt County, TX",May-19,42931,41533,1398,3.3
9076,CN4823300000000,48,233,"Hutchinson County, TX",May-19,8673,8355,318,3.7
9077,CN4823500000000,48,235,"Irion County, TX",May-19,762,745,17,2.2
9078,CN4823700000000,48,237,"Jack County, TX",May-19,3493,3403,90,2.6
9079,CN4823900000000,48,239,"Jackson County, TX",May-19,7533,7333,200,2.7
9080,CN4824100000000,48,241,"Jasper County, TX",May-19,12782,12104,678,5.3
9081,CN4824300000000,48,243,"Jeff Davis County, TX",May-19,1066,1042,24,2.3
9082,CN4824500000000,48,245,"Jefferson County, TX",May-19,106124,100688,5436,5.1
9083,CN4824700000000,48,247,"Jim Hogg County, TX",May-19,1883,1805,78,4.1
9084,CN4824900000000,48,249,"Jim Wells County, TX",May-19,16902,16213,689,4.1
9085,CN4825100000000,48,251,"Johnson County, TX",May-19,81294,79038,2256,2.8
9086,CN4825300000000,48,253,"Jones County, TX",May-19,5697,5492,205,3.6
9087,CN4825500000000,48,255,"Karnes County, TX",May-19,7091,6933,158,2.2
9088,CN4825700000000,48,257,"Kaufman County, TX",May-19,63817,61954,1863,2.9
9089,CN4825900000000,48,259,"Kendall County, TX",May-19,21963,21434,529,2.4
9090,CN4826100000000,48,261,"Kenedy County, TX",May-19,243,237,6,2.5
9091,CN4826300000000,48,263,"Kent County, TX",May-19,494,485,9,1.8
9092,CN4826500000000,48,265,"Kerr County, TX",May-19,22313,21736,577,2.6
9093,CN4826700000000,48,267,"Kimble County, TX",May-19,1863,1812,51,2.7
9094,CN4826900000000,48,269,"King County, TX",May-19,248,243,5,2.0
9095,CN4827100000000,48,271,"Kinney County, TX",May-19,1378,1333,45,3.3
9096,CN4827300000000,48,273,"Kleberg County, TX",May-19,13673,13158,515,3.8
9097,CN4827500000000,48,275,"Knox County, TX",May-19,1471,1430,41,2.8
9098,CN4827700000000,48,277,"Lamar County, TX",May-19,23807,23080,727,3.1
9099,CN4827900000000,48,279,"Lamb County, TX",May-19,5340,5164,176,3.3
9100,CN4828100000000,48,281,"Lampasas County, TX",May-19,9151,8893,258,2.8
9101,CN4828300000000,48,283,"La Salle County, TX",May-19,4376,4285,91,2.1
9102,CN4828500000000,48,285,"Lavaca County, TX",May-19,8602,8362,240,2.8
9103,CN4828700000000,48,287,"Lee County, TX",May-19,10400,10167,233,2.2
9104,CN4828900000000,48,289,"Leon County, TX",May-19,6229,5984,245,3.9
9105,CN4829100000000,48,291,"Liberty County, TX",May-19,32747,31323,1424,4.3
9106,CN4829300000000,48,293,"Limestone County, TX",May-19,8498,8208,290,3.4
9107,CN4829500000000,48,295,"Lipscomb County, TX",May-19,1678,1640,38,2.3
9108,CN4829700000000,48,297,"Live Oak County, TX",May-19,5471,5316,155,2.8
9109,CN4829900000000,48,299,"Llano County, TX",May-19,8624,8357,267,3.1
9110,CN4830100000000,48,301,"Loving County, TX",May-19,560,556,4,0.7
9111,CN4830300000000,48,303,"Lubbock County, TX",May-19,157583,153767,3816,2.4
9112,CN4830500000000,48,305,"Lynn County, TX",May-19,2797,2727,70,2.5
9113,CN4830700000000,48,307,"McCulloch County, TX",May-19,3471,3254,217,6.3
9114,CN4830900000000,48,309,"McLennan County, TX",May-19,118574,115138,3436,2.9
9115,CN4831100000000,48,311,"McMullen County, TX",May-19,766,757,9,1.2
9116,CN4831300000000,48,313,"Madison County, TX",May-19,4546,4377,169,3.7
9117,CN4831500000000,48,315,"Marion County, TX",May-19,4206,4055,151,3.6
9118,CN4831700000000,48,317,"Martin County, TX",May-19,2881,2825,56,1.9
9119,CN4831900000000,48,319,"Mason County, TX",May-19,1783,1732,51,2.9
9120,CN4832100000000,48,321,"Matagorda County, TX",May-19,16711,15897,814,4.9
9121,CN4832300000000,48,323,"Maverick County, TX",May-19,23940,22264,1676,7.0
9122,CN4832500000000,48,325,"Medina County, TX",May-19,21649,21052,597,2.8
9123,CN4832700000000,48,327,"Menard County, TX",May-19,861,835,26,3.0
9124,CN4832900000000,48,329,"Midland County, TX",May-19,106821,104937,1884,1.8
9125,CN4833100000000,48,331,"Milam County, TX",May-19,9769,9326,443,4.5
9126,CN4833300000000,48,333,"Mills County, TX",May-19,1869,1819,50,2.7
9127,CN4833500000000,48,335,"Mitchell County, TX",May-19,2335,2266,69,3.0
9128,CN4833700000000,48,337,"Montague County, TX",May-19,9371,9134,237,2.5
9129,CN4833900000000,48,339,"Montgomery County, TX",May-19,281724,273191,8533,3.0
9130,CN4834100000000,48,341,"Moore County, TX",May-19,11014,10790,224,2.0
9131,CN4834300000000,48,343,"Morris County, TX",May-19,4787,4565,222,4.6
9132,CN4834500000000,48,345,"Motley County, TX",May-19,485,471,14,2.9
9133,CN4834700000000,48,347,"Nacogdoches County, TX",May-19,28005,27118,887,3.2
9134,CN4834900000000,48,349,"Navarro County, TX",May-19,23734,23059,675,2.8
9135,CN4835100000000,48,351,"Newton County, TX",May-19,5136,4862,274,5.3
9136,CN4835300000000,48,353,"Nolan County, TX",May-19,6885,6711,174,2.5
9137,CN4835500000000,48,355,"Nueces County, TX",May-19,166696,160625,6071,3.6
9138,CN4835700000000,48,357,"Ochiltree County, TX",May-19,4317,4216,101,2.3
9139,CN4835900000000,48,359,"Oldham County, TX",May-19,923,900,23,2.5
9140,CN4836100000000,48,361,"Orange County, TX",May-19,36131,34488,1643,4.5
9141,CN4836300000000,48,363,"Palo Pinto County, TX",May-19,13651,13258,393,2.9
9142,CN4836500000000,48,365,"Panola County, TX",May-19,10053,9694,359,3.6
9143,CN4836700000000,48,367,"Parker County, TX",May-19,66708,64992,1716,2.6
9144,CN4836900000000,48,369,"Parmer County, TX",May-19,4947,4853,94,1.9
9145,CN4837100000000,48,371,"Pecos County, TX",May-19,6352,6169,183,2.9
9146,CN4837300000000,48,373,"Polk County, TX",May-19,17777,17055,722,4.1
9147,CN4837500000000,48,375,"Potter County, TX",May-19,55078,53794,1284,2.3
9148,CN4837700000000,48,377,"Presidio County, TX",May-19,3061,2883,178,5.8
9149,CN4837900000000,48,379,"Rains County, TX",May-19,6034,5875,159,2.6
9150,CN4838100000000,48,381,"Randall County, TX",May-19,72095,70567,1528,2.1
9151,CN4838300000000,48,383,"Reagan County, TX",May-19,1935,1894,41,2.1
9152,CN4838500000000,48,385,"Real County, TX",May-19,1068,1031,37,3.5
9153,CN4838700000000,48,387,"Red River County, TX",May-19,5084,4882,202,4.0
9154,CN4838900000000,48,389,"Reeves County, TX",May-19,11299,11134,165,1.5
9155,CN4839100000000,48,391,"Refugio County, TX",May-19,3197,3092,105,3.3
9156,CN4839300000000,48,393,"Roberts County, TX",May-19,416,403,13,3.1
9157,CN4839500000000,48,395,"Robertson County, TX",May-19,7652,7407,245,3.2
9158,CN4839700000000,48,397,"Rockwall County, TX",May-19,51486,50039,1447,2.8
9159,CN4839900000000,48,399,"Runnels County, TX",May-19,4638,4530,108,2.3
9160,CN4840100000000,48,401,"Rusk County, TX",May-19,22997,22278,719,3.1
9161,CN4840300000000,48,403,"Sabine County, TX",May-19,3757,3547,210,5.6
9162,CN4840500000000,48,405,"San Augustine County, TX",May-19,3317,3181,136,4.1
9163,CN4840700000000,48,407,"San Jacinto County, TX",May-19,11725,11257,468,4.0
9164,CN4840900000000,48,409,"San Patricio County, TX",May-19,29775,28331,1444,4.8
9165,CN4841100000000,48,411,"San Saba County, TX",May-19,2506,2434,72,2.9
9166,CN4841300000000,48,413,"Schleicher County, TX",May-19,1326,1291,35,2.6
9167,CN4841500000000,48,415,"Scurry County, TX",May-19,6801,6606,195,2.9
9168,CN4841700000000,48,417,"Shackelford County, TX",May-19,1905,1865,40,2.1
9169,CN4841900000000,48,419,"Shelby County, TX",May-19,11172,10798,374,3.3
9170,CN4842100000000,48,421,"Sherman County, TX",May-19,1378,1350,28,2.0
9171,CN4842300000000,48,423,"Smith County, TX",May-19,106825,103662,3163,3.0
9172,CN4842500000000,48,425,"Somervell County, TX",May-19,4314,4183,131,3.0
9173,CN4842700000000,48,427,"Starr County, TX",May-19,25066,23089,1977,7.9
9174,CN4842900000000,48,429,"Stephens County, TX",May-19,4117,3999,118,2.9
9175,CN4843100000000,48,431,"Sterling County, TX",May-19,596,579,17,2.9
9176,CN4843300000000,48,433,"Stonewall County, TX",May-19,603,588,15,2.5
9177,CN4843500000000,48,435,"Sutton County, TX",May-19,1518,1471,47,3.1
9178,CN4843700000000,48,437,"Swisher County, TX",May-19,2648,2562,86,3.2
9179,CN4843900000000,48,439,"Tarrant County, TX",May-19,1071220,1039833,31387,2.9
9180,CN4844100000000,48,441,"Taylor County, TX",May-19,66381,64675,1706,2.6
9181,CN4844300000000,48,443,"Terrell County, TX",May-19,394,384,10,2.5
9182,CN4844500000000,48,445,"Terry County, TX",May-19,5088,4916,172,3.4
9183,CN4844700000000,48,447,"Throckmorton County, TX",May-19,663,644,19,2.9
9184,CN4844900000000,48,449,"Titus County, TX",May-19,12901,12417,484,3.8
9185,CN4845100000000,48,451,"Tom Green County, TX",May-19,54167,52694,1473,2.7
9186,CN4845300000000,48,453,"Travis County, TX",May-19,734176,717545,16631,2.3
9187,CN4845500000000,48,455,"Trinity County, TX",May-19,5298,5088,210,4.0
9188,CN4845700000000,48,457,"Tyler County, TX",May-19,7086,6743,343,4.8
9189,CN4845900000000,48,459,"Upshur County, TX",May-19,17838,17272,566,3.2
9190,CN4846100000000,48,461,"Upton County, TX",May-19,1678,1631,47,2.8
9191,CN4846300000000,48,463,"Uvalde County, TX",May-19,11587,11201,386,3.3
9192,CN4846500000000,48,465,"Val Verde County, TX",May-19,22998,22302,696,3.0
9193,CN4846700000000,48,467,"Van Zandt County, TX",May-19,26019,25294,725,2.8
9194,CN4846900000000,48,469,"Victoria County, TX",May-19,42610,41303,1307,3.1
9195,CN4847100000000,48,471,"Walker County, TX",May-19,23894,23053,841,3.5
9196,CN4847300000000,48,473,"Waller County, TX",May-19,23295,22540,755,3.2
9197,CN4847500000000,48,475,"Ward County, TX",May-19,7477,7331,146,2.0
9198,CN4847700000000,48,477,"Washington County, TX",May-19,14998,14573,425,2.8
9199,CN4847900000000,48,479,"Webb County, TX",May-19,118482,114466,4016,3.4
9200,CN4848100000000,48,481,"Wharton County, TX",May-19,21762,21107,655,3.0
9201,CN4848300000000,48,483,"Wheeler County, TX",May-19,2280,2222,58,2.5
9202,CN4848500000000,48,485,"Wichita County, TX",May-19,55852,54273,1579,2.8
9203,CN4848700000000,48,487,"Wilbarger County, TX",May-19,4951,4798,153,3.1
9204,CN4848900000000,48,489,"Willacy County, TX",May-19,6531,6003,528,8.1
9205,CN4849100000000,48,491,"Williamson County, TX",May-19,311131,303292,7839,2.5
9206,CN4849300000000,48,493,"Wilson County, TX",May-19,24648,24034,614,2.5
9207,CN4849500000000,48,495,"Winkler County, TX",May-19,3930,3831,99,2.5
9208,CN4849700000000,48,497,"Wise County, TX",May-19,31575,30706,869,2.8
9209,CN4849900000000,48,499,"Wood County, TX",May-19,17632,17039,593,3.4
9210,CN4850100000000,48,501,"Yoakum County, TX",May-19,3811,3717,94,2.5
9211,CN4850300000000,48,503,"Young County, TX",May-19,8005,7796,209,2.6
9212,CN4850500000000,48,505,"Zapata County, TX",May-19,5174,4950,224,4.3
9213,CN4850700000000,48,507,"Zavala County, TX",May-19,3285,3042,243,7.4
9214,CN4900100000000,49,1,"Beaver County, UT",May-19,2943,2846,97,3.3
9215,CN4900300000000,49,3,"Box Elder County, UT",May-19,25911,25279,632,2.4
9216,CN4900500000000,49,5,"Cache County, UT",May-19,65000,63619,1381,2.1
9217,CN4900700000000,49,7,"Carbon County, UT",May-19,8646,8323,323,3.7
9218,CN4900900000000,49,9,"Daggett County, UT",May-19,428,415,13,3.0
9219,CN4901100000000,49,11,"Davis County, UT",May-19,173826,169656,4170,2.4
9220,CN4901300000000,49,13,"Duchesne County, UT",May-19,7789,7488,301,3.9
9221,CN4901500000000,49,15,"Emery County, UT",May-19,4522,4368,154,3.4
9222,CN4901700000000,49,17,"Garfield County, UT",May-19,3080,2953,127,4.1
9223,CN4901900000000,49,19,"Grand County, UT",May-19,6578,6431,147,2.2
9224,CN4902100000000,49,21,"Iron County, UT",May-19,23823,23108,715,3.0
9225,CN4902300000000,49,23,"Juab County, UT",May-19,5639,5493,146,2.6
9226,CN4902500000000,49,25,"Kane County, UT",May-19,3900,3806,94,2.4
9227,CN4902700000000,49,27,"Millard County, UT",May-19,6118,5955,163,2.7
9228,CN4902900000000,49,29,"Morgan County, UT",May-19,5569,5433,136,2.4
9229,CN4903100000000,49,31,"Piute County, UT",May-19,495,473,22,4.4
9230,CN4903300000000,49,33,"Rich County, UT",May-19,1193,1160,33,2.8
9231,CN4903500000000,49,35,"Salt Lake County, UT",May-19,631449,615461,15988,2.5
9232,CN4903700000000,49,37,"San Juan County, UT",May-19,5959,5714,245,4.1
9233,CN4903900000000,49,39,"Sanpete County, UT",May-19,12595,12216,379,3.0
9234,CN4904100000000,49,41,"Sevier County, UT",May-19,9783,9512,271,2.8
9235,CN4904300000000,49,43,"Summit County, UT",May-19,23268,22497,771,3.3
9236,CN4904500000000,49,45,"Tooele County, UT",May-19,33788,32844,944,2.8
9237,CN4904700000000,49,47,"Uintah County, UT",May-19,13696,13172,524,3.8
9238,CN4904900000000,49,49,"Utah County, UT",May-19,303124,295836,7288,2.4
9239,CN4905100000000,49,51,"Wasatch County, UT",May-19,15793,15315,478,3.0
9240,CN4905300000000,49,53,"Washington County, UT",May-19,75961,73839,2122,2.8
9241,CN4905500000000,49,55,"Wayne County, UT",May-19,1484,1426,58,3.9
9242,CN4905700000000,49,57,"Weber County, UT",May-19,127352,123875,3477,2.7
9243,CN5000100000000,50,1,"Addison County, VT",May-19,20690,20266,424,2.0
9244,CN5000300000000,50,3,"Bennington County, VT",May-19,18110,17613,497,2.7
9245,CN5000500000000,50,5,"Caledonia County, VT",May-19,14529,14181,348,2.4
9246,CN5000700000000,50,7,"Chittenden County, VT",May-19,96087,94418,1669,1.7
9247,CN5000900000000,50,9,"Essex County, VT",May-19,2687,2615,72,2.7
9248,CN5001100000000,50,11,"Franklin County, VT",May-19,27417,26900,517,1.9
9249,CN5001300000000,50,13,"Grand Isle County, VT",May-19,3990,3912,78,2.0
9250,CN5001500000000,50,15,"Lamoille County, VT",May-19,13815,13404,411,3.0
9251,CN5001700000000,50,17,"Orange County, VT",May-19,15947,15629,318,2.0
9252,CN5001900000000,50,19,"Orleans County, VT",May-19,13181,12735,446,3.4
9253,CN5002100000000,50,21,"Rutland County, VT",May-19,30460,29601,859,2.8
9254,CN5002300000000,50,23,"Washington County, VT",May-19,34227,33521,706,2.1
9255,CN5002500000000,50,25,"Windham County, VT",May-19,22028,21450,578,2.6
9256,CN5002700000000,50,27,"Windsor County, VT",May-19,28495,27915,580,2.0
9257,CN5100100000000,51,1,"Accomack County, VA",May-19,16601,16079,522,3.1
9258,CN5100300000000,51,3,"Albemarle County, VA",May-19,58002,56554,1448,2.5
9259,CN5100500000000,51,5,"Alleghany County, VA",May-19,6918,6708,210,3.0
9260,CN5100700000000,51,7,"Amelia County, VA",May-19,6265,6077,188,3.0
9261,CN5100900000000,51,9,"Amherst County, VA",May-19,15054,14586,468,3.1
9262,CN5101100000000,51,11,"Appomattox County, VA",May-19,7151,6917,234,3.3
9263,CN5101300000000,51,13,"Arlington County, VA",May-19,155416,152528,2888,1.9
9264,CN5101500000000,51,15,"Augusta County, VA",May-19,37583,36678,905,2.4
9265,CN5101700000000,51,17,"Bath County, VA",May-19,2481,2425,56,2.3
9266,CN5101900000000,51,19,"Bedford County, VA",May-19,38544,37484,1060,2.8
9267,CN5102100000000,51,21,"Bland County, VA",May-19,2871,2804,67,2.3
9268,CN5102300000000,51,23,"Botetourt County, VA",May-19,17462,17049,413,2.4
9269,CN5102500000000,51,25,"Brunswick County, VA",May-19,6029,5766,263,4.4
9270,CN5102700000000,51,27,"Buchanan County, VA",May-19,6755,6443,312,4.6
9271,CN5102900000000,51,29,"Buckingham County, VA",May-19,6482,6225,257,4.0
9272,CN5103100000000,51,31,"Campbell County, VA",May-19,26061,25264,797,3.1
9273,CN5103300000000,51,33,"Caroline County, VA",May-19,15281,14823,458,3.0
9274,CN5103500000000,51,35,"Carroll County, VA",May-19,13438,13031,407,3.0
9275,CN5103600000000,51,36,"Charles City County, VA",May-19,3657,3536,121,3.3
9276,CN5103700000000,51,37,"Charlotte County, VA",May-19,5248,5074,174,3.3
9277,CN5104100000000,51,41,"Chesterfield County, VA",May-19,188282,183290,4992,2.7
9278,CN5104300000000,51,43,"Clarke County, VA",May-19,7605,7426,179,2.4
9279,CN5104500000000,51,45,"Craig County, VA",May-19,2314,2240,74,3.2
9280,CN5104700000000,51,47,"Culpeper County, VA",May-19,24708,24092,616,2.5
9281,CN5104900000000,51,49,"Cumberland County, VA",May-19,4654,4527,127,2.7
9282,CN5105100000000,51,51,"Dickenson County, VA",May-19,4745,4533,212,4.5
9283,CN5105300000000,51,53,"Dinwiddie County, VA",May-19,13692,13260,432,3.2
9284,CN5105700000000,51,57,"Essex County, VA",May-19,5524,5348,176,3.2
9285,CN5105900000000,51,59,"Fairfax County, VA",May-19,639829,625467,14362,2.2
9286,CN5106100000000,51,61,"Fauquier County, VA",May-19,37340,36441,899,2.4
9287,CN5106300000000,51,63,"Floyd County, VA",May-19,8206,8010,196,2.4
9288,CN5106500000000,51,65,"Fluvanna County, VA",May-19,14112,13792,320,2.3
9289,CN5106700000000,51,67,"Franklin County, VA",May-19,26472,25719,753,2.8
9290,CN5106900000000,51,69,"Frederick County, VA",May-19,48140,46999,1141,2.4
9291,CN5107100000000,51,71,"Giles County, VA",May-19,7951,7712,239,3.0
9292,CN5107300000000,51,73,"Gloucester County, VA",May-19,19668,19173,495,2.5
9293,CN5107500000000,51,75,"Goochland County, VA",May-19,11257,10955,302,2.7
9294,CN5107700000000,51,77,"Grayson County, VA",May-19,8227,8021,206,2.5
9295,CN5107900000000,51,79,"Greene County, VA",May-19,10629,10390,239,2.2
9296,CN5108100000000,51,81,"Greensville County, VA",May-19,4270,4136,134,3.1
9297,CN5108300000000,51,83,"Halifax County, VA",May-19,15771,15192,579,3.7
9298,CN5108500000000,51,85,"Hanover County, VA",May-19,59460,58048,1412,2.4
9299,CN5108700000000,51,87,"Henrico County, VA",May-19,182735,177878,4857,2.7
9300,CN5108900000000,51,89,"Henry County, VA",May-19,23818,23069,749,3.1
9301,CN5109100000000,51,91,"Highland County, VA",May-19,1217,1188,29,2.4
9302,CN5109300000000,51,93,"Isle of Wight County, VA",May-19,19539,18989,550,2.8
9303,CN5109500000000,51,95,"James City County, VA",May-19,36822,35876,946,2.6
9304,CN5109700000000,51,97,"King and Queen County, VA",May-19,3872,3766,106,2.7
9305,CN5109900000000,51,99,"King George County, VA",May-19,13413,13074,339,2.5
9306,CN5110100000000,51,101,"King William County, VA",May-19,9169,8944,225,2.5
9307,CN5110300000000,51,103,"Lancaster County, VA",May-19,5438,5251,187,3.4
9308,CN5110500000000,51,105,"Lee County, VA",May-19,8308,8024,284,3.4
9309,CN5110700000000,51,107,"Loudoun County, VA",May-19,223937,218858,5079,2.3
9310,CN5110900000000,51,109,"Louisa County, VA",May-19,19942,19433,509,2.6
9311,CN5111100000000,51,111,"Lunenburg County, VA",May-19,5338,5170,168,3.1
9312,CN5111300000000,51,113,"Madison County, VA",May-19,7448,7288,160,2.1
9313,CN5111500000000,51,115,"Mathews County, VA",May-19,4161,4047,114,2.7
9314,CN5111700000000,51,117,"Mecklenburg County, VA",May-19,12656,12169,487,3.8
9315,CN5111900000000,51,119,"Middlesex County, VA",May-19,5273,5145,128,2.4
9316,CN5112100000000,51,121,"Montgomery County, VA",May-19,50735,49315,1420,2.8
9317,CN5112500000000,51,125,"Nelson County, VA",May-19,7533,7322,211,2.8
9318,CN5112700000000,51,127,"New Kent County, VA",May-19,12530,12232,298,2.4
9319,CN5113100000000,51,131,"Northampton County, VA",May-19,5390,5174,216,4.0
9320,CN5113300000000,51,133,"Northumberland County, VA",May-19,5658,5458,200,3.5
9321,CN5113500000000,51,135,"Nottoway County, VA",May-19,7288,7090,198,2.7
9322,CN5113700000000,51,137,"Orange County, VA",May-19,17374,16871,503,2.9
9323,CN5113900000000,51,139,"Page County, VA",May-19,12090,11694,396,3.3
9324,CN5114100000000,51,141,"Patrick County, VA",May-19,7458,7207,251,3.4
9325,CN5114300000000,51,143,"Pittsylvania County, VA",May-19,30158,29180,978,3.2
9326,CN5114500000000,51,145,"Powhatan County, VA",May-19,14186,13855,331,2.3
9327,CN5114700000000,51,147,"Prince Edward County, VA",May-19,10573,10168,405,3.8
9328,CN5114900000000,51,149,"Prince George County, VA",May-19,15119,14641,478,3.2
9329,CN5115300000000,51,153,"Prince William County, VA",May-19,247123,241065,6058,2.5
9330,CN5115500000000,51,155,"Pulaski County, VA",May-19,16208,15721,487,3.0
9331,CN5115700000000,51,157,"Rappahannock County, VA",May-19,3702,3615,87,2.4
9332,CN5115900000000,51,159,"Richmond County, VA",May-19,4091,3986,105,2.6
9333,CN5116100000000,51,161,"Roanoke County, VA",May-19,49649,48434,1215,2.4
9334,CN5116300000000,51,163,"Rockbridge County, VA",May-19,10885,10605,280,2.6
9335,CN5116500000000,51,165,"Rockingham County, VA",May-19,41210,40187,1023,2.5
9336,CN5116700000000,51,167,"Russell County, VA",May-19,11153,10744,409,3.7
9337,CN5116900000000,51,169,"Scott County, VA",May-19,9166,8883,283,3.1
9338,CN5117100000000,51,171,"Shenandoah County, VA",May-19,22248,21701,547,2.5
9339,CN5117300000000,51,173,"Smyth County, VA",May-19,13721,13263,458,3.3
9340,CN5117500000000,51,175,"Southampton County, VA",May-19,9059,8839,220,2.4
9341,CN5117700000000,51,177,"Spotsylvania County, VA",May-19,67401,65534,1867,2.8
9342,CN5117900000000,51,179,"Stafford County, VA",May-19,72476,70538,1938,2.7
9343,CN5118100000000,51,181,"Surry County, VA",May-19,3625,3507,118,3.3
9344,CN5118300000000,51,183,"Sussex County, VA",May-19,3755,3595,160,4.3
9345,CN5118500000000,51,185,"Tazewell County, VA",May-19,15888,15282,606,3.8
9346,CN5118700000000,51,187,"Warren County, VA",May-19,20528,19986,542,2.6
9347,CN5119100000000,51,191,"Washington County, VA",May-19,26819,26002,817,3.0
9348,CN5119300000000,51,193,"Westmoreland County, VA",May-19,9548,9253,295,3.1
9349,CN5119500000000,51,195,"Wise County, VA",May-19,13343,12785,558,4.2
9350,CN5119700000000,51,197,"Wythe County, VA",May-19,13684,13261,423,3.1
9351,CN5119900000000,51,199,"York County, VA",May-19,32977,32125,852,2.6
9352,CN5151000000000,51,510,"Alexandria city, VA",May-19,101979,99914,2065,2.0
9353,CN5152000000000,51,520,"Bristol city, VA",May-19,7242,6987,255,3.5
9354,CN5153000000000,51,530,"Buena Vista city, VA",May-19,3320,3233,87,2.6
9355,CN5154000000000,51,540,"Charlottesville city, VA",May-19,26850,26182,668,2.5
9356,CN5155000000000,51,550,"Chesapeake city, VA",May-19,123427,119974,3453,2.8
9357,CN5157000000000,51,570,"Colonial Heights city, VA",May-19,8840,8569,271,3.1
9358,CN5158000000000,51,580,"Covington city, VA",May-19,2400,2313,87,3.6
9359,CN5159000000000,51,590,"Danville city, VA",May-19,19119,18152,967,5.1
9360,CN5159500000000,51,595,"Emporia city, VA",May-19,2278,2177,101,4.4
9361,CN5160000000000,51,600,"Fairfax city, VA",May-19,13555,13267,288,2.1
9362,CN5161000000000,51,610,"Falls Church city, VA",May-19,8664,8489,175,2.0
9363,CN5162000000000,51,620,"Franklin city, VA",May-19,3589,3456,133,3.7
9364,CN5163000000000,51,630,"Fredericksburg city, VA",May-19,14239,13777,462,3.2
9365,CN5164000000000,51,640,"Galax city, VA",May-19,2963,2875,88,3.0
9366,CN5165000000000,51,650,"Hampton city, VA",May-19,64685,62373,2312,3.6
9367,CN5166000000000,51,660,"Harrisonburg city, VA",May-19,24704,23855,849,3.4
9368,CN5167000000000,51,670,"Hopewell city, VA",May-19,9684,9311,373,3.9
9369,CN5167800000000,51,678,"Lexington city, VA",May-19,2108,2013,95,4.5
9370,CN5168000000000,51,680,"Lynchburg city, VA",May-19,36477,35125,1352,3.7
9371,CN5168300000000,51,683,"Manassas city, VA",May-19,22180,21662,518,2.3
9372,CN5168500000000,51,685,"Manassas Park city, VA",May-19,9440,9216,224,2.4
9373,CN5169000000000,51,690,"Martinsville city, VA",May-19,5465,5251,214,3.9
9374,CN5170000000000,51,700,"Newport News city, VA",May-19,89270,86350,2920,3.3
9375,CN5171000000000,51,710,"Norfolk city, VA",May-19,112289,108542,3747,3.3
9376,CN5172000000000,51,720,"Norton city, VA",May-19,1673,1617,56,3.3
9377,CN5173000000000,51,730,"Petersburg city, VA",May-19,13061,12358,703,5.4
9378,CN5173500000000,51,735,"Poquoson city, VA",May-19,6404,6259,145,2.3
9379,CN5174000000000,51,740,"Portsmouth city, VA",May-19,44503,42858,1645,3.7
9380,CN5175000000000,51,750,"Radford city, VA",May-19,8759,8444,315,3.6
9381,CN5176000000000,51,760,"Richmond city, VA",May-19,118823,115059,3764,3.2
9382,CN5177000000000,51,770,"Roanoke city, VA",May-19,49388,47994,1394,2.8
9383,CN5177500000000,51,775,"Salem city, VA",May-19,13045,12700,345,2.6
9384,CN5179000000000,51,790,"Staunton city, VA",May-19,12302,11982,320,2.6
9385,CN5180000000000,51,800,"Suffolk city, VA",May-19,44879,43554,1325,3.0
9386,CN5181000000000,51,810,"Virginia Beach city, VA",May-19,234504,228415,6089,2.6
9387,CN5182000000000,51,820,"Waynesboro city, VA",May-19,10749,10454,295,2.7
9388,CN5183000000000,51,830,"Williamsburg city, VA",May-19,6740,6482,258,3.8
9389,CN5184000000000,51,840,"Winchester city, VA",May-19,14762,14367,395,2.7
9390,CN5300100000000,53,1,"Adams County, WA",May-19,10022,9546,476,4.7
9391,CN5300300000000,53,3,"Asotin County, WA",May-19,10271,9872,399,3.9
9392,CN5300500000000,53,5,"Benton County, WA",May-19,103049,98038,5011,4.9
9393,CN5300700000000,53,7,"Chelan County, WA",May-19,43412,41294,2118,4.9
9394,CN5300900000000,53,9,"Clallam County, WA",May-19,28618,26881,1737,6.1
9395,CN5301100000000,53,11,"Clark County, WA",May-19,239246,228001,11245,4.7
9396,CN5301300000000,53,13,"Columbia County, WA",May-19,1849,1754,95,5.1
9397,CN5301500000000,53,15,"Cowlitz County, WA",May-19,47572,44682,2890,6.1
9398,CN5301700000000,53,17,"Douglas County, WA",May-19,21608,20496,1112,5.1
9399,CN5301900000000,53,19,"Ferry County, WA",May-19,2575,2318,257,10.0
9400,CN5302100000000,53,21,"Franklin County, WA",May-19,43872,41440,2432,5.5
9401,CN5302300000000,53,23,"Garfield County, WA",May-19,905,864,41,4.5
9402,CN5302500000000,53,25,"Grant County, WA",May-19,46618,43699,2919,6.3
9403,CN5302700000000,53,27,"Grays Harbor County, WA",May-19,28923,26947,1976,6.8
9404,CN5302900000000,53,29,"Island County, WA",May-19,35691,33947,1744,4.9
9405,CN5303100000000,53,31,"Jefferson County, WA",May-19,12674,11988,686,5.4
9406,CN5303300000000,53,33,"King County, WA",May-19,1286119,1251636,34483,2.7
9407,CN5303500000000,53,35,"Kitsap County, WA",May-19,127404,121653,5751,4.5
9408,CN5303700000000,53,37,"Kittitas County, WA",May-19,23650,22499,1151,4.9
9409,CN5303900000000,53,39,"Klickitat County, WA",May-19,10462,9893,569,5.4
9410,CN5304100000000,53,41,"Lewis County, WA",May-19,34791,32769,2022,5.8
9411,CN5304300000000,53,43,"Lincoln County, WA",May-19,5015,4792,223,4.4
9412,CN5304500000000,53,45,"Mason County, WA",May-19,24801,23253,1548,6.2
9413,CN5304700000000,53,47,"Okanogan County, WA",May-19,20034,18782,1252,6.2
9414,CN5304900000000,53,49,"Pacific County, WA",May-19,8475,7888,587,6.9
9415,CN5305100000000,53,51,"Pend Oreille County, WA",May-19,4998,4660,338,6.8
9416,CN5305300000000,53,53,"Pierce County, WA",May-19,437533,415224,22309,5.1
9417,CN5305500000000,53,55,"San Juan County, WA",May-19,8537,8230,307,3.6
9418,CN5305700000000,53,57,"Skagit County, WA",May-19,62744,59463,3281,5.2
9419,CN5305900000000,53,59,"Skamania County, WA",May-19,5482,5200,282,5.1
9420,CN5306100000000,53,61,"Snohomish County, WA",May-19,437788,425237,12551,2.9
9421,CN5306300000000,53,63,"Spokane County, WA",May-19,253402,240750,12652,5.0
9422,CN5306500000000,53,65,"Stevens County, WA",May-19,18903,17714,1189,6.3
9423,CN5306700000000,53,67,"Thurston County, WA",May-19,141359,134649,6710,4.7
9424,CN5306900000000,53,69,"Wahkiakum County, WA",May-19,1370,1289,81,5.9
9425,CN5307100000000,53,71,"Walla Walla County, WA",May-19,29812,28470,1342,4.5
9426,CN5307300000000,53,73,"Whatcom County, WA",May-19,114936,109533,5403,4.7
9427,CN5307500000000,53,75,"Whitman County, WA",May-19,23361,22400,961,4.1
9428,CN5307700000000,53,77,"Yakima County, WA",May-19,130493,121637,8856,6.8
9429,CN5400100000000,54,1,"Barbour County, WV",May-19,7117,6733,384,5.4
9430,CN5400300000000,54,3,"Berkeley County, WV",May-19,58021,56082,1939,3.3
9431,CN5400500000000,54,5,"Boone County, WV",May-19,7407,7024,383,5.2
9432,CN5400700000000,54,7,"Braxton County, WV",May-19,5222,4891,331,6.3
9433,CN5400900000000,54,9,"Brooke County, WV",May-19,9977,9502,475,4.8
9434,CN5401100000000,54,11,"Cabell County, WV",May-19,41469,39831,1638,3.9
9435,CN5401300000000,54,13,"Calhoun County, WV",May-19,2494,2254,240,9.6
9436,CN5401500000000,54,15,"Clay County, WV",May-19,3095,2880,215,6.9
9437,CN5401700000000,54,17,"Doddridge County, WV",May-19,4051,3884,167,4.1
9438,CN5401900000000,54,19,"Fayette County, WV",May-19,16299,15473,826,5.1
9439,CN5402100000000,54,21,"Gilmer County, WV",May-19,2430,2287,143,5.9
9440,CN5402300000000,54,23,"Grant County, WV",May-19,5933,5657,276,4.7
9441,CN5402500000000,54,25,"Greenbrier County, WV",May-19,16090,15442,648,4.0
9442,CN5402700000000,54,27,"Hampshire County, WV",May-19,10739,10375,364,3.4
9443,CN5402900000000,54,29,"Hancock County, WV",May-19,13012,12424,588,4.5
9444,CN5403100000000,54,31,"Hardy County, WV",May-19,5793,5544,249,4.3
9445,CN5403300000000,54,33,"Harrison County, WV",May-19,34587,33186,1401,4.1
9446,CN5403500000000,54,35,"Jackson County, WV",May-19,13666,13075,591,4.3
9447,CN5403700000000,54,37,"Jefferson County, WV",May-19,30806,29938,868,2.8
9448,CN5403900000000,54,39,"Kanawha County, WV",May-19,82037,78516,3521,4.3
9449,CN5404100000000,54,41,"Lewis County, WV",May-19,6805,6441,364,5.3
9450,CN5404300000000,54,43,"Lincoln County, WV",May-19,7139,6746,393,5.5
9451,CN5404500000000,54,45,"Logan County, WV",May-19,11133,10540,593,5.3
9452,CN5404700000000,54,47,"McDowell County, WV",May-19,4367,3979,388,8.9
9453,CN5404900000000,54,49,"Marion County, WV",May-19,25468,24284,1184,4.6
9454,CN5405100000000,54,51,"Marshall County, WV",May-19,14235,13425,810,5.7
9455,CN5405300000000,54,53,"Mason County, WV",May-19,10317,9783,534,5.2
9456,CN5405500000000,54,55,"Mercer County, WV",May-19,21046,19925,1121,5.3
9457,CN5405700000000,54,57,"Mineral County, WV",May-19,12663,12098,565,4.5
9458,CN5405900000000,54,59,"Mingo County, WV",May-19,6924,6499,425,6.1
9459,CN5406100000000,54,61,"Monongalia County, WV",May-19,54482,52600,1882,3.5
9460,CN5406300000000,54,63,"Monroe County, WV",May-19,6031,5797,234,3.9
9461,CN5406500000000,54,65,"Morgan County, WV",May-19,8172,7881,291,3.6
9462,CN5406700000000,54,67,"Nicholas County, WV",May-19,9443,8943,500,5.3
9463,CN5406900000000,54,69,"Ohio County, WV",May-19,21399,20496,903,4.2
9464,CN5407100000000,54,71,"Pendleton County, WV",May-19,3755,3621,134,3.6
9465,CN5407300000000,54,73,"Pleasants County, WV",May-19,2879,2712,167,5.8
9466,CN5407500000000,54,75,"Pocahontas County, WV",May-19,3634,3389,245,6.7
9467,CN5407700000000,54,77,"Preston County, WV",May-19,15561,14927,634,4.1
9468,CN5407900000000,54,79,"Putnam County, WV",May-19,26685,25603,1082,4.1
9469,CN5408100000000,54,81,"Raleigh County, WV",May-19,30606,29289,1317,4.3
9470,CN5408300000000,54,83,"Randolph County, WV",May-19,12406,11723,683,5.5
9471,CN5408500000000,54,85,"Ritchie County, WV",May-19,4373,4179,194,4.4
9472,CN5408700000000,54,87,"Roane County, WV",May-19,5063,4657,406,8.0
9473,CN5408900000000,54,89,"Summers County, WV",May-19,4343,4134,209,4.8
9474,CN5409100000000,54,91,"Taylor County, WV",May-19,7887,7551,336,4.3
9475,CN5409300000000,54,93,"Tucker County, WV",May-19,3275,3124,151,4.6
9476,CN5409500000000,54,95,"Tyler County, WV",May-19,3124,2901,223,7.1
9477,CN5409700000000,54,97,"Upshur County, WV",May-19,9592,9063,529,5.5
9478,CN5409900000000,54,99,"Wayne County, WV",May-19,15728,14960,768,4.9
9479,CN5410100000000,54,101,"Webster County, WV",May-19,3359,3190,169,5.0
9480,CN5410300000000,54,103,"Wetzel County, WV",May-19,6588,6190,398,6.0
9481,CN5410500000000,54,105,"Wirt County, WV",May-19,2278,2131,147,6.5
9482,CN5410700000000,54,107,"Wood County, WV",May-19,36722,35008,1714,4.7
9483,CN5410900000000,54,109,"Wyoming County, WV",May-19,6667,6237,430,6.4
9484,CN5500100000000,55,1,"Adams County, WI",May-19,8185,7866,319,3.9
9485,CN5500300000000,55,3,"Ashland County, WI",May-19,7843,7527,316,4.0
9486,CN5500500000000,55,5,"Barron County, WI",May-19,24283,23544,739,3.0
9487,CN5500700000000,55,7,"Bayfield County, WI",May-19,7470,7135,335,4.5
9488,CN5500900000000,55,9,"Brown County, WI",May-19,141495,137231,4264,3.0
9489,CN5501100000000,55,11,"Buffalo County, WI",May-19,6457,6236,221,3.4
9490,CN5501300000000,55,13,"Burnett County, WI",May-19,7054,6754,300,4.3
9491,CN5501500000000,55,15,"Calumet County, WI",May-19,27405,26656,749,2.7
9492,CN5501700000000,55,17,"Chippewa County, WI",May-19,33030,32038,992,3.0
9493,CN5501900000000,55,19,"Clark County, WI",May-19,17646,17142,504,2.9
9494,CN5502100000000,55,21,"Columbia County, WI",May-19,31036,30138,898,2.9
9495,CN5502300000000,55,23,"Crawford County, WI",May-19,7482,7224,258,3.4
9496,CN5502500000000,55,25,"Dane County, WI",May-19,317217,309205,8012,2.5
9497,CN5502700000000,55,27,"Dodge County, WI",May-19,47130,45848,1282,2.7
9498,CN5502900000000,55,29,"Door County, WI",May-19,15222,14751,471,3.1
9499,CN5503100000000,55,31,"Douglas County, WI",May-19,23026,22199,827,3.6
9500,CN5503300000000,55,33,"Dunn County, WI",May-19,23795,22986,809,3.4
9501,CN5503500000000,55,35,"Eau Claire County, WI",May-19,59141,57418,1723,2.9
9502,CN5503700000000,55,37,"Florence County, WI",May-19,2182,2107,75,3.4
9503,CN5503900000000,55,39,"Fond du Lac County, WI",May-19,57109,55549,1560,2.7
9504,CN5504100000000,55,41,"Forest County, WI",May-19,3970,3780,190,4.8
9505,CN5504300000000,55,43,"Grant County, WI",May-19,28004,27163,841,3.0
9506,CN5504500000000,55,45,"Green County, WI",May-19,20659,20099,560,2.7
9507,CN5504700000000,55,47,"Green Lake County, WI",May-19,9488,9177,311,3.3
9508,CN5504900000000,55,49,"Iowa County, WI",May-19,13436,13092,344,2.6
9509,CN5505100000000,55,51,"Iron County, WI",May-19,2489,2375,114,4.6
9510,CN5505300000000,55,53,"Jackson County, WI",May-19,10268,9952,316,3.1
9511,CN5505500000000,55,55,"Jefferson County, WI",May-19,45486,44145,1341,2.9
9512,CN5505700000000,55,57,"Juneau County, WI",May-19,13547,13161,386,2.8
9513,CN5505900000000,55,59,"Kenosha County, WI",May-19,89079,85859,3220,3.6
9514,CN5506100000000,55,61,"Kewaunee County, WI",May-19,10924,10615,309,2.8
9515,CN5506300000000,55,63,"La Crosse County, WI",May-19,66388,64520,1868,2.8
9516,CN5506500000000,55,65,"Lafayette County, WI",May-19,10042,9796,246,2.4
9517,CN5506700000000,55,67,"Langlade County, WI",May-19,9299,8988,311,3.3
9518,CN5506900000000,55,69,"Lincoln County, WI",May-19,14916,14465,451,3.0
9519,CN5507100000000,55,71,"Manitowoc County, WI",May-19,40749,39534,1215,3.0
9520,CN5507300000000,55,73,"Marathon County, WI",May-19,73010,71015,1995,2.7
9521,CN5507500000000,55,75,"Marinette County, WI",May-19,19413,18736,677,3.5
9522,CN5507700000000,55,77,"Marquette County, WI",May-19,7668,7429,239,3.1
9523,CN5507800000000,55,78,"Menominee County, WI",May-19,1606,1502,104,6.5
9524,CN5507900000000,55,79,"Milwaukee County, WI",May-19,463479,446389,17090,3.7
9525,CN5508100000000,55,81,"Monroe County, WI",May-19,23338,22706,632,2.7
9526,CN5508300000000,55,83,"Oconto County, WI",May-19,20354,19728,626,3.1
9527,CN5508500000000,55,85,"Oneida County, WI",May-19,17671,17070,601,3.4
9528,CN5508700000000,55,87,"Outagamie County, WI",May-19,102622,99720,2902,2.8
9529,CN5508900000000,55,89,"Ozaukee County, WI",May-19,48706,47320,1386,2.8
9530,CN5509100000000,55,91,"Pepin County, WI",May-19,4137,4024,113,2.7
9531,CN5509300000000,55,93,"Pierce County, WI",May-19,25171,24405,766,3.0
9532,CN5509500000000,55,95,"Polk County, WI",May-19,24251,23532,719,3.0
9533,CN5509700000000,55,97,"Portage County, WI",May-19,38662,37428,1234,3.2
9534,CN5509900000000,55,99,"Price County, WI",May-19,6373,6148,225,3.5
9535,CN5510100000000,55,101,"Racine County, WI",May-19,98154,94638,3516,3.6
9536,CN5510300000000,55,103,"Richland County, WI",May-19,9191,8928,263,2.9
9537,CN5510500000000,55,105,"Rock County, WI",May-19,84832,81881,2951,3.5
9538,CN5510700000000,55,107,"Rusk County, WI",May-19,6589,6330,259,3.9
9539,CN5510900000000,55,109,"St. Croix County, WI",May-19,50017,48595,1422,2.8
9540,CN5511100000000,55,111,"Sauk County, WI",May-19,35232,34303,929,2.6
9541,CN5511300000000,55,113,"Sawyer County, WI",May-19,7947,7658,289,3.6
9542,CN5511500000000,55,115,"Shawano County, WI",May-19,20937,20336,601,2.9
9543,CN5511700000000,55,117,"Sheboygan County, WI",May-19,62176,60546,1630,2.6
9544,CN5511900000000,55,119,"Taylor County, WI",May-19,10817,10502,315,2.9
9545,CN5512100000000,55,121,"Trempealeau County, WI",May-19,15874,15395,479,3.0
9546,CN5512300000000,55,123,"Vernon County, WI",May-19,15311,14867,444,2.9
9547,CN5512500000000,55,125,"Vilas County, WI",May-19,10066,9724,342,3.4
9548,CN5512700000000,55,127,"Walworth County, WI",May-19,58390,56619,1771,3.0
9549,CN5512900000000,55,129,"Washburn County, WI",May-19,7766,7511,255,3.3
9550,CN5513100000000,55,131,"Washington County, WI",May-19,76685,74593,2092,2.7
9551,CN5513300000000,55,133,"Waukesha County, WI",May-19,223493,217136,6357,2.8
9552,CN5513500000000,55,135,"Waupaca County, WI",May-19,25789,25031,758,2.9
9553,CN5513700000000,55,137,"Waushara County, WI",May-19,11308,10923,385,3.4
9554,CN5513900000000,55,139,"Winnebago County, WI",May-19,91139,88493,2646,2.9
9555,CN5514100000000,55,141,"Wood County, WI",May-19,34846,33703,1143,3.3
9556,CN5600100000000,56,1,"Albany County, WY",May-19,20622,19998,624,3.0
9557,CN5600300000000,56,3,"Big Horn County, WY",May-19,5241,5035,206,3.9
9558,CN5600500000000,56,5,"Campbell County, WY",May-19,23085,22347,738,3.2
9559,CN5600700000000,56,7,"Carbon County, WY",May-19,7775,7544,231,3.0
9560,CN5600900000000,56,9,"Converse County, WY",May-19,8591,8365,226,2.6
9561,CN5601100000000,56,11,"Crook County, WY",May-19,3636,3530,106,2.9
9562,CN5601300000000,56,13,"Fremont County, WY",May-19,18375,17683,692,3.8
9563,CN5601500000000,56,15,"Goshen County, WY",May-19,6458,6222,236,3.7
9564,CN5601700000000,56,17,"Hot Springs County, WY",May-19,2161,2091,70,3.2
9565,CN5601900000000,56,19,"Johnson County, WY",May-19,4111,3972,139,3.4
9566,CN5602100000000,56,21,"Laramie County, WY",May-19,48095,46554,1541,3.2
9567,CN5602300000000,56,23,"Lincoln County, WY",May-19,8817,8543,274,3.1
9568,CN5602500000000,56,25,"Natrona County, WY",May-19,38975,37548,1427,3.7
9569,CN5602700000000,56,27,"Niobrara County, WY",May-19,1205,1173,32,2.7
9570,CN5602900000000,56,29,"Park County, WY",May-19,15678,15141,537,3.4
9571,CN5603100000000,56,31,"Platte County, WY",May-19,4681,4539,142,3.0
9572,CN5603300000000,56,33,"Sheridan County, WY",May-19,15553,15069,484,3.1
9573,CN5603500000000,56,35,"Sublette County, WY",May-19,3975,3816,159,4.0
9574,CN5603700000000,56,37,"Sweetwater County, WY",May-19,21472,20730,742,3.5
9575,CN5603900000000,56,39,"Teton County, WY",May-19,14760,14327,433,2.9
9576,CN5604100000000,56,41,"Uinta County, WY",May-19,9175,8843,332,3.6
9577,CN5604300000000,56,43,"Washakie County, WY",May-19,3880,3741,139,3.6
9578,CN5604500000000,56,45,"Weston County, WY",May-19,3802,3695,107,2.8
9579,CN7200100000000,72,1,"Adjuntas Municipio, PR",May-19,4105,3564,541,13.2
9580,CN7200300000000,72,3,"Aguada Municipio, PR",May-19,11980,10837,1143,9.5
9581,CN7200500000000,72,5,"Aguadilla Municipio, PR",May-19,14575,13200,1375,9.4
9582,CN7200700000000,72,7,"Aguas Buenas Municipio, PR",May-19,6510,5947,563,8.6
9583,CN7200900000000,72,9,"Aibonito Municipio, PR",May-19,6462,5789,673,10.4
9584,CN7201100000000,72,11,"Anasco Municipio, PR",May-19,8882,8175,707,8.0
9585,CN7201300000000,72,13,"Arecibo Municipio, PR",May-19,23924,21780,2144,9.0
9586,CN7201500000000,72,15,"Arroyo Municipio, PR",May-19,4735,4113,622,13.1
9587,CN7201700000000,72,17,"Barceloneta Municipio, PR",May-19,5893,5252,641,10.9
9588,CN7201900000000,72,19,"Barranquitas Municipio, PR",May-19,7280,6702,578,7.9
9589,CN7202100000000,72,21,"Bayamon Municipio, PR",May-19,65062,61315,3747,5.8
9590,CN7202300000000,72,23,"Cabo Rojo Municipio, PR",May-19,13504,12437,1067,7.9
9591,CN7202500000000,72,25,"Caguas Municipio, PR",May-19,47586,44605,2981,6.3
9592,CN7202700000000,72,27,"Camuy Municipio, PR",May-19,9469,8745,724,7.6
9593,CN7202900000000,72,29,"Canovanas Municipio, PR",May-19,15949,15007,942,5.9
9594,CN7203100000000,72,31,"Carolina Municipio, PR",May-19,61219,57954,3265,5.3
9595,CN7203300000000,72,33,"Catano Municipio, PR",May-19,7804,7293,511,6.5
9596,CN7203500000000,72,35,"Cayey Municipio, PR",May-19,16045,15034,1011,6.3
9597,CN7203700000000,72,37,"Ceiba Municipio, PR",May-19,3737,3350,387,10.4
9598,CN7203900000000,72,39,"Ciales Municipio, PR",May-19,3681,3299,382,10.4
9599,CN7204100000000,72,41,"Cidra Municipio, PR",May-19,15422,14460,962,6.2
9600,CN7204300000000,72,43,"Coamo Municipio, PR",May-19,9975,8815,1160,11.6
9601,CN7204500000000,72,45,"Comerio Municipio, PR",May-19,4858,4464,394,8.1
9602,CN7204700000000,72,47,"Corozal Municipio, PR",May-19,8860,8109,751,8.5
9603,CN7204900000000,72,49,"Culebra Municipio, PR",May-19,905,881,24,2.7
9604,CN7205100000000,72,51,"Dorado Municipio, PR",May-19,13116,12443,673,5.1
9605,CN7205300000000,72,53,"Fajardo Municipio, PR",May-19,11019,9839,1180,10.7
9606,CN7205400000000,72,54,"Florida Municipio, PR",May-19,3318,2958,360,10.8
9607,CN7205500000000,72,55,"Guanica Municipio, PR",May-19,3901,3387,514,13.2
9608,CN7205700000000,72,57,"Guayama Municipio, PR",May-19,11174,9904,1270,11.4
9609,CN7205900000000,72,59,"Guayanilla Municipio, PR",May-19,5241,4573,668,12.7
9610,CN7206100000000,72,61,"Guaynabo Municipio, PR",May-19,37618,36196,1422,3.8
9611,CN7206300000000,72,63,"Gurabo Municipio, PR",May-19,17975,17047,928,5.2
9612,CN7206500000000,72,65,"Hatillo Municipio, PR",May-19,13512,11987,1525,11.3
9613,CN7206700000000,72,67,"Hormigueros Municipio, PR",May-19,5412,4964,448,8.3
9614,CN7206900000000,72,69,"Humacao Municipio, PR",May-19,17177,15481,1696,9.9
9615,CN7207100000000,72,71,"Isabela Municipio, PR",May-19,12338,11315,1023,8.3
9616,CN7207300000000,72,73,"Jayuya Municipio, PR",May-19,4275,3668,607,14.2
9617,CN7207500000000,72,75,"Juana Diaz Municipio, PR",May-19,15088,13573,1515,10.0
9618,CN7207700000000,72,77,"Juncos Municipio, PR",May-19,12168,11236,932,7.7
9619,CN7207900000000,72,79,"Lajas Municipio, PR",May-19,5175,4539,636,12.3
9620,CN7208100000000,72,81,"Lares Municipio, PR",May-19,6842,5883,959,14.0
9621,CN7208300000000,72,83,"Las Marias Municipio, PR",May-19,2658,2374,284,10.7
9622,CN7208500000000,72,85,"Las Piedras Municipio, PR",May-19,11213,10290,923,8.2
9623,CN7208700000000,72,87,"Loiza Municipio, PR",May-19,8371,7779,592,7.1
9624,CN7208900000000,72,89,"Luquillo Municipio, PR",May-19,6165,5627,538,8.7
9625,CN7209100000000,72,91,"Manati Municipio, PR",May-19,11421,10540,881,7.7
9626,CN7209300000000,72,93,"Maricao Municipio, PR",May-19,1880,1633,247,13.1
9627,CN7209500000000,72,95,"Maunabo Municipio, PR",May-19,2981,2511,470,15.8
9628,CN7209700000000,72,97,"Mayaguez Municipio, PR",May-19,21919,19748,2171,9.9
9629,CN7209900000000,72,99,"Moca Municipio, PR",May-19,10514,9486,1028,9.8
9630,CN7210100000000,72,101,"Morovis Municipio, PR",May-19,7912,7232,680,8.6
9631,CN7210300000000,72,103,"Naguabo Municipio, PR",May-19,8085,7432,653,8.1
9632,CN7210500000000,72,105,"Naranjito Municipio, PR",May-19,6991,6465,526,7.5
9633,CN7210700000000,72,107,"Orocovis Municipio, PR",May-19,4878,4457,421,8.6
9634,CN7210900000000,72,109,"Patillas Municipio, PR",May-19,4384,3716,668,15.2
9635,CN7211100000000,72,111,"Penuelas Municipio, PR",May-19,5931,5089,842,14.2
9636,CN7211300000000,72,113,"Ponce Municipio, PR",May-19,45712,41400,4312,9.4
9637,CN7211500000000,72,115,"Quebradillas Municipio, PR",May-19,6050,5409,641,10.6
9638,CN7211700000000,72,117,"Rincon Municipio, PR",May-19,4693,4155,538,11.5
9639,CN7211900000000,72,119,"Rio Grande Municipio, PR",May-19,16815,15677,1138,6.8
9640,CN7212100000000,72,121,"Sabana Grande Municipio, PR",May-19,6077,5309,768,12.6
9641,CN7212300000000,72,123,"Salinas Municipio, PR",May-19,7155,6159,996,13.9
9642,CN7212500000000,72,125,"San German Municipio, PR",May-19,9725,8680,1045,10.7
9643,CN7212700000000,72,127,"San Juan Municipio, PR",May-19,134101,127285,6816,5.1
9644,CN7212900000000,72,129,"San Lorenzo Municipio, PR",May-19,11607,10667,940,8.1
9645,CN7213100000000,72,131,"San Sebastian Municipio, PR",May-19,10345,8950,1395,13.5
9646,CN7213300000000,72,133,"Santa Isabel Municipio, PR",May-19,8881,8002,879,9.9
9647,CN7213500000000,72,135,"Toa Alta Municipio, PR",May-19,26964,25574,1390,5.2
9648,CN7213700000000,72,137,"Toa Baja Municipio, PR",May-19,29073,27519,1554,5.3
9649,CN7213900000000,72,139,"Trujillo Alto Municipio, PR",May-19,26991,25782,1209,4.5
9650,CN7214100000000,72,141,"Utuado Municipio, PR",May-19,6631,5948,683,10.3
9651,CN7214300000000,72,143,"Vega Alta Municipio, PR",May-19,9620,8920,700,7.3
9652,CN7214500000000,72,145,"Vega Baja Municipio, PR",May-19,13143,11963,1180,9.0
9653,CN7214700000000,72,147,"Vieques Municipio, PR",May-19,2675,2499,176,6.6
9654,CN7214900000000,72,149,"Villalba Municipio, PR",May-19,7455,6339,1116,15.0
9655,CN7215100000000,72,151,"Yabucoa Municipio, PR",May-19,8787,7691,1096,12.5
9656,CN7215300000000,72,153,"Yauco Municipio, PR",May-19,9797,8395,1402,14.3
9657,CN0100100000000,01,1,"Autauga County, AL",Jun-19,26310,25536,774,2.9
9658,CN0100300000000,01,3,"Baldwin County, AL",Jun-19,99811,97012,2799,2.8
9659,CN0100500000000,01,5,"Barbour County, AL",Jun-19,8504,8148,356,4.2
9660,CN0100700000000,01,7,"Bibb County, AL",Jun-19,8690,8401,289,3.3
9661,CN0100900000000,01,9,"Blount County, AL",Jun-19,25384,24655,729,2.9
9662,CN0101100000000,01,11,"Bullock County, AL",Jun-19,4830,4663,167,3.5
9663,CN0101300000000,01,13,"Butler County, AL",Jun-19,9321,8986,335,3.6
9664,CN0101500000000,01,15,"Calhoun County, AL",Jun-19,46355,44571,1784,3.8
9665,CN0101700000000,01,17,"Chambers County, AL",Jun-19,15694,15204,490,3.1
9666,CN0101900000000,01,19,"Cherokee County, AL",Jun-19,11795,11428,367,3.1
9667,CN0102100000000,01,21,"Chilton County, AL",Jun-19,19808,19241,567,2.9
9668,CN0102300000000,01,23,"Choctaw County, AL",Jun-19,4607,4370,237,5.1
9669,CN0102500000000,01,25,"Clarke County, AL",Jun-19,7661,7192,469,6.1
9670,CN0102700000000,01,27,"Clay County, AL",Jun-19,6075,5873,202,3.3
9671,CN0102900000000,01,29,"Cleburne County, AL",Jun-19,5823,5633,190,3.3
9672,CN0103100000000,01,31,"Coffee County, AL",Jun-19,21625,20957,668,3.1
9673,CN0103300000000,01,33,"Colbert County, AL",Jun-19,23550,22586,964,4.1
9674,CN0103500000000,01,35,"Conecuh County, AL",Jun-19,4562,4372,190,4.2
9675,CN0103700000000,01,37,"Coosa County, AL",Jun-19,4598,4447,151,3.3
9676,CN0103900000000,01,39,"Covington County, AL",Jun-19,15705,15144,561,3.6
9677,CN0104100000000,01,41,"Crenshaw County, AL",Jun-19,6524,6339,185,2.8
9678,CN0104300000000,01,43,"Cullman County, AL",Jun-19,38692,37576,1116,2.9
9679,CN0104500000000,01,45,"Dale County, AL",Jun-19,20783,20081,702,3.4
9680,CN0104700000000,01,47,"Dallas County, AL",Jun-19,14541,13655,886,6.1
9681,CN0104900000000,01,49,"DeKalb County, AL",Jun-19,31358,30402,956,3.0
9682,CN0105100000000,01,51,"Elmore County, AL",Jun-19,37763,36700,1063,2.8
9683,CN0105300000000,01,53,"Escambia County, AL",Jun-19,14767,14200,567,3.8
9684,CN0105500000000,01,55,"Etowah County, AL",Jun-19,42958,41363,1595,3.7
9685,CN0105700000000,01,57,"Fayette County, AL",Jun-19,6626,6392,234,3.5
9686,CN0105900000000,01,59,"Franklin County, AL",Jun-19,14746,14306,440,3.0
9687,CN0106100000000,01,61,"Geneva County, AL",Jun-19,11096,10756,340,3.1
9688,CN0106300000000,01,63,"Greene County, AL",Jun-19,2913,2726,187,6.4
9689,CN0106500000000,01,65,"Hale County, AL",Jun-19,6081,5793,288,4.7
9690,CN0106700000000,01,67,"Henry County, AL",Jun-19,6989,6722,267,3.8
9691,CN0106900000000,01,69,"Houston County, AL",Jun-19,46396,44857,1539,3.3
9692,CN0107100000000,01,71,"Jackson County, AL",Jun-19,23717,22892,825,3.5
9693,CN0107300000000,01,73,"Jefferson County, AL",Jun-19,318920,308975,9945,3.1
9694,CN0107500000000,01,75,"Lamar County, AL",Jun-19,5886,5667,219,3.7
9695,CN0107700000000,01,77,"Lauderdale County, AL",Jun-19,42522,40930,1592,3.7
9696,CN0107900000000,01,79,"Lawrence County, AL",Jun-19,14365,13872,493,3.4
9697,CN0108100000000,01,81,"Lee County, AL",Jun-19,75926,73599,2327,3.1
9698,CN0108300000000,01,83,"Limestone County, AL",Jun-19,43831,42545,1286,2.9
9699,CN0108500000000,01,85,"Lowndes County, AL",Jun-19,3592,3386,206,5.7
9700,CN0108700000000,01,87,"Macon County, AL",Jun-19,7848,7458,390,5.0
9701,CN0108900000000,01,89,"Madison County, AL",Jun-19,185081,179819,5262,2.8
9702,CN0109100000000,01,91,"Marengo County, AL",Jun-19,7798,7507,291,3.7
9703,CN0109300000000,01,93,"Marion County, AL",Jun-19,13078,12599,479,3.7
9704,CN0109500000000,01,95,"Marshall County, AL",Jun-19,44544,43365,1179,2.6
9705,CN0109700000000,01,97,"Mobile County, AL",Jun-19,189001,181447,7554,4.0
9706,CN0109900000000,01,99,"Monroe County, AL",Jun-19,7304,6931,373,5.1
9707,CN0110100000000,01,101,"Montgomery County, AL",Jun-19,106141,102661,3480,3.3
9708,CN0110300000000,01,103,"Morgan County, AL",Jun-19,58390,56736,1654,2.8
9709,CN0110500000000,01,105,"Perry County, AL",Jun-19,3378,3154,224,6.6
9710,CN0110700000000,01,107,"Pickens County, AL",Jun-19,7875,7537,338,4.3
9711,CN0110900000000,01,109,"Pike County, AL",Jun-19,15294,14737,557,3.6
9712,CN0111100000000,01,111,"Randolph County, AL",Jun-19,9601,9284,317,3.3
9713,CN0111300000000,01,113,"Russell County, AL",Jun-19,23827,23082,745,3.1
9714,CN0111500000000,01,115,"St. Clair County, AL",Jun-19,40584,39394,1190,2.9
9715,CN0111700000000,01,117,"Shelby County, AL",Jun-19,115952,113206,2746,2.4
9716,CN0111900000000,01,119,"Sumter County, AL",Jun-19,4900,4634,266,5.4
9717,CN0112100000000,01,121,"Talladega County, AL",Jun-19,35803,34481,1322,3.7
9718,CN0112300000000,01,123,"Tallapoosa County, AL",Jun-19,19046,18447,599,3.1
9719,CN0112500000000,01,125,"Tuscaloosa County, AL",Jun-19,103801,100525,3276,3.2
9720,CN0112700000000,01,127,"Walker County, AL",Jun-19,25432,24526,906,3.6
9721,CN0112900000000,01,129,"Washington County, AL",Jun-19,6808,6482,326,4.8
9722,CN0113100000000,01,131,"Wilcox County, AL",Jun-19,2737,2548,189,6.9
9723,CN0113300000000,01,133,"Winston County, AL",Jun-19,10111,9753,358,3.5
9724,CN0201300000000,02,13,"Aleutians East Borough, AK",Jun-19,2600,2533,67,2.6
9725,CN0201600000000,02,16,"Aleutians West Census Area, AK",Jun-19,3224,3100,124,3.8
9726,CN0202000000000,02,20,"Anchorage Borough/municipality, AK",Jun-19,147549,139737,7812,5.3
9727,CN0205000000000,02,50,"Bethel Census Area, AK",Jun-19,7468,6429,1039,13.9
9728,CN0206000000000,02,60,"Bristol Bay Borough, AK",Jun-19,708,688,20,2.8
9729,CN0206800000000,02,68,"Denali Borough, AK",Jun-19,1696,1634,62,3.7
9730,CN0207000000000,02,70,"Dillingham Census Area, AK",Jun-19,2282,2100,182,8.0
9731,CN0209000000000,02,90,"Fairbanks North Star Borough, AK",Jun-19,44424,42004,2420,5.4
9732,CN0210000000000,02,100,"Haines Borough, AK",Jun-19,1320,1244,76,5.8
9733,CN0210500000000,02,105,"Hoonah-Angoon Census Area, AK",Jun-19,1414,1302,112,7.9
9734,CN0211000000000,02,110,"Juneau Borough/city, AK",Jun-19,17596,16846,750,4.3
9735,CN0212200000000,02,122,"Kenai Peninsula Borough, AK",Jun-19,27620,25950,1670,6.0
9736,CN0213000000000,02,130,"Ketchikan Gateway Borough, AK",Jun-19,7558,7132,426,5.6
9737,CN0215000000000,02,150,"Kodiak Island Borough, AK",Jun-19,5904,5602,302,5.1
9738,CN0215800000000,02,158,"Kusilvak Census Area, AK",Jun-19,2572,1936,636,24.7
9739,CN0216400000000,02,164,"Lake and Peninsula Borough, AK",Jun-19,837,755,82,9.8
9740,CN0217000000000,02,170,"Matanuska-Susitna Borough, AK",Jun-19,47338,43822,3516,7.4
9741,CN0218000000000,02,180,"Nome Census Area, AK",Jun-19,4093,3567,526,12.9
9742,CN0218500000000,02,185,"North Slope Borough, AK",Jun-19,3422,3184,238,7.0
9743,CN0218800000000,02,188,"Northwest Arctic Borough, AK",Jun-19,2931,2435,496,16.9
9744,CN0219500000000,02,195,"Petersburg Borough, AK",Jun-19,1425,1307,118,8.3
9745,CN0219800000000,02,198,"Prince of Wales-Hyder Census Area, AK",Jun-19,3114,2823,291,9.3
9746,CN0222000000000,02,220,"Sitka Borough/city, AK",Jun-19,4689,4507,182,3.9
9747,CN0223000000000,02,230,"Skagway Municipality, AK",Jun-19,1096,1062,34,3.1
9748,CN0224000000000,02,240,"Southeast Fairbanks Census Area, AK",Jun-19,2920,2659,261,8.9
9749,CN0226100000000,02,261,"Valdez-Cordova Census Area, AK",Jun-19,5495,5156,339,6.2
9750,CN0227500000000,02,275,"Wrangell Borough/city, AK",Jun-19,1068,989,79,7.4
9751,CN0228200000000,02,282,"Yakutat Borough/city, AK",Jun-19,256,242,14,5.5
9752,CN0229000000000,02,290,"Yukon-Koyukuk Census Area, AK",Jun-19,2569,2186,383,14.9
9753,CN0400100000000,04,1,"Apache County, AZ",Jun-19,20716,18542,2174,10.5
9754,CN0400300000000,04,3,"Cochise County, AZ",Jun-19,50239,47200,3039,6.0
9755,CN0400500000000,04,5,"Coconino County, AZ",Jun-19,78032,73438,4594,5.9
9756,CN0400700000000,04,7,"Gila County, AZ",Jun-19,22116,20885,1231,5.6
9757,CN0400900000000,04,9,"Graham County, AZ",Jun-19,15091,14290,801,5.3
9758,CN0401100000000,04,11,"Greenlee County, AZ",Jun-19,4572,4375,197,4.3
9759,CN0401200000000,04,12,"La Paz County, AZ",Jun-19,8808,8255,553,6.3
9760,CN0401300000000,04,13,"Maricopa County, AZ",Jun-19,2305444,2205818,99626,4.3
9761,CN0401500000000,04,15,"Mohave County, AZ",Jun-19,88783,83550,5233,5.9
9762,CN0401700000000,04,17,"Navajo County, AZ",Jun-19,41765,38591,3174,7.6
9763,CN0401900000000,04,19,"Pima County, AZ",Jun-19,497736,474059,23677,4.8
9764,CN0402100000000,04,21,"Pinal County, AZ",Jun-19,184761,175087,9674,5.2
9765,CN0402300000000,04,23,"Santa Cruz County, AZ",Jun-19,19900,18358,1542,7.7
9766,CN0402500000000,04,25,"Yavapai County, AZ",Jun-19,108141,103044,5097,4.7
9767,CN0402700000000,04,27,"Yuma County, AZ",Jun-19,96187,78050,18137,18.9
9768,CN0500100000000,05,1,"Arkansas County, AR",Jun-19,9531,9238,293,3.1
9769,CN0500300000000,05,3,"Ashley County, AR",Jun-19,7989,7533,456,5.7
9770,CN0500500000000,05,5,"Baxter County, AR",Jun-19,16670,15979,691,4.1
9771,CN0500700000000,05,7,"Benton County, AR",Jun-19,137247,133457,3790,2.8
9772,CN0500900000000,05,9,"Boone County, AR",Jun-19,16381,15854,527,3.2
9773,CN0501100000000,05,11,"Bradley County, AR",Jun-19,4603,4402,201,4.4
9774,CN0501300000000,05,13,"Calhoun County, AR",Jun-19,2504,2388,116,4.6
9775,CN0501500000000,05,15,"Carroll County, AR",Jun-19,13079,12701,378,2.9
9776,CN0501700000000,05,17,"Chicot County, AR",Jun-19,3352,3116,236,7.0
9777,CN0501900000000,05,19,"Clark County, AR",Jun-19,9479,9074,405,4.3
9778,CN0502100000000,05,21,"Clay County, AR",Jun-19,5787,5492,295,5.1
9779,CN0502300000000,05,23,"Cleburne County, AR",Jun-19,9590,9175,415,4.3
9780,CN0502500000000,05,25,"Cleveland County, AR",Jun-19,3227,3099,128,4.0
9781,CN0502700000000,05,27,"Columbia County, AR",Jun-19,9186,8715,471,5.1
9782,CN0502900000000,05,29,"Conway County, AR",Jun-19,8467,8062,405,4.8
9783,CN0503100000000,05,31,"Craighead County, AR",Jun-19,55875,54127,1748,3.1
9784,CN0503300000000,05,33,"Crawford County, AR",Jun-19,27291,26319,972,3.6
9785,CN0503500000000,05,35,"Crittenden County, AR",Jun-19,21634,20560,1074,5.0
9786,CN0503700000000,05,37,"Cross County, AR",Jun-19,7622,7298,324,4.3
9787,CN0503900000000,05,39,"Dallas County, AR",Jun-19,2902,2751,151,5.2
9788,CN0504100000000,05,41,"Desha County, AR",Jun-19,5483,5210,273,5.0
9789,CN0504300000000,05,43,"Drew County, AR",Jun-19,7857,7423,434,5.5
9790,CN0504500000000,05,45,"Faulkner County, AR",Jun-19,63109,61150,1959,3.1
9791,CN0504700000000,05,47,"Franklin County, AR",Jun-19,7604,7315,289,3.8
9792,CN0504900000000,05,49,"Fulton County, AR",Jun-19,5181,4968,213,4.1
9793,CN0505100000000,05,51,"Garland County, AR",Jun-19,41985,40295,1690,4.0
9794,CN0505300000000,05,53,"Grant County, AR",Jun-19,8494,8201,293,3.4
9795,CN0505500000000,05,55,"Greene County, AR",Jun-19,20257,19468,789,3.9
9796,CN0505700000000,05,57,"Hempstead County, AR",Jun-19,10074,9663,411,4.1
9797,CN0505900000000,05,59,"Hot Spring County, AR",Jun-19,14244,13673,571,4.0
9798,CN0506100000000,05,61,"Howard County, AR",Jun-19,5758,5550,208,3.6
9799,CN0506300000000,05,63,"Independence County, AR",Jun-19,16714,15981,733,4.4
9800,CN0506500000000,05,65,"Izard County, AR",Jun-19,4927,4628,299,6.1
9801,CN0506700000000,05,67,"Jackson County, AR",Jun-19,5907,5489,418,7.1
9802,CN0506900000000,05,69,"Jefferson County, AR",Jun-19,27984,26287,1697,6.1
9803,CN0507100000000,05,71,"Johnson County, AR",Jun-19,10478,9874,604,5.8
9804,CN0507300000000,05,73,"Lafayette County, AR",Jun-19,2502,2380,122,4.9
9805,CN0507500000000,05,75,"Lawrence County, AR",Jun-19,6748,6437,311,4.6
9806,CN0507700000000,05,77,"Lee County, AR",Jun-19,2832,2704,128,4.5
9807,CN0507900000000,05,79,"Lincoln County, AR",Jun-19,3979,3785,194,4.9
9808,CN0508100000000,05,81,"Little River County, AR",Jun-19,5625,5380,245,4.4
9809,CN0508300000000,05,83,"Logan County, AR",Jun-19,8737,8345,392,4.5
9810,CN0508500000000,05,85,"Lonoke County, AR",Jun-19,34743,33649,1094,3.1
9811,CN0508700000000,05,87,"Madison County, AR",Jun-19,7413,7219,194,2.6
9812,CN0508900000000,05,89,"Marion County, AR",Jun-19,6870,6593,277,4.0
9813,CN0509100000000,05,91,"Miller County, AR",Jun-19,20214,19318,896,4.4
9814,CN0509300000000,05,93,"Mississippi County, AR",Jun-19,17797,16467,1330,7.5
9815,CN0509500000000,05,95,"Monroe County, AR",Jun-19,2799,2663,136,4.9
9816,CN0509700000000,05,97,"Montgomery County, AR",Jun-19,3109,2977,132,4.2
9817,CN0509900000000,05,99,"Nevada County, AR",Jun-19,3732,3555,177,4.7
9818,CN0510100000000,05,101,"Newton County, AR",Jun-19,3402,3283,119,3.5
9819,CN0510300000000,05,103,"Ouachita County, AR",Jun-19,10055,9537,518,5.2
9820,CN0510500000000,05,105,"Perry County, AR",Jun-19,4332,4141,191,4.4
9821,CN0510700000000,05,107,"Phillips County, AR",Jun-19,6481,6089,392,6.0
9822,CN0510900000000,05,109,"Pike County, AR",Jun-19,4418,4248,170,3.8
9823,CN0511100000000,05,111,"Poinsett County, AR",Jun-19,10310,9920,390,3.8
9824,CN0511300000000,05,113,"Polk County, AR",Jun-19,8183,7831,352,4.3
9825,CN0511500000000,05,115,"Pope County, AR",Jun-19,28918,27454,1464,5.1
9826,CN0511700000000,05,117,"Prairie County, AR",Jun-19,3610,3452,158,4.4
9827,CN0511900000000,05,119,"Pulaski County, AR",Jun-19,192483,185580,6903,3.6
9828,CN0512100000000,05,121,"Randolph County, AR",Jun-19,7399,7069,330,4.5
9829,CN0512300000000,05,123,"St. Francis County, AR",Jun-19,8355,7884,471,5.6
9830,CN0512500000000,05,125,"Saline County, AR",Jun-19,59756,58020,1736,2.9
9831,CN0512700000000,05,127,"Scott County, AR",Jun-19,4389,4241,148,3.4
9832,CN0512900000000,05,129,"Searcy County, AR",Jun-19,3159,3024,135,4.3
9833,CN0513100000000,05,131,"Sebastian County, AR",Jun-19,57505,55484,2021,3.5
9834,CN0513300000000,05,133,"Sevier County, AR",Jun-19,5522,5251,271,4.9
9835,CN0513500000000,05,135,"Sharp County, AR",Jun-19,5877,5556,321,5.5
9836,CN0513700000000,05,137,"Stone County, AR",Jun-19,4863,4628,235,4.8
9837,CN0513900000000,05,139,"Union County, AR",Jun-19,16095,15186,909,5.6
9838,CN0514100000000,05,141,"Van Buren County, AR",Jun-19,5907,5624,283,4.8
9839,CN0514300000000,05,143,"Washington County, AR",Jun-19,125099,121812,3287,2.6
9840,CN0514500000000,05,145,"White County, AR",Jun-19,33955,32402,1553,4.6
9841,CN0514700000000,05,147,"Woodruff County, AR",Jun-19,2801,2648,153,5.5
9842,CN0514900000000,05,149,"Yell County, AR",Jun-19,8386,8021,365,4.4
9843,CN0600100000000,06,1,"Alameda County, CA",Jun-19,840754,814723,26031,3.1
9844,CN0600300000000,06,3,"Alpine County, CA",Jun-19,483,449,34,7.0
9845,CN0600500000000,06,5,"Amador County, CA",Jun-19,14982,14422,560,3.7
9846,CN0600700000000,06,7,"Butte County, CA",Jun-19,97541,92299,5242,5.4
9847,CN0600900000000,06,9,"Calaveras County, CA",Jun-19,21403,20596,807,3.8
9848,CN0601100000000,06,11,"Colusa County, CA",Jun-19,11020,9841,1179,10.7
9849,CN0601300000000,06,13,"Contra Costa County, CA",Jun-19,558996,540960,18036,3.2
9850,CN0601500000000,06,15,"Del Norte County, CA",Jun-19,9734,9210,524,5.4
9851,CN0601700000000,06,17,"El Dorado County, CA",Jun-19,91488,88194,3294,3.6
9852,CN0601900000000,06,19,"Fresno County, CA",Jun-19,451786,420043,31743,7.0
9853,CN0602100000000,06,21,"Glenn County, CA",Jun-19,12841,12038,803,6.3
9854,CN0602300000000,06,23,"Humboldt County, CA",Jun-19,62345,60059,2286,3.7
9855,CN0602500000000,06,25,"Imperial County, CA",Jun-19,71901,58759,13142,18.3
9856,CN0602700000000,06,27,"Inyo County, CA",Jun-19,8808,8501,307,3.5
9857,CN0602900000000,06,29,"Kern County, CA",Jun-19,390954,359852,31102,8.0
9858,CN0603100000000,06,31,"Kings County, CA",Jun-19,57229,52687,4542,7.9
9859,CN0603300000000,06,33,"Lake County, CA",Jun-19,29417,27993,1424,4.8
9860,CN0603500000000,06,35,"Lassen County, CA",Jun-19,9633,9188,445,4.6
9861,CN0603700000000,06,37,"Los Angeles County, CA",Jun-19,5079145,4851414,227731,4.5
9862,CN0603900000000,06,39,"Madera County, CA",Jun-19,62281,58016,4265,6.8
9863,CN0604100000000,06,41,"Marin County, CA",Jun-19,139248,135896,3352,2.4
9864,CN0604300000000,06,43,"Mariposa County, CA",Jun-19,7834,7518,316,4.0
9865,CN0604500000000,06,45,"Mendocino County, CA",Jun-19,39064,37597,1467,3.8
9866,CN0604700000000,06,47,"Merced County, CA",Jun-19,115242,105906,9336,8.1
9867,CN0604900000000,06,49,"Modoc County, CA",Jun-19,3357,3167,190,5.7
9868,CN0605100000000,06,51,"Mono County, CA",Jun-19,8240,7912,328,4.0
9869,CN0605300000000,06,53,"Monterey County, CA",Jun-19,231689,220670,11019,4.8
9870,CN0605500000000,06,55,"Napa County, CA",Jun-19,75059,72992,2067,2.8
9871,CN0605700000000,06,57,"Nevada County, CA",Jun-19,48284,46665,1619,3.4
9872,CN0605900000000,06,59,"Orange County, CA",Jun-19,1613664,1566398,47266,2.9
9873,CN0606100000000,06,61,"Placer County, CA",Jun-19,187021,180999,6022,3.2
9874,CN0606300000000,06,63,"Plumas County, CA",Jun-19,8309,7803,506,6.1
9875,CN0606500000000,06,65,"Riverside County, CA",Jun-19,1095978,1048189,47789,4.4
9876,CN0606700000000,06,67,"Sacramento County, CA",Jun-19,709868,682632,27236,3.8
9877,CN0606900000000,06,69,"San Benito County, CA",Jun-19,31305,29797,1508,4.8
9878,CN0607100000000,06,71,"San Bernardino County, CA",Jun-19,959870,920468,39402,4.1
9879,CN0607300000000,06,73,"San Diego County, CA",Jun-19,1582682,1529812,52870,3.3
9880,CN0607500000000,06,75,"San Francisco County/city, CA",Jun-19,578941,565408,13533,2.3
9881,CN0607700000000,06,77,"San Joaquin County, CA",Jun-19,327178,308158,19020,5.8
9882,CN0607900000000,06,79,"San Luis Obispo County, CA",Jun-19,142111,137872,4239,3.0
9883,CN0608100000000,06,81,"San Mateo County, CA",Jun-19,456418,446509,9909,2.2
9884,CN0608300000000,06,83,"Santa Barbara County, CA",Jun-19,221045,213517,7528,3.4
9885,CN0608500000000,06,85,"Santa Clara County, CA",Jun-19,1049760,1022128,27632,2.6
9886,CN0608700000000,06,87,"Santa Cruz County, CA",Jun-19,144904,138792,6112,4.2
9887,CN0608900000000,06,89,"Shasta County, CA",Jun-19,74445,71043,3402,4.6
9888,CN0609100000000,06,91,"Sierra County, CA",Jun-19,1358,1292,66,4.9
9889,CN0609300000000,06,93,"Siskiyou County, CA",Jun-19,17507,16503,1004,5.7
9890,CN0609500000000,06,95,"Solano County, CA",Jun-19,209064,201001,8063,3.9
9891,CN0609700000000,06,97,"Sonoma County, CA",Jun-19,256989,249774,7215,2.8
9892,CN0609900000000,06,99,"Stanislaus County, CA",Jun-19,242761,227352,15409,6.3
9893,CN0610100000000,06,101,"Sutter County, CA",Jun-19,46161,42926,3235,7.0
9894,CN0610300000000,06,103,"Tehama County, CA",Jun-19,25681,24242,1439,5.6
9895,CN0610500000000,06,105,"Trinity County, CA",Jun-19,4967,4729,238,4.8
9896,CN0610700000000,06,107,"Tulare County, CA",Jun-19,205888,187049,18839,9.2
9897,CN0610900000000,06,109,"Tuolumne County, CA",Jun-19,21324,20385,939,4.4
9898,CN0611100000000,06,111,"Ventura County, CA",Jun-19,421387,406224,15163,3.6
9899,CN0611300000000,06,113,"Yolo County, CA",Jun-19,108473,104174,4299,4.0
9900,CN0611500000000,06,115,"Yuba County, CA",Jun-19,29717,27954,1763,5.9
9901,CN0800100000000,08,1,"Adams County, CO",Jun-19,277181,268734,8447,3.0
9902,CN0800300000000,08,3,"Alamosa County, CO",Jun-19,8751,8444,307,3.5
9903,CN0800500000000,08,5,"Arapahoe County, CO",Jun-19,371533,360803,10730,2.9
9904,CN0800700000000,08,7,"Archuleta County, CO",Jun-19,7202,6959,243,3.4
9905,CN0800900000000,08,9,"Baca County, CO",Jun-19,2165,2125,40,1.8
9906,CN0801100000000,08,11,"Bent County, CO",Jun-19,1899,1841,58,3.1
9907,CN0801300000000,08,13,"Boulder County, CO",Jun-19,195857,190697,5160,2.6
9908,CN0801400000000,08,14,"Broomfield County/city, CO",Jun-19,40826,39735,1091,2.7
9909,CN0801500000000,08,15,"Chaffee County, CO",Jun-19,10581,10327,254,2.4
9910,CN0801700000000,08,17,"Cheyenne County, CO",Jun-19,1164,1142,22,1.9
9911,CN0801900000000,08,19,"Clear Creek County, CO",Jun-19,6174,5999,175,2.8
9912,CN0802100000000,08,21,"Conejos County, CO",Jun-19,4160,4007,153,3.7
9913,CN0802300000000,08,23,"Costilla County, CO",Jun-19,1904,1831,73,3.8
9914,CN0802500000000,08,25,"Crowley County, CO",Jun-19,1514,1447,67,4.4
9915,CN0802700000000,08,27,"Custer County, CO",Jun-19,2129,2055,74,3.5
9916,CN0802900000000,08,29,"Delta County, CO",Jun-19,14566,14068,498,3.4
9917,CN0803100000000,08,31,"Denver County/city, CO",Jun-19,424447,412478,11969,2.8
9918,CN0803300000000,08,33,"Dolores County, CO",Jun-19,1167,1133,34,2.9
9919,CN0803500000000,08,35,"Douglas County, CO",Jun-19,197806,192707,5099,2.6
9920,CN0803700000000,08,37,"Eagle County, CO",Jun-19,36254,35368,886,2.4
9921,CN0803900000000,08,39,"Elbert County, CO",Jun-19,15430,15058,372,2.4
9922,CN0804100000000,08,41,"El Paso County, CO",Jun-19,344798,332737,12061,3.5
9923,CN0804300000000,08,43,"Fremont County, CO",Jun-19,15753,15038,715,4.5
9924,CN0804500000000,08,45,"Garfield County, CO",Jun-19,32983,32098,885,2.7
9925,CN0804700000000,08,47,"Gilpin County, CO",Jun-19,3861,3759,102,2.6
9926,CN0804900000000,08,49,"Grand County, CO",Jun-19,10033,9790,243,2.4
9927,CN0805100000000,08,51,"Gunnison County, CO",Jun-19,11622,11361,261,2.2
9928,CN0805300000000,08,53,"Hinsdale County, CO",Jun-19,509,497,12,2.4
9929,CN0805500000000,08,55,"Huerfano County, CO",Jun-19,2586,2446,140,5.4
9930,CN0805700000000,08,57,"Jackson County, CO",Jun-19,1022,995,27,2.6
9931,CN0805900000000,08,59,"Jefferson County, CO",Jun-19,341468,332232,9236,2.7
9932,CN0806100000000,08,61,"Kiowa County, CO",Jun-19,941,923,18,1.9
9933,CN0806300000000,08,63,"Kit Carson County, CO",Jun-19,4383,4301,82,1.9
9934,CN0806500000000,08,65,"Lake County, CO",Jun-19,4860,4729,131,2.7
9935,CN0806700000000,08,67,"La Plata County, CO",Jun-19,32708,31870,838,2.6
9936,CN0806900000000,08,69,"Larimer County, CO",Jun-19,207215,201970,5245,2.5
9937,CN0807100000000,08,71,"Las Animas County, CO",Jun-19,6581,6314,267,4.1
9938,CN0807300000000,08,73,"Lincoln County, CO",Jun-19,2447,2389,58,2.4
9939,CN0807500000000,08,75,"Logan County, CO",Jun-19,11124,10830,294,2.6
9940,CN0807700000000,08,77,"Mesa County, CO",Jun-19,76133,73374,2759,3.6
9941,CN0807900000000,08,79,"Mineral County, CO",Jun-19,599,583,16,2.7
9942,CN0808100000000,08,81,"Moffat County, CO",Jun-19,7520,7279,241,3.2
9943,CN0808300000000,08,83,"Montezuma County, CO",Jun-19,13235,12763,472,3.6
9944,CN0808500000000,08,85,"Montrose County, CO",Jun-19,22127,21452,675,3.1
9945,CN0808700000000,08,87,"Morgan County, CO",Jun-19,16453,15976,477,2.9
9946,CN0808900000000,08,89,"Otero County, CO",Jun-19,8426,8076,350,4.2
9947,CN0809100000000,08,91,"Ouray County, CO",Jun-19,2687,2616,71,2.6
9948,CN0809300000000,08,93,"Park County, CO",Jun-19,11397,11104,293,2.6
9949,CN0809500000000,08,95,"Phillips County, CO",Jun-19,2667,2615,52,1.9
9950,CN0809700000000,08,97,"Pitkin County, CO",Jun-19,11469,11099,370,3.2
9951,CN0809900000000,08,99,"Prowers County, CO",Jun-19,6316,6119,197,3.1
9952,CN0810100000000,08,101,"Pueblo County, CO",Jun-19,76305,73050,3255,4.3
9953,CN0810300000000,08,103,"Rio Blanco County, CO",Jun-19,3014,2900,114,3.8
9954,CN0810500000000,08,105,"Rio Grande County, CO",Jun-19,5582,5359,223,4.0
9955,CN0810700000000,08,107,"Routt County, CO",Jun-19,16272,15865,407,2.5
9956,CN0810900000000,08,109,"Saguache County, CO",Jun-19,3607,3445,162,4.5
9957,CN0811100000000,08,111,"San Juan County, CO",Jun-19,666,649,17,2.6
9958,CN0811300000000,08,113,"San Miguel County, CO",Jun-19,5716,5560,156,2.7
9959,CN0811500000000,08,115,"Sedgwick County, CO",Jun-19,1236,1204,32,2.6
9960,CN0811700000000,08,117,"Summit County, CO",Jun-19,21768,21295,473,2.2
9961,CN0811900000000,08,119,"Teller County, CO",Jun-19,12938,12509,429,3.3
9962,CN0812100000000,08,121,"Washington County, CO",Jun-19,3019,2948,71,2.4
9963,CN0812300000000,08,123,"Weld County, CO",Jun-19,168997,164284,4713,2.8
9964,CN0812500000000,08,125,"Yuma County, CO",Jun-19,6554,6442,112,1.7
9965,CN0900100000000,09,1,"Fairfield County, CT",Jun-19,487316,468879,18437,3.8
9966,CN0900300000000,09,3,"Hartford County, CT",Jun-19,483358,464258,19100,4.0
9967,CN0900500000000,09,5,"Litchfield County, CT",Jun-19,106325,102699,3626,3.4
9968,CN0900700000000,09,7,"Middlesex County, CT",Jun-19,93801,90715,3086,3.3
9969,CN0900900000000,09,9,"New Haven County, CT",Jun-19,463719,444742,18977,4.1
9970,CN0901100000000,09,11,"New London County, CT",Jun-19,139268,134073,5195,3.7
9971,CN0901300000000,09,13,"Tolland County, CT",Jun-19,87146,84165,2981,3.4
9972,CN0901500000000,09,15,"Windham County, CT",Jun-19,64690,61907,2783,4.3
9973,CN1000100000000,10,1,"Kent County, DE",Jun-19,79134,75389,3745,4.7
9974,CN1000300000000,10,3,"New Castle County, DE",Jun-19,298263,286113,12150,4.1
9975,CN1000500000000,10,5,"Sussex County, DE",Jun-19,113355,109350,4005,3.5
9976,CN1100100000000,11,1,District of Columbia,Jun-19,412636,388574,24062,5.8
9977,CN1200100000000,12,1,"Alachua County, FL",Jun-19,136507,131999,4508,3.3
9978,CN1200300000000,12,3,"Baker County, FL",Jun-19,11877,11468,409,3.4
9979,CN1200500000000,12,5,"Bay County, FL",Jun-19,86456,83140,3316,3.8
9980,CN1200700000000,12,7,"Bradford County, FL",Jun-19,10848,10477,371,3.4
9981,CN1200900000000,12,9,"Brevard County, FL",Jun-19,285268,275572,9696,3.4
9982,CN1201100000000,12,11,"Broward County, FL",Jun-19,1042537,1008746,33791,3.2
9983,CN1201300000000,12,13,"Calhoun County, FL",Jun-19,4930,4728,202,4.1
9984,CN1201500000000,12,15,"Charlotte County, FL",Jun-19,71458,68683,2775,3.9
9985,CN1201700000000,12,17,"Citrus County, FL",Jun-19,47675,45230,2445,5.1
9986,CN1201900000000,12,19,"Clay County, FL",Jun-19,107826,104315,3511,3.3
9987,CN1202100000000,12,21,"Collier County, FL",Jun-19,175950,170083,5867,3.3
9988,CN1202300000000,12,23,"Columbia County, FL",Jun-19,29772,28714,1058,3.6
9989,CN1202700000000,12,27,"DeSoto County, FL",Jun-19,13948,13422,526,3.8
9990,CN1202900000000,12,29,"Dixie County, FL",Jun-19,5604,5362,242,4.3
9991,CN1203100000000,12,31,"Duval County, FL",Jun-19,493308,475547,17761,3.6
9992,CN1203300000000,12,33,"Escambia County, FL",Jun-19,146497,141441,5056,3.5
9993,CN1203500000000,12,35,"Flagler County, FL",Jun-19,47115,45178,1937,4.1
9994,CN1203700000000,12,37,"Franklin County, FL",Jun-19,4909,4743,166,3.4
9995,CN1203900000000,12,39,"Gadsden County, FL",Jun-19,18894,18075,819,4.3
9996,CN1204100000000,12,41,"Gilchrist County, FL",Jun-19,7027,6756,271,3.9
9997,CN1204300000000,12,43,"Glades County, FL",Jun-19,4962,4730,232,4.7
9998,CN1204500000000,12,45,"Gulf County, FL",Jun-19,5925,5640,285,4.8
9999,CN1204700000000,12,47,"Hamilton County, FL",Jun-19,4654,4467,187,4.0
10000,CN1204900000000,12,49,"Hardee County, FL",Jun-19,7983,7524,459,5.7
10001,CN1205100000000,12,51,"Hendry County, FL",Jun-19,14454,13494,960,6.6
10002,CN1205300000000,12,53,"Hernando County, FL",Jun-19,72111,68838,3273,4.5
10003,CN1205500000000,12,55,"Highlands County, FL",Jun-19,36110,34342,1768,4.9
10004,CN1205700000000,12,57,"Hillsborough County, FL",Jun-19,749157,724334,24823,3.3
10005,CN1205900000000,12,59,"Holmes County, FL",Jun-19,6984,6721,263,3.8
10006,CN1206100000000,12,61,"Indian River County, FL",Jun-19,65296,62589,2707,4.1
10007,CN1206300000000,12,63,"Jackson County, FL",Jun-19,16961,16279,682,4.0
10008,CN1206500000000,12,65,"Jefferson County, FL",Jun-19,5527,5328,199,3.6
10009,CN1206700000000,12,67,"Lafayette County, FL",Jun-19,2764,2670,94,3.4
10010,CN1206900000000,12,69,"Lake County, FL",Jun-19,159415,153889,5526,3.5
10011,CN1207100000000,12,71,"Lee County, FL",Jun-19,344466,332575,11891,3.5
10012,CN1207300000000,12,73,"Leon County, FL",Jun-19,153149,147885,5264,3.4
10013,CN1207500000000,12,75,"Levy County, FL",Jun-19,16512,15828,684,4.1
10014,CN1207700000000,12,77,"Liberty County, FL",Jun-19,2652,2548,104,3.9
10015,CN1207900000000,12,79,"Madison County, FL",Jun-19,7482,7181,301,4.0
10016,CN1208100000000,12,81,"Manatee County, FL",Jun-19,179539,173507,6032,3.4
10017,CN1208300000000,12,83,"Marion County, FL",Jun-19,137956,132220,5736,4.2
10018,CN1208500000000,12,85,"Martin County, FL",Jun-19,74044,71503,2541,3.4
10019,CN1208600000000,12,86,"Miami-Dade County, FL",Jun-19,1369579,1335085,34494,2.5
10020,CN1208700000000,12,87,"Monroe County, FL",Jun-19,46480,45460,1020,2.2
10021,CN1208900000000,12,89,"Nassau County, FL",Jun-19,41273,39970,1303,3.2
10022,CN1209100000000,12,91,"Okaloosa County, FL",Jun-19,100089,97273,2816,2.8
10023,CN1209300000000,12,93,"Okeechobee County, FL",Jun-19,17141,16480,661,3.9
10024,CN1209500000000,12,95,"Orange County, FL",Jun-19,764141,740245,23896,3.1
10025,CN1209700000000,12,97,"Osceola County, FL",Jun-19,184769,178276,6493,3.5
10026,CN1209900000000,12,99,"Palm Beach County, FL",Jun-19,732206,706550,25656,3.5
10027,CN1210100000000,12,101,"Pasco County, FL",Jun-19,238424,229470,8954,3.8
10028,CN1210300000000,12,103,"Pinellas County, FL",Jun-19,494700,479006,15694,3.2
10029,CN1210500000000,12,105,"Polk County, FL",Jun-19,305166,292952,12214,4.0
10030,CN1210700000000,12,107,"Putnam County, FL",Jun-19,26286,25049,1237,4.7
10031,CN1210900000000,12,109,"St. Johns County, FL",Jun-19,132876,129083,3793,2.9
10032,CN1211100000000,12,111,"St. Lucie County, FL",Jun-19,144998,138820,6178,4.3
10033,CN1211300000000,12,113,"Santa Rosa County, FL",Jun-19,83264,80562,2702,3.2
10034,CN1211500000000,12,115,"Sarasota County, FL",Jun-19,189165,182798,6367,3.4
10035,CN1211700000000,12,117,"Seminole County, FL",Jun-19,256100,248055,8045,3.1
10036,CN1211900000000,12,119,"Sumter County, FL",Jun-19,32753,31116,1637,5.0
10037,CN1212100000000,12,121,"Suwannee County, FL",Jun-19,18334,17688,646,3.5
10038,CN1212300000000,12,123,"Taylor County, FL",Jun-19,8409,8086,323,3.8
10039,CN1212500000000,12,125,"Union County, FL",Jun-19,4587,4436,151,3.3
10040,CN1212700000000,12,127,"Volusia County, FL",Jun-19,254596,245147,9449,3.7
10041,CN1212900000000,12,129,"Wakulla County, FL",Jun-19,14682,14217,465,3.2
10042,CN1213100000000,12,131,"Walton County, FL",Jun-19,32577,31623,954,2.9
10043,CN1213300000000,12,133,"Washington County, FL",Jun-19,9735,9387,348,3.6
10044,CN1300100000000,13,1,"Appling County, GA",Jun-19,8926,8507,419,4.7
10045,CN1300300000000,13,3,"Atkinson County, GA",Jun-19,4548,4415,133,2.9
10046,CN1300500000000,13,5,"Bacon County, GA",Jun-19,4971,4776,195,3.9
10047,CN1300700000000,13,7,"Baker County, GA",Jun-19,1107,1050,57,5.1
10048,CN1300900000000,13,9,"Baldwin County, GA",Jun-19,17355,16534,821,4.7
10049,CN1301100000000,13,11,"Banks County, GA",Jun-19,9484,9185,299,3.2
10050,CN1301300000000,13,13,"Barrow County, GA",Jun-19,40336,39071,1265,3.1
10051,CN1301500000000,13,15,"Bartow County, GA",Jun-19,50366,48621,1745,3.5
10052,CN1301700000000,13,17,"Ben Hill County, GA",Jun-19,5235,4939,296,5.7
10053,CN1301900000000,13,19,"Berrien County, GA",Jun-19,7336,7049,287,3.9
10054,CN1302100000000,13,21,"Bibb County, GA",Jun-19,67942,64974,2968,4.4
10055,CN1302300000000,13,23,"Bleckley County, GA",Jun-19,4570,4293,277,6.1
10056,CN1302500000000,13,25,"Brantley County, GA",Jun-19,7239,6927,312,4.3
10057,CN1302700000000,13,27,"Brooks County, GA",Jun-19,6711,6458,253,3.8
10058,CN1302900000000,13,29,"Bryan County, GA",Jun-19,18352,17751,601,3.3
10059,CN1303100000000,13,31,"Bulloch County, GA",Jun-19,35985,34367,1618,4.5
10060,CN1303300000000,13,33,"Burke County, GA",Jun-19,9100,8605,495,5.4
10061,CN1303500000000,13,35,"Butts County, GA",Jun-19,10723,10321,402,3.7
10062,CN1303700000000,13,37,"Calhoun County, GA",Jun-19,2087,2005,82,3.9
10063,CN1303900000000,13,39,"Camden County, GA",Jun-19,21040,20210,830,3.9
10064,CN1304300000000,13,43,"Candler County, GA",Jun-19,5467,5298,169,3.1
10065,CN1304500000000,13,45,"Carroll County, GA",Jun-19,55161,53001,2160,3.9
10066,CN1304700000000,13,47,"Catoosa County, GA",Jun-19,33496,32407,1089,3.3
10067,CN1304900000000,13,49,"Charlton County, GA",Jun-19,4747,4545,202,4.3
10068,CN1305100000000,13,51,"Chatham County, GA",Jun-19,140415,135352,5063,3.6
10069,CN1305300000000,13,53,"Chattahoochee County, GA",Jun-19,1975,1888,87,4.4
10070,CN1305500000000,13,55,"Chattooga County, GA",Jun-19,10147,9744,403,4.0
10071,CN1305700000000,13,57,"Cherokee County, GA",Jun-19,135665,131531,4134,3.0
10072,CN1305900000000,13,59,"Clarke County, GA",Jun-19,58389,55941,2448,4.2
10073,CN1306100000000,13,61,"Clay County, GA",Jun-19,860,797,63,7.3
10074,CN1306300000000,13,63,"Clayton County, GA",Jun-19,137980,131466,6514,4.7
10075,CN1306500000000,13,65,"Clinch County, GA",Jun-19,2711,2587,124,4.6
10076,CN1306700000000,13,67,"Cobb County, GA",Jun-19,424718,410884,13834,3.3
10077,CN1306900000000,13,69,"Coffee County, GA",Jun-19,18610,17872,738,4.0
10078,CN1307100000000,13,71,"Colquitt County, GA",Jun-19,21018,20290,728,3.5
10079,CN1307300000000,13,73,"Columbia County, GA",Jun-19,75153,72629,2524,3.4
10080,CN1307500000000,13,75,"Cook County, GA",Jun-19,7854,7567,287,3.7
10081,CN1307700000000,13,77,"Coweta County, GA",Jun-19,74601,72087,2514,3.4
10082,CN1307900000000,13,79,"Crawford County, GA",Jun-19,5567,5347,220,4.0
10083,CN1308100000000,13,81,"Crisp County, GA",Jun-19,9488,9099,389,4.1
10084,CN1308300000000,13,83,"Dade County, GA",Jun-19,8172,7872,300,3.7
10085,CN1308500000000,13,85,"Dawson County, GA",Jun-19,12260,11874,386,3.1
10086,CN1308700000000,13,87,"Decatur County, GA",Jun-19,11307,10824,483,4.3
10087,CN1308900000000,13,89,"DeKalb County, GA",Jun-19,399254,384310,14944,3.7
10088,CN1309100000000,13,91,"Dodge County, GA",Jun-19,7156,6709,447,6.2
10089,CN1309300000000,13,93,"Dooly County, GA",Jun-19,4941,4723,218,4.4
10090,CN1309500000000,13,95,"Dougherty County, GA",Jun-19,38298,36239,2059,5.4
10091,CN1309700000000,13,97,"Douglas County, GA",Jun-19,73255,70372,2883,3.9
10092,CN1309900000000,13,99,"Early County, GA",Jun-19,4284,4099,185,4.3
10093,CN1310100000000,13,101,"Echols County, GA",Jun-19,1841,1778,63,3.4
10094,CN1310300000000,13,103,"Effingham County, GA",Jun-19,31057,30065,992,3.2
10095,CN1310500000000,13,105,"Elbert County, GA",Jun-19,7589,7276,313,4.1
10096,CN1310700000000,13,107,"Emanuel County, GA",Jun-19,8134,7685,449,5.5
10097,CN1310900000000,13,109,"Evans County, GA",Jun-19,4749,4561,188,4.0
10098,CN1311100000000,13,111,"Fannin County, GA",Jun-19,11570,11162,408,3.5
10099,CN1311300000000,13,113,"Fayette County, GA",Jun-19,57999,56045,1954,3.4
10100,CN1311500000000,13,115,"Floyd County, GA",Jun-19,43887,42135,1752,4.0
10101,CN1311700000000,13,117,"Forsyth County, GA",Jun-19,121956,118178,3778,3.1
10102,CN1311900000000,13,119,"Franklin County, GA",Jun-19,9815,9429,386,3.9
10103,CN1312100000000,13,121,"Fulton County, GA",Jun-19,556898,535369,21529,3.9
10104,CN1312300000000,13,123,"Gilmer County, GA",Jun-19,11785,11326,459,3.9
10105,CN1312500000000,13,125,"Glascock County, GA",Jun-19,1249,1199,50,4.0
10106,CN1312700000000,13,127,"Glynn County, GA",Jun-19,39788,38384,1404,3.5
10107,CN1312900000000,13,129,"Gordon County, GA",Jun-19,28205,27215,990,3.5
10108,CN1313100000000,13,131,"Grady County, GA",Jun-19,10229,9837,392,3.8
10109,CN1313300000000,13,133,"Greene County, GA",Jun-19,7128,6848,280,3.9
10110,CN1313500000000,13,135,"Gwinnett County, GA",Jun-19,489340,472790,16550,3.4
10111,CN1313700000000,13,137,"Habersham County, GA",Jun-19,18992,18293,699,3.7
10112,CN1313900000000,13,139,"Hall County, GA",Jun-19,101625,98426,3199,3.1
10113,CN1314100000000,13,141,"Hancock County, GA",Jun-19,2377,2246,131,5.5
10114,CN1314300000000,13,143,"Haralson County, GA",Jun-19,12534,12077,457,3.6
10115,CN1314500000000,13,145,"Harris County, GA",Jun-19,16595,16034,561,3.4
10116,CN1314700000000,13,147,"Hart County, GA",Jun-19,11353,10934,419,3.7
10117,CN1314900000000,13,149,"Heard County, GA",Jun-19,5233,5033,200,3.8
10118,CN1315100000000,13,151,"Henry County, GA",Jun-19,115657,111061,4596,4.0
10119,CN1315300000000,13,153,"Houston County, GA",Jun-19,70665,68092,2573,3.6
10120,CN1315500000000,13,155,"Irwin County, GA",Jun-19,3079,2922,157,5.1
10121,CN1315700000000,13,157,"Jackson County, GA",Jun-19,36186,35124,1062,2.9
10122,CN1315900000000,13,159,"Jasper County, GA",Jun-19,6894,6662,232,3.4
10123,CN1316100000000,13,161,"Jeff Davis County, GA",Jun-19,6068,5751,317,5.2
10124,CN1316300000000,13,163,"Jefferson County, GA",Jun-19,6501,6149,352,5.4
10125,CN1316500000000,13,165,"Jenkins County, GA",Jun-19,3120,2954,166,5.3
10126,CN1316700000000,13,167,"Johnson County, GA",Jun-19,4044,3882,162,4.0
10127,CN1316900000000,13,169,"Jones County, GA",Jun-19,13636,13157,479,3.5
10128,CN1317100000000,13,171,"Lamar County, GA",Jun-19,8230,7872,358,4.3
10129,CN1317300000000,13,173,"Lanier County, GA",Jun-19,3715,3558,157,4.2
10130,CN1317500000000,13,175,"Laurens County, GA",Jun-19,19282,18340,942,4.9
10131,CN1317700000000,13,177,"Lee County, GA",Jun-19,14644,14150,494,3.4
10132,CN1317900000000,13,179,"Liberty County, GA",Jun-19,25867,24768,1099,4.2
10133,CN1318100000000,13,181,"Lincoln County, GA",Jun-19,3506,3365,141,4.0
10134,CN1318300000000,13,183,"Long County, GA",Jun-19,8012,7662,350,4.4
10135,CN1318500000000,13,185,"Lowndes County, GA",Jun-19,51042,49034,2008,3.9
10136,CN1318700000000,13,187,"Lumpkin County, GA",Jun-19,16739,16132,607,3.6
10137,CN1318900000000,13,189,"McDuffie County, GA",Jun-19,8845,8375,470,5.3
10138,CN1319100000000,13,191,"McIntosh County, GA",Jun-19,6165,5932,233,3.8
10139,CN1319300000000,13,193,"Macon County, GA",Jun-19,4645,4406,239,5.1
10140,CN1319500000000,13,195,"Madison County, GA",Jun-19,13049,12614,435,3.3
10141,CN1319700000000,13,197,"Marion County, GA",Jun-19,3293,3136,157,4.8
10142,CN1319900000000,13,199,"Meriwether County, GA",Jun-19,8868,8430,438,4.9
10143,CN1320100000000,13,201,"Miller County, GA",Jun-19,2695,2592,103,3.8
10144,CN1320500000000,13,205,"Mitchell County, GA",Jun-19,8171,7763,408,5.0
10145,CN1320700000000,13,207,"Monroe County, GA",Jun-19,12923,12464,459,3.6
10146,CN1320900000000,13,209,"Montgomery County, GA",Jun-19,3780,3551,229,6.1
10147,CN1321100000000,13,211,"Morgan County, GA",Jun-19,9133,8826,307,3.4
10148,CN1321300000000,13,213,"Murray County, GA",Jun-19,15437,14645,792,5.1
10149,CN1321500000000,13,215,"Muscogee County, GA",Jun-19,77679,73779,3900,5.0
10150,CN1321700000000,13,217,"Newton County, GA",Jun-19,52184,49936,2248,4.3
10151,CN1321900000000,13,219,"Oconee County, GA",Jun-19,19194,18628,566,2.9
10152,CN1322100000000,13,221,"Oglethorpe County, GA",Jun-19,6777,6531,246,3.6
10153,CN1322300000000,13,223,"Paulding County, GA",Jun-19,85834,83042,2792,3.3
10154,CN1322500000000,13,225,"Peach County, GA",Jun-19,11817,11256,561,4.7
10155,CN1322700000000,13,227,"Pickens County, GA",Jun-19,15244,14756,488,3.2
10156,CN1322900000000,13,229,"Pierce County, GA",Jun-19,8627,8302,325,3.8
10157,CN1323100000000,13,231,"Pike County, GA",Jun-19,8867,8567,300,3.4
10158,CN1323300000000,13,233,"Polk County, GA",Jun-19,18415,17697,718,3.9
10159,CN1323500000000,13,235,"Pulaski County, GA",Jun-19,4034,3858,176,4.4
10160,CN1323700000000,13,237,"Putnam County, GA",Jun-19,8130,7762,368,4.5
10161,CN1323900000000,13,239,"Quitman County, GA",Jun-19,798,756,42,5.3
10162,CN1324100000000,13,241,"Rabun County, GA",Jun-19,7253,6981,272,3.8
10163,CN1324300000000,13,243,"Randolph County, GA",Jun-19,2453,2322,131,5.3
10164,CN1324500000000,13,245,"Richmond County, GA",Jun-19,85343,81115,4228,5.0
10165,CN1324700000000,13,247,"Rockdale County, GA",Jun-19,44765,42888,1877,4.2
10166,CN1324900000000,13,249,"Schley County, GA",Jun-19,2191,2098,93,4.2
10167,CN1325100000000,13,251,"Screven County, GA",Jun-19,5004,4721,283,5.7
10168,CN1325300000000,13,253,"Seminole County, GA",Jun-19,3009,2859,150,5.0
10169,CN1325500000000,13,255,"Spalding County, GA",Jun-19,28619,27390,1229,4.3
10170,CN1325700000000,13,257,"Stephens County, GA",Jun-19,10642,10195,447,4.2
10171,CN1325900000000,13,259,"Stewart County, GA",Jun-19,2340,2226,114,4.9
10172,CN1326100000000,13,261,"Sumter County, GA",Jun-19,12608,11961,647,5.1
10173,CN1326300000000,13,263,"Talbot County, GA",Jun-19,2833,2682,151,5.3
10174,CN1326500000000,13,265,"Taliaferro County, GA",Jun-19,571,545,26,4.6
10175,CN1326700000000,13,267,"Tattnall County, GA",Jun-19,9397,8997,400,4.3
10176,CN1326900000000,13,269,"Taylor County, GA",Jun-19,3126,3001,125,4.0
10177,CN1327100000000,13,271,"Telfair County, GA",Jun-19,4177,3666,511,12.2
10178,CN1327300000000,13,273,"Terrell County, GA",Jun-19,3485,3293,192,5.5
10179,CN1327500000000,13,275,"Thomas County, GA",Jun-19,16197,15488,709,4.4
10180,CN1327700000000,13,277,"Tift County, GA",Jun-19,19516,18811,705,3.6
10181,CN1327900000000,13,279,"Toombs County, GA",Jun-19,11505,10902,603,5.2
10182,CN1328100000000,13,281,"Towns County, GA",Jun-19,3945,3734,211,5.3
10183,CN1328300000000,13,283,"Treutlen County, GA",Jun-19,2607,2458,149,5.7
10184,CN1328500000000,13,285,"Troup County, GA",Jun-19,37491,36192,1299,3.5
10185,CN1328700000000,13,287,"Turner County, GA",Jun-19,3116,2991,125,4.0
10186,CN1328900000000,13,289,"Twiggs County, GA",Jun-19,2874,2708,166,5.8
10187,CN1329100000000,13,291,"Union County, GA",Jun-19,10215,9868,347,3.4
10188,CN1329300000000,13,293,"Upson County, GA",Jun-19,11261,10828,433,3.8
10189,CN1329500000000,13,295,"Walker County, GA",Jun-19,31198,30090,1108,3.6
10190,CN1329700000000,13,297,"Walton County, GA",Jun-19,45963,44400,1563,3.4
10191,CN1329900000000,13,299,"Ware County, GA",Jun-19,15428,14835,593,3.8
10192,CN1330100000000,13,301,"Warren County, GA",Jun-19,2798,2667,131,4.7
10193,CN1330300000000,13,303,"Washington County, GA",Jun-19,6985,6672,313,4.5
10194,CN1330500000000,13,305,"Wayne County, GA",Jun-19,11478,10973,505,4.4
10195,CN1330700000000,13,307,"Webster County, GA",Jun-19,978,927,51,5.2
10196,CN1330900000000,13,309,"Wheeler County, GA",Jun-19,1573,1436,137,8.7
10197,CN1331100000000,13,311,"White County, GA",Jun-19,16286,15824,462,2.8
10198,CN1331300000000,13,313,"Whitfield County, GA",Jun-19,43389,41528,1861,4.3
10199,CN1331500000000,13,315,"Wilcox County, GA",Jun-19,2676,2533,143,5.3
10200,CN1331700000000,13,317,"Wilkes County, GA",Jun-19,3845,3667,178,4.6
10201,CN1331900000000,13,319,"Wilkinson County, GA",Jun-19,3940,3764,176,4.5
10202,CN1332100000000,13,321,"Worth County, GA",Jun-19,8768,8418,350,4.0
10203,CN1500100000000,15,1,"Hawaii County, HI",Jun-19,91356,87520,3836,4.2
10204,CN1500300000000,15,3,"Honolulu County/city, HI",Jun-19,450087,435685,14402,3.2
10205,CN1500700000000,15,7,"Kauai County, HI",Jun-19,36943,35813,1130,3.1
10206,CN1500900000000,15,9,"Maui County, HI",Jun-19,87202,84492,2710,3.1
10207,CN1600100000000,16,1,"Ada County, ID",Jun-19,255346,249113,6233,2.4
10208,CN1600300000000,16,3,"Adams County, ID",Jun-19,1782,1681,101,5.7
10209,CN1600500000000,16,5,"Bannock County, ID",Jun-19,42500,41377,1123,2.6
10210,CN1600700000000,16,7,"Bear Lake County, ID",Jun-19,3084,3008,76,2.5
10211,CN1600900000000,16,9,"Benewah County, ID",Jun-19,4140,3991,149,3.6
10212,CN1601100000000,16,11,"Bingham County, ID",Jun-19,24082,23514,568,2.4
10213,CN1601300000000,16,13,"Blaine County, ID",Jun-19,12565,12278,287,2.3
10214,CN1601500000000,16,15,"Boise County, ID",Jun-19,3515,3380,135,3.8
10215,CN1601700000000,16,17,"Bonner County, ID",Jun-19,20390,19694,696,3.4
10216,CN1601900000000,16,19,"Bonneville County, ID",Jun-19,57821,56562,1259,2.2
10217,CN1602100000000,16,21,"Boundary County, ID",Jun-19,5562,5373,189,3.4
10218,CN1602300000000,16,23,"Butte County, ID",Jun-19,1415,1383,32,2.3
10219,CN1602500000000,16,25,"Camas County, ID",Jun-19,704,689,15,2.1
10220,CN1602700000000,16,27,"Canyon County, ID",Jun-19,105204,101873,3331,3.2
10221,CN1602900000000,16,29,"Caribou County, ID",Jun-19,4220,4132,88,2.1
10222,CN1603100000000,16,31,"Cassia County, ID",Jun-19,12403,12106,297,2.4
10223,CN1603300000000,16,33,"Clark County, ID",Jun-19,389,377,12,3.1
10224,CN1603500000000,16,35,"Clearwater County, ID",Jun-19,2935,2771,164,5.6
10225,CN1603700000000,16,37,"Custer County, ID",Jun-19,2497,2424,73,2.9
10226,CN1603900000000,16,39,"Elmore County, ID",Jun-19,11847,11460,387,3.3
10227,CN1604100000000,16,41,"Franklin County, ID",Jun-19,7036,6881,155,2.2
10228,CN1604300000000,16,43,"Fremont County, ID",Jun-19,8108,7952,156,1.9
10229,CN1604500000000,16,45,"Gem County, ID",Jun-19,8343,8107,236,2.8
10230,CN1604700000000,16,47,"Gooding County, ID",Jun-19,8313,8110,203,2.4
10231,CN1604900000000,16,49,"Idaho County, ID",Jun-19,6811,6547,264,3.9
10232,CN1605100000000,16,51,"Jefferson County, ID",Jun-19,14240,13946,294,2.1
10233,CN1605300000000,16,53,"Jerome County, ID",Jun-19,12347,12060,287,2.3
10234,CN1605500000000,16,55,"Kootenai County, ID",Jun-19,81852,79473,2379,2.9
10235,CN1605700000000,16,57,"Latah County, ID",Jun-19,19399,18873,526,2.7
10236,CN1605900000000,16,59,"Lemhi County, ID",Jun-19,3722,3592,130,3.5
10237,CN1606100000000,16,61,"Lewis County, ID",Jun-19,1719,1643,76,4.4
10238,CN1606300000000,16,63,"Lincoln County, ID",Jun-19,2736,2660,76,2.8
10239,CN1606500000000,16,65,"Madison County, ID",Jun-19,22812,22391,421,1.8
10240,CN1606700000000,16,67,"Minidoka County, ID",Jun-19,11580,11301,279,2.4
10241,CN1606900000000,16,69,"Nez Perce County, ID",Jun-19,21107,20587,520,2.5
10242,CN1607100000000,16,71,"Oneida County, ID",Jun-19,2392,2342,50,2.1
10243,CN1607300000000,16,73,"Owyhee County, ID",Jun-19,5680,5509,171,3.0
10244,CN1607500000000,16,75,"Payette County, ID",Jun-19,11811,11419,392,3.3
10245,CN1607700000000,16,77,"Power County, ID",Jun-19,4092,3981,111,2.7
10246,CN1607900000000,16,79,"Shoshone County, ID",Jun-19,5204,4950,254,4.9
10247,CN1608100000000,16,81,"Teton County, ID",Jun-19,7204,7081,123,1.7
10248,CN1608300000000,16,83,"Twin Falls County, ID",Jun-19,41624,40503,1121,2.7
10249,CN1608500000000,16,85,"Valley County, ID",Jun-19,5922,5767,155,2.6
10250,CN1608700000000,16,87,"Washington County, ID",Jun-19,4672,4492,180,3.9
10251,CN1700100000000,17,1,"Adams County, IL",Jun-19,32700,31656,1044,3.2
10252,CN1700300000000,17,3,"Alexander County, IL",Jun-19,2074,1933,141,6.8
10253,CN1700500000000,17,5,"Bond County, IL",Jun-19,7900,7615,285,3.6
10254,CN1700700000000,17,7,"Boone County, IL",Jun-19,26593,25167,1426,5.4
10255,CN1700900000000,17,9,"Brown County, IL",Jun-19,2988,2919,69,2.3
10256,CN1701100000000,17,11,"Bureau County, IL",Jun-19,17704,17021,683,3.9
10257,CN1701300000000,17,13,"Calhoun County, IL",Jun-19,2380,2247,133,5.6
10258,CN1701500000000,17,15,"Carroll County, IL",Jun-19,7520,7257,263,3.5
10259,CN1701700000000,17,17,"Cass County, IL",Jun-19,6253,6010,243,3.9
10260,CN1701900000000,17,19,"Champaign County, IL",Jun-19,105029,100912,4117,3.9
10261,CN1702100000000,17,21,"Christian County, IL",Jun-19,14882,14193,689,4.6
10262,CN1702300000000,17,23,"Clark County, IL",Jun-19,7703,7388,315,4.1
10263,CN1702500000000,17,25,"Clay County, IL",Jun-19,6646,6353,293,4.4
10264,CN1702700000000,17,27,"Clinton County, IL",Jun-19,20665,20072,593,2.9
10265,CN1702900000000,17,29,"Coles County, IL",Jun-19,22991,21987,1004,4.4
10266,CN1703100000000,17,31,"Cook County, IL",Jun-19,2636171,2524474,111697,4.2
10267,CN1703300000000,17,33,"Crawford County, IL",Jun-19,8776,8422,354,4.0
10268,CN1703500000000,17,35,"Cumberland County, IL",Jun-19,6055,5867,188,3.1
10269,CN1703700000000,17,37,"DeKalb County, IL",Jun-19,55910,53696,2214,4.0
10270,CN1703900000000,17,39,"De Witt County, IL",Jun-19,7401,7110,291,3.9
10271,CN1704100000000,17,41,"Douglas County, IL",Jun-19,10329,9946,383,3.7
10272,CN1704300000000,17,43,"DuPage County, IL",Jun-19,515730,498538,17192,3.3
10273,CN1704500000000,17,45,"Edgar County, IL",Jun-19,9015,8649,366,4.1
10274,CN1704700000000,17,47,"Edwards County, IL",Jun-19,2799,2698,101,3.6
10275,CN1704900000000,17,49,"Effingham County, IL",Jun-19,19491,18892,599,3.1
10276,CN1705100000000,17,51,"Fayette County, IL",Jun-19,10090,9702,388,3.8
10277,CN1705300000000,17,53,"Ford County, IL",Jun-19,6322,6070,252,4.0
10278,CN1705500000000,17,55,"Franklin County, IL",Jun-19,16365,15536,829,5.1
10279,CN1705700000000,17,57,"Fulton County, IL",Jun-19,15351,14570,781,5.1
10280,CN1705900000000,17,59,"Gallatin County, IL",Jun-19,2385,2275,110,4.6
10281,CN1706100000000,17,61,"Greene County, IL",Jun-19,6124,5867,257,4.2
10282,CN1706300000000,17,63,"Grundy County, IL",Jun-19,25864,24615,1249,4.8
10283,CN1706500000000,17,65,"Hamilton County, IL",Jun-19,4505,4347,158,3.5
10284,CN1706700000000,17,67,"Hancock County, IL",Jun-19,8654,8272,382,4.4
10285,CN1706900000000,17,69,"Hardin County, IL",Jun-19,1309,1218,91,7.0
10286,CN1707100000000,17,71,"Henderson County, IL",Jun-19,3745,3593,152,4.1
10287,CN1707300000000,17,73,"Henry County, IL",Jun-19,25409,24342,1067,4.2
10288,CN1707500000000,17,75,"Iroquois County, IL",Jun-19,14963,14446,517,3.5
10289,CN1707700000000,17,77,"Jackson County, IL",Jun-19,27347,26294,1053,3.9
10290,CN1707900000000,17,79,"Jasper County, IL",Jun-19,4759,4569,190,4.0
10291,CN1708100000000,17,81,"Jefferson County, IL",Jun-19,17479,16675,804,4.6
10292,CN1708300000000,17,83,"Jersey County, IL",Jun-19,11113,10617,496,4.5
10293,CN1708500000000,17,85,"Jo Daviess County, IL",Jun-19,11215,10891,324,2.9
10294,CN1708700000000,17,87,"Johnson County, IL",Jun-19,4081,3849,232,5.7
10295,CN1708900000000,17,89,"Kane County, IL",Jun-19,275648,264683,10965,4.0
10296,CN1709100000000,17,91,"Kankakee County, IL",Jun-19,56391,53910,2481,4.4
10297,CN1709300000000,17,93,"Kendall County, IL",Jun-19,69833,67165,2668,3.8
10298,CN1709500000000,17,95,"Knox County, IL",Jun-19,22109,21110,999,4.5
10299,CN1709700000000,17,97,"Lake County, IL",Jun-19,383562,369802,13760,3.6
10300,CN1709900000000,17,99,"LaSalle County, IL",Jun-19,55328,52706,2622,4.7
10301,CN1710100000000,17,101,"Lawrence County, IL",Jun-19,5964,5665,299,5.0
10302,CN1710300000000,17,103,"Lee County, IL",Jun-19,17657,16962,695,3.9
10303,CN1710500000000,17,105,"Livingston County, IL",Jun-19,16785,16135,650,3.9
10304,CN1710700000000,17,107,"Logan County, IL",Jun-19,12642,12092,550,4.4
10305,CN1710900000000,17,109,"McDonough County, IL",Jun-19,12515,11883,632,5.0
10306,CN1711100000000,17,111,"McHenry County, IL",Jun-19,168037,162000,6037,3.6
10307,CN1711300000000,17,113,"McLean County, IL",Jun-19,87302,83966,3336,3.8
10308,CN1711500000000,17,115,"Macon County, IL",Jun-19,49456,46891,2565,5.2
10309,CN1711700000000,17,117,"Macoupin County, IL",Jun-19,23251,22312,939,4.0
10310,CN1711900000000,17,119,"Madison County, IL",Jun-19,135737,130250,5487,4.0
10311,CN1712100000000,17,121,"Marion County, IL",Jun-19,17786,17029,757,4.3
10312,CN1712300000000,17,123,"Marshall County, IL",Jun-19,5420,5195,225,4.2
10313,CN1712500000000,17,125,"Mason County, IL",Jun-19,6398,6073,325,5.1
10314,CN1712700000000,17,127,"Massac County, IL",Jun-19,5692,5360,332,5.8
10315,CN1712900000000,17,129,"Menard County, IL",Jun-19,6608,6399,209,3.2
10316,CN1713100000000,17,131,"Mercer County, IL",Jun-19,8209,7887,322,3.9
10317,CN1713300000000,17,133,"Monroe County, IL",Jun-19,18984,18406,578,3.0
10318,CN1713500000000,17,135,"Montgomery County, IL",Jun-19,12060,11517,543,4.5
10319,CN1713700000000,17,137,"Morgan County, IL",Jun-19,16824,16197,627,3.7
10320,CN1713900000000,17,139,"Moultrie County, IL",Jun-19,7770,7502,268,3.4
10321,CN1714100000000,17,141,"Ogle County, IL",Jun-19,25677,24577,1100,4.3
10322,CN1714300000000,17,143,"Peoria County, IL",Jun-19,86056,81952,4104,4.8
10323,CN1714500000000,17,145,"Perry County, IL",Jun-19,8331,7919,412,4.9
10324,CN1714700000000,17,147,"Piatt County, IL",Jun-19,8352,8061,291,3.5
10325,CN1714900000000,17,149,"Pike County, IL",Jun-19,7295,7021,274,3.8
10326,CN1715100000000,17,151,"Pope County, IL",Jun-19,1705,1611,94,5.5
10327,CN1715300000000,17,153,"Pulaski County, IL",Jun-19,1977,1858,119,6.0
10328,CN1715500000000,17,155,"Putnam County, IL",Jun-19,3091,2954,137,4.4
10329,CN1715700000000,17,157,"Randolph County, IL",Jun-19,14316,13810,506,3.5
10330,CN1715900000000,17,159,"Richland County, IL",Jun-19,7304,7015,289,4.0
10331,CN1716100000000,17,161,"Rock Island County, IL",Jun-19,72226,69015,3211,4.4
10332,CN1716300000000,17,163,"St. Clair County, IL",Jun-19,127859,122148,5711,4.5
10333,CN1716500000000,17,165,"Saline County, IL",Jun-19,9567,9067,500,5.2
10334,CN1716700000000,17,167,"Sangamon County, IL",Jun-19,102846,98876,3970,3.9
10335,CN1716900000000,17,169,"Schuyler County, IL",Jun-19,3438,3321,117,3.4
10336,CN1717100000000,17,171,"Scott County, IL",Jun-19,2537,2434,103,4.1
10337,CN1717300000000,17,173,"Shelby County, IL",Jun-19,10817,10413,404,3.7
10338,CN1717500000000,17,175,"Stark County, IL",Jun-19,2590,2462,128,4.9
10339,CN1717700000000,17,177,"Stephenson County, IL",Jun-19,22379,21495,884,4.0
10340,CN1717900000000,17,179,"Tazewell County, IL",Jun-19,64722,62085,2637,4.1
10341,CN1718100000000,17,181,"Union County, IL",Jun-19,7420,7043,377,5.1
10342,CN1718300000000,17,183,"Vermilion County, IL",Jun-19,33223,31639,1584,4.8
10343,CN1718500000000,17,185,"Wabash County, IL",Jun-19,5871,5640,231,3.9
10344,CN1718700000000,17,187,"Warren County, IL",Jun-19,8663,8315,348,4.0
10345,CN1718900000000,17,189,"Washington County, IL",Jun-19,10448,10194,254,2.4
10346,CN1719100000000,17,191,"Wayne County, IL",Jun-19,7113,6796,317,4.5
10347,CN1719300000000,17,193,"White County, IL",Jun-19,6685,6458,227,3.4
10348,CN1719500000000,17,195,"Whiteside County, IL",Jun-19,29411,28245,1166,4.0
10349,CN1719700000000,17,197,"Will County, IL",Jun-19,363149,347660,15489,4.3
10350,CN1719900000000,17,199,"Williamson County, IL",Jun-19,31232,29907,1325,4.2
10351,CN1720100000000,17,201,"Winnebago County, IL",Jun-19,141305,133567,7738,5.5
10352,CN1720300000000,17,203,"Woodford County, IL",Jun-19,19044,18407,637,3.3
10353,CN1800100000000,18,1,"Adams County, IN",Jun-19,17514,17035,479,2.7
10354,CN1800300000000,18,3,"Allen County, IN",Jun-19,189241,183273,5968,3.2
10355,CN1800500000000,18,5,"Bartholomew County, IN",Jun-19,45511,44331,1180,2.6
10356,CN1800700000000,18,7,"Benton County, IN",Jun-19,4508,4356,152,3.4
10357,CN1800900000000,18,9,"Blackford County, IN",Jun-19,5046,4859,187,3.7
10358,CN1801100000000,18,11,"Boone County, IN",Jun-19,36885,35936,949,2.6
10359,CN1801300000000,18,13,"Brown County, IN",Jun-19,7851,7610,241,3.1
10360,CN1801500000000,18,15,"Carroll County, IN",Jun-19,10062,9764,298,3.0
10361,CN1801700000000,18,17,"Cass County, IN",Jun-19,18418,17815,603,3.3
10362,CN1801900000000,18,19,"Clark County, IN",Jun-19,62644,60502,2142,3.4
10363,CN1802100000000,18,21,"Clay County, IN",Jun-19,12118,11698,420,3.5
10364,CN1802300000000,18,23,"Clinton County, IN",Jun-19,17268,16808,460,2.7
10365,CN1802500000000,18,25,"Crawford County, IN",Jun-19,4961,4776,185,3.7
10366,CN1802700000000,18,27,"Daviess County, IN",Jun-19,17158,16694,464,2.7
10367,CN1802900000000,18,29,"Dearborn County, IN",Jun-19,26308,25388,920,3.5
10368,CN1803100000000,18,31,"Decatur County, IN",Jun-19,15491,15053,438,2.8
10369,CN1803300000000,18,33,"DeKalb County, IN",Jun-19,23066,22417,649,2.8
10370,CN1803500000000,18,35,"Delaware County, IN",Jun-19,52488,50317,2171,4.1
10371,CN1803700000000,18,37,"Dubois County, IN",Jun-19,23738,23133,605,2.5
10372,CN1803900000000,18,39,"Elkhart County, IN",Jun-19,115752,112169,3583,3.1
10373,CN1804100000000,18,41,"Fayette County, IN",Jun-19,8905,8475,430,4.8
10374,CN1804300000000,18,43,"Floyd County, IN",Jun-19,42291,40929,1362,3.2
10375,CN1804500000000,18,45,"Fountain County, IN",Jun-19,8144,7869,275,3.4
10376,CN1804700000000,18,47,"Franklin County, IN",Jun-19,11759,11363,396,3.4
10377,CN1804900000000,18,49,"Fulton County, IN",Jun-19,10154,9856,298,2.9
10378,CN1805100000000,18,51,"Gibson County, IN",Jun-19,19619,19115,504,2.6
10379,CN1805300000000,18,53,"Grant County, IN",Jun-19,31365,30187,1178,3.8
10380,CN1805500000000,18,55,"Greene County, IN",Jun-19,13637,13089,548,4.0
10381,CN1805700000000,18,57,"Hamilton County, IN",Jun-19,186644,181697,4947,2.7
10382,CN1805900000000,18,59,"Hancock County, IN",Jun-19,40927,39712,1215,3.0
10383,CN1806100000000,18,61,"Harrison County, IN",Jun-19,20614,19958,656,3.2
10384,CN1806300000000,18,63,"Hendricks County, IN",Jun-19,91311,88761,2550,2.8
10385,CN1806500000000,18,65,"Henry County, IN",Jun-19,22351,21625,726,3.2
10386,CN1806700000000,18,67,"Howard County, IN",Jun-19,36204,34839,1365,3.8
10387,CN1806900000000,18,69,"Huntington County, IN",Jun-19,18375,17788,587,3.2
10388,CN1807100000000,18,71,"Jackson County, IN",Jun-19,23180,22518,662,2.9
10389,CN1807300000000,18,73,"Jasper County, IN",Jun-19,16580,16019,561,3.4
10390,CN1807500000000,18,75,"Jay County, IN",Jun-19,9577,9296,281,2.9
10391,CN1807700000000,18,77,"Jefferson County, IN",Jun-19,15175,14649,526,3.5
10392,CN1807900000000,18,79,"Jennings County, IN",Jun-19,13737,13307,430,3.1
10393,CN1808100000000,18,81,"Johnson County, IN",Jun-19,84237,81909,2328,2.8
10394,CN1808300000000,18,83,"Knox County, IN",Jun-19,18796,18196,600,3.2
10395,CN1808500000000,18,85,"Kosciusko County, IN",Jun-19,43084,41838,1246,2.9
10396,CN1808700000000,18,87,"LaGrange County, IN",Jun-19,20563,19987,576,2.8
10397,CN1808900000000,18,89,"Lake County, IN",Jun-19,234040,223278,10762,4.6
10398,CN1809100000000,18,91,"LaPorte County, IN",Jun-19,48878,46882,1996,4.1
10399,CN1809300000000,18,93,"Lawrence County, IN",Jun-19,20803,20028,775,3.7
10400,CN1809500000000,18,95,"Madison County, IN",Jun-19,60018,57827,2191,3.7
10401,CN1809700000000,18,97,"Marion County, IN",Jun-19,498035,481261,16774,3.4
10402,CN1809900000000,18,99,"Marshall County, IN",Jun-19,23823,23105,718,3.0
10403,CN1810100000000,18,101,"Martin County, IN",Jun-19,5510,5360,150,2.7
10404,CN1810300000000,18,103,"Miami County, IN",Jun-19,15774,15177,597,3.8
10405,CN1810500000000,18,105,"Monroe County, IN",Jun-19,67118,64610,2508,3.7
10406,CN1810700000000,18,107,"Montgomery County, IN",Jun-19,18849,18244,605,3.2
10407,CN1810900000000,18,109,"Morgan County, IN",Jun-19,36932,35774,1158,3.1
10408,CN1811100000000,18,111,"Newton County, IN",Jun-19,7102,6837,265,3.7
10409,CN1811300000000,18,113,"Noble County, IN",Jun-19,24144,23409,735,3.0
10410,CN1811500000000,18,115,"Ohio County, IN",Jun-19,3248,3135,113,3.5
10411,CN1811700000000,18,117,"Orange County, IN",Jun-19,8703,8381,322,3.7
10412,CN1811900000000,18,119,"Owen County, IN",Jun-19,9003,8625,378,4.2
10413,CN1812100000000,18,121,"Parke County, IN",Jun-19,7305,7032,273,3.7
10414,CN1812300000000,18,123,"Perry County, IN",Jun-19,9423,9108,315,3.3
10415,CN1812500000000,18,125,"Pike County, IN",Jun-19,6210,5982,228,3.7
10416,CN1812700000000,18,127,"Porter County, IN",Jun-19,88365,85154,3211,3.6
10417,CN1812900000000,18,129,"Posey County, IN",Jun-19,13864,13481,383,2.8
10418,CN1813100000000,18,131,"Pulaski County, IN",Jun-19,6741,6542,199,3.0
10419,CN1813300000000,18,133,"Putnam County, IN",Jun-19,17087,16460,627,3.7
10420,CN1813500000000,18,135,"Randolph County, IN",Jun-19,11467,11052,415,3.6
10421,CN1813700000000,18,137,"Ripley County, IN",Jun-19,14672,14207,465,3.2
10422,CN1813900000000,18,139,"Rush County, IN",Jun-19,9063,8827,236,2.6
10423,CN1814100000000,18,141,"St. Joseph County, IN",Jun-19,137320,132230,5090,3.7
10424,CN1814300000000,18,143,"Scott County, IN",Jun-19,10738,10335,403,3.8
10425,CN1814500000000,18,145,"Shelby County, IN",Jun-19,23524,22831,693,2.9
10426,CN1814700000000,18,147,"Spencer County, IN",Jun-19,11688,11332,356,3.0
10427,CN1814900000000,18,149,"Starke County, IN",Jun-19,10247,9839,408,4.0
10428,CN1815100000000,18,151,"Steuben County, IN",Jun-19,20899,20338,561,2.7
10429,CN1815300000000,18,153,"Sullivan County, IN",Jun-19,8446,8090,356,4.2
10430,CN1815500000000,18,155,"Switzerland County, IN",Jun-19,5128,4959,169,3.3
10431,CN1815700000000,18,157,"Tippecanoe County, IN",Jun-19,96641,93567,3074,3.2
10432,CN1815900000000,18,159,"Tipton County, IN",Jun-19,9407,9152,255,2.7
10433,CN1816100000000,18,161,"Union County, IN",Jun-19,3636,3513,123,3.4
10434,CN1816300000000,18,163,"Vanderburgh County, IN",Jun-19,96088,93054,3034,3.2
10435,CN1816500000000,18,165,"Vermillion County, IN",Jun-19,7024,6684,340,4.8
10436,CN1816700000000,18,167,"Vigo County, IN",Jun-19,48446,46366,2080,4.3
10437,CN1816900000000,18,169,"Wabash County, IN",Jun-19,14960,14478,482,3.2
10438,CN1817100000000,18,171,"Warren County, IN",Jun-19,4260,4132,128,3.0
10439,CN1817300000000,18,173,"Warrick County, IN",Jun-19,33630,32617,1013,3.0
10440,CN1817500000000,18,175,"Washington County, IN",Jun-19,13956,13506,450,3.2
10441,CN1817700000000,18,177,"Wayne County, IN",Jun-19,31317,30169,1148,3.7
10442,CN1817900000000,18,179,"Wells County, IN",Jun-19,14721,14330,391,2.7
10443,CN1818100000000,18,181,"White County, IN",Jun-19,13849,13482,367,2.7
10444,CN1818300000000,18,183,"Whitley County, IN",Jun-19,18112,17586,526,2.9
10445,CN1900100000000,19,1,"Adair County, IA",Jun-19,4375,4279,96,2.2
10446,CN1900300000000,19,3,"Adams County, IA",Jun-19,2310,2272,38,1.6
10447,CN1900500000000,19,5,"Allamakee County, IA",Jun-19,7500,7284,216,2.9
10448,CN1900700000000,19,7,"Appanoose County, IA",Jun-19,6270,6061,209,3.3
10449,CN1900900000000,19,9,"Audubon County, IA",Jun-19,3174,3096,78,2.5
10450,CN1901100000000,19,11,"Benton County, IA",Jun-19,13771,13400,371,2.7
10451,CN1901300000000,19,13,"Black Hawk County, IA",Jun-19,70176,68031,2145,3.1
10452,CN1901500000000,19,15,"Boone County, IA",Jun-19,15098,14700,398,2.6
10453,CN1901700000000,19,17,"Bremer County, IA",Jun-19,14041,13733,308,2.2
10454,CN1901900000000,19,19,"Buchanan County, IA",Jun-19,11577,11294,283,2.4
10455,CN1902100000000,19,21,"Buena Vista County, IA",Jun-19,11809,11508,301,2.5
10456,CN1902300000000,19,23,"Butler County, IA",Jun-19,8089,7863,226,2.8
10457,CN1902500000000,19,25,"Calhoun County, IA",Jun-19,4414,4300,114,2.6
10458,CN1902700000000,19,27,"Carroll County, IA",Jun-19,11296,11062,234,2.1
10459,CN1902900000000,19,29,"Cass County, IA",Jun-19,7122,6932,190,2.7
10460,CN1903100000000,19,31,"Cedar County, IA",Jun-19,11184,10913,271,2.4
10461,CN1903300000000,19,33,"Cerro Gordo County, IA",Jun-19,24551,23846,705,2.9
10462,CN1903500000000,19,35,"Cherokee County, IA",Jun-19,6298,6134,164,2.6
10463,CN1903700000000,19,37,"Chickasaw County, IA",Jun-19,6674,6510,164,2.5
10464,CN1903900000000,19,39,"Clarke County, IA",Jun-19,4981,4839,142,2.9
10465,CN1904100000000,19,41,"Clay County, IA",Jun-19,8806,8562,244,2.8
10466,CN1904300000000,19,43,"Clayton County, IA",Jun-19,10515,10237,278,2.6
10467,CN1904500000000,19,45,"Clinton County, IA",Jun-19,23476,22615,861,3.7
10468,CN1904700000000,19,47,"Crawford County, IA",Jun-19,8294,8029,265,3.2
10469,CN1904900000000,19,49,"Dallas County, IA",Jun-19,50861,49786,1075,2.1
10470,CN1905100000000,19,51,"Davis County, IA",Jun-19,4310,4199,111,2.6
10471,CN1905300000000,19,53,"Decatur County, IA",Jun-19,4340,4228,112,2.6
10472,CN1905500000000,19,55,"Delaware County, IA",Jun-19,10904,10665,239,2.2
10473,CN1905700000000,19,57,"Des Moines County, IA",Jun-19,20075,19223,852,4.2
10474,CN1905900000000,19,59,"Dickinson County, IA",Jun-19,11532,11268,264,2.3
10475,CN1906100000000,19,61,"Dubuque County, IA",Jun-19,56757,55404,1353,2.4
10476,CN1906300000000,19,63,"Emmet County, IA",Jun-19,5474,5296,178,3.3
10477,CN1906500000000,19,65,"Fayette County, IA",Jun-19,10327,9971,356,3.4
10478,CN1906700000000,19,67,"Floyd County, IA",Jun-19,9087,8819,268,2.9
10479,CN1906900000000,19,69,"Franklin County, IA",Jun-19,5984,5853,131,2.2
10480,CN1907100000000,19,71,"Fremont County, IA",Jun-19,3725,3579,146,3.9
10481,CN1907300000000,19,73,"Greene County, IA",Jun-19,5589,5397,192,3.4
10482,CN1907500000000,19,75,"Grundy County, IA",Jun-19,6572,6394,178,2.7
10483,CN1907700000000,19,77,"Guthrie County, IA",Jun-19,5698,5534,164,2.9
10484,CN1907900000000,19,79,"Hamilton County, IA",Jun-19,6997,6814,183,2.6
10485,CN1908100000000,19,81,"Hancock County, IA",Jun-19,6103,5942,161,2.6
10486,CN1908300000000,19,83,"Hardin County, IA",Jun-19,8319,8066,253,3.0
10487,CN1908500000000,19,85,"Harrison County, IA",Jun-19,7493,7312,181,2.4
10488,CN1908700000000,19,87,"Henry County, IA",Jun-19,9755,9488,267,2.7
10489,CN1908900000000,19,89,"Howard County, IA",Jun-19,5277,5143,134,2.5
10490,CN1909100000000,19,91,"Humboldt County, IA",Jun-19,5276,5158,118,2.2
10491,CN1909300000000,19,93,"Ida County, IA",Jun-19,4209,4127,82,1.9
10492,CN1909500000000,19,95,"Iowa County, IA",Jun-19,10734,10512,222,2.1
10493,CN1909700000000,19,97,"Jackson County, IA",Jun-19,11363,11041,322,2.8
10494,CN1909900000000,19,99,"Jasper County, IA",Jun-19,20529,19956,573,2.8
10495,CN1910100000000,19,101,"Jefferson County, IA",Jun-19,10114,9865,249,2.5
10496,CN1910300000000,19,103,"Johnson County, IA",Jun-19,87383,85343,2040,2.3
10497,CN1910500000000,19,105,"Jones County, IA",Jun-19,10855,10559,296,2.7
10498,CN1910700000000,19,107,"Keokuk County, IA",Jun-19,5369,5209,160,3.0
10499,CN1910900000000,19,109,"Kossuth County, IA",Jun-19,8753,8577,176,2.0
10500,CN1911100000000,19,111,"Lee County, IA",Jun-19,16616,15976,640,3.9
10501,CN1911300000000,19,113,"Linn County, IA",Jun-19,125418,121743,3675,2.9
10502,CN1911500000000,19,115,"Louisa County, IA",Jun-19,6202,6012,190,3.1
10503,CN1911700000000,19,117,"Lucas County, IA",Jun-19,4823,4722,101,2.1
10504,CN1911900000000,19,119,"Lyon County, IA",Jun-19,7327,7223,104,1.4
10505,CN1912100000000,19,121,"Madison County, IA",Jun-19,8764,8455,309,3.5
10506,CN1912300000000,19,123,"Mahaska County, IA",Jun-19,12140,11823,317,2.6
10507,CN1912500000000,19,125,"Marion County, IA",Jun-19,18986,18585,401,2.1
10508,CN1912700000000,19,127,"Marshall County, IA",Jun-19,18383,17662,721,3.9
10509,CN1912900000000,19,129,"Mills County, IA",Jun-19,7542,7363,179,2.4
10510,CN1913100000000,19,131,"Mitchell County, IA",Jun-19,7259,7147,112,1.5
10511,CN1913300000000,19,133,"Monona County, IA",Jun-19,4591,4450,141,3.1
10512,CN1913500000000,19,135,"Monroe County, IA",Jun-19,4109,3998,111,2.7
10513,CN1913700000000,19,137,"Montgomery County, IA",Jun-19,5199,5062,137,2.6
10514,CN1913900000000,19,139,"Muscatine County, IA",Jun-19,22624,21982,642,2.8
10515,CN1914100000000,19,141,"O'Brien County, IA",Jun-19,8489,8293,196,2.3
10516,CN1914300000000,19,143,"Osceola County, IA",Jun-19,3637,3562,75,2.1
10517,CN1914500000000,19,145,"Page County, IA",Jun-19,6609,6433,176,2.7
10518,CN1914700000000,19,147,"Palo Alto County, IA",Jun-19,4924,4817,107,2.2
10519,CN1914900000000,19,149,"Plymouth County, IA",Jun-19,15073,14738,335,2.2
10520,CN1915100000000,19,151,"Pocahontas County, IA",Jun-19,4618,4528,90,1.9
10521,CN1915300000000,19,153,"Polk County, IA",Jun-19,276442,268421,8021,2.9
10522,CN1915500000000,19,155,"Pottawattamie County, IA",Jun-19,49697,48453,1244,2.5
10523,CN1915700000000,19,157,"Poweshiek County, IA",Jun-19,10197,9934,263,2.6
10524,CN1915900000000,19,159,"Ringgold County, IA",Jun-19,2543,2470,73,2.9
10525,CN1916100000000,19,161,"Sac County, IA",Jun-19,5478,5358,120,2.2
10526,CN1916300000000,19,163,"Scott County, IA",Jun-19,91849,88674,3175,3.5
10527,CN1916500000000,19,165,"Shelby County, IA",Jun-19,6946,6798,148,2.1
10528,CN1916700000000,19,167,"Sioux County, IA",Jun-19,20911,20516,395,1.9
10529,CN1916900000000,19,169,"Story County, IA",Jun-19,56480,55101,1379,2.4
10530,CN1917100000000,19,171,"Tama County, IA",Jun-19,9691,9450,241,2.5
10531,CN1917300000000,19,173,"Taylor County, IA",Jun-19,3278,3208,70,2.1
10532,CN1917500000000,19,175,"Union County, IA",Jun-19,6430,6223,207,3.2
10533,CN1917700000000,19,177,"Van Buren County, IA",Jun-19,3792,3691,101,2.7
10534,CN1917900000000,19,179,"Wapello County, IA",Jun-19,18107,17489,618,3.4
10535,CN1918100000000,19,181,"Warren County, IA",Jun-19,29070,28309,761,2.6
10536,CN1918300000000,19,183,"Washington County, IA",Jun-19,12063,11777,286,2.4
10537,CN1918500000000,19,185,"Wayne County, IA",Jun-19,2887,2810,77,2.7
10538,CN1918700000000,19,187,"Webster County, IA",Jun-19,20027,19350,677,3.4
10539,CN1918900000000,19,189,"Winnebago County, IA",Jun-19,5323,5131,192,3.6
10540,CN1919100000000,19,191,"Winneshiek County, IA",Jun-19,11632,11331,301,2.6
10541,CN1919300000000,19,193,"Woodbury County, IA",Jun-19,56999,55441,1558,2.7
10542,CN1919500000000,19,195,"Worth County, IA",Jun-19,4347,4229,118,2.7
10543,CN1919700000000,19,197,"Wright County, IA",Jun-19,7298,7115,183,2.5
10544,CN2000100000000,20,1,"Allen County, KS",Jun-19,6654,6366,288,4.3
10545,CN2000300000000,20,3,"Anderson County, KS",Jun-19,4253,4116,137,3.2
10546,CN2000500000000,20,5,"Atchison County, KS",Jun-19,7062,6642,420,5.9
10547,CN2000700000000,20,7,"Barber County, KS",Jun-19,2365,2313,52,2.2
10548,CN2000900000000,20,9,"Barton County, KS",Jun-19,13600,13196,404,3.0
10549,CN2001100000000,20,11,"Bourbon County, KS",Jun-19,6793,6485,308,4.5
10550,CN2001300000000,20,13,"Brown County, KS",Jun-19,5406,5227,179,3.3
10551,CN2001500000000,20,15,"Butler County, KS",Jun-19,32804,31684,1120,3.4
10552,CN2001700000000,20,17,"Chase County, KS",Jun-19,1627,1591,36,2.2
10553,CN2001900000000,20,19,"Chautauqua County, KS",Jun-19,1477,1413,64,4.3
10554,CN2002100000000,20,21,"Cherokee County, KS",Jun-19,10255,9823,432,4.2
10555,CN2002300000000,20,23,"Cheyenne County, KS",Jun-19,1320,1286,34,2.6
10556,CN2002500000000,20,25,"Clark County, KS",Jun-19,1072,1046,26,2.4
10557,CN2002700000000,20,27,"Clay County, KS",Jun-19,3856,3723,133,3.4
10558,CN2002900000000,20,29,"Cloud County, KS",Jun-19,3853,3726,127,3.3
10559,CN2003100000000,20,31,"Coffey County, KS",Jun-19,3998,3803,195,4.9
10560,CN2003300000000,20,33,"Comanche County, KS",Jun-19,899,877,22,2.4
10561,CN2003500000000,20,35,"Cowley County, KS",Jun-19,16242,15659,583,3.6
10562,CN2003700000000,20,37,"Crawford County, KS",Jun-19,18992,18200,792,4.2
10563,CN2003900000000,20,39,"Decatur County, KS",Jun-19,1233,1195,38,3.1
10564,CN2004100000000,20,41,"Dickinson County, KS",Jun-19,8948,8562,386,4.3
10565,CN2004300000000,20,43,"Doniphan County, KS",Jun-19,4206,4045,161,3.8
10566,CN2004500000000,20,45,"Douglas County, KS",Jun-19,62085,60098,1987,3.2
10567,CN2004700000000,20,47,"Edwards County, KS",Jun-19,1487,1451,36,2.4
10568,CN2004900000000,20,49,"Elk County, KS",Jun-19,1181,1131,50,4.2
10569,CN2005100000000,20,51,"Ellis County, KS",Jun-19,17310,16894,416,2.4
10570,CN2005300000000,20,53,"Ellsworth County, KS",Jun-19,2837,2755,82,2.9
10571,CN2005500000000,20,55,"Finney County, KS",Jun-19,20729,20206,523,2.5
10572,CN2005700000000,20,57,"Ford County, KS",Jun-19,16776,16354,422,2.5
10573,CN2005900000000,20,59,"Franklin County, KS",Jun-19,14197,13684,513,3.6
10574,CN2006100000000,20,61,"Geary County, KS",Jun-19,11344,10793,551,4.9
10575,CN2006300000000,20,63,"Gove County, KS",Jun-19,1479,1453,26,1.8
10576,CN2006500000000,20,65,"Graham County, KS",Jun-19,1105,1073,32,2.9
10577,CN2006700000000,20,67,"Grant County, KS",Jun-19,3240,3141,99,3.1
10578,CN2006900000000,20,69,"Gray County, KS",Jun-19,3225,3163,62,1.9
10579,CN2007100000000,20,71,"Greeley County, KS",Jun-19,800,782,18,2.3
10580,CN2007300000000,20,73,"Greenwood County, KS",Jun-19,3262,3153,109,3.3
10581,CN2007500000000,20,75,"Hamilton County, KS",Jun-19,1571,1541,30,1.9
10582,CN2007700000000,20,77,"Harper County, KS",Jun-19,2970,2896,74,2.5
10583,CN2007900000000,20,79,"Harvey County, KS",Jun-19,17108,16603,505,3.0
10584,CN2008100000000,20,81,"Haskell County, KS",Jun-19,2237,2181,56,2.5
10585,CN2008300000000,20,83,"Hodgeman County, KS",Jun-19,994,970,24,2.4
10586,CN2008500000000,20,85,"Jackson County, KS",Jun-19,7307,7100,207,2.8
10587,CN2008700000000,20,87,"Jefferson County, KS",Jun-19,10272,9970,302,2.9
10588,CN2008900000000,20,89,"Jewell County, KS",Jun-19,1318,1282,36,2.7
10589,CN2009100000000,20,91,"Johnson County, KS",Jun-19,343911,334425,9486,2.8
10590,CN2009300000000,20,93,"Kearny County, KS",Jun-19,2076,2028,48,2.3
10591,CN2009500000000,20,95,"Kingman County, KS",Jun-19,3414,3307,107,3.1
10592,CN2009700000000,20,97,"Kiowa County, KS",Jun-19,1283,1253,30,2.3
10593,CN2009900000000,20,99,"Labette County, KS",Jun-19,10264,9733,531,5.2
10594,CN2010100000000,20,101,"Lane County, KS",Jun-19,764,746,18,2.4
10595,CN2010300000000,20,103,"Leavenworth County, KS",Jun-19,36968,35756,1212,3.3
10596,CN2010500000000,20,105,"Lincoln County, KS",Jun-19,1635,1599,36,2.2
10597,CN2010700000000,20,107,"Linn County, KS",Jun-19,4460,4209,251,5.6
10598,CN2010900000000,20,109,"Logan County, KS",Jun-19,1680,1648,32,1.9
10599,CN2011100000000,20,111,"Lyon County, KS",Jun-19,16910,16311,599,3.5
10600,CN2011300000000,20,113,"McPherson County, KS",Jun-19,17418,17028,390,2.2
10601,CN2011500000000,20,115,"Marion County, KS",Jun-19,6045,5850,195,3.2
10602,CN2011700000000,20,117,"Marshall County, KS",Jun-19,5571,5408,163,2.9
10603,CN2011900000000,20,119,"Meade County, KS",Jun-19,2179,2125,54,2.5
10604,CN2012100000000,20,121,"Miami County, KS",Jun-19,17695,17144,551,3.1
10605,CN2012300000000,20,123,"Mitchell County, KS",Jun-19,3404,3318,86,2.5
10606,CN2012500000000,20,125,"Montgomery County, KS",Jun-19,15168,14513,655,4.3
10607,CN2012700000000,20,127,"Morris County, KS",Jun-19,3038,2964,74,2.4
10608,CN2012900000000,20,129,"Morton County, KS",Jun-19,1150,1118,32,2.8
10609,CN2013100000000,20,131,"Nemaha County, KS",Jun-19,5442,5285,157,2.9
10610,CN2013300000000,20,133,"Neosho County, KS",Jun-19,6247,5913,334,5.3
10611,CN2013500000000,20,135,"Ness County, KS",Jun-19,1353,1323,30,2.2
10612,CN2013700000000,20,137,"Norton County, KS",Jun-19,2742,2680,62,2.3
10613,CN2013900000000,20,139,"Osage County, KS",Jun-19,8083,7818,265,3.3
10614,CN2014100000000,20,141,"Osborne County, KS",Jun-19,2061,2023,38,1.8
10615,CN2014300000000,20,143,"Ottawa County, KS",Jun-19,3031,2941,90,3.0
10616,CN2014500000000,20,145,"Pawnee County, KS",Jun-19,2846,2764,82,2.9
10617,CN2014700000000,20,147,"Phillips County, KS",Jun-19,2710,2642,68,2.5
10618,CN2014900000000,20,149,"Pottawatomie County, KS",Jun-19,11686,11338,348,3.0
10619,CN2015100000000,20,151,"Pratt County, KS",Jun-19,5007,4874,133,2.7
10620,CN2015300000000,20,153,"Rawlins County, KS",Jun-19,1494,1462,32,2.1
10621,CN2015500000000,20,155,"Reno County, KS",Jun-19,30158,29215,943,3.1
10622,CN2015700000000,20,157,"Republic County, KS",Jun-19,2249,2191,58,2.6
10623,CN2015900000000,20,159,"Rice County, KS",Jun-19,5306,5153,153,2.9
10624,CN2016100000000,20,161,"Riley County, KS",Jun-19,33050,32041,1009,3.1
10625,CN2016300000000,20,163,"Rooks County, KS",Jun-19,2583,2470,113,4.4
10626,CN2016500000000,20,165,"Rush County, KS",Jun-19,1636,1590,46,2.8
10627,CN2016700000000,20,167,"Russell County, KS",Jun-19,3360,3255,105,3.1
10628,CN2016900000000,20,169,"Saline County, KS",Jun-19,30134,29149,985,3.3
10629,CN2017100000000,20,171,"Scott County, KS",Jun-19,2810,2754,56,2.0
10630,CN2017300000000,20,173,"Sedgwick County, KS",Jun-19,253688,244713,8975,3.5
10631,CN2017500000000,20,175,"Seward County, KS",Jun-19,9418,9100,318,3.4
10632,CN2017700000000,20,177,"Shawnee County, KS",Jun-19,92458,89454,3004,3.2
10633,CN2017900000000,20,179,"Sheridan County, KS",Jun-19,1417,1389,28,2.0
10634,CN2018100000000,20,181,"Sherman County, KS",Jun-19,2859,2785,74,2.6
10635,CN2018300000000,20,183,"Smith County, KS",Jun-19,2011,1955,56,2.8
10636,CN2018500000000,20,185,"Stafford County, KS",Jun-19,1996,1936,60,3.0
10637,CN2018700000000,20,187,"Stanton County, KS",Jun-19,1024,996,28,2.7
10638,CN2018900000000,20,189,"Stevens County, KS",Jun-19,2556,2492,64,2.5
10639,CN2019100000000,20,191,"Sumner County, KS",Jun-19,10985,10583,402,3.7
10640,CN2019300000000,20,193,"Thomas County, KS",Jun-19,4269,4166,103,2.4
10641,CN2019500000000,20,195,"Trego County, KS",Jun-19,1422,1388,34,2.4
10642,CN2019700000000,20,197,"Wabaunsee County, KS",Jun-19,3696,3573,123,3.3
10643,CN2019900000000,20,199,"Wallace County, KS",Jun-19,813,791,22,2.7
10644,CN2020100000000,20,201,"Washington County, KS",Jun-19,2942,2858,84,2.9
10645,CN2020300000000,20,203,"Wichita County, KS",Jun-19,1671,1645,26,1.6
10646,CN2020500000000,20,205,"Wilson County, KS",Jun-19,4029,3862,167,4.1
10647,CN2020700000000,20,207,"Woodson County, KS",Jun-19,1689,1617,72,4.3
10648,CN2020900000000,20,209,"Wyandotte County, KS",Jun-19,78467,75077,3390,4.3
10649,CN2100100000000,21,1,"Adair County, KY",Jun-19,7153,6724,429,6.0
10650,CN2100300000000,21,3,"Allen County, KY",Jun-19,9286,8843,443,4.8
10651,CN2100500000000,21,5,"Anderson County, KY",Jun-19,12317,11814,503,4.1
10652,CN2100700000000,21,7,"Ballard County, KY",Jun-19,3564,3353,211,5.9
10653,CN2100900000000,21,9,"Barren County, KY",Jun-19,19135,18175,960,5.0
10654,CN2101100000000,21,11,"Bath County, KY",Jun-19,4735,4417,318,6.7
10655,CN2101300000000,21,13,"Bell County, KY",Jun-19,8495,7887,608,7.2
10656,CN2101500000000,21,15,"Boone County, KY",Jun-19,72265,69541,2724,3.8
10657,CN2101700000000,21,17,"Bourbon County, KY",Jun-19,10303,9894,409,4.0
10658,CN2101900000000,21,19,"Boyd County, KY",Jun-19,17940,16793,1147,6.4
10659,CN2102100000000,21,21,"Boyle County, KY",Jun-19,12872,12162,710,5.5
10660,CN2102300000000,21,23,"Bracken County, KY",Jun-19,3900,3707,193,4.9
10661,CN2102500000000,21,25,"Breathitt County, KY",Jun-19,3645,3357,288,7.9
10662,CN2102700000000,21,27,"Breckinridge County, KY",Jun-19,8209,7745,464,5.7
10663,CN2102900000000,21,29,"Bullitt County, KY",Jun-19,43536,41512,2024,4.6
10664,CN2103100000000,21,31,"Butler County, KY",Jun-19,5178,4880,298,5.8
10665,CN2103300000000,21,33,"Caldwell County, KY",Jun-19,5586,5270,316,5.7
10666,CN2103500000000,21,35,"Calloway County, KY",Jun-19,18854,17945,909,4.8
10667,CN2103700000000,21,37,"Campbell County, KY",Jun-19,51694,49647,2047,4.0
10668,CN2103900000000,21,39,"Carlisle County, KY",Jun-19,2288,2188,100,4.4
10669,CN2104100000000,21,41,"Carroll County, KY",Jun-19,5351,5113,238,4.4
10670,CN2104300000000,21,43,"Carter County, KY",Jun-19,9923,9030,893,9.0
10671,CN2104500000000,21,45,"Casey County, KY",Jun-19,6917,6602,315,4.6
10672,CN2104700000000,21,47,"Christian County, KY",Jun-19,25232,23584,1648,6.5
10673,CN2104900000000,21,49,"Clark County, KY",Jun-19,17537,16762,775,4.4
10674,CN2105100000000,21,51,"Clay County, KY",Jun-19,5246,4820,426,8.1
10675,CN2105300000000,21,53,"Clinton County, KY",Jun-19,4130,3893,237,5.7
10676,CN2105500000000,21,55,"Crittenden County, KY",Jun-19,3900,3698,202,5.2
10677,CN2105700000000,21,57,"Cumberland County, KY",Jun-19,3274,3133,141,4.3
10678,CN2105900000000,21,59,"Daviess County, KY",Jun-19,47979,45867,2112,4.4
10679,CN2106100000000,21,61,"Edmonson County, KY",Jun-19,4875,4613,262,5.4
10680,CN2106300000000,21,63,"Elliott County, KY",Jun-19,2071,1891,180,8.7
10681,CN2106500000000,21,65,"Estill County, KY",Jun-19,5419,5128,291,5.4
10682,CN2106700000000,21,67,"Fayette County, KY",Jun-19,178859,171956,6903,3.9
10683,CN2106900000000,21,69,"Fleming County, KY",Jun-19,6451,6072,379,5.9
10684,CN2107100000000,21,71,"Floyd County, KY",Jun-19,11037,10246,791,7.2
10685,CN2107300000000,21,73,"Franklin County, KY",Jun-19,25832,24732,1100,4.3
10686,CN2107500000000,21,75,"Fulton County, KY",Jun-19,2100,1970,130,6.2
10687,CN2107700000000,21,77,"Gallatin County, KY",Jun-19,4199,4014,185,4.4
10688,CN2107900000000,21,79,"Garrard County, KY",Jun-19,7836,7422,414,5.3
10689,CN2108100000000,21,81,"Grant County, KY",Jun-19,11958,11427,531,4.4
10690,CN2108300000000,21,83,"Graves County, KY",Jun-19,16221,15405,816,5.0
10691,CN2108500000000,21,85,"Grayson County, KY",Jun-19,11257,10632,625,5.6
10692,CN2108700000000,21,87,"Green County, KY",Jun-19,5164,4909,255,4.9
10693,CN2108900000000,21,89,"Greenup County, KY",Jun-19,13528,12538,990,7.3
10694,CN2109100000000,21,91,"Hancock County, KY",Jun-19,4031,3857,174,4.3
10695,CN2109300000000,21,93,"Hardin County, KY",Jun-19,50079,47769,2310,4.6
10696,CN2109500000000,21,95,"Harlan County, KY",Jun-19,6534,5961,573,8.8
10697,CN2109700000000,21,97,"Harrison County, KY",Jun-19,9027,8587,440,4.9
10698,CN2109900000000,21,99,"Hart County, KY",Jun-19,8200,7805,395,4.8
10699,CN2110100000000,21,101,"Henderson County, KY",Jun-19,22422,21462,960,4.3
10700,CN2110300000000,21,103,"Henry County, KY",Jun-19,8443,8103,340,4.0
10701,CN2110500000000,21,105,"Hickman County, KY",Jun-19,1872,1776,96,5.1
10702,CN2110700000000,21,107,"Hopkins County, KY",Jun-19,18840,17847,993,5.3
10703,CN2110900000000,21,109,"Jackson County, KY",Jun-19,4193,3902,291,6.9
10704,CN2111100000000,21,111,"Jefferson County, KY",Jun-19,406357,387795,18562,4.6
10705,CN2111300000000,21,113,"Jessamine County, KY",Jun-19,27042,25914,1128,4.2
10706,CN2111500000000,21,115,"Johnson County, KY",Jun-19,6854,6346,508,7.4
10707,CN2111700000000,21,117,"Kenton County, KY",Jun-19,89420,85871,3549,4.0
10708,CN2111900000000,21,119,"Knott County, KY",Jun-19,4632,4278,354,7.6
10709,CN2112100000000,21,121,"Knox County, KY",Jun-19,10086,9394,692,6.9
10710,CN2112300000000,21,123,"Larue County, KY",Jun-19,6108,5804,304,5.0
10711,CN2112500000000,21,125,"Laurel County, KY",Jun-19,24963,23577,1386,5.6
10712,CN2112700000000,21,127,"Lawrence County, KY",Jun-19,5231,4828,403,7.7
10713,CN2112900000000,21,129,"Lee County, KY",Jun-19,2077,1936,141,6.8
10714,CN2113100000000,21,131,"Leslie County, KY",Jun-19,2739,2528,211,7.7
10715,CN2113300000000,21,133,"Letcher County, KY",Jun-19,6362,5900,462,7.3
10716,CN2113500000000,21,135,"Lewis County, KY",Jun-19,4747,4310,437,9.2
10717,CN2113700000000,21,137,"Lincoln County, KY",Jun-19,9550,9019,531,5.6
10718,CN2113900000000,21,139,"Livingston County, KY",Jun-19,3689,3481,208,5.6
10719,CN2114100000000,21,141,"Logan County, KY",Jun-19,12851,12271,580,4.5
10720,CN2114300000000,21,143,"Lyon County, KY",Jun-19,3354,3190,164,4.9
10721,CN2114500000000,21,145,"McCracken County, KY",Jun-19,29444,27851,1593,5.4
10722,CN2114700000000,21,147,"McCreary County, KY",Jun-19,4733,4413,320,6.8
10723,CN2114900000000,21,149,"McLean County, KY",Jun-19,4328,4115,213,4.9
10724,CN2115100000000,21,151,"Madison County, KY",Jun-19,47853,45635,2218,4.6
10725,CN2115300000000,21,153,"Magoffin County, KY",Jun-19,3078,2746,332,10.8
10726,CN2115500000000,21,155,"Marion County, KY",Jun-19,9975,9536,439,4.4
10727,CN2115700000000,21,157,"Marshall County, KY",Jun-19,15485,14714,771,5.0
10728,CN2115900000000,21,159,"Martin County, KY",Jun-19,2818,2602,216,7.7
10729,CN2116100000000,21,161,"Mason County, KY",Jun-19,7190,6734,456,6.3
10730,CN2116300000000,21,163,"Meade County, KY",Jun-19,12574,11941,633,5.0
10731,CN2116500000000,21,165,"Menifee County, KY",Jun-19,2348,2177,171,7.3
10732,CN2116700000000,21,167,"Mercer County, KY",Jun-19,10309,9789,520,5.0
10733,CN2116900000000,21,169,"Metcalfe County, KY",Jun-19,4204,3988,216,5.1
10734,CN2117100000000,21,171,"Monroe County, KY",Jun-19,4801,4588,213,4.4
10735,CN2117300000000,21,173,"Montgomery County, KY",Jun-19,11857,11129,728,6.1
10736,CN2117500000000,21,175,"Morgan County, KY",Jun-19,4684,4416,268,5.7
10737,CN2117700000000,21,177,"Muhlenberg County, KY",Jun-19,10762,10004,758,7.0
10738,CN2117900000000,21,179,"Nelson County, KY",Jun-19,23644,22496,1148,4.9
10739,CN2118100000000,21,181,"Nicholas County, KY",Jun-19,3309,3145,164,5.0
10740,CN2118300000000,21,183,"Ohio County, KY",Jun-19,9994,9418,576,5.8
10741,CN2118500000000,21,185,"Oldham County, KY",Jun-19,33877,32608,1269,3.7
10742,CN2118700000000,21,187,"Owen County, KY",Jun-19,5310,5041,269,5.1
10743,CN2118900000000,21,189,"Owsley County, KY",Jun-19,1156,1070,86,7.4
10744,CN2119100000000,21,191,"Pendleton County, KY",Jun-19,7120,6819,301,4.2
10745,CN2119300000000,21,193,"Perry County, KY",Jun-19,8442,7916,526,6.2
10746,CN2119500000000,21,195,"Pike County, KY",Jun-19,19823,18553,1270,6.4
10747,CN2119700000000,21,197,"Powell County, KY",Jun-19,5115,4822,293,5.7
10748,CN2119900000000,21,199,"Pulaski County, KY",Jun-19,26840,25422,1418,5.3
10749,CN2120100000000,21,201,"Robertson County, KY",Jun-19,838,793,45,5.4
10750,CN2120300000000,21,203,"Rockcastle County, KY",Jun-19,6751,6388,363,5.4
10751,CN2120500000000,21,205,"Rowan County, KY",Jun-19,10479,9838,641,6.1
10752,CN2120700000000,21,207,"Russell County, KY",Jun-19,6455,6071,384,5.9
10753,CN2120900000000,21,209,"Scott County, KY",Jun-19,29817,28612,1205,4.0
10754,CN2121100000000,21,211,"Shelby County, KY",Jun-19,26096,25103,993,3.8
10755,CN2121300000000,21,213,"Simpson County, KY",Jun-19,9026,8586,440,4.9
10756,CN2121500000000,21,215,"Spencer County, KY",Jun-19,10347,9954,393,3.8
10757,CN2121700000000,21,217,"Taylor County, KY",Jun-19,12600,11959,641,5.1
10758,CN2121900000000,21,219,"Todd County, KY",Jun-19,5571,5336,235,4.2
10759,CN2122100000000,21,221,"Trigg County, KY",Jun-19,6096,5784,312,5.1
10760,CN2122300000000,21,223,"Trimble County, KY",Jun-19,3970,3782,188,4.7
10761,CN2122500000000,21,225,"Union County, KY",Jun-19,6339,6026,313,4.9
10762,CN2122700000000,21,227,"Warren County, KY",Jun-19,65797,62840,2957,4.5
10763,CN2122900000000,21,229,"Washington County, KY",Jun-19,6404,6138,266,4.2
10764,CN2123100000000,21,231,"Wayne County, KY",Jun-19,7775,7296,479,6.2
10765,CN2123300000000,21,233,"Webster County, KY",Jun-19,5994,5723,271,4.5
10766,CN2123500000000,21,235,"Whitley County, KY",Jun-19,13921,13096,825,5.9
10767,CN2123700000000,21,237,"Wolfe County, KY",Jun-19,2006,1859,147,7.3
10768,CN2123900000000,21,239,"Woodford County, KY",Jun-19,15596,15070,526,3.4
10769,CN2200100000000,22,1,"Acadia Parish, LA",Jun-19,24132,22665,1467,6.1
10770,CN2200300000000,22,3,"Allen Parish, LA",Jun-19,9016,8429,587,6.5
10771,CN2200500000000,22,5,"Ascension Parish, LA",Jun-19,64060,61055,3005,4.7
10772,CN2200700000000,22,7,"Assumption Parish, LA",Jun-19,8973,8372,601,6.7
10773,CN2200900000000,22,9,"Avoyelles Parish, LA",Jun-19,15338,14295,1043,6.8
10774,CN2201100000000,22,11,"Beauregard Parish, LA",Jun-19,14741,13873,868,5.9
10775,CN2201300000000,22,13,"Bienville Parish, LA",Jun-19,5606,5249,357,6.4
10776,CN2201500000000,22,15,"Bossier Parish, LA",Jun-19,58238,55310,2928,5.0
10777,CN2201700000000,22,17,"Caddo Parish, LA",Jun-19,104692,98226,6466,6.2
10778,CN2201900000000,22,19,"Calcasieu Parish, LA",Jun-19,108475,103431,5044,4.6
10779,CN2202100000000,22,21,"Caldwell Parish, LA",Jun-19,3803,3576,227,6.0
10780,CN2202300000000,22,23,"Cameron Parish, LA",Jun-19,4024,3847,177,4.4
10781,CN2202500000000,22,25,"Catahoula Parish, LA",Jun-19,3432,3183,249,7.3
10782,CN2202700000000,22,27,"Claiborne Parish, LA",Jun-19,5891,5534,357,6.1
10783,CN2202900000000,22,29,"Concordia Parish, LA",Jun-19,7078,6540,538,7.6
10784,CN2203100000000,22,31,"De Soto Parish, LA",Jun-19,10932,10224,708,6.5
10785,CN2203300000000,22,33,"East Baton Rouge Parish, LA",Jun-19,231435,219420,12015,5.2
10786,CN2203500000000,22,35,"East Carroll Parish, LA",Jun-19,1909,1677,232,12.2
10787,CN2203700000000,22,37,"East Feliciana Parish, LA",Jun-19,8015,7591,424,5.3
10788,CN2203900000000,22,39,"Evangeline Parish, LA",Jun-19,12223,11383,840,6.9
10789,CN2204100000000,22,41,"Franklin Parish, LA",Jun-19,7581,6994,587,7.7
10790,CN2204300000000,22,43,"Grant Parish, LA",Jun-19,8304,7750,554,6.7
10791,CN2204500000000,22,45,"Iberia Parish, LA",Jun-19,28538,26773,1765,6.2
10792,CN2204700000000,22,47,"Iberville Parish, LA",Jun-19,14057,13127,930,6.6
10793,CN2204900000000,22,49,"Jackson Parish, LA",Jun-19,6888,6523,365,5.3
10794,CN2205100000000,22,51,"Jefferson Parish, LA",Jun-19,215808,205439,10369,4.8
10795,CN2205300000000,22,53,"Jefferson Davis Parish, LA",Jun-19,13439,12710,729,5.4
10796,CN2205500000000,22,55,"Lafayette Parish, LA",Jun-19,115147,109403,5744,5.0
10797,CN2205700000000,22,57,"Lafourche Parish, LA",Jun-19,42413,40180,2233,5.3
10798,CN2205900000000,22,59,"LaSalle Parish, LA",Jun-19,6879,6519,360,5.2
10799,CN2206100000000,22,61,"Lincoln Parish, LA",Jun-19,21597,20157,1440,6.7
10800,CN2206300000000,22,63,"Livingston Parish, LA",Jun-19,69010,65706,3304,4.8
10801,CN2206500000000,22,65,"Madison Parish, LA",Jun-19,3633,3290,343,9.4
10802,CN2206700000000,22,67,"Morehouse Parish, LA",Jun-19,10049,9191,858,8.5
10803,CN2206900000000,22,69,"Natchitoches Parish, LA",Jun-19,16162,15023,1139,7.0
10804,CN2207100000000,22,71,"Orleans Parish, LA",Jun-19,181222,170849,10373,5.7
10805,CN2207300000000,22,73,"Ouachita Parish, LA",Jun-19,70363,66143,4220,6.0
10806,CN2207500000000,22,75,"Plaquemines Parish, LA",Jun-19,10142,9639,503,5.0
10807,CN2207700000000,22,77,"Pointe Coupee Parish, LA",Jun-19,9925,9316,609,6.1
10808,CN2207900000000,22,79,"Rapides Parish, LA",Jun-19,55707,52505,3202,5.7
10809,CN2208100000000,22,81,"Red River Parish, LA",Jun-19,3791,3572,219,5.8
10810,CN2208300000000,22,83,"Richland Parish, LA",Jun-19,8391,7819,572,6.8
10811,CN2208500000000,22,85,"Sabine Parish, LA",Jun-19,9302,8785,517,5.6
10812,CN2208700000000,22,87,"St. Bernard Parish, LA",Jun-19,20100,18990,1110,5.5
10813,CN2208900000000,22,89,"St. Charles Parish, LA",Jun-19,25413,24119,1294,5.1
10814,CN2209100000000,22,91,"St. Helena Parish, LA",Jun-19,4312,3999,313,7.3
10815,CN2209300000000,22,93,"St. James Parish, LA",Jun-19,9320,8676,644,6.9
10816,CN2209500000000,22,95,"St. John the Baptist Parish, LA",Jun-19,19834,18577,1257,6.3
10817,CN2209700000000,22,97,"St. Landry Parish, LA",Jun-19,32548,30238,2310,7.1
10818,CN2209900000000,22,99,"St. Martin Parish, LA",Jun-19,22418,21106,1312,5.9
10819,CN2210100000000,22,101,"St. Mary Parish, LA",Jun-19,20127,18833,1294,6.4
10820,CN2210300000000,22,103,"St. Tammany Parish, LA",Jun-19,120763,114915,5848,4.8
10821,CN2210500000000,22,105,"Tangipahoa Parish, LA",Jun-19,54574,51002,3572,6.5
10822,CN2210700000000,22,107,"Tensas Parish, LA",Jun-19,1435,1284,151,10.5
10823,CN2210900000000,22,109,"Terrebonne Parish, LA",Jun-19,46582,44129,2453,5.3
10824,CN2211100000000,22,111,"Union Parish, LA",Jun-19,9129,8538,591,6.5
10825,CN2211300000000,22,113,"Vermilion Parish, LA",Jun-19,24471,23081,1390,5.7
10826,CN2211500000000,22,115,"Vernon Parish, LA",Jun-19,16132,15069,1063,6.6
10827,CN2211700000000,22,117,"Washington Parish, LA",Jun-19,16936,15738,1198,7.1
10828,CN2211900000000,22,119,"Webster Parish, LA",Jun-19,14673,13650,1023,7.0
10829,CN2212100000000,22,121,"West Baton Rouge Parish, LA",Jun-19,13713,12971,742,5.4
10830,CN2212300000000,22,123,"West Carroll Parish, LA",Jun-19,3691,3324,367,9.9
10831,CN2212500000000,22,125,"West Feliciana Parish, LA",Jun-19,5385,5139,246,4.6
10832,CN2212700000000,22,127,"Winn Parish, LA",Jun-19,4877,4532,345,7.1
10833,CN2300100000000,23,1,"Androscoggin County, ME",Jun-19,55328,53796,1532,2.8
10834,CN2300300000000,23,3,"Aroostook County, ME",Jun-19,30348,28963,1385,4.6
10835,CN2300500000000,23,5,"Cumberland County, ME",Jun-19,167436,163567,3869,2.3
10836,CN2300700000000,23,7,"Franklin County, ME",Jun-19,13897,13367,530,3.8
10837,CN2300900000000,23,9,"Hancock County, ME",Jun-19,30761,30012,749,2.4
10838,CN2301100000000,23,11,"Kennebec County, ME",Jun-19,62229,60502,1727,2.8
10839,CN2301300000000,23,13,"Knox County, ME",Jun-19,20982,20478,504,2.4
10840,CN2301500000000,23,15,"Lincoln County, ME",Jun-19,17590,17157,433,2.5
10841,CN2301700000000,23,17,"Oxford County, ME",Jun-19,26482,25577,905,3.4
10842,CN2301900000000,23,19,"Penobscot County, ME",Jun-19,76497,74204,2293,3.0
10843,CN2302100000000,23,21,"Piscataquis County, ME",Jun-19,7376,7138,238,3.2
10844,CN2302300000000,23,23,"Sagadahoc County, ME",Jun-19,19591,19179,412,2.1
10845,CN2302500000000,23,25,"Somerset County, ME",Jun-19,22716,21825,891,3.9
10846,CN2302700000000,23,27,"Waldo County, ME",Jun-19,20813,20205,608,2.9
10847,CN2302900000000,23,29,"Washington County, ME",Jun-19,13778,13207,571,4.1
10848,CN2303100000000,23,31,"York County, ME",Jun-19,115302,112590,2712,2.4
10849,CN2400100000000,24,1,"Allegany County, MD",Jun-19,32496,30662,1834,5.6
10850,CN2400300000000,24,3,"Anne Arundel County, MD",Jun-19,320643,309956,10687,3.3
10851,CN2400500000000,24,5,"Baltimore County, MD",Jun-19,461962,443493,18469,4.0
10852,CN2400900000000,24,9,"Calvert County, MD",Jun-19,50598,48785,1813,3.6
10853,CN2401100000000,24,11,"Caroline County, MD",Jun-19,18328,17634,694,3.8
10854,CN2401300000000,24,13,"Carroll County, MD",Jun-19,96933,93827,3106,3.2
10855,CN2401500000000,24,15,"Cecil County, MD",Jun-19,53436,51161,2275,4.3
10856,CN2401700000000,24,17,"Charles County, MD",Jun-19,88318,84934,3384,3.8
10857,CN2401900000000,24,19,"Dorchester County, MD",Jun-19,16097,15266,831,5.2
10858,CN2402100000000,24,21,"Frederick County, MD",Jun-19,136742,131990,4752,3.5
10859,CN2402300000000,24,23,"Garrett County, MD",Jun-19,15841,15141,700,4.4
10860,CN2402500000000,24,25,"Harford County, MD",Jun-19,143529,138316,5213,3.6
10861,CN2402700000000,24,27,"Howard County, MD",Jun-19,190942,185081,5861,3.1
10862,CN2402900000000,24,29,"Kent County, MD",Jun-19,10249,9833,416,4.1
10863,CN2403100000000,24,31,"Montgomery County, MD",Jun-19,568944,550346,18598,3.3
10864,CN2403300000000,24,33,"Prince George's County, MD",Jun-19,514658,494075,20583,4.0
10865,CN2403500000000,24,35,"Queen Anne's County, MD",Jun-19,28001,27066,935,3.3
10866,CN2403700000000,24,37,"St. Mary's County, MD",Jun-19,57742,55678,2064,3.6
10867,CN2403900000000,24,39,"Somerset County, MD",Jun-19,9689,9066,623,6.4
10868,CN2404100000000,24,41,"Talbot County, MD",Jun-19,19380,18682,698,3.6
10869,CN2404300000000,24,43,"Washington County, MD",Jun-19,75406,72319,3087,4.1
10870,CN2404500000000,24,45,"Wicomico County, MD",Jun-19,54774,52250,2524,4.6
10871,CN2404700000000,24,47,"Worcester County, MD",Jun-19,26586,25172,1414,5.3
10872,CN2451000000000,24,510,"Baltimore city, MD",Jun-19,294244,278182,16062,5.5
10873,CN2500100000000,25,1,"Barnstable County, MA",Jun-19,123191,119389,3802,3.1
10874,CN2500300000000,25,3,"Berkshire County, MA",Jun-19,67243,64910,2333,3.5
10875,CN2500500000000,25,5,"Bristol County, MA",Jun-19,305427,293661,11766,3.9
10876,CN2500700000000,25,7,"Dukes County, MA",Jun-19,11158,10851,307,2.8
10877,CN2500900000000,25,9,"Essex County, MA",Jun-19,432801,418856,13945,3.2
10878,CN2501100000000,25,11,"Franklin County, MA",Jun-19,41426,40276,1150,2.8
10879,CN2501300000000,25,13,"Hampden County, MA",Jun-19,229665,219304,10361,4.5
10880,CN2501500000000,25,15,"Hampshire County, MA",Jun-19,90736,87909,2827,3.1
10881,CN2501700000000,25,17,"Middlesex County, MA",Jun-19,936739,912523,24216,2.6
10882,CN2501900000000,25,19,"Nantucket County/town, MA",Jun-19,9213,9020,193,2.1
10883,CN2502100000000,25,21,"Norfolk County, MA",Jun-19,398168,387016,11152,2.8
10884,CN2502300000000,25,23,"Plymouth County, MA",Jun-19,288814,279671,9143,3.2
10885,CN2502500000000,25,25,"Suffolk County, MA",Jun-19,465144,451000,14144,3.0
10886,CN2502700000000,25,27,"Worcester County, MA",Jun-19,451728,436468,15260,3.4
10887,CN2600100000000,26,1,"Alcona County, MI",Jun-19,4060,3817,243,6.0
10888,CN2600300000000,26,3,"Alger County, MI",Jun-19,3464,3211,253,7.3
10889,CN2600500000000,26,5,"Allegan County, MI",Jun-19,63674,61590,2084,3.3
10890,CN2600700000000,26,7,"Alpena County, MI",Jun-19,13324,12690,634,4.8
10891,CN2600900000000,26,9,"Antrim County, MI",Jun-19,11075,10564,511,4.6
10892,CN2601100000000,26,11,"Arenac County, MI",Jun-19,6315,5924,391,6.2
10893,CN2601300000000,26,13,"Baraga County, MI",Jun-19,3310,3087,223,6.7
10894,CN2601500000000,26,15,"Barry County, MI",Jun-19,32088,30995,1093,3.4
10895,CN2601700000000,26,17,"Bay County, MI",Jun-19,50736,48263,2473,4.9
10896,CN2601900000000,26,19,"Benzie County, MI",Jun-19,9307,8878,429,4.6
10897,CN2602100000000,26,21,"Berrien County, MI",Jun-19,75435,72056,3379,4.5
10898,CN2602300000000,26,23,"Branch County, MI",Jun-19,19720,18887,833,4.2
10899,CN2602500000000,26,25,"Calhoun County, MI",Jun-19,63134,60310,2824,4.5
10900,CN2602700000000,26,27,"Cass County, MI",Jun-19,24597,23393,1204,4.9
10901,CN2602900000000,26,29,"Charlevoix County, MI",Jun-19,13870,13285,585,4.2
10902,CN2603100000000,26,31,"Cheboygan County, MI",Jun-19,11154,10728,426,3.8
10903,CN2603300000000,26,33,"Chippewa County, MI",Jun-19,16227,15206,1021,6.3
10904,CN2603500000000,26,35,"Clare County, MI",Jun-19,11924,11192,732,6.1
10905,CN2603700000000,26,37,"Clinton County, MI",Jun-19,40665,39367,1298,3.2
10906,CN2603900000000,26,39,"Crawford County, MI",Jun-19,5807,5498,309,5.3
10907,CN2604100000000,26,41,"Delta County, MI",Jun-19,17548,16655,893,5.1
10908,CN2604300000000,26,43,"Dickinson County, MI",Jun-19,12549,12003,546,4.4
10909,CN2604500000000,26,45,"Eaton County, MI",Jun-19,56471,54420,2051,3.6
10910,CN2604700000000,26,47,"Emmet County, MI",Jun-19,19011,18137,874,4.6
10911,CN2604900000000,26,49,"Genesee County, MI",Jun-19,185201,175252,9949,5.4
10912,CN2605100000000,26,51,"Gladwin County, MI",Jun-19,10148,9559,589,5.8
10913,CN2605300000000,26,53,"Gogebic County, MI",Jun-19,6022,5668,354,5.9
10914,CN2605500000000,26,55,"Grand Traverse County, MI",Jun-19,52352,50645,1707,3.3
10915,CN2605700000000,26,57,"Gratiot County, MI",Jun-19,18172,17365,807,4.4
10916,CN2605900000000,26,59,"Hillsdale County, MI",Jun-19,20791,19874,917,4.4
10917,CN2606100000000,26,61,"Houghton County, MI",Jun-19,15725,14833,892,5.7
10918,CN2606300000000,26,63,"Huron County, MI",Jun-19,15866,15170,696,4.4
10919,CN2606500000000,26,65,"Ingham County, MI",Jun-19,149489,143607,5882,3.9
10920,CN2606700000000,26,67,"Ionia County, MI",Jun-19,30659,29580,1079,3.5
10921,CN2606900000000,26,69,"Iosco County, MI",Jun-19,10624,10006,618,5.8
10922,CN2607100000000,26,71,"Iron County, MI",Jun-19,5317,5026,291,5.5
10923,CN2607300000000,26,73,"Isabella County, MI",Jun-19,35001,33499,1502,4.3
10924,CN2607500000000,26,75,"Jackson County, MI",Jun-19,74817,71759,3058,4.1
10925,CN2607700000000,26,77,"Kalamazoo County, MI",Jun-19,134354,129525,4829,3.6
10926,CN2607900000000,26,79,"Kalkaska County, MI",Jun-19,8311,7885,426,5.1
10927,CN2608100000000,26,81,"Kent County, MI",Jun-19,364887,353191,11696,3.2
10928,CN2608300000000,26,83,"Keweenaw County, MI",Jun-19,870,798,72,8.3
10929,CN2608500000000,26,85,"Lake County, MI",Jun-19,3772,3526,246,6.5
10930,CN2608700000000,26,87,"Lapeer County, MI",Jun-19,41507,39298,2209,5.3
10931,CN2608900000000,26,89,"Leelanau County, MI",Jun-19,11038,10675,363,3.3
10932,CN2609100000000,26,91,"Lenawee County, MI",Jun-19,46655,44802,1853,4.0
10933,CN2609300000000,26,93,"Livingston County, MI",Jun-19,104271,100779,3492,3.3
10934,CN2609500000000,26,95,"Luce County, MI",Jun-19,2391,2252,139,5.8
10935,CN2609700000000,26,97,"Mackinac County, MI",Jun-19,5981,5785,196,3.3
10936,CN2609900000000,26,99,"Macomb County, MI",Jun-19,451365,431788,19577,4.3
10937,CN2610100000000,26,101,"Manistee County, MI",Jun-19,11067,10476,591,5.3
10938,CN2610300000000,26,103,"Marquette County, MI",Jun-19,32393,30659,1734,5.4
10939,CN2610500000000,26,105,"Mason County, MI",Jun-19,14376,13706,670,4.7
10940,CN2610700000000,26,107,"Mecosta County, MI",Jun-19,17762,16848,914,5.1
10941,CN2610900000000,26,109,"Menominee County, MI",Jun-19,11353,10929,424,3.7
10942,CN2611100000000,26,111,"Midland County, MI",Jun-19,41049,39440,1609,3.9
10943,CN2611300000000,26,113,"Missaukee County, MI",Jun-19,7172,6817,355,4.9
10944,CN2611500000000,26,115,"Monroe County, MI",Jun-19,76171,73132,3039,4.0
10945,CN2611700000000,26,117,"Montcalm County, MI",Jun-19,28736,27501,1235,4.3
10946,CN2611900000000,26,119,"Montmorency County, MI",Jun-19,3079,2856,223,7.2
10947,CN2612100000000,26,121,"Muskegon County, MI",Jun-19,78937,75381,3556,4.5
10948,CN2612300000000,26,123,"Newaygo County, MI",Jun-19,24144,23077,1067,4.4
10949,CN2612500000000,26,125,"Oakland County, MI",Jun-19,681473,656868,24605,3.6
10950,CN2612700000000,26,127,"Oceana County, MI",Jun-19,12872,12197,675,5.2
10951,CN2612900000000,26,129,"Ogemaw County, MI",Jun-19,8436,7916,520,6.2
10952,CN2613100000000,26,131,"Ontonagon County, MI",Jun-19,2128,1990,138,6.5
10953,CN2613300000000,26,133,"Osceola County, MI",Jun-19,11345,10855,490,4.3
10954,CN2613500000000,26,135,"Oscoda County, MI",Jun-19,3228,3017,211,6.5
10955,CN2613700000000,26,137,"Otsego County, MI",Jun-19,12147,11546,601,4.9
10956,CN2613900000000,26,139,"Ottawa County, MI",Jun-19,163485,158415,5070,3.1
10957,CN2614100000000,26,141,"Presque Isle County, MI",Jun-19,5150,4819,331,6.4
10958,CN2614300000000,26,143,"Roscommon County, MI",Jun-19,8217,7638,579,7.0
10959,CN2614500000000,26,145,"Saginaw County, MI",Jun-19,87792,83467,4325,4.9
10960,CN2614700000000,26,147,"St. Clair County, MI",Jun-19,76192,72558,3634,4.8
10961,CN2614900000000,26,149,"St. Joseph County, MI",Jun-19,28514,27262,1252,4.4
10962,CN2615100000000,26,151,"Sanilac County, MI",Jun-19,19996,19053,943,4.7
10963,CN2615300000000,26,153,"Schoolcraft County, MI",Jun-19,3412,3199,213,6.2
10964,CN2615500000000,26,155,"Shiawassee County, MI",Jun-19,33720,32221,1499,4.4
10965,CN2615700000000,26,157,"Tuscola County, MI",Jun-19,24307,23025,1282,5.3
10966,CN2615900000000,26,159,"Van Buren County, MI",Jun-19,35443,33737,1706,4.8
10967,CN2616100000000,26,161,"Washtenaw County, MI",Jun-19,196456,189784,6672,3.4
10968,CN2616300000000,26,163,"Wayne County, MI",Jun-19,804409,762087,42322,5.3
10969,CN2616500000000,26,165,"Wexford County, MI",Jun-19,15307,14530,777,5.1
10970,CN2700100000000,27,1,"Aitkin County, MN",Jun-19,7414,7090,324,4.4
10971,CN2700300000000,27,3,"Anoka County, MN",Jun-19,199916,193607,6309,3.2
10972,CN2700500000000,27,5,"Becker County, MN",Jun-19,19456,18813,643,3.3
10973,CN2700700000000,27,7,"Beltrami County, MN",Jun-19,24551,23569,982,4.0
10974,CN2700900000000,27,9,"Benton County, MN",Jun-19,21824,21125,699,3.2
10975,CN2701100000000,27,11,"Big Stone County, MN",Jun-19,2586,2507,79,3.1
10976,CN2701300000000,27,13,"Blue Earth County, MN",Jun-19,40417,39181,1236,3.1
10977,CN2701500000000,27,15,"Brown County, MN",Jun-19,14588,14130,458,3.1
10978,CN2701700000000,27,17,"Carlton County, MN",Jun-19,17837,17124,713,4.0
10979,CN2701900000000,27,19,"Carver County, MN",Jun-19,59372,57618,1754,3.0
10980,CN2702100000000,27,21,"Cass County, MN",Jun-19,15282,14672,610,4.0
10981,CN2702300000000,27,23,"Chippewa County, MN",Jun-19,7080,6827,253,3.6
10982,CN2702500000000,27,25,"Chisago County, MN",Jun-19,30180,29169,1011,3.3
10983,CN2702700000000,27,27,"Clay County, MN",Jun-19,36118,34989,1129,3.1
10984,CN2702900000000,27,29,"Clearwater County, MN",Jun-19,4445,4169,276,6.2
10985,CN2703100000000,27,31,"Cook County, MN",Jun-19,3269,3162,107,3.3
10986,CN2703300000000,27,33,"Cottonwood County, MN",Jun-19,6159,5915,244,4.0
10987,CN2703500000000,27,35,"Crow Wing County, MN",Jun-19,33683,32541,1142,3.4
10988,CN2703700000000,27,37,"Dakota County, MN",Jun-19,244672,237151,7521,3.1
10989,CN2703900000000,27,39,"Dodge County, MN",Jun-19,12043,11653,390,3.2
10990,CN2704100000000,27,41,"Douglas County, MN",Jun-19,21813,21194,619,2.8
10991,CN2704300000000,27,43,"Faribault County, MN",Jun-19,7190,6901,289,4.0
10992,CN2704500000000,27,45,"Fillmore County, MN",Jun-19,11729,11390,339,2.9
10993,CN2704700000000,27,47,"Freeborn County, MN",Jun-19,16454,15898,556,3.4
10994,CN2704900000000,27,49,"Goodhue County, MN",Jun-19,27495,26668,827,3.0
10995,CN2705100000000,27,51,"Grant County, MN",Jun-19,3364,3238,126,3.7
10996,CN2705300000000,27,53,"Hennepin County, MN",Jun-19,715771,693763,22008,3.1
10997,CN2705500000000,27,55,"Houston County, MN",Jun-19,10355,10051,304,2.9
10998,CN2705700000000,27,57,"Hubbard County, MN",Jun-19,10449,10025,424,4.1
10999,CN2705900000000,27,59,"Isanti County, MN",Jun-19,21368,20676,692,3.2
11000,CN2706100000000,27,61,"Itasca County, MN",Jun-19,22507,21305,1202,5.3
11001,CN2706300000000,27,63,"Jackson County, MN",Jun-19,5829,5570,259,4.4
11002,CN2706500000000,27,65,"Kanabec County, MN",Jun-19,9123,8769,354,3.9
11003,CN2706700000000,27,67,"Kandiyohi County, MN",Jun-19,24737,23959,778,3.1
11004,CN2706900000000,27,69,"Kittson County, MN",Jun-19,2449,2363,86,3.5
11005,CN2707100000000,27,71,"Koochiching County, MN",Jun-19,6232,5832,400,6.4
11006,CN2707300000000,27,73,"Lac qui Parle County, MN",Jun-19,3684,3561,123,3.3
11007,CN2707500000000,27,75,"Lake County, MN",Jun-19,5862,5656,206,3.5
11008,CN2707700000000,27,77,"Lake of the Woods County, MN",Jun-19,2535,2427,108,4.3
11009,CN2707900000000,27,79,"Le Sueur County, MN",Jun-19,16180,15644,536,3.3
11010,CN2708100000000,27,81,"Lincoln County, MN",Jun-19,3402,3298,104,3.1
11011,CN2708300000000,27,83,"Lyon County, MN",Jun-19,14920,14435,485,3.3
11012,CN2708500000000,27,85,"McLeod County, MN",Jun-19,19622,18948,674,3.4
11013,CN2708700000000,27,87,"Mahnomen County, MN",Jun-19,2360,2264,96,4.1
11014,CN2708900000000,27,89,"Marshall County, MN",Jun-19,5522,5315,207,3.7
11015,CN2709100000000,27,91,"Martin County, MN",Jun-19,10467,10009,458,4.4
11016,CN2709300000000,27,93,"Meeker County, MN",Jun-19,13502,13065,437,3.2
11017,CN2709500000000,27,95,"Mille Lacs County, MN",Jun-19,12889,12382,507,3.9
11018,CN2709700000000,27,97,"Morrison County, MN",Jun-19,17755,17150,605,3.4
11019,CN2709900000000,27,99,"Mower County, MN",Jun-19,20674,20034,640,3.1
11020,CN2710100000000,27,101,"Murray County, MN",Jun-19,5048,4898,150,3.0
11021,CN2710300000000,27,103,"Nicollet County, MN",Jun-19,20876,20295,581,2.8
11022,CN2710500000000,27,105,"Nobles County, MN",Jun-19,11391,11034,357,3.1
11023,CN2710700000000,27,107,"Norman County, MN",Jun-19,3392,3230,162,4.8
11024,CN2710900000000,27,109,"Olmsted County, MN",Jun-19,89685,87182,2503,2.8
11025,CN2711100000000,27,111,"Otter Tail County, MN",Jun-19,32711,31637,1074,3.3
11026,CN2711300000000,27,113,"Pennington County, MN",Jun-19,8790,8517,273,3.1
11027,CN2711500000000,27,115,"Pine County, MN",Jun-19,15166,14547,619,4.1
11028,CN2711700000000,27,117,"Pipestone County, MN",Jun-19,5067,4929,138,2.7
11029,CN2711900000000,27,119,"Polk County, MN",Jun-19,16736,15985,751,4.5
11030,CN2712100000000,27,121,"Pope County, MN",Jun-19,6694,6509,185,2.8
11031,CN2712300000000,27,123,"Ramsey County, MN",Jun-19,293448,283835,9613,3.3
11032,CN2712500000000,27,125,"Red Lake County, MN",Jun-19,2249,2154,95,4.2
11033,CN2712700000000,27,127,"Redwood County, MN",Jun-19,7887,7617,270,3.4
11034,CN2712900000000,27,129,"Renville County, MN",Jun-19,8729,8369,360,4.1
11035,CN2713100000000,27,131,"Rice County, MN",Jun-19,37896,36680,1216,3.2
11036,CN2713300000000,27,133,"Rock County, MN",Jun-19,5833,5698,135,2.3
11037,CN2713500000000,27,135,"Roseau County, MN",Jun-19,7973,7678,295,3.7
11038,CN2713700000000,27,137,"St. Louis County, MN",Jun-19,102296,98232,4064,4.0
11039,CN2713900000000,27,139,"Scott County, MN",Jun-19,84519,82101,2418,2.9
11040,CN2714100000000,27,141,"Sherburne County, MN",Jun-19,52839,51165,1674,3.2
11041,CN2714300000000,27,143,"Sibley County, MN",Jun-19,8708,8422,286,3.3
11042,CN2714500000000,27,145,"Stearns County, MN",Jun-19,90493,87675,2818,3.1
11043,CN2714700000000,27,147,"Steele County, MN",Jun-19,21434,20739,695,3.2
11044,CN2714900000000,27,149,"Stevens County, MN",Jun-19,5605,5454,151,2.7
11045,CN2715100000000,27,151,"Swift County, MN",Jun-19,5047,4883,164,3.2
11046,CN2715300000000,27,153,"Todd County, MN",Jun-19,13655,13184,471,3.4
11047,CN2715500000000,27,155,"Traverse County, MN",Jun-19,1868,1807,61,3.3
11048,CN2715700000000,27,157,"Wabasha County, MN",Jun-19,12511,12123,388,3.1
11049,CN2715900000000,27,159,"Wadena County, MN",Jun-19,5982,5696,286,4.8
11050,CN2716100000000,27,161,"Waseca County, MN",Jun-19,9265,8924,341,3.7
11051,CN2716300000000,27,163,"Washington County, MN",Jun-19,145185,140804,4381,3.0
11052,CN2716500000000,27,165,"Watonwan County, MN",Jun-19,6707,6455,252,3.8
11053,CN2716700000000,27,167,"Wilkin County, MN",Jun-19,3609,3485,124,3.4
11054,CN2716900000000,27,169,"Winona County, MN",Jun-19,28618,27667,951,3.3
11055,CN2717100000000,27,171,"Wright County, MN",Jun-19,76302,74050,2252,3.0
11056,CN2717300000000,27,173,"Yellow Medicine County, MN",Jun-19,5510,5297,213,3.9
11057,CN2800100000000,28,1,"Adams County, MS",Jun-19,11525,10588,937,8.1
11058,CN2800300000000,28,3,"Alcorn County, MS",Jun-19,16165,15256,909,5.6
11059,CN2800500000000,28,5,"Amite County, MS",Jun-19,4594,4235,359,7.8
11060,CN2800700000000,28,7,"Attala County, MS",Jun-19,7241,6730,511,7.1
11061,CN2800900000000,28,9,"Benton County, MS",Jun-19,3087,2854,233,7.5
11062,CN2801100000000,28,11,"Bolivar County, MS",Jun-19,12661,11548,1113,8.8
11063,CN2801300000000,28,13,"Calhoun County, MS",Jun-19,5897,5538,359,6.1
11064,CN2801500000000,28,15,"Carroll County, MS",Jun-19,3555,3306,249,7.0
11065,CN2801700000000,28,17,"Chickasaw County, MS",Jun-19,7027,6569,458,6.5
11066,CN2801900000000,28,19,"Choctaw County, MS",Jun-19,3851,3625,226,5.9
11067,CN2802100000000,28,21,"Claiborne County, MS",Jun-19,3130,2710,420,13.4
11068,CN2802300000000,28,23,"Clarke County, MS",Jun-19,5979,5545,434,7.3
11069,CN2802500000000,28,25,"Clay County, MS",Jun-19,8008,7313,695,8.7
11070,CN2802700000000,28,27,"Coahoma County, MS",Jun-19,8660,7878,782,9.0
11071,CN2802900000000,28,29,"Copiah County, MS",Jun-19,11494,10571,923,8.0
11072,CN2803100000000,28,31,"Covington County, MS",Jun-19,8294,7824,470,5.7
11073,CN2803300000000,28,33,"DeSoto County, MS",Jun-19,91549,86764,4785,5.2
11074,CN2803500000000,28,35,"Forrest County, MS",Jun-19,33124,31061,2063,6.2
11075,CN2803700000000,28,37,"Franklin County, MS",Jun-19,2925,2702,223,7.6
11076,CN2803900000000,28,39,"George County, MS",Jun-19,9113,8369,744,8.2
11077,CN2804100000000,28,41,"Greene County, MS",Jun-19,4468,4067,401,9.0
11078,CN2804300000000,28,43,"Grenada County, MS",Jun-19,9825,9239,586,6.0
11079,CN2804500000000,28,45,"Hancock County, MS",Jun-19,19060,17846,1214,6.4
11080,CN2804700000000,28,47,"Harrison County, MS",Jun-19,87934,82684,5250,6.0
11081,CN2804900000000,28,49,"Hinds County, MS",Jun-19,108244,101395,6849,6.3
11082,CN2805100000000,28,51,"Holmes County, MS",Jun-19,5827,5119,708,12.2
11083,CN2805300000000,28,53,"Humphreys County, MS",Jun-19,2354,2104,250,10.6
11084,CN2805500000000,28,55,"Issaquena County, MS",Jun-19,403,351,52,12.9
11085,CN2805700000000,28,57,"Itawamba County, MS",Jun-19,10691,10085,606,5.7
11086,CN2805900000000,28,59,"Jackson County, MS",Jun-19,59592,55518,4074,6.8
11087,CN2806100000000,28,61,"Jasper County, MS",Jun-19,6349,5849,500,7.9
11088,CN2806300000000,28,63,"Jefferson County, MS",Jun-19,2111,1720,391,18.5
11089,CN2806500000000,28,65,"Jefferson Davis County, MS",Jun-19,4163,3796,367,8.8
11090,CN2806700000000,28,67,"Jones County, MS",Jun-19,26773,25063,1710,6.4
11091,CN2806900000000,28,69,"Kemper County, MS",Jun-19,3675,3312,363,9.9
11092,CN2807100000000,28,71,"Lafayette County, MS",Jun-19,27692,25966,1726,6.2
11093,CN2807300000000,28,73,"Lamar County, MS",Jun-19,30414,28902,1512,5.0
11094,CN2807500000000,28,75,"Lauderdale County, MS",Jun-19,30681,28628,2053,6.7
11095,CN2807700000000,28,77,"Lawrence County, MS",Jun-19,4758,4370,388,8.2
11096,CN2807900000000,28,79,"Leake County, MS",Jun-19,8293,7769,524,6.3
11097,CN2808100000000,28,81,"Lee County, MS",Jun-19,41465,39343,2122,5.1
11098,CN2808300000000,28,83,"Leflore County, MS",Jun-19,10238,9372,866,8.5
11099,CN2808500000000,28,85,"Lincoln County, MS",Jun-19,14955,13996,959,6.4
11100,CN2808700000000,28,87,"Lowndes County, MS",Jun-19,25383,23694,1689,6.7
11101,CN2808900000000,28,89,"Madison County, MS",Jun-19,53818,50940,2878,5.3
11102,CN2809100000000,28,91,"Marion County, MS",Jun-19,10075,9443,632,6.3
11103,CN2809300000000,28,93,"Marshall County, MS",Jun-19,14646,13607,1039,7.1
11104,CN2809500000000,28,95,"Monroe County, MS",Jun-19,15749,14758,991,6.3
11105,CN2809700000000,28,97,"Montgomery County, MS",Jun-19,4092,3820,272,6.6
11106,CN2809900000000,28,99,"Neshoba County, MS",Jun-19,10732,10002,730,6.8
11107,CN2810100000000,28,101,"Newton County, MS",Jun-19,9043,8440,603,6.7
11108,CN2810300000000,28,103,"Noxubee County, MS",Jun-19,3966,3629,337,8.5
11109,CN2810500000000,28,105,"Oktibbeha County, MS",Jun-19,22440,20749,1691,7.5
11110,CN2810700000000,28,107,"Panola County, MS",Jun-19,12858,11848,1010,7.9
11111,CN2810900000000,28,109,"Pearl River County, MS",Jun-19,24095,22642,1453,6.0
11112,CN2811100000000,28,111,"Perry County, MS",Jun-19,4289,3960,329,7.7
11113,CN2811300000000,28,113,"Pike County, MS",Jun-19,14968,13804,1164,7.8
11114,CN2811500000000,28,115,"Pontotoc County, MS",Jun-19,14902,14147,755,5.1
11115,CN2811700000000,28,117,"Prentiss County, MS",Jun-19,11501,10833,668,5.8
11116,CN2811900000000,28,119,"Quitman County, MS",Jun-19,2521,2268,253,10.0
11117,CN2812100000000,28,121,"Rankin County, MS",Jun-19,76686,73151,3535,4.6
11118,CN2812300000000,28,123,"Scott County, MS",Jun-19,13168,12438,730,5.5
11119,CN2812500000000,28,125,"Sharkey County, MS",Jun-19,1676,1526,150,8.9
11120,CN2812700000000,28,127,"Simpson County, MS",Jun-19,10935,10272,663,6.1
11121,CN2812900000000,28,129,"Smith County, MS",Jun-19,7029,6614,415,5.9
11122,CN2813100000000,28,131,"Stone County, MS",Jun-19,7022,6438,584,8.3
11123,CN2813300000000,28,133,"Sunflower County, MS",Jun-19,8030,7310,720,9.0
11124,CN2813500000000,28,135,"Tallahatchie County, MS",Jun-19,5458,5094,364,6.7
11125,CN2813700000000,28,137,"Tate County, MS",Jun-19,12572,11709,863,6.9
11126,CN2813900000000,28,139,"Tippah County, MS",Jun-19,9538,8936,602,6.3
11127,CN2814100000000,28,141,"Tishomingo County, MS",Jun-19,8765,8258,507,5.8
11128,CN2814300000000,28,143,"Tunica County, MS",Jun-19,4564,4232,332,7.3
11129,CN2814500000000,28,145,"Union County, MS",Jun-19,14411,13727,684,4.7
11130,CN2814700000000,28,147,"Walthall County, MS",Jun-19,5086,4638,448,8.8
11131,CN2814900000000,28,149,"Warren County, MS",Jun-19,20465,19045,1420,6.9
11132,CN2815100000000,28,151,"Washington County, MS",Jun-19,17510,15996,1514,8.6
11133,CN2815300000000,28,153,"Wayne County, MS",Jun-19,7698,7149,549,7.1
11134,CN2815500000000,28,155,"Webster County, MS",Jun-19,4008,3750,258,6.4
11135,CN2815700000000,28,157,"Wilkinson County, MS",Jun-19,2886,2541,345,12.0
11136,CN2815900000000,28,159,"Winston County, MS",Jun-19,7603,7058,545,7.2
11137,CN2816100000000,28,161,"Yalobusha County, MS",Jun-19,4931,4572,359,7.3
11138,CN2816300000000,28,163,"Yazoo County, MS",Jun-19,9720,8968,752,7.7
11139,CN2900100000000,29,1,"Adair County, MO",Jun-19,10318,9817,501,4.9
11140,CN2900300000000,29,3,"Andrew County, MO",Jun-19,9845,9541,304,3.1
11141,CN2900500000000,29,5,"Atchison County, MO",Jun-19,2686,2546,140,5.2
11142,CN2900700000000,29,7,"Audrain County, MO",Jun-19,10711,10319,392,3.7
11143,CN2900900000000,29,9,"Barry County, MO",Jun-19,15557,15071,486,3.1
11144,CN2901100000000,29,11,"Barton County, MO",Jun-19,5206,4996,210,4.0
11145,CN2901300000000,29,13,"Bates County, MO",Jun-19,7917,7564,353,4.5
11146,CN2901500000000,29,15,"Benton County, MO",Jun-19,7306,6958,348,4.8
11147,CN2901700000000,29,17,"Bollinger County, MO",Jun-19,5501,5254,247,4.5
11148,CN2901900000000,29,19,"Boone County, MO",Jun-19,96112,93576,2536,2.6
11149,CN2902100000000,29,21,"Buchanan County, MO",Jun-19,45171,43764,1407,3.1
11150,CN2902300000000,29,23,"Butler County, MO",Jun-19,18287,17105,1182,6.5
11151,CN2902500000000,29,25,"Caldwell County, MO",Jun-19,4349,4206,143,3.3
11152,CN2902700000000,29,27,"Callaway County, MO",Jun-19,21527,20848,679,3.2
11153,CN2902900000000,29,29,"Camden County, MO",Jun-19,20392,19698,694,3.4
11154,CN2903100000000,29,31,"Cape Girardeau County, MO",Jun-19,41220,39927,1293,3.1
11155,CN2903300000000,29,33,"Carroll County, MO",Jun-19,4572,4413,159,3.5
11156,CN2903500000000,29,35,"Carter County, MO",Jun-19,2613,2466,147,5.6
11157,CN2903700000000,29,37,"Cass County, MO",Jun-19,55362,53663,1699,3.1
11158,CN2903900000000,29,39,"Cedar County, MO",Jun-19,5781,5547,234,4.0
11159,CN2904100000000,29,41,"Chariton County, MO",Jun-19,3707,3581,126,3.4
11160,CN2904300000000,29,43,"Christian County, MO",Jun-19,44989,43786,1203,2.7
11161,CN2904500000000,29,45,"Clark County, MO",Jun-19,3254,3123,131,4.0
11162,CN2904700000000,29,47,"Clay County, MO",Jun-19,137948,134061,3887,2.8
11163,CN2904900000000,29,49,"Clinton County, MO",Jun-19,10776,10455,321,3.0
11164,CN2905100000000,29,51,"Cole County, MO",Jun-19,39369,38289,1080,2.7
11165,CN2905300000000,29,53,"Cooper County, MO",Jun-19,7476,7205,271,3.6
11166,CN2905500000000,29,55,"Crawford County, MO",Jun-19,11201,10775,426,3.8
11167,CN2905700000000,29,57,"Dade County, MO",Jun-19,3572,3456,116,3.2
11168,CN2905900000000,29,59,"Dallas County, MO",Jun-19,6986,6705,281,4.0
11169,CN2906100000000,29,61,"Daviess County, MO",Jun-19,4123,3998,125,3.0
11170,CN2906300000000,29,63,"DeKalb County, MO",Jun-19,4838,4683,155,3.2
11171,CN2906500000000,29,65,"Dent County, MO",Jun-19,6410,6166,244,3.8
11172,CN2906700000000,29,67,"Douglas County, MO",Jun-19,5067,4862,205,4.0
11173,CN2906900000000,29,69,"Dunklin County, MO",Jun-19,11739,11023,716,6.1
11174,CN2907100000000,29,71,"Franklin County, MO",Jun-19,53541,51880,1661,3.1
11175,CN2907300000000,29,73,"Gasconade County, MO",Jun-19,7767,7547,220,2.8
11176,CN2907500000000,29,75,"Gentry County, MO",Jun-19,3566,3452,114,3.2
11177,CN2907700000000,29,77,"Greene County, MO",Jun-19,151710,147657,4053,2.7
11178,CN2907900000000,29,79,"Grundy County, MO",Jun-19,4315,4163,152,3.5
11179,CN2908100000000,29,81,"Harrison County, MO",Jun-19,3759,3653,106,2.8
11180,CN2908300000000,29,83,"Henry County, MO",Jun-19,9860,9437,423,4.3
11181,CN2908500000000,29,85,"Hickory County, MO",Jun-19,3956,3802,154,3.9
11182,CN2908700000000,29,87,"Holt County, MO",Jun-19,2597,2498,99,3.8
11183,CN2908900000000,29,89,"Howard County, MO",Jun-19,4832,4672,160,3.3
11184,CN2909100000000,29,91,"Howell County, MO",Jun-19,16583,15909,674,4.1
11185,CN2909300000000,29,93,"Iron County, MO",Jun-19,3615,3439,176,4.9
11186,CN2909500000000,29,95,"Jackson County, MO",Jun-19,367535,353695,13840,3.8
11187,CN2909700000000,29,97,"Jasper County, MO",Jun-19,57128,55342,1786,3.1
11188,CN2909900000000,29,99,"Jefferson County, MO",Jun-19,119201,115525,3676,3.1
11189,CN2910100000000,29,101,"Johnson County, MO",Jun-19,23196,22304,892,3.8
11190,CN2910300000000,29,103,"Knox County, MO",Jun-19,1751,1693,58,3.3
11191,CN2910500000000,29,105,"Laclede County, MO",Jun-19,17178,16482,696,4.1
11192,CN2910700000000,29,107,"Lafayette County, MO",Jun-19,16911,16374,537,3.2
11193,CN2910900000000,29,109,"Lawrence County, MO",Jun-19,18071,17462,609,3.4
11194,CN2911100000000,29,111,"Lewis County, MO",Jun-19,5008,4851,157,3.1
11195,CN2911300000000,29,113,"Lincoln County, MO",Jun-19,28627,27660,967,3.4
11196,CN2911500000000,29,115,"Linn County, MO",Jun-19,5197,4931,266,5.1
11197,CN2911700000000,29,117,"Livingston County, MO",Jun-19,7411,7242,169,2.3
11198,CN2911900000000,29,119,"McDonald County, MO",Jun-19,10628,10205,423,4.0
11199,CN2912100000000,29,121,"Macon County, MO",Jun-19,7558,7314,244,3.2
11200,CN2912300000000,29,123,"Madison County, MO",Jun-19,5494,5296,198,3.6
11201,CN2912500000000,29,125,"Maries County, MO",Jun-19,3905,3762,143,3.7
11202,CN2912700000000,29,127,"Marion County, MO",Jun-19,14661,14173,488,3.3
11203,CN2912900000000,29,129,"Mercer County, MO",Jun-19,1819,1766,53,2.9
11204,CN2913100000000,29,131,"Miller County, MO",Jun-19,12836,12418,418,3.3
11205,CN2913300000000,29,133,"Mississippi County, MO",Jun-19,5828,5548,280,4.8
11206,CN2913500000000,29,135,"Moniteau County, MO",Jun-19,7288,7056,232,3.2
11207,CN2913700000000,29,137,"Monroe County, MO",Jun-19,3892,3715,177,4.5
11208,CN2913900000000,29,139,"Montgomery County, MO",Jun-19,5722,5529,193,3.4
11209,CN2914100000000,29,141,"Morgan County, MO",Jun-19,8457,8141,316,3.7
11210,CN2914300000000,29,143,"New Madrid County, MO",Jun-19,8259,7862,397,4.8
11211,CN2914500000000,29,145,"Newton County, MO",Jun-19,27288,26297,991,3.6
11212,CN2914700000000,29,147,"Nodaway County, MO",Jun-19,10758,10361,397,3.7
11213,CN2914900000000,29,149,"Oregon County, MO",Jun-19,3863,3694,169,4.4
11214,CN2915100000000,29,151,"Osage County, MO",Jun-19,7093,6914,179,2.5
11215,CN2915300000000,29,153,"Ozark County, MO",Jun-19,3513,3320,193,5.5
11216,CN2915500000000,29,155,"Pemiscot County, MO",Jun-19,6474,6106,368,5.7
11217,CN2915700000000,29,157,"Perry County, MO",Jun-19,10113,9828,285,2.8
11218,CN2915900000000,29,159,"Pettis County, MO",Jun-19,20879,20072,807,3.9
11219,CN2916100000000,29,161,"Phelps County, MO",Jun-19,19743,19057,686,3.5
11220,CN2916300000000,29,163,"Pike County, MO",Jun-19,7535,7248,287,3.8
11221,CN2916500000000,29,165,"Platte County, MO",Jun-19,59390,57811,1579,2.7
11222,CN2916700000000,29,167,"Polk County, MO",Jun-19,14483,13971,512,3.5
11223,CN2916900000000,29,169,"Pulaski County, MO",Jun-19,14781,14223,558,3.8
11224,CN2917100000000,29,171,"Putnam County, MO",Jun-19,2244,2166,78,3.5
11225,CN2917300000000,29,173,"Ralls County, MO",Jun-19,5658,5487,171,3.0
11226,CN2917500000000,29,175,"Randolph County, MO",Jun-19,10371,9962,409,3.9
11227,CN2917700000000,29,177,"Ray County, MO",Jun-19,11148,10708,440,3.9
11228,CN2917900000000,29,179,"Reynolds County, MO",Jun-19,3230,3128,102,3.2
11229,CN2918100000000,29,181,"Ripley County, MO",Jun-19,5152,4761,391,7.6
11230,CN2918300000000,29,183,"St. Charles County, MO",Jun-19,229219,223266,5953,2.6
11231,CN2918500000000,29,185,"St. Clair County, MO",Jun-19,3759,3561,198,5.3
11232,CN2918600000000,29,186,"Ste. Genevieve County, MO",Jun-19,9340,9076,264,2.8
11233,CN2918700000000,29,187,"St. Francois County, MO",Jun-19,27160,26143,1017,3.7
11234,CN2918900000000,29,189,"St. Louis County, MO",Jun-19,538570,521358,17212,3.2
11235,CN2919500000000,29,195,"Saline County, MO",Jun-19,10790,10401,389,3.6
11236,CN2919700000000,29,197,"Schuyler County, MO",Jun-19,1901,1807,94,4.9
11237,CN2919900000000,29,199,"Scotland County, MO",Jun-19,2354,2279,75,3.2
11238,CN2920100000000,29,201,"Scott County, MO",Jun-19,20055,19269,786,3.9
11239,CN2920300000000,29,203,"Shannon County, MO",Jun-19,3289,3110,179,5.4
11240,CN2920500000000,29,205,"Shelby County, MO",Jun-19,3066,2989,77,2.5
11241,CN2920700000000,29,207,"Stoddard County, MO",Jun-19,13039,12331,708,5.4
11242,CN2920900000000,29,209,"Stone County, MO",Jun-19,15013,14469,544,3.6
11243,CN2921100000000,29,211,"Sullivan County, MO",Jun-19,2642,2553,89,3.4
11244,CN2921300000000,29,213,"Taney County, MO",Jun-19,29426,28442,984,3.3
11245,CN2921500000000,29,215,"Texas County, MO",Jun-19,9043,8652,391,4.3
11246,CN2921700000000,29,217,"Vernon County, MO",Jun-19,9497,9135,362,3.8
11247,CN2921900000000,29,219,"Warren County, MO",Jun-19,18064,17552,512,2.8
11248,CN2922100000000,29,221,"Washington County, MO",Jun-19,10526,10048,478,4.5
11249,CN2922300000000,29,223,"Wayne County, MO",Jun-19,5420,5108,312,5.8
11250,CN2922500000000,29,225,"Webster County, MO",Jun-19,17158,16590,568,3.3
11251,CN2922700000000,29,227,"Worth County, MO",Jun-19,1194,1150,44,3.7
11252,CN2922900000000,29,229,"Wright County, MO",Jun-19,7378,7062,316,4.3
11253,CN2951000000000,29,510,"St. Louis city, MO",Jun-19,155046,148484,6562,4.2
11254,CN3000100000000,30,1,"Beaverhead County, MT",Jun-19,5062,4921,141,2.8
11255,CN3000300000000,30,3,"Big Horn County, MT",Jun-19,4748,4388,360,7.6
11256,CN3000500000000,30,5,"Blaine County, MT",Jun-19,2399,2318,81,3.4
11257,CN3000700000000,30,7,"Broadwater County, MT",Jun-19,2625,2518,107,4.1
11258,CN3000900000000,30,9,"Carbon County, MT",Jun-19,5460,5290,170,3.1
11259,CN3001100000000,30,11,"Carter County, MT",Jun-19,612,592,20,3.3
11260,CN3001300000000,30,13,"Cascade County, MT",Jun-19,38463,37170,1293,3.4
11261,CN3001500000000,30,15,"Chouteau County, MT",Jun-19,2461,2403,58,2.4
11262,CN3001700000000,30,17,"Custer County, MT",Jun-19,6019,5849,170,2.8
11263,CN3001900000000,30,19,"Daniels County, MT",Jun-19,867,844,23,2.7
11264,CN3002100000000,30,21,"Dawson County, MT",Jun-19,4536,4423,113,2.5
11265,CN3002300000000,30,23,"Deer Lodge County, MT",Jun-19,5115,4962,153,3.0
11266,CN3002500000000,30,25,"Fallon County, MT",Jun-19,1710,1686,24,1.4
11267,CN3002700000000,30,27,"Fergus County, MT",Jun-19,6227,6075,152,2.4
11268,CN3002900000000,30,29,"Flathead County, MT",Jun-19,49408,47352,2056,4.2
11269,CN3003100000000,30,31,"Gallatin County, MT",Jun-19,69420,67918,1502,2.2
11270,CN3003300000000,30,33,"Garfield County, MT",Jun-19,694,679,15,2.2
11271,CN3003500000000,30,35,"Glacier County, MT",Jun-19,6062,5603,459,7.6
11272,CN3003700000000,30,37,"Golden Valley County, MT",Jun-19,362,348,14,3.9
11273,CN3003900000000,30,39,"Granite County, MT",Jun-19,1708,1631,77,4.5
11274,CN3004100000000,30,41,"Hill County, MT",Jun-19,7679,7376,303,3.9
11275,CN3004300000000,30,43,"Jefferson County, MT",Jun-19,5717,5546,171,3.0
11276,CN3004500000000,30,45,"Judith Basin County, MT",Jun-19,885,861,24,2.7
11277,CN3004700000000,30,47,"Lake County, MT",Jun-19,13690,13147,543,4.0
11278,CN3004900000000,30,49,"Lewis and Clark County, MT",Jun-19,36200,35127,1073,3.0
11279,CN3005100000000,30,51,"Liberty County, MT",Jun-19,914,890,24,2.6
11280,CN3005300000000,30,53,"Lincoln County, MT",Jun-19,8264,7759,505,6.1
11281,CN3005500000000,30,55,"McCone County, MT",Jun-19,939,919,20,2.1
11282,CN3005700000000,30,57,"Madison County, MT",Jun-19,4470,4340,130,2.9
11283,CN3005900000000,30,59,"Meagher County, MT",Jun-19,896,868,28,3.1
11284,CN3006100000000,30,61,"Mineral County, MT",Jun-19,1836,1741,95,5.2
11285,CN3006300000000,30,63,"Missoula County, MT",Jun-19,64333,62426,1907,3.0
11286,CN3006500000000,30,65,"Musselshell County, MT",Jun-19,2275,2192,83,3.6
11287,CN3006700000000,30,67,"Park County, MT",Jun-19,9316,9040,276,3.0
11288,CN3006900000000,30,69,"Petroleum County, MT",Jun-19,270,262,8,3.0
11289,CN3007100000000,30,71,"Phillips County, MT",Jun-19,1854,1791,63,3.4
11290,CN3007300000000,30,73,"Pondera County, MT",Jun-19,2711,2604,107,3.9
11291,CN3007500000000,30,75,"Powder River County, MT",Jun-19,952,932,20,2.1
11292,CN3007700000000,30,77,"Powell County, MT",Jun-19,3044,2946,98,3.2
11293,CN3007900000000,30,79,"Prairie County, MT",Jun-19,458,440,18,3.9
11294,CN3008100000000,30,81,"Ravalli County, MT",Jun-19,20611,19836,775,3.8
11295,CN3008300000000,30,83,"Richland County, MT",Jun-19,5840,5676,164,2.8
11296,CN3008500000000,30,85,"Roosevelt County, MT",Jun-19,4610,4405,205,4.4
11297,CN3008700000000,30,87,"Rosebud County, MT",Jun-19,3818,3596,222,5.8
11298,CN3008900000000,30,89,"Sanders County, MT",Jun-19,4933,4671,262,5.3
11299,CN3009100000000,30,91,"Sheridan County, MT",Jun-19,1751,1714,37,2.1
11300,CN3009300000000,30,93,"Silver Bow County, MT",Jun-19,17455,16808,647,3.7
11301,CN3009500000000,30,95,"Stillwater County, MT",Jun-19,5055,4900,155,3.1
11302,CN3009700000000,30,97,"Sweet Grass County, MT",Jun-19,1825,1774,51,2.8
11303,CN3009900000000,30,99,"Teton County, MT",Jun-19,2776,2695,81,2.9
11304,CN3010100000000,30,101,"Toole County, MT",Jun-19,2129,2078,51,2.4
11305,CN3010300000000,30,103,"Treasure County, MT",Jun-19,323,314,9,2.8
11306,CN3010500000000,30,105,"Valley County, MT",Jun-19,4151,4032,119,2.9
11307,CN3010700000000,30,107,"Wheatland County, MT",Jun-19,755,727,28,3.7
11308,CN3010900000000,30,109,"Wibaux County, MT",Jun-19,467,453,14,3.0
11309,CN3011100000000,30,111,"Yellowstone County, MT",Jun-19,82501,79697,2804,3.4
11310,CN3100100000000,31,1,"Adams County, NE",Jun-19,17209,16611,598,3.5
11311,CN3100300000000,31,3,"Antelope County, NE",Jun-19,3744,3650,94,2.5
11312,CN3100500000000,31,5,"Arthur County, NE",Jun-19,239,227,12,5.0
11313,CN3100700000000,31,7,"Banner County, NE",Jun-19,380,365,15,3.9
11314,CN3100900000000,31,9,"Blaine County, NE",Jun-19,273,261,12,4.4
11315,CN3101100000000,31,11,"Boone County, NE",Jun-19,3093,3009,84,2.7
11316,CN3101300000000,31,13,"Box Butte County, NE",Jun-19,5522,5324,198,3.6
11317,CN3101500000000,31,15,"Boyd County, NE",Jun-19,1137,1101,36,3.2
11318,CN3101700000000,31,17,"Brown County, NE",Jun-19,1455,1393,62,4.3
11319,CN3101900000000,31,19,"Buffalo County, NE",Jun-19,27837,26975,862,3.1
11320,CN3102100000000,31,21,"Burt County, NE",Jun-19,3618,3497,121,3.3
11321,CN3102300000000,31,23,"Butler County, NE",Jun-19,4787,4650,137,2.9
11322,CN3102500000000,31,25,"Cass County, NE",Jun-19,13717,13220,497,3.6
11323,CN3102700000000,31,27,"Cedar County, NE",Jun-19,4798,4668,130,2.7
11324,CN3102900000000,31,29,"Chase County, NE",Jun-19,2386,2328,58,2.4
11325,CN3103100000000,31,31,"Cherry County, NE",Jun-19,3623,3526,97,2.7
11326,CN3103300000000,31,33,"Cheyenne County, NE",Jun-19,4569,4391,178,3.9
11327,CN3103500000000,31,35,"Clay County, NE",Jun-19,3440,3336,104,3.0
11328,CN3103700000000,31,37,"Colfax County, NE",Jun-19,5691,5517,174,3.1
11329,CN3103900000000,31,39,"Cuming County, NE",Jun-19,4876,4741,135,2.8
11330,CN3104100000000,31,41,"Custer County, NE",Jun-19,6714,6546,168,2.5
11331,CN3104300000000,31,43,"Dakota County, NE",Jun-19,10897,10446,451,4.1
11332,CN3104500000000,31,45,"Dawes County, NE",Jun-19,5146,4951,195,3.8
11333,CN3104700000000,31,47,"Dawson County, NE",Jun-19,13416,12995,421,3.1
11334,CN3104900000000,31,49,"Deuel County, NE",Jun-19,1021,990,31,3.0
11335,CN3105100000000,31,51,"Dixon County, NE",Jun-19,3105,3004,101,3.3
11336,CN3105300000000,31,53,"Dodge County, NE",Jun-19,19702,19058,644,3.3
11337,CN3105500000000,31,55,"Douglas County, NE",Jun-19,301528,291011,10517,3.5
11338,CN3105700000000,31,57,"Dundy County, NE",Jun-19,1237,1205,32,2.6
11339,CN3105900000000,31,59,"Fillmore County, NE",Jun-19,3309,3224,85,2.6
11340,CN3106100000000,31,61,"Franklin County, NE",Jun-19,1533,1483,50,3.3
11341,CN3106300000000,31,63,"Frontier County, NE",Jun-19,1645,1590,55,3.3
11342,CN3106500000000,31,65,"Furnas County, NE",Jun-19,2729,2645,84,3.1
11343,CN3106700000000,31,67,"Gage County, NE",Jun-19,11248,10872,376,3.3
11344,CN3106900000000,31,69,"Garden County, NE",Jun-19,1189,1160,29,2.4
11345,CN3107100000000,31,71,"Garfield County, NE",Jun-19,1245,1202,43,3.5
11346,CN3107300000000,31,73,"Gosper County, NE",Jun-19,1205,1169,36,3.0
11347,CN3107500000000,31,75,"Grant County, NE",Jun-19,439,427,12,2.7
11348,CN3107700000000,31,77,"Greeley County, NE",Jun-19,1313,1272,41,3.1
11349,CN3107900000000,31,79,"Hall County, NE",Jun-19,32319,31220,1099,3.4
11350,CN3108100000000,31,81,"Hamilton County, NE",Jun-19,4881,4729,152,3.1
11351,CN3108300000000,31,83,"Harlan County, NE",Jun-19,1909,1856,53,2.8
11352,CN3108500000000,31,85,"Hayes County, NE",Jun-19,637,623,14,2.2
11353,CN3108700000000,31,87,"Hitchcock County, NE",Jun-19,1312,1269,43,3.3
11354,CN3108900000000,31,89,"Holt County, NE",Jun-19,6056,5897,159,2.6
11355,CN3109100000000,31,91,"Hooker County, NE",Jun-19,481,467,14,2.9
11356,CN3109300000000,31,93,"Howard County, NE",Jun-19,3424,3315,109,3.2
11357,CN3109500000000,31,95,"Jefferson County, NE",Jun-19,4275,4147,128,3.0
11358,CN3109700000000,31,97,"Johnson County, NE",Jun-19,2097,2023,74,3.5
11359,CN3109900000000,31,99,"Kearney County, NE",Jun-19,3877,3778,99,2.6
11360,CN3110100000000,31,101,"Keith County, NE",Jun-19,4865,4727,138,2.8
11361,CN3110300000000,31,103,"Keya Paha County, NE",Jun-19,608,593,15,2.5
11362,CN3110500000000,31,105,"Kimball County, NE",Jun-19,2070,2002,68,3.3
11363,CN3110700000000,31,107,"Knox County, NE",Jun-19,4874,4732,142,2.9
11364,CN3110900000000,31,109,"Lancaster County, NE",Jun-19,175493,169936,5557,3.2
11365,CN3111100000000,31,111,"Lincoln County, NE",Jun-19,18636,17932,704,3.8
11366,CN3111300000000,31,113,"Logan County, NE",Jun-19,494,480,14,2.8
11367,CN3111500000000,31,115,"Loup County, NE",Jun-19,436,421,15,3.4
11368,CN3111700000000,31,117,"McPherson County, NE",Jun-19,448,431,17,3.8
11369,CN3111900000000,31,119,"Madison County, NE",Jun-19,20024,19390,634,3.2
11370,CN3112100000000,31,121,"Merrick County, NE",Jun-19,4097,3971,126,3.1
11371,CN3112300000000,31,123,"Morrill County, NE",Jun-19,2709,2637,72,2.7
11372,CN3112500000000,31,125,"Nance County, NE",Jun-19,2036,1983,53,2.6
11373,CN3112700000000,31,127,"Nemaha County, NE",Jun-19,3567,3396,171,4.8
11374,CN3112900000000,31,129,"Nuckolls County, NE",Jun-19,2511,2443,68,2.7
11375,CN3113100000000,31,131,"Otoe County, NE",Jun-19,8592,8262,330,3.8
11376,CN3113300000000,31,133,"Pawnee County, NE",Jun-19,1516,1463,53,3.5
11377,CN3113500000000,31,135,"Perkins County, NE",Jun-19,1900,1852,48,2.5
11378,CN3113700000000,31,137,"Phelps County, NE",Jun-19,5133,4983,150,2.9
11379,CN3113900000000,31,139,"Pierce County, NE",Jun-19,4252,4136,116,2.7
11380,CN3114100000000,31,141,"Platte County, NE",Jun-19,17992,17423,569,3.2
11381,CN3114300000000,31,143,"Polk County, NE",Jun-19,3068,2984,84,2.7
11382,CN3114500000000,31,145,"Red Willow County, NE",Jun-19,5993,5793,200,3.3
11383,CN3114700000000,31,147,"Richardson County, NE",Jun-19,4389,4230,159,3.6
11384,CN3114900000000,31,149,"Rock County, NE",Jun-19,912,886,26,2.9
11385,CN3115100000000,31,151,"Saline County, NE",Jun-19,7524,7257,267,3.5
11386,CN3115300000000,31,153,"Sarpy County, NE",Jun-19,97231,94142,3089,3.2
11387,CN3115500000000,31,155,"Saunders County, NE",Jun-19,11334,10989,345,3.0
11388,CN3115700000000,31,157,"Scotts Bluff County, NE",Jun-19,18592,17874,718,3.9
11389,CN3115900000000,31,159,"Seward County, NE",Jun-19,8991,8656,335,3.7
11390,CN3116100000000,31,161,"Sheridan County, NE",Jun-19,2791,2694,97,3.5
11391,CN3116300000000,31,163,"Sherman County, NE",Jun-19,1739,1684,55,3.2
11392,CN3116500000000,31,165,"Sioux County, NE",Jun-19,787,765,22,2.8
11393,CN3116700000000,31,167,"Stanton County, NE",Jun-19,3595,3496,99,2.8
11394,CN3116900000000,31,169,"Thayer County, NE",Jun-19,2879,2804,75,2.6
11395,CN3117100000000,31,171,"Thomas County, NE",Jun-19,437,423,14,3.2
11396,CN3117300000000,31,173,"Thurston County, NE",Jun-19,3097,2941,156,5.0
11397,CN3117500000000,31,175,"Valley County, NE",Jun-19,2221,2146,75,3.4
11398,CN3117700000000,31,177,"Washington County, NE",Jun-19,11397,11035,362,3.2
11399,CN3117900000000,31,179,"Wayne County, NE",Jun-19,5692,5490,202,3.5
11400,CN3118100000000,31,181,"Webster County, NE",Jun-19,1772,1698,74,4.2
11401,CN3118300000000,31,183,"Wheeler County, NE",Jun-19,626,609,17,2.7
11402,CN3118500000000,31,185,"York County, NE",Jun-19,7485,7254,231,3.1
11403,CN3200100000000,32,1,"Churchill County, NV",Jun-19,11087,10689,398,3.6
11404,CN3200300000000,32,3,"Clark County, NV",Jun-19,1130891,1081514,49377,4.4
11405,CN3200500000000,32,5,"Douglas County, NV",Jun-19,23627,22716,911,3.9
11406,CN3200700000000,32,7,"Elko County, NV",Jun-19,27769,26942,827,3.0
11407,CN3200900000000,32,9,"Esmeralda County, NV",Jun-19,393,378,15,3.8
11408,CN3201100000000,32,11,"Eureka County, NV",Jun-19,1056,1030,26,2.5
11409,CN3201300000000,32,13,"Humboldt County, NV",Jun-19,8241,7996,245,3.0
11410,CN3201500000000,32,15,"Lander County, NV",Jun-19,3214,3113,101,3.1
11411,CN3201700000000,32,17,"Lincoln County, NV",Jun-19,2097,2013,84,4.0
11412,CN3201900000000,32,19,"Lyon County, NV",Jun-19,23858,22763,1095,4.6
11413,CN3202100000000,32,21,"Mineral County, NV",Jun-19,2054,1969,85,4.1
11414,CN3202300000000,32,23,"Nye County, NV",Jun-19,17521,16626,895,5.1
11415,CN3202700000000,32,27,"Pershing County, NV",Jun-19,2553,2452,101,4.0
11416,CN3202900000000,32,29,"Storey County, NV",Jun-19,2039,1964,75,3.7
11417,CN3203100000000,32,31,"Washoe County, NV",Jun-19,255987,247685,8302,3.2
11418,CN3203300000000,32,33,"White Pine County, NV",Jun-19,4701,4550,151,3.2
11419,CN3251000000000,32,510,"Carson City, NV",Jun-19,26575,25517,1058,4.0
11420,CN3300100000000,33,1,"Belknap County, NH",Jun-19,32901,32114,787,2.4
11421,CN3300300000000,33,3,"Carroll County, NH",Jun-19,24900,24277,623,2.5
11422,CN3300500000000,33,5,"Cheshire County, NH",Jun-19,40455,39399,1056,2.6
11423,CN3300700000000,33,7,"Coos County, NH",Jun-19,15041,14606,435,2.9
11424,CN3300900000000,33,9,"Grafton County, NH",Jun-19,49648,48543,1105,2.2
11425,CN3301100000000,33,11,"Hillsborough County, NH",Jun-19,244122,237812,6310,2.6
11426,CN3301300000000,33,13,"Merrimack County, NH",Jun-19,84162,82283,1879,2.2
11427,CN3301500000000,33,15,"Rockingham County, NH",Jun-19,191875,186869,5006,2.6
11428,CN3301700000000,33,17,"Strafford County, NH",Jun-19,74659,72951,1708,2.3
11429,CN3301900000000,33,19,"Sullivan County, NH",Jun-19,23312,22780,532,2.3
11430,CN3400100000000,34,1,"Atlantic County, NJ",Jun-19,122278,116865,5413,4.4
11431,CN3400300000000,34,3,"Bergen County, NJ",Jun-19,480430,467228,13202,2.7
11432,CN3400500000000,34,5,"Burlington County, NJ",Jun-19,230268,223370,6898,3.0
11433,CN3400700000000,34,7,"Camden County, NJ",Jun-19,252607,243096,9511,3.8
11434,CN3400900000000,34,9,"Cape May County, NJ",Jun-19,53261,51001,2260,4.2
11435,CN3401100000000,34,11,"Cumberland County, NJ",Jun-19,65373,62255,3118,4.8
11436,CN3401300000000,34,13,"Essex County, NJ",Jun-19,369369,353665,15704,4.3
11437,CN3401500000000,34,15,"Gloucester County, NJ",Jun-19,149552,144444,5108,3.4
11438,CN3401700000000,34,17,"Hudson County, NJ",Jun-19,360305,348959,11346,3.1
11439,CN3401900000000,34,19,"Hunterdon County, NJ",Jun-19,64637,63025,1612,2.5
11440,CN3402100000000,34,21,"Mercer County, NJ",Jun-19,203279,197221,6058,3.0
11441,CN3402300000000,34,23,"Middlesex County, NJ",Jun-19,443802,431040,12762,2.9
11442,CN3402500000000,34,25,"Monmouth County, NJ",Jun-19,331536,321981,9555,2.9
11443,CN3402700000000,34,27,"Morris County, NJ",Jun-19,257095,250416,6679,2.6
11444,CN3402900000000,34,29,"Ocean County, NJ",Jun-19,276901,267923,8978,3.2
11445,CN3403100000000,34,31,"Passaic County, NJ",Jun-19,241053,231574,9479,3.9
11446,CN3403300000000,34,33,"Salem County, NJ",Jun-19,28929,27641,1288,4.5
11447,CN3403500000000,34,35,"Somerset County, NJ",Jun-19,171791,166935,4856,2.8
11448,CN3403700000000,34,37,"Sussex County, NJ",Jun-19,73952,71713,2239,3.0
11449,CN3403900000000,34,39,"Union County, NJ",Jun-19,276658,267312,9346,3.4
11450,CN3404100000000,34,41,"Warren County, NJ",Jun-19,55732,54026,1706,3.1
11451,CN3500100000000,35,1,"Bernalillo County, NM",Jun-19,334800,317741,17059,5.1
11452,CN3500300000000,35,3,"Catron County, NM",Jun-19,1192,1119,73,6.1
11453,CN3500500000000,35,5,"Chaves County, NM",Jun-19,27155,25589,1566,5.8
11454,CN3500600000000,35,6,"Cibola County, NM",Jun-19,9085,8435,650,7.2
11455,CN3500700000000,35,7,"Colfax County, NM",Jun-19,6291,5997,294,4.7
11456,CN3500900000000,35,9,"Curry County, NM",Jun-19,21463,20431,1032,4.8
11457,CN3501100000000,35,11,"De Baca County, NM",Jun-19,809,767,42,5.2
11458,CN3501300000000,35,13,"Dona Ana County, NM",Jun-19,96906,90689,6217,6.4
11459,CN3501500000000,35,15,"Eddy County, NM",Jun-19,34206,33001,1205,3.5
11460,CN3501700000000,35,17,"Grant County, NM",Jun-19,12121,11472,649,5.4
11461,CN3501900000000,35,19,"Guadalupe County, NM",Jun-19,1616,1518,98,6.1
11462,CN3502100000000,35,21,"Harding County, NM",Jun-19,278,263,15,5.4
11463,CN3502300000000,35,23,"Hidalgo County, NM",Jun-19,2160,2064,96,4.4
11464,CN3502500000000,35,25,"Lea County, NM",Jun-19,30990,29548,1442,4.7
11465,CN3502700000000,35,27,"Lincoln County, NM",Jun-19,9378,8924,454,4.8
11466,CN3502800000000,35,28,"Los Alamos County, NM",Jun-19,9620,9269,351,3.6
11467,CN3502900000000,35,29,"Luna County, NM",Jun-19,10691,9550,1141,10.7
11468,CN3503100000000,35,31,"McKinley County, NM",Jun-19,24154,22142,2012,8.3
11469,CN3503300000000,35,33,"Mora County, NM",Jun-19,2287,2151,136,5.9
11470,CN3503500000000,35,35,"Otero County, NM",Jun-19,24961,23536,1425,5.7
11471,CN3503700000000,35,37,"Quay County, NM",Jun-19,3258,3059,199,6.1
11472,CN3503900000000,35,39,"Rio Arriba County, NM",Jun-19,17119,16144,975,5.7
11473,CN3504100000000,35,41,"Roosevelt County, NM",Jun-19,7716,7284,432,5.6
11474,CN3504300000000,35,43,"Sandoval County, NM",Jun-19,66906,63150,3756,5.6
11475,CN3504500000000,35,45,"San Juan County, NM",Jun-19,52329,48999,3330,6.4
11476,CN3504700000000,35,47,"San Miguel County, NM",Jun-19,10726,10019,707,6.6
11477,CN3504900000000,35,49,"Santa Fe County, NM",Jun-19,75847,72434,3413,4.5
11478,CN3505100000000,35,51,"Sierra County, NM",Jun-19,3974,3702,272,6.8
11479,CN3505300000000,35,53,"Socorro County, NM",Jun-19,6517,6064,453,7.0
11480,CN3505500000000,35,55,"Taos County, NM",Jun-19,15189,14194,995,6.6
11481,CN3505700000000,35,57,"Torrance County, NM",Jun-19,5662,5247,415,7.3
11482,CN3505900000000,35,59,"Union County, NM",Jun-19,1880,1811,69,3.7
11483,CN3506100000000,35,61,"Valencia County, NM",Jun-19,30926,29005,1921,6.2
11484,CN3600100000000,36,1,"Albany County, NY",Jun-19,158236,152554,5682,3.6
11485,CN3600300000000,36,3,"Allegany County, NY",Jun-19,18809,17868,941,5.0
11486,CN3600500000000,36,5,"Bronx County, NY",Jun-19,594675,563955,30720,5.2
11487,CN3600700000000,36,7,"Broome County, NY",Jun-19,84333,80533,3800,4.5
11488,CN3600900000000,36,9,"Cattaraugus County, NY",Jun-19,33390,31877,1513,4.5
11489,CN3601100000000,36,11,"Cayuga County, NY",Jun-19,36166,34762,1404,3.9
11490,CN3601300000000,36,13,"Chautauqua County, NY",Jun-19,54622,52255,2367,4.3
11491,CN3601500000000,36,15,"Chemung County, NY",Jun-19,35272,33816,1456,4.1
11492,CN3601700000000,36,17,"Chenango County, NY",Jun-19,22230,21346,884,4.0
11493,CN3601900000000,36,19,"Clinton County, NY",Jun-19,36204,34692,1512,4.2
11494,CN3602100000000,36,21,"Columbia County, NY",Jun-19,31555,30583,972,3.1
11495,CN3602300000000,36,23,"Cortland County, NY",Jun-19,22218,21219,999,4.5
11496,CN3602500000000,36,25,"Delaware County, NY",Jun-19,19222,18363,859,4.5
11497,CN3602700000000,36,27,"Dutchess County, NY",Jun-19,144524,139370,5154,3.6
11498,CN3602900000000,36,29,"Erie County, NY",Jun-19,442850,425191,17659,4.0
11499,CN3603100000000,36,31,"Essex County, NY",Jun-19,17201,16505,696,4.0
11500,CN3603300000000,36,33,"Franklin County, NY",Jun-19,19601,18747,854,4.4
11501,CN3603500000000,36,35,"Fulton County, NY",Jun-19,22940,21910,1030,4.5
11502,CN3603700000000,36,37,"Genesee County, NY",Jun-19,30246,29236,1010,3.3
11503,CN3603900000000,36,39,"Greene County, NY",Jun-19,20438,19603,835,4.1
11504,CN3604100000000,36,41,"Hamilton County, NY",Jun-19,2333,2246,87,3.7
11505,CN3604300000000,36,43,"Herkimer County, NY",Jun-19,28322,26766,1556,5.5
11506,CN3604500000000,36,45,"Jefferson County, NY",Jun-19,44858,42816,2042,4.6
11507,CN3604700000000,36,47,"Kings County, NY",Jun-19,1194038,1145881,48157,4.0
11508,CN3604900000000,36,49,"Lewis County, NY",Jun-19,11877,11368,509,4.3
11509,CN3605100000000,36,51,"Livingston County, NY",Jun-19,30749,29550,1199,3.9
11510,CN3605300000000,36,53,"Madison County, NY",Jun-19,32772,31436,1336,4.1
11511,CN3605500000000,36,55,"Monroe County, NY",Jun-19,362903,348433,14470,4.0
11512,CN3605700000000,36,57,"Montgomery County, NY",Jun-19,22470,21480,990,4.4
11513,CN3605900000000,36,59,"Nassau County, NY",Jun-19,717695,693683,24012,3.3
11514,CN3606100000000,36,61,"New York County, NY",Jun-19,908891,876886,32005,3.5
11515,CN3606300000000,36,63,"Niagara County, NY",Jun-19,98760,94450,4310,4.4
11516,CN3606500000000,36,65,"Oneida County, NY",Jun-19,101823,97681,4142,4.1
11517,CN3606700000000,36,67,"Onondaga County, NY",Jun-19,221445,213175,8270,3.7
11518,CN3606900000000,36,69,"Ontario County, NY",Jun-19,55510,53492,2018,3.6
11519,CN3607100000000,36,71,"Orange County, NY",Jun-19,186740,179869,6871,3.7
11520,CN3607300000000,36,73,"Orleans County, NY",Jun-19,17550,16806,744,4.2
11521,CN3607500000000,36,75,"Oswego County, NY",Jun-19,53034,50363,2671,5.0
11522,CN3607700000000,36,77,"Otsego County, NY",Jun-19,28435,27335,1100,3.9
11523,CN3607900000000,36,79,"Putnam County, NY",Jun-19,51363,49540,1823,3.5
11524,CN3608100000000,36,81,"Queens County, NY",Jun-19,1135700,1096611,39089,3.4
11525,CN3608300000000,36,83,"Rensselaer County, NY",Jun-19,81388,78448,2940,3.6
11526,CN3608500000000,36,85,"Richmond County, NY",Jun-19,221573,213173,8400,3.8
11527,CN3608700000000,36,87,"Rockland County, NY",Jun-19,156705,151301,5404,3.4
11528,CN3608900000000,36,89,"St. Lawrence County, NY",Jun-19,42674,40424,2250,5.3
11529,CN3609100000000,36,91,"Saratoga County, NY",Jun-19,119284,115486,3798,3.2
11530,CN3609300000000,36,93,"Schenectady County, NY",Jun-19,76346,73511,2835,3.7
11531,CN3609500000000,36,95,"Schoharie County, NY",Jun-19,14590,13999,591,4.1
11532,CN3609700000000,36,97,"Schuyler County, NY",Jun-19,8195,7883,312,3.8
11533,CN3609900000000,36,99,"Seneca County, NY",Jun-19,16148,15581,567,3.5
11534,CN3610100000000,36,101,"Steuben County, NY",Jun-19,42860,41124,1736,4.1
11535,CN3610300000000,36,103,"Suffolk County, NY",Jun-19,787206,760302,26904,3.4
11536,CN3610500000000,36,105,"Sullivan County, NY",Jun-19,37185,35844,1341,3.6
11537,CN3610700000000,36,107,"Tioga County, NY",Jun-19,22932,22027,905,3.9
11538,CN3610900000000,36,109,"Tompkins County, NY",Jun-19,47722,45911,1811,3.8
11539,CN3611100000000,36,111,"Ulster County, NY",Jun-19,88443,85206,3237,3.7
11540,CN3611300000000,36,113,"Warren County, NY",Jun-19,32284,31079,1205,3.7
11541,CN3611500000000,36,115,"Washington County, NY",Jun-19,28681,27689,992,3.5
11542,CN3611700000000,36,117,"Wayne County, NY",Jun-19,43857,42268,1589,3.6
11543,CN3611900000000,36,119,"Westchester County, NY",Jun-19,488845,471000,17845,3.7
11544,CN3612100000000,36,121,"Wyoming County, NY",Jun-19,18251,17617,634,3.5
11545,CN3612300000000,36,123,"Yates County, NY",Jun-19,11805,11416,389,3.3
11546,CN3700100000000,37,1,"Alamance County, NC",Jun-19,82450,78976,3474,4.2
11547,CN3700300000000,37,3,"Alexander County, NC",Jun-19,18223,17557,666,3.7
11548,CN3700500000000,37,5,"Alleghany County, NC",Jun-19,4462,4238,224,5.0
11549,CN3700700000000,37,7,"Anson County, NC",Jun-19,10753,10286,467,4.3
11550,CN3700900000000,37,9,"Ashe County, NC",Jun-19,12727,12215,512,4.0
11551,CN3701100000000,37,11,"Avery County, NC",Jun-19,7737,7433,304,3.9
11552,CN3701300000000,37,13,"Beaufort County, NC",Jun-19,19617,18634,983,5.0
11553,CN3701500000000,37,15,"Bertie County, NC",Jun-19,7664,7260,404,5.3
11554,CN3701700000000,37,17,"Bladen County, NC",Jun-19,14501,13765,736,5.1
11555,CN3701900000000,37,19,"Brunswick County, NC",Jun-19,56911,53943,2968,5.2
11556,CN3702100000000,37,21,"Buncombe County, NC",Jun-19,142644,138002,4642,3.3
11557,CN3702300000000,37,23,"Burke County, NC",Jun-19,41542,39858,1684,4.1
11558,CN3702500000000,37,25,"Cabarrus County, NC",Jun-19,110419,106249,4170,3.8
11559,CN3702700000000,37,27,"Caldwell County, NC",Jun-19,37091,35452,1639,4.4
11560,CN3702900000000,37,29,"Camden County, NC",Jun-19,4641,4444,197,4.2
11561,CN3703100000000,37,31,"Carteret County, NC",Jun-19,33554,32124,1430,4.3
11562,CN3703300000000,37,33,"Caswell County, NC",Jun-19,9861,9380,481,4.9
11563,CN3703500000000,37,35,"Catawba County, NC",Jun-19,80005,76894,3111,3.9
11564,CN3703700000000,37,37,"Chatham County, NC",Jun-19,35736,34381,1355,3.8
11565,CN3703900000000,37,39,"Cherokee County, NC",Jun-19,11279,10736,543,4.8
11566,CN3704100000000,37,41,"Chowan County, NC",Jun-19,5584,5295,289,5.2
11567,CN3704300000000,37,43,"Clay County, NC",Jun-19,4179,3968,211,5.0
11568,CN3704500000000,37,45,"Cleveland County, NC",Jun-19,48652,46564,2088,4.3
11569,CN3704700000000,37,47,"Columbus County, NC",Jun-19,22841,21655,1186,5.2
11570,CN3704900000000,37,49,"Craven County, NC",Jun-19,42775,40890,1885,4.4
11571,CN3705100000000,37,51,"Cumberland County, NC",Jun-19,129667,122649,7018,5.4
11572,CN3705300000000,37,53,"Currituck County, NC",Jun-19,14286,13758,528,3.7
11573,CN3705500000000,37,55,"Dare County, NC",Jun-19,22934,22071,863,3.8
11574,CN3705700000000,37,57,"Davidson County, NC",Jun-19,81962,78721,3241,4.0
11575,CN3705900000000,37,59,"Davie County, NC",Jun-19,20909,20131,778,3.7
11576,CN3706100000000,37,61,"Duplin County, NC",Jun-19,25030,23911,1119,4.5
11577,CN3706300000000,37,63,"Durham County, NC",Jun-19,171559,165113,6446,3.8
11578,CN3706500000000,37,65,"Edgecombe County, NC",Jun-19,21178,19832,1346,6.4
11579,CN3706700000000,37,67,"Forsyth County, NC",Jun-19,190530,182735,7795,4.1
11580,CN3706900000000,37,69,"Franklin County, NC",Jun-19,31625,30246,1379,4.4
11581,CN3707100000000,37,71,"Gaston County, NC",Jun-19,112581,107932,4649,4.1
11582,CN3707300000000,37,73,"Gates County, NC",Jun-19,5419,5180,239,4.4
11583,CN3707500000000,37,75,"Graham County, NC",Jun-19,3359,3173,186,5.5
11584,CN3707700000000,37,77,"Granville County, NC",Jun-19,30134,29027,1107,3.7
11585,CN3707900000000,37,79,"Greene County, NC",Jun-19,9443,9027,416,4.4
11586,CN3708100000000,37,81,"Guilford County, NC",Jun-19,264926,253072,11854,4.5
11587,CN3708300000000,37,83,"Halifax County, NC",Jun-19,20630,19410,1220,5.9
11588,CN3708500000000,37,85,"Harnett County, NC",Jun-19,53836,51115,2721,5.1
11589,CN3708700000000,37,87,"Haywood County, NC",Jun-19,30424,29299,1125,3.7
11590,CN3708900000000,37,89,"Henderson County, NC",Jun-19,55947,53898,2049,3.7
11591,CN3709100000000,37,91,"Hertford County, NC",Jun-19,9183,8647,536,5.8
11592,CN3709300000000,37,93,"Hoke County, NC",Jun-19,20409,19330,1079,5.3
11593,CN3709500000000,37,95,"Hyde County, NC",Jun-19,2193,2059,134,6.1
11594,CN3709700000000,37,97,"Iredell County, NC",Jun-19,90623,87149,3474,3.8
11595,CN3709900000000,37,99,"Jackson County, NC",Jun-19,19916,19003,913,4.6
11596,CN3710100000000,37,101,"Johnston County, NC",Jun-19,100022,96049,3973,4.0
11597,CN3710300000000,37,103,"Jones County, NC",Jun-19,4448,4263,185,4.2
11598,CN3710500000000,37,105,"Lee County, NC",Jun-19,26155,24876,1279,4.9
11599,CN3710700000000,37,107,"Lenoir County, NC",Jun-19,28181,27029,1152,4.1
11600,CN3710900000000,37,109,"Lincoln County, NC",Jun-19,44045,42373,1672,3.8
11601,CN3711100000000,37,111,"McDowell County, NC",Jun-19,20938,20103,835,4.0
11602,CN3711300000000,37,113,"Macon County, NC",Jun-19,16028,15371,657,4.1
11603,CN3711500000000,37,115,"Madison County, NC",Jun-19,10333,9917,416,4.0
11604,CN3711700000000,37,117,"Martin County, NC",Jun-19,8857,8352,505,5.7
11605,CN3711900000000,37,119,"Mecklenburg County, NC",Jun-19,630348,605842,24506,3.9
11606,CN3712100000000,37,121,"Mitchell County, NC",Jun-19,6026,5723,303,5.0
11607,CN3712300000000,37,123,"Montgomery County, NC",Jun-19,11784,11276,508,4.3
11608,CN3712500000000,37,125,"Moore County, NC",Jun-19,43357,41561,1796,4.1
11609,CN3712700000000,37,127,"Nash County, NC",Jun-19,43155,40861,2294,5.3
11610,CN3712900000000,37,129,"New Hanover County, NC",Jun-19,126056,121222,4834,3.8
11611,CN3713100000000,37,131,"Northampton County, NC",Jun-19,7828,7398,430,5.5
11612,CN3713300000000,37,133,"Onslow County, NC",Jun-19,65496,62245,3251,5.0
11613,CN3713500000000,37,135,"Orange County, NC",Jun-19,79133,76191,2942,3.7
11614,CN3713700000000,37,137,"Pamlico County, NC",Jun-19,5451,5226,225,4.1
11615,CN3713900000000,37,139,"Pasquotank County, NC",Jun-19,16764,15947,817,4.9
11616,CN3714100000000,37,141,"Pender County, NC",Jun-19,29261,28038,1223,4.2
11617,CN3714300000000,37,143,"Perquimans County, NC",Jun-19,4960,4691,269,5.4
11618,CN3714500000000,37,145,"Person County, NC",Jun-19,18468,17611,857,4.6
11619,CN3714700000000,37,147,"Pitt County, NC",Jun-19,89437,85042,4395,4.9
11620,CN3714900000000,37,149,"Polk County, NC",Jun-19,9273,8890,383,4.1
11621,CN3715100000000,37,151,"Randolph County, NC",Jun-19,66748,63991,2757,4.1
11622,CN3715300000000,37,153,"Richmond County, NC",Jun-19,16645,15728,917,5.5
11623,CN3715500000000,37,155,"Robeson County, NC",Jun-19,50561,47647,2914,5.8
11624,CN3715700000000,37,157,"Rockingham County, NC",Jun-19,40433,38533,1900,4.7
11625,CN3715900000000,37,159,"Rowan County, NC",Jun-19,67033,64205,2828,4.2
11626,CN3716100000000,37,161,"Rutherford County, NC",Jun-19,25425,24099,1326,5.2
11627,CN3716300000000,37,163,"Sampson County, NC",Jun-19,28901,27650,1251,4.3
11628,CN3716500000000,37,165,"Scotland County, NC",Jun-19,11479,10693,786,6.8
11629,CN3716700000000,37,167,"Stanly County, NC",Jun-19,30627,29418,1209,3.9
11630,CN3716900000000,37,169,"Stokes County, NC",Jun-19,21993,21139,854,3.9
11631,CN3717100000000,37,171,"Surry County, NC",Jun-19,34237,32908,1329,3.9
11632,CN3717300000000,37,173,"Swain County, NC",Jun-19,7306,7016,290,4.0
11633,CN3717500000000,37,175,"Transylvania County, NC",Jun-19,15252,14645,607,4.0
11634,CN3717700000000,37,177,"Tyrrell County, NC",Jun-19,1651,1566,85,5.1
11635,CN3717900000000,37,179,"Union County, NC",Jun-19,125444,120746,4698,3.7
11636,CN3718100000000,37,181,"Vance County, NC",Jun-19,17705,16615,1090,6.2
11637,CN3718300000000,37,183,"Wake County, NC",Jun-19,602050,580091,21959,3.6
11638,CN3718500000000,37,185,"Warren County, NC",Jun-19,6749,6330,419,6.2
11639,CN3718700000000,37,187,"Washington County, NC",Jun-19,4557,4284,273,6.0
11640,CN3718900000000,37,189,"Watauga County, NC",Jun-19,29364,28194,1170,4.0
11641,CN3719100000000,37,191,"Wayne County, NC",Jun-19,52481,50137,2344,4.5
11642,CN3719300000000,37,193,"Wilkes County, NC",Jun-19,29189,27871,1318,4.5
11643,CN3719500000000,37,195,"Wilson County, NC",Jun-19,34953,32718,2235,6.4
11644,CN3719700000000,37,197,"Yadkin County, NC",Jun-19,17921,17247,674,3.8
11645,CN3719900000000,37,199,"Yancey County, NC",Jun-19,8455,8106,349,4.1
11646,CN3800100000000,38,1,"Adams County, ND",Jun-19,1078,1056,22,2.0
11647,CN3800300000000,38,3,"Barnes County, ND",Jun-19,5287,5047,240,4.5
11648,CN3800500000000,38,5,"Benson County, ND",Jun-19,2218,2111,107,4.8
11649,CN3800700000000,38,7,"Billings County, ND",Jun-19,554,544,10,1.8
11650,CN3800900000000,38,9,"Bottineau County, ND",Jun-19,3100,2994,106,3.4
11651,CN3801100000000,38,11,"Bowman County, ND",Jun-19,1807,1779,28,1.5
11652,CN3801300000000,38,13,"Burke County, ND",Jun-19,1069,1042,27,2.5
11653,CN3801500000000,38,15,"Burleigh County, ND",Jun-19,50180,48920,1260,2.5
11654,CN3801700000000,38,17,"Cass County, ND",Jun-19,103211,100966,2245,2.2
11655,CN3801900000000,38,19,"Cavalier County, ND",Jun-19,1947,1890,57,2.9
11656,CN3802100000000,38,21,"Dickey County, ND",Jun-19,2389,2338,51,2.1
11657,CN3802300000000,38,23,"Divide County, ND",Jun-19,1486,1465,21,1.4
11658,CN3802500000000,38,25,"Dunn County, ND",Jun-19,3336,3278,58,1.7
11659,CN3802700000000,38,27,"Eddy County, ND",Jun-19,1319,1259,60,4.5
11660,CN3802900000000,38,29,"Emmons County, ND",Jun-19,1473,1419,54,3.7
11661,CN3803100000000,38,31,"Foster County, ND",Jun-19,1553,1507,46,3.0
11662,CN3803300000000,38,33,"Golden Valley County, ND",Jun-19,877,861,16,1.8
11663,CN3803500000000,38,35,"Grand Forks County, ND",Jun-19,37500,36545,955,2.5
11664,CN3803700000000,38,37,"Grant County, ND",Jun-19,1203,1178,25,2.1
11665,CN3803900000000,38,39,"Griggs County, ND",Jun-19,1039,1008,31,3.0
11666,CN3804100000000,38,41,"Hettinger County, ND",Jun-19,1414,1387,27,1.9
11667,CN3804300000000,38,43,"Kidder County, ND",Jun-19,1318,1266,52,3.9
11668,CN3804500000000,38,45,"LaMoure County, ND",Jun-19,2095,2046,49,2.3
11669,CN3804700000000,38,47,"Logan County, ND",Jun-19,863,841,22,2.5
11670,CN3804900000000,38,49,"McHenry County, ND",Jun-19,3096,2993,103,3.3
11671,CN3805100000000,38,51,"McIntosh County, ND",Jun-19,1164,1125,39,3.4
11672,CN3805300000000,38,53,"McKenzie County, ND",Jun-19,10651,10468,183,1.7
11673,CN3805500000000,38,55,"McLean County, ND",Jun-19,4921,4762,159,3.2
11674,CN3805700000000,38,57,"Mercer County, ND",Jun-19,3789,3633,156,4.1
11675,CN3805900000000,38,59,"Morton County, ND",Jun-19,16509,16014,495,3.0
11676,CN3806100000000,38,61,"Mountrail County, ND",Jun-19,7484,7368,116,1.5
11677,CN3806300000000,38,63,"Nelson County, ND",Jun-19,1437,1386,51,3.5
11678,CN3806500000000,38,65,"Oliver County, ND",Jun-19,884,848,36,4.1
11679,CN3806700000000,38,67,"Pembina County, ND",Jun-19,3423,3265,158,4.6
11680,CN3806900000000,38,69,"Pierce County, ND",Jun-19,1783,1719,64,3.6
11681,CN3807100000000,38,71,"Ramsey County, ND",Jun-19,5699,5522,177,3.1
11682,CN3807300000000,38,73,"Ransom County, ND",Jun-19,2873,2818,55,1.9
11683,CN3807500000000,38,75,"Renville County, ND",Jun-19,1188,1157,31,2.6
11684,CN3807700000000,38,77,"Richland County, ND",Jun-19,8761,8524,237,2.7
11685,CN3807900000000,38,79,"Rolette County, ND",Jun-19,4868,4267,601,12.3
11686,CN3808100000000,38,81,"Sargent County, ND",Jun-19,2747,2692,55,2.0
11687,CN3808300000000,38,83,"Sheridan County, ND",Jun-19,701,679,22,3.1
11688,CN3808500000000,38,85,"Sioux County, ND",Jun-19,1270,1210,60,4.7
11689,CN3808700000000,38,87,"Slope County, ND",Jun-19,406,396,10,2.5
11690,CN3808900000000,38,89,"Stark County, ND",Jun-19,19123,18697,426,2.2
11691,CN3809100000000,38,91,"Steele County, ND",Jun-19,999,971,28,2.8
11692,CN3809300000000,38,93,"Stutsman County, ND",Jun-19,10412,10144,268,2.6
11693,CN3809500000000,38,95,"Towner County, ND",Jun-19,1195,1158,37,3.1
11694,CN3809700000000,38,97,"Traill County, ND",Jun-19,4415,4250,165,3.7
11695,CN3809900000000,38,99,"Walsh County, ND",Jun-19,5416,5193,223,4.1
11696,CN3810100000000,38,101,"Ward County, ND",Jun-19,32216,31392,824,2.6
11697,CN3810300000000,38,103,"Wells County, ND",Jun-19,1944,1887,57,2.9
11698,CN3810500000000,38,105,"Williams County, ND",Jun-19,24984,24481,503,2.0
11699,CN3900100000000,39,1,"Adams County, OH",Jun-19,10810,10102,708,6.5
11700,CN3900300000000,39,3,"Allen County, OH",Jun-19,48341,46275,2066,4.3
11701,CN3900500000000,39,5,"Ashland County, OH",Jun-19,26963,25861,1102,4.1
11702,CN3900700000000,39,7,"Ashtabula County, OH",Jun-19,45020,42922,2098,4.7
11703,CN3900900000000,39,9,"Athens County, OH",Jun-19,25121,23493,1628,6.5
11704,CN3901100000000,39,11,"Auglaize County, OH",Jun-19,25278,24466,812,3.2
11705,CN3901300000000,39,13,"Belmont County, OH",Jun-19,30443,28906,1537,5.0
11706,CN3901500000000,39,15,"Brown County, OH",Jun-19,19746,18763,983,5.0
11707,CN3901700000000,39,17,"Butler County, OH",Jun-19,197696,189347,8349,4.2
11708,CN3901900000000,39,19,"Carroll County, OH",Jun-19,12972,12364,608,4.7
11709,CN3902100000000,39,21,"Champaign County, OH",Jun-19,20131,19373,758,3.8
11710,CN3902300000000,39,23,"Clark County, OH",Jun-19,63496,60702,2794,4.4
11711,CN3902500000000,39,25,"Clermont County, OH",Jun-19,108143,103738,4405,4.1
11712,CN3902700000000,39,27,"Clinton County, OH",Jun-19,17710,16836,874,4.9
11713,CN3902900000000,39,29,"Columbiana County, OH",Jun-19,47719,45340,2379,5.0
11714,CN3903100000000,39,31,"Coshocton County, OH",Jun-19,14545,13685,860,5.9
11715,CN3903300000000,39,33,"Crawford County, OH",Jun-19,18509,17622,887,4.8
11716,CN3903500000000,39,35,"Cuyahoga County, OH",Jun-19,620557,591254,29303,4.7
11717,CN3903700000000,39,37,"Darke County, OH",Jun-19,26138,25166,972,3.7
11718,CN3903900000000,39,39,"Defiance County, OH",Jun-19,18158,17344,814,4.5
11719,CN3904100000000,39,41,"Delaware County, OH",Jun-19,110875,107035,3840,3.5
11720,CN3904300000000,39,43,"Erie County, OH",Jun-19,39383,37733,1650,4.2
11721,CN3904500000000,39,45,"Fairfield County, OH",Jun-19,78250,75164,3086,3.9
11722,CN3904700000000,39,47,"Fayette County, OH",Jun-19,13903,13325,578,4.2
11723,CN3904900000000,39,49,"Franklin County, OH",Jun-19,700851,674059,26792,3.8
11724,CN3905100000000,39,51,"Fulton County, OH",Jun-19,22436,21541,895,4.0
11725,CN3905300000000,39,53,"Gallia County, OH",Jun-19,11952,11302,650,5.4
11726,CN3905500000000,39,55,"Geauga County, OH",Jun-19,49652,47731,1921,3.9
11727,CN3905700000000,39,57,"Greene County, OH",Jun-19,83714,80258,3456,4.1
11728,CN3905900000000,39,59,"Guernsey County, OH",Jun-19,18797,17853,944,5.0
11729,CN3906100000000,39,61,"Hamilton County, OH",Jun-19,421382,403937,17445,4.1
11730,CN3906300000000,39,63,"Hancock County, OH",Jun-19,42158,40710,1448,3.4
11731,CN3906500000000,39,65,"Hardin County, OH",Jun-19,13611,12954,657,4.8
11732,CN3906700000000,39,67,"Harrison County, OH",Jun-19,6905,6562,343,5.0
11733,CN3906900000000,39,69,"Henry County, OH",Jun-19,13302,12737,565,4.2
11734,CN3907100000000,39,71,"Highland County, OH",Jun-19,16972,16070,902,5.3
11735,CN3907300000000,39,73,"Hocking County, OH",Jun-19,13068,12504,564,4.3
11736,CN3907500000000,39,75,"Holmes County, OH",Jun-19,21070,20378,692,3.3
11737,CN3907700000000,39,77,"Huron County, OH",Jun-19,28419,27031,1388,4.9
11738,CN3907900000000,39,79,"Jackson County, OH",Jun-19,12672,11904,768,6.1
11739,CN3908100000000,39,81,"Jefferson County, OH",Jun-19,27922,26277,1645,5.9
11740,CN3908300000000,39,83,"Knox County, OH",Jun-19,31419,30082,1337,4.3
11741,CN3908500000000,39,85,"Lake County, OH",Jun-19,127788,122485,5303,4.1
11742,CN3908700000000,39,87,"Lawrence County, OH",Jun-19,23827,22519,1308,5.5
11743,CN3908900000000,39,89,"Licking County, OH",Jun-19,90849,87234,3615,4.0
11744,CN3909100000000,39,91,"Logan County, OH",Jun-19,22998,22147,851,3.7
11745,CN3909300000000,39,93,"Lorain County, OH",Jun-19,155363,148071,7292,4.7
11746,CN3909500000000,39,95,"Lucas County, OH",Jun-19,210712,201037,9675,4.6
11747,CN3909700000000,39,97,"Madison County, OH",Jun-19,20814,20064,750,3.6
11748,CN3909900000000,39,99,"Mahoning County, OH",Jun-19,104106,98004,6102,5.9
11749,CN3910100000000,39,101,"Marion County, OH",Jun-19,28596,27363,1233,4.3
11750,CN3910300000000,39,103,"Medina County, OH",Jun-19,98656,94826,3830,3.9
11751,CN3910500000000,39,105,"Meigs County, OH",Jun-19,8888,8280,608,6.8
11752,CN3910700000000,39,107,"Mercer County, OH",Jun-19,23939,23266,673,2.8
11753,CN3910900000000,39,109,"Miami County, OH",Jun-19,54270,52193,2077,3.8
11754,CN3911100000000,39,111,"Monroe County, OH",Jun-19,5298,4892,406,7.7
11755,CN3911300000000,39,113,"Montgomery County, OH",Jun-19,253849,242475,11374,4.5
11756,CN3911500000000,39,115,"Morgan County, OH",Jun-19,6775,6402,373,5.5
11757,CN3911700000000,39,117,"Morrow County, OH",Jun-19,16834,16135,699,4.2
11758,CN3911900000000,39,119,"Muskingum County, OH",Jun-19,39704,37811,1893,4.8
11759,CN3912100000000,39,121,"Noble County, OH",Jun-19,4729,4418,311,6.6
11760,CN3912300000000,39,123,"Ottawa County, OH",Jun-19,22391,21452,939,4.2
11761,CN3912500000000,39,125,"Paulding County, OH",Jun-19,8637,8276,361,4.2
11762,CN3912700000000,39,127,"Perry County, OH",Jun-19,15879,15091,788,5.0
11763,CN3912900000000,39,129,"Pickaway County, OH",Jun-19,26500,25404,1096,4.1
11764,CN3913100000000,39,131,"Pike County, OH",Jun-19,10906,10244,662,6.1
11765,CN3913300000000,39,133,"Portage County, OH",Jun-19,87588,83796,3792,4.3
11766,CN3913500000000,39,135,"Preble County, OH",Jun-19,21283,20462,821,3.9
11767,CN3913700000000,39,137,"Putnam County, OH",Jun-19,19084,18482,602,3.2
11768,CN3913900000000,39,139,"Richland County, OH",Jun-19,52970,50577,2393,4.5
11769,CN3914100000000,39,141,"Ross County, OH",Jun-19,35546,34012,1534,4.3
11770,CN3914300000000,39,143,"Sandusky County, OH",Jun-19,30841,29619,1222,4.0
11771,CN3914500000000,39,145,"Scioto County, OH",Jun-19,28798,26988,1810,6.3
11772,CN3914700000000,39,147,"Seneca County, OH",Jun-19,27477,26325,1152,4.2
11773,CN3914900000000,39,149,"Shelby County, OH",Jun-19,24589,23673,916,3.7
11774,CN3915100000000,39,151,"Stark County, OH",Jun-19,186606,178259,8347,4.5
11775,CN3915300000000,39,153,"Summit County, OH",Jun-19,273467,261277,12190,4.5
11776,CN3915500000000,39,155,"Trumbull County, OH",Jun-19,87620,82145,5475,6.2
11777,CN3915700000000,39,157,"Tuscarawas County, OH",Jun-19,45811,43889,1922,4.2
11778,CN3915900000000,39,159,"Union County, OH",Jun-19,29021,28028,993,3.4
11779,CN3916100000000,39,161,"Van Wert County, OH",Jun-19,15239,14716,523,3.4
11780,CN3916300000000,39,163,"Vinton County, OH",Jun-19,5541,5263,278,5.0
11781,CN3916500000000,39,165,"Warren County, OH",Jun-19,120607,115995,4612,3.8
11782,CN3916700000000,39,167,"Washington County, OH",Jun-19,27736,26287,1449,5.2
11783,CN3916900000000,39,169,"Wayne County, OH",Jun-19,62355,60205,2150,3.4
11784,CN3917100000000,39,171,"Williams County, OH",Jun-19,19205,18553,652,3.4
11785,CN3917300000000,39,173,"Wood County, OH",Jun-19,71554,68732,2822,3.9
11786,CN3917500000000,39,175,"Wyandot County, OH",Jun-19,13069,12663,406,3.1
11787,CN4000100000000,40,1,"Adair County, OK",Jun-19,8010,7648,362,4.5
11788,CN4000300000000,40,3,"Alfalfa County, OK",Jun-19,2771,2715,56,2.0
11789,CN4000500000000,40,5,"Atoka County, OK",Jun-19,4904,4667,237,4.8
11790,CN4000700000000,40,7,"Beaver County, OK",Jun-19,2855,2795,60,2.1
11791,CN4000900000000,40,9,"Beckham County, OK",Jun-19,10641,10330,311,2.9
11792,CN4001100000000,40,11,"Blaine County, OK",Jun-19,4870,4760,110,2.3
11793,CN4001300000000,40,13,"Bryan County, OK",Jun-19,22013,21277,736,3.3
11794,CN4001500000000,40,15,"Caddo County, OK",Jun-19,11488,11034,454,4.0
11795,CN4001700000000,40,17,"Canadian County, OK",Jun-19,74420,72148,2272,3.1
11796,CN4001900000000,40,19,"Carter County, OK",Jun-19,22015,21229,786,3.6
11797,CN4002100000000,40,21,"Cherokee County, OK",Jun-19,18823,17935,888,4.7
11798,CN4002300000000,40,23,"Choctaw County, OK",Jun-19,5397,5113,284,5.3
11799,CN4002500000000,40,25,"Cimarron County, OK",Jun-19,1277,1251,26,2.0
11800,CN4002700000000,40,27,"Cleveland County, OK",Jun-19,143547,139056,4491,3.1
11801,CN4002900000000,40,29,"Coal County, OK",Jun-19,2472,2368,104,4.2
11802,CN4003100000000,40,31,"Comanche County, OK",Jun-19,48776,46885,1891,3.9
11803,CN4003300000000,40,33,"Cotton County, OK",Jun-19,2733,2642,91,3.3
11804,CN4003500000000,40,35,"Craig County, OK",Jun-19,6047,5827,220,3.6
11805,CN4003700000000,40,37,"Creek County, OK",Jun-19,32002,30763,1239,3.9
11806,CN4003900000000,40,39,"Custer County, OK",Jun-19,15895,15461,434,2.7
11807,CN4004100000000,40,41,"Delaware County, OK",Jun-19,18465,17747,718,3.9
11808,CN4004300000000,40,43,"Dewey County, OK",Jun-19,2931,2862,69,2.4
11809,CN4004500000000,40,45,"Ellis County, OK",Jun-19,2151,2097,54,2.5
11810,CN4004700000000,40,47,"Garfield County, OK",Jun-19,27237,26375,862,3.2
11811,CN4004900000000,40,49,"Garvin County, OK",Jun-19,12492,12083,409,3.3
11812,CN4005100000000,40,51,"Grady County, OK",Jun-19,26494,25648,846,3.2
11813,CN4005300000000,40,53,"Grant County, OK",Jun-19,2649,2585,64,2.4
11814,CN4005500000000,40,55,"Greer County, OK",Jun-19,1852,1768,84,4.5
11815,CN4005700000000,40,57,"Harmon County, OK",Jun-19,1199,1161,38,3.2
11816,CN4005900000000,40,59,"Harper County, OK",Jun-19,1647,1591,56,3.4
11817,CN4006100000000,40,61,"Haskell County, OK",Jun-19,4220,3990,230,5.5
11818,CN4006300000000,40,63,"Hughes County, OK",Jun-19,5205,4902,303,5.8
11819,CN4006500000000,40,65,"Jackson County, OK",Jun-19,10796,10460,336,3.1
11820,CN4006700000000,40,67,"Jefferson County, OK",Jun-19,2487,2395,92,3.7
11821,CN4006900000000,40,69,"Johnston County, OK",Jun-19,3836,3666,170,4.4
11822,CN4007100000000,40,71,"Kay County, OK",Jun-19,18558,17690,868,4.7
11823,CN4007300000000,40,73,"Kingfisher County, OK",Jun-19,9285,9074,211,2.3
11824,CN4007500000000,40,75,"Kiowa County, OK",Jun-19,3386,3250,136,4.0
11825,CN4007700000000,40,77,"Latimer County, OK",Jun-19,3191,2987,204,6.4
11826,CN4007900000000,40,79,"Le Flore County, OK",Jun-19,19284,18286,998,5.2
11827,CN4008100000000,40,81,"Lincoln County, OK",Jun-19,15832,15237,595,3.8
11828,CN4008300000000,40,83,"Logan County, OK",Jun-19,22151,21447,704,3.2
11829,CN4008500000000,40,85,"Love County, OK",Jun-19,6188,6034,154,2.5
11830,CN4008700000000,40,87,"McClain County, OK",Jun-19,19648,19082,566,2.9
11831,CN4008900000000,40,89,"McCurtain County, OK",Jun-19,14288,13395,893,6.3
11832,CN4009100000000,40,91,"McIntosh County, OK",Jun-19,7158,6723,435,6.1
11833,CN4009300000000,40,93,"Major County, OK",Jun-19,3857,3773,84,2.2
11834,CN4009500000000,40,95,"Marshall County, OK",Jun-19,7069,6820,249,3.5
11835,CN4009700000000,40,97,"Mayes County, OK",Jun-19,19541,18848,693,3.5
11836,CN4009900000000,40,99,"Murray County, OK",Jun-19,6514,6326,188,2.9
11837,CN4010100000000,40,101,"Muskogee County, OK",Jun-19,29814,28505,1309,4.4
11838,CN4010300000000,40,103,"Noble County, OK",Jun-19,5734,5583,151,2.6
11839,CN4010500000000,40,105,"Nowata County, OK",Jun-19,4655,4485,170,3.7
11840,CN4010700000000,40,107,"Okfuskee County, OK",Jun-19,4671,4434,237,5.1
11841,CN4010900000000,40,109,"Oklahoma County, OK",Jun-19,386512,373465,13047,3.4
11842,CN4011100000000,40,111,"Okmulgee County, OK",Jun-19,15889,15055,834,5.2
11843,CN4011300000000,40,113,"Osage County, OK",Jun-19,20902,20062,840,4.0
11844,CN4011500000000,40,115,"Ottawa County, OK",Jun-19,14150,13609,541,3.8
11845,CN4011700000000,40,117,"Pawnee County, OK",Jun-19,7442,7131,311,4.2
11846,CN4011900000000,40,119,"Payne County, OK",Jun-19,37929,36630,1299,3.4
11847,CN4012100000000,40,121,"Pittsburg County, OK",Jun-19,17139,16403,736,4.3
11848,CN4012300000000,40,123,"Pontotoc County, OK",Jun-19,18903,18304,599,3.2
11849,CN4012500000000,40,125,"Pottawatomie County, OK",Jun-19,32595,31332,1263,3.9
11850,CN4012700000000,40,127,"Pushmataha County, OK",Jun-19,4126,3894,232,5.6
11851,CN4012900000000,40,129,"Roger Mills County, OK",Jun-19,1828,1774,54,3.0
11852,CN4013100000000,40,131,"Rogers County, OK",Jun-19,45637,44127,1510,3.3
11853,CN4013300000000,40,133,"Seminole County, OK",Jun-19,9420,8933,487,5.2
11854,CN4013500000000,40,135,"Sequoyah County, OK",Jun-19,16341,15642,699,4.3
11855,CN4013700000000,40,137,"Stephens County, OK",Jun-19,18789,17959,830,4.4
11856,CN4013900000000,40,139,"Texas County, OK",Jun-19,11151,10903,248,2.2
11857,CN4014100000000,40,141,"Tillman County, OK",Jun-19,2898,2795,103,3.6
11858,CN4014300000000,40,143,"Tulsa County, OK",Jun-19,327477,316630,10847,3.3
11859,CN4014500000000,40,145,"Wagoner County, OK",Jun-19,38387,37151,1236,3.2
11860,CN4014700000000,40,147,"Washington County, OK",Jun-19,22631,21787,844,3.7
11861,CN4014900000000,40,149,"Washita County, OK",Jun-19,5183,5012,171,3.3
11862,CN4015100000000,40,151,"Woods County, OK",Jun-19,4525,4419,106,2.3
11863,CN4015300000000,40,153,"Woodward County, OK",Jun-19,9154,8900,254,2.8
11864,CN4100100000000,41,1,"Baker County, OR",Jun-19,7131,6821,310,4.3
11865,CN4100300000000,41,3,"Benton County, OR",Jun-19,49120,47477,1643,3.3
11866,CN4100500000000,41,5,"Clackamas County, OR",Jun-19,219038,210926,8112,3.7
11867,CN4100700000000,41,7,"Clatsop County, OR",Jun-19,19754,19002,752,3.8
11868,CN4100900000000,41,9,"Columbia County, OR",Jun-19,24367,23217,1150,4.7
11869,CN4101100000000,41,11,"Coos County, OR",Jun-19,26340,24988,1352,5.1
11870,CN4101300000000,41,13,"Crook County, OR",Jun-19,9751,9257,494,5.1
11871,CN4101500000000,41,15,"Curry County, OR",Jun-19,9034,8569,465,5.1
11872,CN4101700000000,41,17,"Deschutes County, OR",Jun-19,97100,93317,3783,3.9
11873,CN4101900000000,41,19,"Douglas County, OR",Jun-19,46356,44006,2350,5.1
11874,CN4102100000000,41,21,"Gilliam County, OR",Jun-19,1006,971,35,3.5
11875,CN4102300000000,41,23,"Grant County, OR",Jun-19,3324,3166,158,4.8
11876,CN4102500000000,41,25,"Harney County, OR",Jun-19,3597,3439,158,4.4
11877,CN4102700000000,41,27,"Hood River County, OR",Jun-19,14539,14065,474,3.3
11878,CN4102900000000,41,29,"Jackson County, OR",Jun-19,103596,98781,4815,4.6
11879,CN4103100000000,41,31,"Jefferson County, OR",Jun-19,10410,9940,470,4.5
11880,CN4103300000000,41,33,"Josephine County, OR",Jun-19,36143,34309,1834,5.1
11881,CN4103500000000,41,35,"Klamath County, OR",Jun-19,29637,28006,1631,5.5
11882,CN4103700000000,41,37,"Lake County, OR",Jun-19,3656,3480,176,4.8
11883,CN4103900000000,41,39,"Lane County, OR",Jun-19,181181,173266,7915,4.4
11884,CN4104100000000,41,41,"Lincoln County, OR",Jun-19,21539,20583,956,4.4
11885,CN4104300000000,41,43,"Linn County, OR",Jun-19,58902,56215,2687,4.6
11886,CN4104500000000,41,45,"Malheur County, OR",Jun-19,12469,11941,528,4.2
11887,CN4104700000000,41,47,"Marion County, OR",Jun-19,163663,156829,6834,4.2
11888,CN4104900000000,41,49,"Morrow County, OR",Jun-19,5828,5587,241,4.1
11889,CN4105100000000,41,51,"Multnomah County, OR",Jun-19,453924,437777,16147,3.6
11890,CN4105300000000,41,53,"Polk County, OR",Jun-19,40093,38336,1757,4.4
11891,CN4105500000000,41,55,"Sherman County, OR",Jun-19,942,911,31,3.3
11892,CN4105700000000,41,57,"Tillamook County, OR",Jun-19,12094,11610,484,4.0
11893,CN4105900000000,41,59,"Umatilla County, OR",Jun-19,37683,36089,1594,4.2
11894,CN4106100000000,41,61,"Union County, OR",Jun-19,12077,11522,555,4.6
11895,CN4106300000000,41,63,"Wallowa County, OR",Jun-19,3534,3363,171,4.8
11896,CN4106500000000,41,65,"Wasco County, OR",Jun-19,15604,15044,560,3.6
11897,CN4106700000000,41,67,"Washington County, OR",Jun-19,324809,313746,11063,3.4
11898,CN4106900000000,41,69,"Wheeler County, OR",Jun-19,726,690,36,5.0
11899,CN4107100000000,41,71,"Yamhill County, OR",Jun-19,54976,52931,2045,3.7
11900,CN4200100000000,42,1,"Adams County, PA",Jun-19,55868,53961,1907,3.4
11901,CN4200300000000,42,3,"Allegheny County, PA",Jun-19,652083,624380,27703,4.2
11902,CN4200500000000,42,5,"Armstrong County, PA",Jun-19,32395,30858,1537,4.7
11903,CN4200700000000,42,7,"Beaver County, PA",Jun-19,84481,80618,3863,4.6
11904,CN4200900000000,42,9,"Bedford County, PA",Jun-19,24089,23060,1029,4.3
11905,CN4201100000000,42,11,"Berks County, PA",Jun-19,217595,207923,9672,4.4
11906,CN4201300000000,42,13,"Blair County, PA",Jun-19,60402,57582,2820,4.7
11907,CN4201500000000,42,15,"Bradford County, PA",Jun-19,29582,28369,1213,4.1
11908,CN4201700000000,42,17,"Bucks County, PA",Jun-19,346920,334069,12851,3.7
11909,CN4201900000000,42,19,"Butler County, PA",Jun-19,100429,96501,3928,3.9
11910,CN4202100000000,42,21,"Cambria County, PA",Jun-19,58485,55066,3419,5.8
11911,CN4202300000000,42,23,"Cameron County, PA",Jun-19,2140,2036,104,4.9
11912,CN4202500000000,42,25,"Carbon County, PA",Jun-19,32351,30680,1671,5.2
11913,CN4202700000000,42,27,"Centre County, PA",Jun-19,76322,73570,2752,3.6
11914,CN4202900000000,42,29,"Chester County, PA",Jun-19,291026,281578,9448,3.2
11915,CN4203100000000,42,31,"Clarion County, PA",Jun-19,17065,16271,794,4.7
11916,CN4203300000000,42,33,"Clearfield County, PA",Jun-19,35935,34180,1755,4.9
11917,CN4203500000000,42,35,"Clinton County, PA",Jun-19,18323,17370,953,5.2
11918,CN4203700000000,42,37,"Columbia County, PA",Jun-19,33319,31677,1642,4.9
11919,CN4203900000000,42,39,"Crawford County, PA",Jun-19,39331,37442,1889,4.8
11920,CN4204100000000,42,41,"Cumberland County, PA",Jun-19,133902,129121,4781,3.6
11921,CN4204300000000,42,43,"Dauphin County, PA",Jun-19,145902,139768,6134,4.2
11922,CN4204500000000,42,45,"Delaware County, PA",Jun-19,299286,287011,12275,4.1
11923,CN4204700000000,42,47,"Elk County, PA",Jun-19,16003,15240,763,4.8
11924,CN4204900000000,42,49,"Erie County, PA",Jun-19,129310,123285,6025,4.7
11925,CN4205100000000,42,51,"Fayette County, PA",Jun-19,57390,54099,3291,5.7
11926,CN4205300000000,42,53,"Forest County, PA",Jun-19,1871,1739,132,7.1
11927,CN4205500000000,42,55,"Franklin County, PA",Jun-19,78317,75320,2997,3.8
11928,CN4205700000000,42,57,"Fulton County, PA",Jun-19,8086,7778,308,3.8
11929,CN4205900000000,42,59,"Greene County, PA",Jun-19,16542,15662,880,5.3
11930,CN4206100000000,42,61,"Huntingdon County, PA",Jun-19,20105,19077,1028,5.1
11931,CN4206300000000,42,63,"Indiana County, PA",Jun-19,38553,36460,2093,5.4
11932,CN4206500000000,42,65,"Jefferson County, PA",Jun-19,20887,19965,922,4.4
11933,CN4206700000000,42,67,"Juniata County, PA",Jun-19,12939,12395,544,4.2
11934,CN4206900000000,42,69,"Lackawanna County, PA",Jun-19,104990,99846,5144,4.9
11935,CN4207100000000,42,71,"Lancaster County, PA",Jun-19,288734,278302,10432,3.6
11936,CN4207300000000,42,73,"Lawrence County, PA",Jun-19,41142,39183,1959,4.8
11937,CN4207500000000,42,75,"Lebanon County, PA",Jun-19,73742,70822,2920,4.0
11938,CN4207700000000,42,77,"Lehigh County, PA",Jun-19,194013,185385,8628,4.4
11939,CN4207900000000,42,79,"Luzerne County, PA",Jun-19,157176,148420,8756,5.6
11940,CN4208100000000,42,81,"Lycoming County, PA",Jun-19,56896,54268,2628,4.6
11941,CN4208300000000,42,83,"McKean County, PA",Jun-19,17591,16698,893,5.1
11942,CN4208500000000,42,85,"Mercer County, PA",Jun-19,49835,47339,2496,5.0
11943,CN4208700000000,42,87,"Mifflin County, PA",Jun-19,21323,20348,975,4.6
11944,CN4208900000000,42,89,"Monroe County, PA",Jun-19,83661,79212,4449,5.3
11945,CN4209100000000,42,91,"Montgomery County, PA",Jun-19,458829,442818,16011,3.5
11946,CN4209300000000,42,93,"Montour County, PA",Jun-19,9054,8721,333,3.7
11947,CN4209500000000,42,95,"Northampton County, PA",Jun-19,162604,155257,7347,4.5
11948,CN4209700000000,42,97,"Northumberland County, PA",Jun-19,43865,41511,2354,5.4
11949,CN4209900000000,42,99,"Perry County, PA",Jun-19,24968,24025,943,3.8
11950,CN4210100000000,42,101,"Philadelphia County/city, PA",Jun-19,716485,675677,40808,5.7
11951,CN4210300000000,42,103,"Pike County, PA",Jun-19,25612,24285,1327,5.2
11952,CN4210500000000,42,105,"Potter County, PA",Jun-19,7340,6989,351,4.8
11953,CN4210700000000,42,107,"Schuylkill County, PA",Jun-19,67491,63850,3641,5.4
11954,CN4210900000000,42,109,"Snyder County, PA",Jun-19,20160,18772,1388,6.9
11955,CN4211100000000,42,111,"Somerset County, PA",Jun-19,33944,32234,1710,5.0
11956,CN4211300000000,42,113,"Sullivan County, PA",Jun-19,2767,2638,129,4.7
11957,CN4211500000000,42,115,"Susquehanna County, PA",Jun-19,20876,20072,804,3.9
11958,CN4211700000000,42,117,"Tioga County, PA",Jun-19,19376,18414,962,5.0
11959,CN4211900000000,42,119,"Union County, PA",Jun-19,19514,18627,887,4.5
11960,CN4212100000000,42,121,"Venango County, PA",Jun-19,22857,21748,1109,4.9
11961,CN4212300000000,42,123,"Warren County, PA",Jun-19,19233,18394,839,4.4
11962,CN4212500000000,42,125,"Washington County, PA",Jun-19,107642,102833,4809,4.5
11963,CN4212700000000,42,127,"Wayne County, PA",Jun-19,22649,21731,918,4.1
11964,CN4212900000000,42,129,"Westmoreland County, PA",Jun-19,182415,173866,8549,4.7
11965,CN4213100000000,42,131,"Wyoming County, PA",Jun-19,13644,13008,636,4.7
11966,CN4213300000000,42,133,"York County, PA",Jun-19,237121,227435,9686,4.1
11967,CN4400100000000,44,1,"Bristol County, RI",Jun-19,26095,25364,731,2.8
11968,CN4400300000000,44,3,"Kent County, RI",Jun-19,91005,88293,2712,3.0
11969,CN4400500000000,44,5,"Newport County, RI",Jun-19,44286,43139,1147,2.6
11970,CN4400700000000,44,7,"Providence County, RI",Jun-19,326786,314632,12154,3.7
11971,CN4400900000000,44,9,"Washington County, RI",Jun-19,69587,67685,1902,2.7
11972,CN4500100000000,45,1,"Abbeville County, SC",Jun-19,10100,9727,373,3.7
11973,CN4500300000000,45,3,"Aiken County, SC",Jun-19,75459,72971,2488,3.3
11974,CN4500500000000,45,5,"Allendale County, SC",Jun-19,2686,2535,151,5.6
11975,CN4500700000000,45,7,"Anderson County, SC",Jun-19,92161,89343,2818,3.1
11976,CN4500900000000,45,9,"Bamberg County, SC",Jun-19,4972,4653,319,6.4
11977,CN4501100000000,45,11,"Barnwell County, SC",Jun-19,8319,7937,382,4.6
11978,CN4501300000000,45,13,"Beaufort County, SC",Jun-19,79798,77422,2376,3.0
11979,CN4501500000000,45,15,"Berkeley County, SC",Jun-19,105576,102625,2951,2.8
11980,CN4501700000000,45,17,"Calhoun County, SC",Jun-19,6623,6362,261,3.9
11981,CN4501900000000,45,19,"Charleston County, SC",Jun-19,214938,209468,5470,2.5
11982,CN4502100000000,45,21,"Cherokee County, SC",Jun-19,25453,24566,887,3.5
11983,CN4502300000000,45,23,"Chester County, SC",Jun-19,13560,12934,626,4.6
11984,CN4502500000000,45,25,"Chesterfield County, SC",Jun-19,22266,21562,704,3.2
11985,CN4502700000000,45,27,"Clarendon County, SC",Jun-19,12874,12322,552,4.3
11986,CN4502900000000,45,29,"Colleton County, SC",Jun-19,17030,16432,598,3.5
11987,CN4503100000000,45,31,"Darlington County, SC",Jun-19,30849,29652,1197,3.9
11988,CN4503300000000,45,33,"Dillon County, SC",Jun-19,13136,12590,546,4.2
11989,CN4503500000000,45,35,"Dorchester County, SC",Jun-19,79315,77133,2182,2.8
11990,CN4503700000000,45,37,"Edgefield County, SC",Jun-19,10798,10459,339,3.1
11991,CN4503900000000,45,39,"Fairfield County, SC",Jun-19,9629,9180,449,4.7
11992,CN4504100000000,45,41,"Florence County, SC",Jun-19,67867,65673,2194,3.2
11993,CN4504300000000,45,43,"Georgetown County, SC",Jun-19,26658,25673,985,3.7
11994,CN4504500000000,45,45,"Greenville County, SC",Jun-19,257323,250340,6983,2.7
11995,CN4504700000000,45,47,"Greenwood County, SC",Jun-19,31488,30385,1103,3.5
11996,CN4504900000000,45,49,"Hampton County, SC",Jun-19,8496,8219,277,3.3
11997,CN4505100000000,45,51,"Horry County, SC",Jun-19,155817,150374,5443,3.5
11998,CN4505300000000,45,53,"Jasper County, SC",Jun-19,13054,12672,382,2.9
11999,CN4505500000000,45,55,"Kershaw County, SC",Jun-19,29367,28391,976,3.3
12000,CN4505700000000,45,57,"Lancaster County, SC",Jun-19,41636,40139,1497,3.6
12001,CN4505900000000,45,59,"Laurens County, SC",Jun-19,30490,29497,993,3.3
12002,CN4506100000000,45,61,"Lee County, SC",Jun-19,6607,6319,288,4.4
12003,CN4506300000000,45,63,"Lexington County, SC",Jun-19,150546,146559,3987,2.6
12004,CN4506500000000,45,65,"McCormick County, SC",Jun-19,3427,3321,106,3.1
12005,CN4506700000000,45,67,"Marion County, SC",Jun-19,13208,12619,589,4.5
12006,CN4506900000000,45,69,"Marlboro County, SC",Jun-19,9197,8750,447,4.9
12007,CN4507100000000,45,71,"Newberry County, SC",Jun-19,19296,18740,556,2.9
12008,CN4507300000000,45,73,"Oconee County, SC",Jun-19,35304,34181,1123,3.2
12009,CN4507500000000,45,75,"Orangeburg County, SC",Jun-19,35014,33310,1704,4.9
12010,CN4507700000000,45,77,"Pickens County, SC",Jun-19,58131,56250,1881,3.2
12011,CN4507900000000,45,79,"Richland County, SC",Jun-19,199511,193156,6355,3.2
12012,CN4508100000000,45,81,"Saluda County, SC",Jun-19,8922,8655,267,3.0
12013,CN4508300000000,45,83,"Spartanburg County, SC",Jun-19,154298,149693,4605,3.0
12014,CN4508500000000,45,85,"Sumter County, SC",Jun-19,44112,42449,1663,3.8
12015,CN4508700000000,45,87,"Union County, SC",Jun-19,11735,11289,446,3.8
12016,CN4508900000000,45,89,"Williamsburg County, SC",Jun-19,12264,11674,590,4.8
12017,CN4509100000000,45,91,"York County, SC",Jun-19,141589,137287,4302,3.0
12018,CN4600300000000,46,3,"Aurora County, SD",Jun-19,1569,1530,39,2.5
12019,CN4600500000000,46,5,"Beadle County, SD",Jun-19,9919,9639,280,2.8
12020,CN4600700000000,46,7,"Bennett County, SD",Jun-19,1076,1015,61,5.7
12021,CN4600900000000,46,9,"Bon Homme County, SD",Jun-19,2943,2855,88,3.0
12022,CN4601100000000,46,11,"Brookings County, SD",Jun-19,18879,18221,658,3.5
12023,CN4601300000000,46,13,"Brown County, SD",Jun-19,21026,20391,635,3.0
12024,CN4601500000000,46,15,"Brule County, SD",Jun-19,2544,2461,83,3.3
12025,CN4601700000000,46,17,"Buffalo County, SD",Jun-19,697,639,58,8.3
12026,CN4601900000000,46,19,"Butte County, SD",Jun-19,5122,4961,161,3.1
12027,CN4602100000000,46,21,"Campbell County, SD",Jun-19,788,759,29,3.7
12028,CN4602300000000,46,23,"Charles Mix County, SD",Jun-19,3892,3741,151,3.9
12029,CN4602500000000,46,25,"Clark County, SD",Jun-19,1984,1908,76,3.8
12030,CN4602700000000,46,27,"Clay County, SD",Jun-19,7017,6755,262,3.7
12031,CN4602900000000,46,29,"Codington County, SD",Jun-19,15652,15188,464,3.0
12032,CN4603100000000,46,31,"Corson County, SD",Jun-19,1367,1272,95,6.9
12033,CN4603300000000,46,33,"Custer County, SD",Jun-19,4081,3921,160,3.9
12034,CN4603500000000,46,35,"Davison County, SD",Jun-19,11286,10978,308,2.7
12035,CN4603700000000,46,37,"Day County, SD",Jun-19,2841,2741,100,3.5
12036,CN4603900000000,46,39,"Deuel County, SD",Jun-19,2235,2152,83,3.7
12037,CN4604100000000,46,41,"Dewey County, SD",Jun-19,2302,2054,248,10.8
12038,CN4604300000000,46,43,"Douglas County, SD",Jun-19,1605,1566,39,2.4
12039,CN4604500000000,46,45,"Edmunds County, SD",Jun-19,2050,1987,63,3.1
12040,CN4604700000000,46,47,"Fall River County, SD",Jun-19,3178,3049,129,4.1
12041,CN4604900000000,46,49,"Faulk County, SD",Jun-19,1085,1049,36,3.3
12042,CN4605100000000,46,51,"Grant County, SD",Jun-19,4508,4384,124,2.8
12043,CN4605300000000,46,53,"Gregory County, SD",Jun-19,2085,2020,65,3.1
12044,CN4605500000000,46,55,"Haakon County, SD",Jun-19,1058,1029,29,2.7
12045,CN4605700000000,46,57,"Hamlin County, SD",Jun-19,3395,3296,99,2.9
12046,CN4605900000000,46,59,"Hand County, SD",Jun-19,1802,1754,48,2.7
12047,CN4606100000000,46,61,"Hanson County, SD",Jun-19,1757,1684,73,4.2
12048,CN4606300000000,46,63,"Harding County, SD",Jun-19,729,709,20,2.7
12049,CN4606500000000,46,65,"Hughes County, SD",Jun-19,10367,10105,262,2.5
12050,CN4606700000000,46,67,"Hutchinson County, SD",Jun-19,3639,3542,97,2.7
12051,CN4606900000000,46,69,"Hyde County, SD",Jun-19,676,654,22,3.3
12052,CN4607100000000,46,71,"Jackson County, SD",Jun-19,1392,1327,65,4.7
12053,CN4607300000000,46,73,"Jerauld County, SD",Jun-19,1134,1103,31,2.7
12054,CN4607500000000,46,75,"Jones County, SD",Jun-19,573,558,15,2.6
12055,CN4607700000000,46,77,"Kingsbury County, SD",Jun-19,2758,2678,80,2.9
12056,CN4607900000000,46,79,"Lake County, SD",Jun-19,6669,6436,233,3.5
12057,CN4608100000000,46,81,"Lawrence County, SD",Jun-19,13694,13264,430,3.1
12058,CN4608300000000,46,83,"Lincoln County, SD",Jun-19,34927,34049,878,2.5
12059,CN4608500000000,46,85,"Lyman County, SD",Jun-19,1752,1665,87,5.0
12060,CN4608700000000,46,87,"McCook County, SD",Jun-19,3078,3002,76,2.5
12061,CN4608900000000,46,89,"McPherson County, SD",Jun-19,998,961,37,3.7
12062,CN4609100000000,46,91,"Marshall County, SD",Jun-19,2478,2395,83,3.3
12063,CN4609300000000,46,93,"Meade County, SD",Jun-19,14573,14082,491,3.4
12064,CN4609500000000,46,95,"Mellette County, SD",Jun-19,735,693,42,5.7
12065,CN4609700000000,46,97,"Miner County, SD",Jun-19,1190,1156,34,2.9
12066,CN4609900000000,46,99,"Minnehaha County, SD",Jun-19,114080,111003,3077,2.7
12067,CN4610100000000,46,101,"Moody County, SD",Jun-19,4152,3967,185,4.5
12068,CN4610200000000,46,102,"Oglala Lakota County, SD",Jun-19,3583,3179,404,11.3
12069,CN4610300000000,46,103,"Pennington County, SD",Jun-19,58645,56745,1900,3.2
12070,CN4610500000000,46,105,"Perkins County, SD",Jun-19,1443,1397,46,3.2
12071,CN4610700000000,46,107,"Potter County, SD",Jun-19,1084,1052,32,3.0
12072,CN4610900000000,46,109,"Roberts County, SD",Jun-19,4875,4690,185,3.8
12073,CN4611100000000,46,111,"Sanborn County, SD",Jun-19,1175,1138,37,3.1
12074,CN4611500000000,46,115,"Spink County, SD",Jun-19,3261,3162,99,3.0
12075,CN4611700000000,46,117,"Stanley County, SD",Jun-19,1890,1842,48,2.5
12076,CN4611900000000,46,119,"Sully County, SD",Jun-19,808,786,22,2.7
12077,CN4612100000000,46,121,"Todd County, SD",Jun-19,3144,2915,229,7.3
12078,CN4612300000000,46,123,"Tripp County, SD",Jun-19,3100,3017,83,2.7
12079,CN4612500000000,46,125,"Turner County, SD",Jun-19,4712,4579,133,2.8
12080,CN4612700000000,46,127,"Union County, SD",Jun-19,8496,8205,291,3.4
12081,CN4612900000000,46,129,"Walworth County, SD",Jun-19,2181,2067,114,5.2
12082,CN4613500000000,46,135,"Yankton County, SD",Jun-19,12213,11877,336,2.8
12083,CN4613700000000,46,137,"Ziebach County, SD",Jun-19,951,881,70,7.4
12084,CN4700100000000,47,1,"Anderson County, TN",Jun-19,35271,33774,1497,4.2
12085,CN4700300000000,47,3,"Bedford County, TN",Jun-19,21393,20446,947,4.4
12086,CN4700500000000,47,5,"Benton County, TN",Jun-19,6957,6580,377,5.4
12087,CN4700700000000,47,7,"Bledsoe County, TN",Jun-19,4235,3971,264,6.2
12088,CN4700900000000,47,9,"Blount County, TN",Jun-19,64508,62136,2372,3.7
12089,CN4701100000000,47,11,"Bradley County, TN",Jun-19,52261,50115,2146,4.1
12090,CN4701300000000,47,13,"Campbell County, TN",Jun-19,15101,14304,797,5.3
12091,CN4701500000000,47,15,"Cannon County, TN",Jun-19,6763,6506,257,3.8
12092,CN4701700000000,47,17,"Carroll County, TN",Jun-19,12208,11497,711,5.8
12093,CN4701900000000,47,19,"Carter County, TN",Jun-19,24039,22916,1123,4.7
12094,CN4702100000000,47,21,"Cheatham County, TN",Jun-19,22394,21694,700,3.1
12095,CN4702300000000,47,23,"Chester County, TN",Jun-19,8758,8402,356,4.1
12096,CN4702500000000,47,25,"Claiborne County, TN",Jun-19,13240,12576,664,5.0
12097,CN4702700000000,47,27,"Clay County, TN",Jun-19,2709,2519,190,7.0
12098,CN4702900000000,47,29,"Cocke County, TN",Jun-19,15468,14732,736,4.8
12099,CN4703100000000,47,31,"Coffee County, TN",Jun-19,26195,25197,998,3.8
12100,CN4703300000000,47,33,"Crockett County, TN",Jun-19,7101,6833,268,3.8
12101,CN4703500000000,47,35,"Cumberland County, TN",Jun-19,23605,22488,1117,4.7
12102,CN4703700000000,47,37,"Davidson County, TN",Jun-19,413898,401887,12011,2.9
12103,CN4703900000000,47,39,"Decatur County, TN",Jun-19,4636,4376,260,5.6
12104,CN4704100000000,47,41,"DeKalb County, TN",Jun-19,7946,7569,377,4.7
12105,CN4704300000000,47,43,"Dickson County, TN",Jun-19,27676,26734,942,3.4
12106,CN4704500000000,47,45,"Dyer County, TN",Jun-19,16431,15509,922,5.6
12107,CN4704700000000,47,47,"Fayette County, TN",Jun-19,19467,18681,786,4.0
12108,CN4704900000000,47,49,"Fentress County, TN",Jun-19,7487,7124,363,4.8
12109,CN4705100000000,47,51,"Franklin County, TN",Jun-19,20421,19619,802,3.9
12110,CN4705300000000,47,53,"Gibson County, TN",Jun-19,22288,21257,1031,4.6
12111,CN4705500000000,47,55,"Giles County, TN",Jun-19,15179,14538,641,4.2
12112,CN4705700000000,47,57,"Grainger County, TN",Jun-19,9661,9207,454,4.7
12113,CN4705900000000,47,59,"Greene County, TN",Jun-19,30177,28669,1508,5.0
12114,CN4706100000000,47,61,"Grundy County, TN",Jun-19,4895,4658,237,4.8
12115,CN4706300000000,47,63,"Hamblen County, TN",Jun-19,28519,27256,1263,4.4
12116,CN4706500000000,47,65,"Hamilton County, TN",Jun-19,188207,181134,7073,3.8
12117,CN4706700000000,47,67,"Hancock County, TN",Jun-19,2081,1930,151,7.3
12118,CN4706900000000,47,69,"Hardeman County, TN",Jun-19,9636,9151,485,5.0
12119,CN4707100000000,47,71,"Hardin County, TN",Jun-19,10588,10055,533,5.0
12120,CN4707300000000,47,73,"Hawkins County, TN",Jun-19,24272,23137,1135,4.7
12121,CN4707500000000,47,75,"Haywood County, TN",Jun-19,7685,7270,415,5.4
12122,CN4707700000000,47,77,"Henderson County, TN",Jun-19,12416,11842,574,4.6
12123,CN4707900000000,47,79,"Henry County, TN",Jun-19,14389,13750,639,4.4
12124,CN4708100000000,47,81,"Hickman County, TN",Jun-19,11691,11281,410,3.5
12125,CN4708300000000,47,83,"Houston County, TN",Jun-19,3237,3067,170,5.3
12126,CN4708500000000,47,85,"Humphreys County, TN",Jun-19,8954,8566,388,4.3
12127,CN4708700000000,47,87,"Jackson County, TN",Jun-19,4670,4430,240,5.1
12128,CN4708900000000,47,89,"Jefferson County, TN",Jun-19,24904,23850,1054,4.2
12129,CN4709100000000,47,91,"Johnson County, TN",Jun-19,7670,7378,292,3.8
12130,CN4709300000000,47,93,"Knox County, TN",Jun-19,248268,239537,8731,3.5
12131,CN4709500000000,47,95,"Lake County, TN",Jun-19,1772,1664,108,6.1
12132,CN4709700000000,47,97,"Lauderdale County, TN",Jun-19,9789,9201,588,6.0
12133,CN4709900000000,47,99,"Lawrence County, TN",Jun-19,19442,18548,894,4.6
12134,CN4710100000000,47,101,"Lewis County, TN",Jun-19,5179,4953,226,4.4
12135,CN4710300000000,47,103,"Lincoln County, TN",Jun-19,16982,16369,613,3.6
12136,CN4710500000000,47,105,"Loudon County, TN",Jun-19,23815,22871,944,4.0
12137,CN4710700000000,47,107,"McMinn County, TN",Jun-19,24199,23142,1057,4.4
12138,CN4710900000000,47,109,"McNairy County, TN",Jun-19,8457,7978,479,5.7
12139,CN4711100000000,47,111,"Macon County, TN",Jun-19,11493,11061,432,3.8
12140,CN4711300000000,47,113,"Madison County, TN",Jun-19,50232,48175,2057,4.1
12141,CN4711500000000,47,115,"Marion County, TN",Jun-19,12787,12169,618,4.8
12142,CN4711700000000,47,117,"Marshall County, TN",Jun-19,15883,15289,594,3.7
12143,CN4711900000000,47,119,"Maury County, TN",Jun-19,50432,48830,1602,3.2
12144,CN4712100000000,47,121,"Meigs County, TN",Jun-19,5225,4949,276,5.3
12145,CN4712300000000,47,123,"Monroe County, TN",Jun-19,20527,19630,897,4.4
12146,CN4712500000000,47,125,"Montgomery County, TN",Jun-19,86436,82637,3799,4.4
12147,CN4712700000000,47,127,"Moore County, TN",Jun-19,3619,3497,122,3.4
12148,CN4712900000000,47,129,"Morgan County, TN",Jun-19,8035,7636,399,5.0
12149,CN4713100000000,47,131,"Obion County, TN",Jun-19,12646,11983,663,5.2
12150,CN4713300000000,47,133,"Overton County, TN",Jun-19,10089,9655,434,4.3
12151,CN4713500000000,47,135,"Perry County, TN",Jun-19,3165,3006,159,5.0
12152,CN4713700000000,47,137,"Pickett County, TN",Jun-19,2447,2336,111,4.5
12153,CN4713900000000,47,139,"Polk County, TN",Jun-19,7549,7189,360,4.8
12154,CN4714100000000,47,141,"Putnam County, TN",Jun-19,35136,33645,1491,4.2
12155,CN4714300000000,47,143,"Rhea County, TN",Jun-19,13228,12353,875,6.6
12156,CN4714500000000,47,145,"Roane County, TN",Jun-19,23825,22691,1134,4.8
12157,CN4714700000000,47,147,"Robertson County, TN",Jun-19,38879,37570,1309,3.4
12158,CN4714900000000,47,149,"Rutherford County, TN",Jun-19,188820,183023,5797,3.1
12159,CN4715100000000,47,151,"Scott County, TN",Jun-19,8593,8144,449,5.2
12160,CN4715300000000,47,153,"Sequatchie County, TN",Jun-19,6329,6031,298,4.7
12161,CN4715500000000,47,155,"Sevier County, TN",Jun-19,57240,55512,1728,3.0
12162,CN4715700000000,47,157,"Shelby County, TN",Jun-19,455281,434222,21059,4.6
12163,CN4715900000000,47,159,"Smith County, TN",Jun-19,9673,9331,342,3.5
12164,CN4716100000000,47,161,"Stewart County, TN",Jun-19,5553,5283,270,4.9
12165,CN4716300000000,47,163,"Sullivan County, TN",Jun-19,71899,68775,3124,4.3
12166,CN4716500000000,47,165,"Sumner County, TN",Jun-19,104784,101580,3204,3.1
12167,CN4716700000000,47,167,"Tipton County, TN",Jun-19,28749,27464,1285,4.5
12168,CN4716900000000,47,169,"Trousdale County, TN",Jun-19,5560,5356,204,3.7
12169,CN4717100000000,47,171,"Unicoi County, TN",Jun-19,7082,6691,391,5.5
12170,CN4717300000000,47,173,"Union County, TN",Jun-19,7780,7389,391,5.0
12171,CN4717500000000,47,175,"Van Buren County, TN",Jun-19,2080,1969,111,5.3
12172,CN4717700000000,47,177,"Warren County, TN",Jun-19,16947,16105,842,5.0
12173,CN4717900000000,47,179,"Washington County, TN",Jun-19,60478,58012,2466,4.1
12174,CN4718100000000,47,181,"Wayne County, TN",Jun-19,6304,5995,309,4.9
12175,CN4718300000000,47,183,"Weakley County, TN",Jun-19,15919,15149,770,4.8
12176,CN4718500000000,47,185,"White County, TN",Jun-19,12317,11805,512,4.2
12177,CN4718700000000,47,187,"Williamson County, TN",Jun-19,131490,127678,3812,2.9
12178,CN4718900000000,47,189,"Wilson County, TN",Jun-19,78503,76032,2471,3.1
12179,CN4800100000000,48,1,"Anderson County, TX",Jun-19,23816,23095,721,3.0
12180,CN4800300000000,48,3,"Andrews County, TX",Jun-19,9923,9682,241,2.4
12181,CN4800500000000,48,5,"Angelina County, TX",Jun-19,35743,34230,1513,4.2
12182,CN4800700000000,48,7,"Aransas County, TX",Jun-19,9409,8986,423,4.5
12183,CN4800900000000,48,9,"Archer County, TX",Jun-19,4147,4021,126,3.0
12184,CN4801100000000,48,11,"Armstrong County, TX",Jun-19,927,901,26,2.8
12185,CN4801300000000,48,13,"Atascosa County, TX",Jun-19,21671,20844,827,3.8
12186,CN4801500000000,48,15,"Austin County, TX",Jun-19,14073,13556,517,3.7
12187,CN4801700000000,48,17,"Bailey County, TX",Jun-19,2601,2487,114,4.4
12188,CN4801900000000,48,19,"Bandera County, TX",Jun-19,10027,9700,327,3.3
12189,CN4802100000000,48,21,"Bastrop County, TX",Jun-19,42906,41468,1438,3.4
12190,CN4802300000000,48,23,"Baylor County, TX",Jun-19,1780,1740,40,2.2
12191,CN4802500000000,48,25,"Bee County, TX",Jun-19,9804,9365,439,4.5
12192,CN4802700000000,48,27,"Bell County, TX",Jun-19,143150,137350,5800,4.1
12193,CN4802900000000,48,29,"Bexar County, TX",Jun-19,947725,916137,31588,3.3
12194,CN4803100000000,48,31,"Blanco County, TX",Jun-19,6492,6321,171,2.6
12195,CN4803300000000,48,33,"Borden County, TX",Jun-19,384,375,9,2.3
12196,CN4803500000000,48,35,"Bosque County, TX",Jun-19,8388,8089,299,3.6
12197,CN4803700000000,48,37,"Bowie County, TX",Jun-19,40175,38301,1874,4.7
12198,CN4803900000000,48,39,"Brazoria County, TX",Jun-19,179125,171317,7808,4.4
12199,CN4804100000000,48,41,"Brazos County, TX",Jun-19,114860,111258,3602,3.1
12200,CN4804300000000,48,43,"Brewster County, TX",Jun-19,4167,4029,138,3.3
12201,CN4804500000000,48,45,"Briscoe County, TX",Jun-19,595,574,21,3.5
12202,CN4804700000000,48,47,"Brooks County, TX",Jun-19,2586,2435,151,5.8
12203,CN4804900000000,48,49,"Brown County, TX",Jun-19,15535,14898,637,4.1
12204,CN4805100000000,48,51,"Burleson County, TX",Jun-19,8063,7798,265,3.3
12205,CN4805300000000,48,53,"Burnet County, TX",Jun-19,23623,22955,668,2.8
12206,CN4805500000000,48,55,"Caldwell County, TX",Jun-19,19667,18947,720,3.7
12207,CN4805700000000,48,57,"Calhoun County, TX",Jun-19,12282,11859,423,3.4
12208,CN4805900000000,48,59,"Callahan County, TX",Jun-19,6071,5869,202,3.3
12209,CN4806100000000,48,61,"Cameron County, TX",Jun-19,167285,157622,9663,5.8
12210,CN4806300000000,48,63,"Camp County, TX",Jun-19,4995,4782,213,4.3
12211,CN4806500000000,48,65,"Carson County, TX",Jun-19,3004,2922,82,2.7
12212,CN4806700000000,48,67,"Cass County, TX",Jun-19,12425,11864,561,4.5
12213,CN4806900000000,48,69,"Castro County, TX",Jun-19,3484,3375,109,3.1
12214,CN4807100000000,48,71,"Chambers County, TX",Jun-19,19482,18528,954,4.9
12215,CN4807300000000,48,73,"Cherokee County, TX",Jun-19,20866,20057,809,3.9
12216,CN4807500000000,48,75,"Childress County, TX",Jun-19,2986,2904,82,2.7
12217,CN4807700000000,48,77,"Clay County, TX",Jun-19,4947,4780,167,3.4
12218,CN4807900000000,48,79,"Cochran County, TX",Jun-19,1134,1090,44,3.9
12219,CN4808100000000,48,81,"Coke County, TX",Jun-19,1471,1418,53,3.6
12220,CN4808300000000,48,83,"Coleman County, TX",Jun-19,2901,2779,122,4.2
12221,CN4808500000000,48,85,"Collin County, TX",Jun-19,562303,543933,18370,3.3
12222,CN4808700000000,48,87,"Collingsworth County, TX",Jun-19,1205,1167,38,3.2
12223,CN4808900000000,48,89,"Colorado County, TX",Jun-19,10002,9684,318,3.2
12224,CN4809100000000,48,91,"Comal County, TX",Jun-19,73169,70845,2324,3.2
12225,CN4809300000000,48,93,"Comanche County, TX",Jun-19,5605,5420,185,3.3
12226,CN4809500000000,48,95,"Concho County, TX",Jun-19,1250,1205,45,3.6
12227,CN4809700000000,48,97,"Cooke County, TX",Jun-19,19962,19376,586,2.9
12228,CN4809900000000,48,99,"Coryell County, TX",Jun-19,24018,23002,1016,4.2
12229,CN4810100000000,48,101,"Cottle County, TX",Jun-19,557,535,22,3.9
12230,CN4810300000000,48,103,"Crane County, TX",Jun-19,1594,1527,67,4.2
12231,CN4810500000000,48,105,"Crockett County, TX",Jun-19,1660,1614,46,2.8
12232,CN4810700000000,48,107,"Crosby County, TX",Jun-19,2502,2391,111,4.4
12233,CN4810900000000,48,109,"Culberson County, TX",Jun-19,1060,1011,49,4.6
12234,CN4811100000000,48,111,"Dallam County, TX",Jun-19,3925,3838,87,2.2
12235,CN4811300000000,48,113,"Dallas County, TX",Jun-19,1361272,1311628,49644,3.6
12236,CN4811500000000,48,115,"Dawson County, TX",Jun-19,4599,4412,187,4.1
12237,CN4811700000000,48,117,"Deaf Smith County, TX",Jun-19,8505,8240,265,3.1
12238,CN4811900000000,48,119,"Delta County, TX",Jun-19,2429,2348,81,3.3
12239,CN4812100000000,48,121,"Denton County, TX",Jun-19,493353,477944,15409,3.1
12240,CN4812300000000,48,123,"DeWitt County, TX",Jun-19,9742,9467,275,2.8
12241,CN4812500000000,48,125,"Dickens County, TX",Jun-19,704,674,30,4.3
12242,CN4812700000000,48,127,"Dimmit County, TX",Jun-19,7390,7173,217,2.9
12243,CN4812900000000,48,129,"Donley County, TX",Jun-19,1487,1430,57,3.8
12244,CN4813100000000,48,131,"Duval County, TX",Jun-19,4995,4763,232,4.6
12245,CN4813300000000,48,133,"Eastland County, TX",Jun-19,8285,7977,308,3.7
12246,CN4813500000000,48,135,"Ector County, TX",Jun-19,87649,85252,2397,2.7
12247,CN4813700000000,48,137,"Edwards County, TX",Jun-19,1051,1026,25,2.4
12248,CN4813900000000,48,139,"Ellis County, TX",Jun-19,92544,89425,3119,3.4
12249,CN4814100000000,48,141,"El Paso County, TX",Jun-19,358241,343708,14533,4.1
12250,CN4814300000000,48,143,"Erath County, TX",Jun-19,20476,19764,712,3.5
12251,CN4814500000000,48,145,"Falls County, TX",Jun-19,6568,6339,229,3.5
12252,CN4814700000000,48,147,"Fannin County, TX",Jun-19,17318,16826,492,2.8
12253,CN4814900000000,48,149,"Fayette County, TX",Jun-19,12545,12185,360,2.9
12254,CN4815100000000,48,151,"Fisher County, TX",Jun-19,1660,1602,58,3.5
12255,CN4815300000000,48,153,"Floyd County, TX",Jun-19,2605,2493,112,4.3
12256,CN4815500000000,48,155,"Foard County, TX",Jun-19,568,549,19,3.3
12257,CN4815700000000,48,157,"Fort Bend County, TX",Jun-19,391307,377071,14236,3.6
12258,CN4815900000000,48,159,"Franklin County, TX",Jun-19,4735,4559,176,3.7
12259,CN4816100000000,48,161,"Freestone County, TX",Jun-19,6415,6099,316,4.9
12260,CN4816300000000,48,163,"Frio County, TX",Jun-19,10476,10162,314,3.0
12261,CN4816500000000,48,165,"Gaines County, TX",Jun-19,9844,9585,259,2.6
12262,CN4816700000000,48,167,"Galveston County, TX",Jun-19,165031,158148,6883,4.2
12263,CN4816900000000,48,169,"Garza County, TX",Jun-19,2180,2116,64,2.9
12264,CN4817100000000,48,171,"Gillespie County, TX",Jun-19,13736,13387,349,2.5
12265,CN4817300000000,48,173,"Glasscock County, TX",Jun-19,814,794,20,2.5
12266,CN4817500000000,48,175,"Goliad County, TX",Jun-19,3256,3145,111,3.4
12267,CN4817700000000,48,177,"Gonzales County, TX",Jun-19,9562,9295,267,2.8
12268,CN4817900000000,48,179,"Gray County, TX",Jun-19,8127,7832,295,3.6
12269,CN4818100000000,48,181,"Grayson County, TX",Jun-19,64188,62126,2062,3.2
12270,CN4818300000000,48,183,"Gregg County, TX",Jun-19,58138,55894,2244,3.9
12271,CN4818500000000,48,185,"Grimes County, TX",Jun-19,11207,10716,491,4.4
12272,CN4818700000000,48,187,"Guadalupe County, TX",Jun-19,81344,78787,2557,3.1
12273,CN4818900000000,48,189,"Hale County, TX",Jun-19,12243,11591,652,5.3
12274,CN4819100000000,48,191,"Hall County, TX",Jun-19,1089,1043,46,4.2
12275,CN4819300000000,48,193,"Hamilton County, TX",Jun-19,3705,3590,115,3.1
12276,CN4819500000000,48,195,"Hansford County, TX",Jun-19,2820,2747,73,2.6
12277,CN4819700000000,48,197,"Hardeman County, TX",Jun-19,1734,1681,53,3.1
12278,CN4819900000000,48,199,"Hardin County, TX",Jun-19,25239,23990,1249,4.9
12279,CN4820100000000,48,201,"Harris County, TX",Jun-19,2311453,2219138,92315,4.0
12280,CN4820300000000,48,203,"Harrison County, TX",Jun-19,29302,28100,1202,4.1
12281,CN4820500000000,48,205,"Hartley County, TX",Jun-19,2808,2759,49,1.7
12282,CN4820700000000,48,207,"Haskell County, TX",Jun-19,2288,2210,78,3.4
12283,CN4820900000000,48,209,"Hays County, TX",Jun-19,119688,116183,3505,2.9
12284,CN4821100000000,48,211,"Hemphill County, TX",Jun-19,2023,1965,58,2.9
12285,CN4821300000000,48,213,"Henderson County, TX",Jun-19,36691,35317,1374,3.7
12286,CN4821500000000,48,215,"Hidalgo County, TX",Jun-19,351385,328474,22911,6.5
12287,CN4821700000000,48,217,"Hill County, TX",Jun-19,16330,15753,577,3.5
12288,CN4821900000000,48,219,"Hockley County, TX",Jun-19,11247,10876,371,3.3
12289,CN4822100000000,48,221,"Hood County, TX",Jun-19,27462,26475,987,3.6
12290,CN4822300000000,48,223,"Hopkins County, TX",Jun-19,17535,16986,549,3.1
12291,CN4822500000000,48,225,"Houston County, TX",Jun-19,10439,10079,360,3.4
12292,CN4822700000000,48,227,"Howard County, TX",Jun-19,14059,13595,464,3.3
12293,CN4822900000000,48,229,"Hudspeth County, TX",Jun-19,1807,1726,81,4.5
12294,CN4823100000000,48,231,"Hunt County, TX",Jun-19,43331,41685,1646,3.8
12295,CN4823300000000,48,233,"Hutchinson County, TX",Jun-19,8837,8433,404,4.6
12296,CN4823500000000,48,235,"Irion County, TX",Jun-19,757,738,19,2.5
12297,CN4823700000000,48,237,"Jack County, TX",Jun-19,3505,3396,109,3.1
12298,CN4823900000000,48,239,"Jackson County, TX",Jun-19,7607,7362,245,3.2
12299,CN4824100000000,48,241,"Jasper County, TX",Jun-19,12853,12042,811,6.3
12300,CN4824300000000,48,243,"Jeff Davis County, TX",Jun-19,1062,1034,28,2.6
12301,CN4824500000000,48,245,"Jefferson County, TX",Jun-19,106609,100036,6573,6.2
12302,CN4824700000000,48,247,"Jim Hogg County, TX",Jun-19,1855,1761,94,5.1
12303,CN4824900000000,48,249,"Jim Wells County, TX",Jun-19,16974,16132,842,5.0
12304,CN4825100000000,48,251,"Johnson County, TX",Jun-19,81925,79106,2819,3.4
12305,CN4825300000000,48,253,"Jones County, TX",Jun-19,5702,5447,255,4.5
12306,CN4825500000000,48,255,"Karnes County, TX",Jun-19,7170,6981,189,2.6
12307,CN4825700000000,48,257,"Kaufman County, TX",Jun-19,64463,62219,2244,3.5
12308,CN4825900000000,48,259,"Kendall County, TX",Jun-19,22075,21440,635,2.9
12309,CN4826100000000,48,261,"Kenedy County, TX",Jun-19,235,227,8,3.4
12310,CN4826300000000,48,263,"Kent County, TX",Jun-19,488,476,12,2.5
12311,CN4826500000000,48,265,"Kerr County, TX",Jun-19,22332,21645,687,3.1
12312,CN4826700000000,48,267,"Kimble County, TX",Jun-19,1914,1852,62,3.2
12313,CN4826900000000,48,269,"King County, TX",Jun-19,231,226,5,2.2
12314,CN4827100000000,48,271,"Kinney County, TX",Jun-19,1390,1341,49,3.5
12315,CN4827300000000,48,273,"Kleberg County, TX",Jun-19,13321,12692,629,4.7
12316,CN4827500000000,48,275,"Knox County, TX",Jun-19,1460,1412,48,3.3
12317,CN4827700000000,48,277,"Lamar County, TX",Jun-19,23784,22952,832,3.5
12318,CN4827900000000,48,279,"Lamb County, TX",Jun-19,5330,5116,214,4.0
12319,CN4828100000000,48,281,"Lampasas County, TX",Jun-19,9162,8843,319,3.5
12320,CN4828300000000,48,283,"La Salle County, TX",Jun-19,4335,4229,106,2.4
12321,CN4828500000000,48,285,"Lavaca County, TX",Jun-19,8695,8413,282,3.2
12322,CN4828700000000,48,287,"Lee County, TX",Jun-19,10166,9880,286,2.8
12323,CN4828900000000,48,289,"Leon County, TX",Jun-19,6339,6047,292,4.6
12324,CN4829100000000,48,291,"Liberty County, TX",Jun-19,33081,31302,1779,5.4
12325,CN4829300000000,48,293,"Limestone County, TX",Jun-19,8608,8255,353,4.1
12326,CN4829500000000,48,295,"Lipscomb County, TX",Jun-19,1656,1607,49,3.0
12327,CN4829700000000,48,297,"Live Oak County, TX",Jun-19,5566,5379,187,3.4
12328,CN4829900000000,48,299,"Llano County, TX",Jun-19,8764,8457,307,3.5
12329,CN4830100000000,48,301,"Loving County, TX",Jun-19,584,580,4,0.7
12330,CN4830300000000,48,303,"Lubbock County, TX",Jun-19,157835,152715,5120,3.2
12331,CN4830500000000,48,305,"Lynn County, TX",Jun-19,2769,2679,90,3.3
12332,CN4830700000000,48,307,"McCulloch County, TX",Jun-19,3433,3221,212,6.2
12333,CN4830900000000,48,309,"McLennan County, TX",Jun-19,119667,115288,4379,3.7
12334,CN4831100000000,48,311,"McMullen County, TX",Jun-19,784,773,11,1.4
12335,CN4831300000000,48,313,"Madison County, TX",Jun-19,4548,4320,228,5.0
12336,CN4831500000000,48,315,"Marion County, TX",Jun-19,4217,4041,176,4.2
12337,CN4831700000000,48,317,"Martin County, TX",Jun-19,2883,2806,77,2.7
12338,CN4831900000000,48,319,"Mason County, TX",Jun-19,1816,1755,61,3.4
12339,CN4832100000000,48,321,"Matagorda County, TX",Jun-19,16747,15743,1004,6.0
12340,CN4832300000000,48,323,"Maverick County, TX",Jun-19,23888,22080,1808,7.6
12341,CN4832500000000,48,325,"Medina County, TX",Jun-19,21777,21062,715,3.3
12342,CN4832700000000,48,327,"Menard County, TX",Jun-19,867,835,32,3.7
12343,CN4832900000000,48,329,"Midland County, TX",Jun-19,107232,104944,2288,2.1
12344,CN4833100000000,48,331,"Milam County, TX",Jun-19,9850,9344,506,5.1
12345,CN4833300000000,48,333,"Mills County, TX",Jun-19,1880,1818,62,3.3
12346,CN4833500000000,48,335,"Mitchell County, TX",Jun-19,2334,2244,90,3.9
12347,CN4833700000000,48,337,"Montague County, TX",Jun-19,9403,9129,274,2.9
12348,CN4833900000000,48,339,"Montgomery County, TX",Jun-19,283353,273228,10125,3.6
12349,CN4834100000000,48,341,"Moore County, TX",Jun-19,11050,10773,277,2.5
12350,CN4834300000000,48,343,"Morris County, TX",Jun-19,4834,4569,265,5.5
12351,CN4834500000000,48,345,"Motley County, TX",Jun-19,490,470,20,4.1
12352,CN4834700000000,48,347,"Nacogdoches County, TX",Jun-19,27947,26741,1206,4.3
12353,CN4834900000000,48,349,"Navarro County, TX",Jun-19,23822,23017,805,3.4
12354,CN4835100000000,48,351,"Newton County, TX",Jun-19,5164,4824,340,6.6
12355,CN4835300000000,48,353,"Nolan County, TX",Jun-19,7093,6873,220,3.1
12356,CN4835500000000,48,355,"Nueces County, TX",Jun-19,167157,159955,7202,4.3
12357,CN4835700000000,48,357,"Ochiltree County, TX",Jun-19,4300,4178,122,2.8
12358,CN4835900000000,48,359,"Oldham County, TX",Jun-19,916,887,29,3.2
12359,CN4836100000000,48,361,"Orange County, TX",Jun-19,36238,34276,1962,5.4
12360,CN4836300000000,48,363,"Palo Pinto County, TX",Jun-19,13719,13261,458,3.3
12361,CN4836500000000,48,365,"Panola County, TX",Jun-19,10088,9665,423,4.2
12362,CN4836700000000,48,367,"Parker County, TX",Jun-19,67092,65018,2074,3.1
12363,CN4836900000000,48,369,"Parmer County, TX",Jun-19,4937,4818,119,2.4
12364,CN4837100000000,48,371,"Pecos County, TX",Jun-19,6487,6277,210,3.2
12365,CN4837300000000,48,373,"Polk County, TX",Jun-19,17902,17041,861,4.8
12366,CN4837500000000,48,375,"Potter County, TX",Jun-19,55084,53440,1644,3.0
12367,CN4837700000000,48,377,"Presidio County, TX",Jun-19,3132,2932,200,6.4
12368,CN4837900000000,48,379,"Rains County, TX",Jun-19,6021,5833,188,3.1
12369,CN4838100000000,48,381,"Randall County, TX",Jun-19,71923,70043,1880,2.6
12370,CN4838300000000,48,383,"Reagan County, TX",Jun-19,1955,1903,52,2.7
12371,CN4838500000000,48,385,"Real County, TX",Jun-19,1226,1174,52,4.2
12372,CN4838700000000,48,387,"Red River County, TX",Jun-19,5080,4843,237,4.7
12373,CN4838900000000,48,389,"Reeves County, TX",Jun-19,11572,11366,206,1.8
12374,CN4839100000000,48,391,"Refugio County, TX",Jun-19,3175,3052,123,3.9
12375,CN4839300000000,48,393,"Roberts County, TX",Jun-19,432,417,15,3.5
12376,CN4839500000000,48,395,"Robertson County, TX",Jun-19,7396,7110,286,3.9
12377,CN4839700000000,48,397,"Rockwall County, TX",Jun-19,51948,50255,1693,3.3
12378,CN4839900000000,48,399,"Runnels County, TX",Jun-19,4656,4518,138,3.0
12379,CN4840100000000,48,401,"Rusk County, TX",Jun-19,22996,22138,858,3.7
12380,CN4840300000000,48,403,"Sabine County, TX",Jun-19,3813,3543,270,7.1
12381,CN4840500000000,48,405,"San Augustine County, TX",Jun-19,3343,3186,157,4.7
12382,CN4840700000000,48,407,"San Jacinto County, TX",Jun-19,11761,11208,553,4.7
12383,CN4840900000000,48,409,"San Patricio County, TX",Jun-19,29885,28185,1700,5.7
12384,CN4841100000000,48,411,"San Saba County, TX",Jun-19,2517,2439,78,3.1
12385,CN4841300000000,48,413,"Schleicher County, TX",Jun-19,1327,1289,38,2.9
12386,CN4841500000000,48,415,"Scurry County, TX",Jun-19,6845,6587,258,3.8
12387,CN4841700000000,48,417,"Shackelford County, TX",Jun-19,1940,1896,44,2.3
12388,CN4841900000000,48,419,"Shelby County, TX",Jun-19,11299,10844,455,4.0
12389,CN4842100000000,48,421,"Sherman County, TX",Jun-19,1396,1360,36,2.6
12390,CN4842300000000,48,423,"Smith County, TX",Jun-19,107044,103249,3795,3.5
12391,CN4842500000000,48,425,"Somervell County, TX",Jun-19,4350,4185,165,3.8
12392,CN4842700000000,48,427,"Starr County, TX",Jun-19,24817,22356,2461,9.9
12393,CN4842900000000,48,429,"Stephens County, TX",Jun-19,4083,3947,136,3.3
12394,CN4843100000000,48,431,"Sterling County, TX",Jun-19,591,574,17,2.9
12395,CN4843300000000,48,433,"Stonewall County, TX",Jun-19,614,597,17,2.8
12396,CN4843500000000,48,435,"Sutton County, TX",Jun-19,1533,1477,56,3.7
12397,CN4843700000000,48,437,"Swisher County, TX",Jun-19,2634,2533,101,3.8
12398,CN4843900000000,48,439,"Tarrant County, TX",Jun-19,1078738,1041255,37483,3.5
12399,CN4844100000000,48,441,"Taylor County, TX",Jun-19,66501,64405,2096,3.2
12400,CN4844300000000,48,443,"Terrell County, TX",Jun-19,400,388,12,3.0
12401,CN4844500000000,48,445,"Terry County, TX",Jun-19,5023,4826,197,3.9
12402,CN4844700000000,48,447,"Throckmorton County, TX",Jun-19,668,640,28,4.2
12403,CN4844900000000,48,449,"Titus County, TX",Jun-19,13025,12443,582,4.5
12404,CN4845100000000,48,451,"Tom Green County, TX",Jun-19,54391,52606,1785,3.3
12405,CN4845300000000,48,453,"Travis County, TX",Jun-19,739439,719531,19908,2.7
12406,CN4845500000000,48,455,"Trinity County, TX",Jun-19,5313,5067,246,4.6
12407,CN4845700000000,48,457,"Tyler County, TX",Jun-19,7189,6755,434,6.0
12408,CN4845900000000,48,459,"Upshur County, TX",Jun-19,17824,17164,660,3.7
12409,CN4846100000000,48,461,"Upton County, TX",Jun-19,1715,1662,53,3.1
12410,CN4846300000000,48,463,"Uvalde County, TX",Jun-19,11724,11252,472,4.0
12411,CN4846500000000,48,465,"Val Verde County, TX",Jun-19,23154,22365,789,3.4
12412,CN4846700000000,48,467,"Van Zandt County, TX",Jun-19,26420,25527,893,3.4
12413,CN4846900000000,48,469,"Victoria County, TX",Jun-19,42698,41163,1535,3.6
12414,CN4847100000000,48,471,"Walker County, TX",Jun-19,23963,22915,1048,4.4
12415,CN4847300000000,48,473,"Waller County, TX",Jun-19,23488,22507,981,4.2
12416,CN4847500000000,48,475,"Ward County, TX",Jun-19,7477,7298,179,2.4
12417,CN4847700000000,48,477,"Washington County, TX",Jun-19,15116,14551,565,3.7
12418,CN4847900000000,48,479,"Webb County, TX",Jun-19,118663,113933,4730,4.0
12419,CN4848100000000,48,481,"Wharton County, TX",Jun-19,21791,21001,790,3.6
12420,CN4848300000000,48,483,"Wheeler County, TX",Jun-19,2286,2219,67,2.9
12421,CN4848500000000,48,485,"Wichita County, TX",Jun-19,56465,54485,1980,3.5
12422,CN4848700000000,48,487,"Wilbarger County, TX",Jun-19,4970,4779,191,3.8
12423,CN4848900000000,48,489,"Willacy County, TX",Jun-19,6525,5923,602,9.2
12424,CN4849100000000,48,491,"Williamson County, TX",Jun-19,313294,304149,9145,2.9
12425,CN4849300000000,48,493,"Wilson County, TX",Jun-19,24840,24078,762,3.1
12426,CN4849500000000,48,495,"Winkler County, TX",Jun-19,3977,3859,118,3.0
12427,CN4849700000000,48,497,"Wise County, TX",Jun-19,31860,30698,1162,3.6
12428,CN4849900000000,48,499,"Wood County, TX",Jun-19,17727,17034,693,3.9
12429,CN4850100000000,48,501,"Yoakum County, TX",Jun-19,3868,3746,122,3.2
12430,CN4850300000000,48,503,"Young County, TX",Jun-19,8074,7824,250,3.1
12431,CN4850500000000,48,505,"Zapata County, TX",Jun-19,5111,4846,265,5.2
12432,CN4850700000000,48,507,"Zavala County, TX",Jun-19,3298,3000,298,9.0
12433,CN4900100000000,49,1,"Beaver County, UT",Jun-19,2915,2802,113,3.9
12434,CN4900300000000,49,3,"Box Elder County, UT",Jun-19,26101,25332,769,2.9
12435,CN4900500000000,49,5,"Cache County, UT",Jun-19,63871,62226,1645,2.6
12436,CN4900700000000,49,7,"Carbon County, UT",Jun-19,8625,8257,368,4.3
12437,CN4900900000000,49,9,"Daggett County, UT",Jun-19,458,444,14,3.1
12438,CN4901100000000,49,11,"Davis County, UT",Jun-19,175134,170230,4904,2.8
12439,CN4901300000000,49,13,"Duchesne County, UT",Jun-19,7968,7621,347,4.4
12440,CN4901500000000,49,15,"Emery County, UT",Jun-19,4489,4299,190,4.2
12441,CN4901700000000,49,17,"Garfield County, UT",Jun-19,3275,3139,136,4.2
12442,CN4901900000000,49,19,"Grand County, UT",Jun-19,6811,6630,181,2.7
12443,CN4902100000000,49,21,"Iron County, UT",Jun-19,23247,22416,831,3.6
12444,CN4902300000000,49,23,"Juab County, UT",Jun-19,5671,5507,164,2.9
12445,CN4902500000000,49,25,"Kane County, UT",Jun-19,4075,3962,113,2.8
12446,CN4902700000000,49,27,"Millard County, UT",Jun-19,6180,5995,185,3.0
12447,CN4902900000000,49,29,"Morgan County, UT",Jun-19,5613,5449,164,2.9
12448,CN4903100000000,49,31,"Piute County, UT",Jun-19,491,468,23,4.7
12449,CN4903300000000,49,33,"Rich County, UT",Jun-19,1446,1411,35,2.4
12450,CN4903500000000,49,35,"Salt Lake County, UT",Jun-19,638198,619745,18453,2.9
12451,CN4903700000000,49,37,"San Juan County, UT",Jun-19,6090,5799,291,4.8
12452,CN4903900000000,49,39,"Sanpete County, UT",Jun-19,12750,12260,490,3.8
12453,CN4904100000000,49,41,"Sevier County, UT",Jun-19,9947,9602,345,3.5
12454,CN4904300000000,49,43,"Summit County, UT",Jun-19,24358,23638,720,3.0
12455,CN4904500000000,49,45,"Tooele County, UT",Jun-19,34212,33071,1141,3.3
12456,CN4904700000000,49,47,"Uintah County, UT",Jun-19,14027,13365,662,4.7
12457,CN4904900000000,49,49,"Utah County, UT",Jun-19,305224,296591,8633,2.8
12458,CN4905100000000,49,51,"Wasatch County, UT",Jun-19,16343,15839,504,3.1
12459,CN4905300000000,49,53,"Washington County, UT",Jun-19,75145,72576,2569,3.4
12460,CN4905500000000,49,55,"Wayne County, UT",Jun-19,1534,1470,64,4.2
12461,CN4905700000000,49,57,"Weber County, UT",Jun-19,128320,124268,4052,3.2
12462,CN5000100000000,50,1,"Addison County, VT",Jun-19,21024,20520,504,2.4
12463,CN5000300000000,50,3,"Bennington County, VT",Jun-19,18304,17768,536,2.9
12464,CN5000500000000,50,5,"Caledonia County, VT",Jun-19,14722,14278,444,3.0
12465,CN5000700000000,50,7,"Chittenden County, VT",Jun-19,97588,95495,2093,2.1
12466,CN5000900000000,50,9,"Essex County, VT",Jun-19,2761,2684,77,2.8
12467,CN5001100000000,50,11,"Franklin County, VT",Jun-19,27837,27222,615,2.2
12468,CN5001300000000,50,13,"Grand Isle County, VT",Jun-19,4043,3958,85,2.1
12469,CN5001500000000,50,15,"Lamoille County, VT",Jun-19,14023,13622,401,2.9
12470,CN5001700000000,50,17,"Orange County, VT",Jun-19,16226,15858,368,2.3
12471,CN5001900000000,50,19,"Orleans County, VT",Jun-19,13378,12892,486,3.6
12472,CN5002100000000,50,21,"Rutland County, VT",Jun-19,30963,30039,924,3.0
12473,CN5002300000000,50,23,"Washington County, VT",Jun-19,34538,33780,758,2.2
12474,CN5002500000000,50,25,"Windham County, VT",Jun-19,22301,21686,615,2.8
12475,CN5002700000000,50,27,"Windsor County, VT",Jun-19,29245,28577,668,2.3
12476,CN5100100000000,51,1,"Accomack County, VA",Jun-19,17300,16743,557,3.2
12477,CN5100300000000,51,3,"Albemarle County, VA",Jun-19,58064,56462,1602,2.8
12478,CN5100500000000,51,5,"Alleghany County, VA",Jun-19,6935,6702,233,3.4
12479,CN5100700000000,51,7,"Amelia County, VA",Jun-19,6408,6199,209,3.3
12480,CN5100900000000,51,9,"Amherst County, VA",Jun-19,15142,14596,546,3.6
12481,CN5101100000000,51,11,"Appomattox County, VA",Jun-19,7229,6955,274,3.8
12482,CN5101300000000,51,13,"Arlington County, VA",Jun-19,156605,153475,3130,2.0
12483,CN5101500000000,51,15,"Augusta County, VA",Jun-19,37937,36954,983,2.6
12484,CN5101700000000,51,17,"Bath County, VA",Jun-19,2641,2581,60,2.3
12485,CN5101900000000,51,19,"Bedford County, VA",Jun-19,38661,37483,1178,3.0
12486,CN5102100000000,51,21,"Bland County, VA",Jun-19,2851,2767,84,2.9
12487,CN5102300000000,51,23,"Botetourt County, VA",Jun-19,17456,16994,462,2.6
12488,CN5102500000000,51,25,"Brunswick County, VA",Jun-19,6172,5883,289,4.7
12489,CN5102700000000,51,27,"Buchanan County, VA",Jun-19,6804,6468,336,4.9
12490,CN5102900000000,51,29,"Buckingham County, VA",Jun-19,6534,6254,280,4.3
12491,CN5103100000000,51,31,"Campbell County, VA",Jun-19,26090,25220,870,3.3
12492,CN5103300000000,51,33,"Caroline County, VA",Jun-19,15439,14923,516,3.3
12493,CN5103500000000,51,35,"Carroll County, VA",Jun-19,13577,13122,455,3.4
12494,CN5103600000000,51,36,"Charles City County, VA",Jun-19,3736,3600,136,3.6
12495,CN5103700000000,51,37,"Charlotte County, VA",Jun-19,5391,5184,207,3.8
12496,CN5104100000000,51,41,"Chesterfield County, VA",Jun-19,189383,183892,5491,2.9
12497,CN5104300000000,51,43,"Clarke County, VA",Jun-19,7808,7606,202,2.6
12498,CN5104500000000,51,45,"Craig County, VA",Jun-19,2318,2238,80,3.5
12499,CN5104700000000,51,47,"Culpeper County, VA",Jun-19,25174,24494,680,2.7
12500,CN5104900000000,51,49,"Cumberland County, VA",Jun-19,4709,4562,147,3.1
12501,CN5105100000000,51,51,"Dickenson County, VA",Jun-19,4789,4547,242,5.1
12502,CN5105300000000,51,53,"Dinwiddie County, VA",Jun-19,13919,13426,493,3.5
12503,CN5105700000000,51,57,"Essex County, VA",Jun-19,5587,5404,183,3.3
12504,CN5105900000000,51,59,"Fairfax County, VA",Jun-19,645532,629898,15634,2.4
12505,CN5106100000000,51,61,"Fauquier County, VA",Jun-19,38163,37177,986,2.6
12506,CN5106300000000,51,63,"Floyd County, VA",Jun-19,8182,7963,219,2.7
12507,CN5106500000000,51,65,"Fluvanna County, VA",Jun-19,14061,13709,352,2.5
12508,CN5106700000000,51,67,"Franklin County, VA",Jun-19,26579,25771,808,3.0
12509,CN5106900000000,51,69,"Frederick County, VA",Jun-19,48540,47289,1251,2.6
12510,CN5107100000000,51,71,"Giles County, VA",Jun-19,7760,7494,266,3.4
12511,CN5107300000000,51,73,"Gloucester County, VA",Jun-19,19951,19418,533,2.7
12512,CN5107500000000,51,75,"Goochland County, VA",Jun-19,11403,11069,334,2.9
12513,CN5107700000000,51,77,"Grayson County, VA",Jun-19,8258,8035,223,2.7
12514,CN5107900000000,51,79,"Greene County, VA",Jun-19,10636,10373,263,2.5
12515,CN5108100000000,51,81,"Greensville County, VA",Jun-19,4290,4150,140,3.3
12516,CN5108300000000,51,83,"Halifax County, VA",Jun-19,15892,15232,660,4.2
12517,CN5108500000000,51,85,"Hanover County, VA",Jun-19,59918,58387,1531,2.6
12518,CN5108700000000,51,87,"Henrico County, VA",Jun-19,183667,178284,5383,2.9
12519,CN5108900000000,51,89,"Henry County, VA",Jun-19,23855,23005,850,3.6
12520,CN5109100000000,51,91,"Highland County, VA",Jun-19,1370,1340,30,2.2
12521,CN5109300000000,51,93,"Isle of Wight County, VA",Jun-19,19848,19256,592,3.0
12522,CN5109500000000,51,95,"James City County, VA",Jun-19,37219,36166,1053,2.8
12523,CN5109700000000,51,97,"King and Queen County, VA",Jun-19,3917,3806,111,2.8
12524,CN5109900000000,51,99,"King George County, VA",Jun-19,13597,13237,360,2.6
12525,CN5110100000000,51,101,"King William County, VA",Jun-19,9290,9041,249,2.7
12526,CN5110300000000,51,103,"Lancaster County, VA",Jun-19,5545,5355,190,3.4
12527,CN5110500000000,51,105,"Lee County, VA",Jun-19,8355,8036,319,3.8
12528,CN5110700000000,51,107,"Loudoun County, VA",Jun-19,226050,220546,5504,2.4
12529,CN5110900000000,51,109,"Louisa County, VA",Jun-19,20129,19582,547,2.7
12530,CN5111100000000,51,111,"Lunenburg County, VA",Jun-19,5381,5202,179,3.3
12531,CN5111300000000,51,113,"Madison County, VA",Jun-19,7604,7424,180,2.4
12532,CN5111500000000,51,115,"Mathews County, VA",Jun-19,4213,4090,123,2.9
12533,CN5111700000000,51,117,"Mecklenburg County, VA",Jun-19,12864,12311,553,4.3
12534,CN5111900000000,51,119,"Middlesex County, VA",Jun-19,5492,5349,143,2.6
12535,CN5112100000000,51,121,"Montgomery County, VA",Jun-19,49029,47442,1587,3.2
12536,CN5112500000000,51,125,"Nelson County, VA",Jun-19,7659,7416,243,3.2
12537,CN5112700000000,51,127,"New Kent County, VA",Jun-19,12650,12320,330,2.6
12538,CN5113100000000,51,131,"Northampton County, VA",Jun-19,5859,5633,226,3.9
12539,CN5113300000000,51,133,"Northumberland County, VA",Jun-19,5895,5692,203,3.4
12540,CN5113500000000,51,135,"Nottoway County, VA",Jun-19,7315,7102,213,2.9
12541,CN5113700000000,51,137,"Orange County, VA",Jun-19,17811,17242,569,3.2
12542,CN5113900000000,51,139,"Page County, VA",Jun-19,12362,11956,406,3.3
12543,CN5114100000000,51,141,"Patrick County, VA",Jun-19,7554,7291,263,3.5
12544,CN5114300000000,51,143,"Pittsylvania County, VA",Jun-19,30465,29349,1116,3.7
12545,CN5114500000000,51,145,"Powhatan County, VA",Jun-19,14306,13937,369,2.6
12546,CN5114700000000,51,147,"Prince Edward County, VA",Jun-19,10656,10184,472,4.4
12547,CN5114900000000,51,149,"Prince George County, VA",Jun-19,15250,14705,545,3.6
12548,CN5115300000000,51,153,"Prince William County, VA",Jun-19,249170,242598,6572,2.6
12549,CN5115500000000,51,155,"Pulaski County, VA",Jun-19,15671,15139,532,3.4
12550,CN5115700000000,51,157,"Rappahannock County, VA",Jun-19,3817,3721,96,2.5
12551,CN5115900000000,51,159,"Richmond County, VA",Jun-19,4162,4042,120,2.9
12552,CN5116100000000,51,161,"Roanoke County, VA",Jun-19,49393,48042,1351,2.7
12553,CN5116300000000,51,163,"Rockbridge County, VA",Jun-19,10824,10510,314,2.9
12554,CN5116500000000,51,165,"Rockingham County, VA",Jun-19,41775,40652,1123,2.7
12555,CN5116700000000,51,167,"Russell County, VA",Jun-19,11357,10894,463,4.1
12556,CN5116900000000,51,169,"Scott County, VA",Jun-19,9142,8842,300,3.3
12557,CN5117100000000,51,171,"Shenandoah County, VA",Jun-19,22595,22000,595,2.6
12558,CN5117300000000,51,173,"Smyth County, VA",Jun-19,13878,13373,505,3.6
12559,CN5117500000000,51,175,"Southampton County, VA",Jun-19,9285,9039,246,2.6
12560,CN5117700000000,51,177,"Spotsylvania County, VA",Jun-19,68190,66079,2111,3.1
12561,CN5117900000000,51,179,"Stafford County, VA",Jun-19,73042,70952,2090,2.9
12562,CN5118100000000,51,181,"Surry County, VA",Jun-19,3712,3572,140,3.8
12563,CN5118300000000,51,183,"Sussex County, VA",Jun-19,3945,3765,180,4.6
12564,CN5118500000000,51,185,"Tazewell County, VA",Jun-19,16027,15351,676,4.2
12565,CN5118700000000,51,187,"Warren County, VA",Jun-19,20804,20205,599,2.9
12566,CN5119100000000,51,191,"Washington County, VA",Jun-19,26738,25805,933,3.5
12567,CN5119300000000,51,193,"Westmoreland County, VA",Jun-19,9807,9494,313,3.2
12568,CN5119500000000,51,195,"Wise County, VA",Jun-19,13387,12750,637,4.8
12569,CN5119700000000,51,197,"Wythe County, VA",Jun-19,13816,13340,476,3.4
12570,CN5119900000000,51,199,"York County, VA",Jun-19,33220,32302,918,2.8
12571,CN5151000000000,51,510,"Alexandria city, VA",Jun-19,102791,100561,2230,2.2
12572,CN5152000000000,51,520,"Bristol city, VA",Jun-19,7206,6914,292,4.1
12573,CN5153000000000,51,530,"Buena Vista city, VA",Jun-19,3285,3179,106,3.2
12574,CN5154000000000,51,540,"Charlottesville city, VA",Jun-19,26690,25964,726,2.7
12575,CN5155000000000,51,550,"Chesapeake city, VA",Jun-19,124381,120662,3719,3.0
12576,CN5157000000000,51,570,"Colonial Heights city, VA",Jun-19,8896,8594,302,3.4
12577,CN5158000000000,51,580,"Covington city, VA",Jun-19,2393,2287,106,4.4
12578,CN5159000000000,51,590,"Danville city, VA",Jun-19,19144,18076,1068,5.6
12579,CN5159500000000,51,595,"Emporia city, VA",Jun-19,2310,2196,114,4.9
12580,CN5160000000000,51,600,"Fairfax city, VA",Jun-19,13660,13361,299,2.2
12581,CN5161000000000,51,610,"Falls Church city, VA",Jun-19,8738,8546,192,2.2
12582,CN5162000000000,51,620,"Franklin city, VA",Jun-19,3613,3461,152,4.2
12583,CN5163000000000,51,630,"Fredericksburg city, VA",Jun-19,14358,13845,513,3.6
12584,CN5164000000000,51,640,"Galax city, VA",Jun-19,2993,2886,107,3.6
12585,CN5165000000000,51,650,"Hampton city, VA",Jun-19,65227,62696,2531,3.9
12586,CN5166000000000,51,660,"Harrisonburg city, VA",Jun-19,24708,23772,936,3.8
12587,CN5167000000000,51,670,"Hopewell city, VA",Jun-19,9760,9328,432,4.4
12588,CN5167800000000,51,678,"Lexington city, VA",Jun-19,2060,1949,111,5.4
12589,CN5168000000000,51,680,"Lynchburg city, VA",Jun-19,36535,34963,1572,4.3
12590,CN5168300000000,51,683,"Manassas city, VA",Jun-19,22370,21798,572,2.6
12591,CN5168500000000,51,685,"Manassas Park city, VA",Jun-19,9535,9289,246,2.6
12592,CN5169000000000,51,690,"Martinsville city, VA",Jun-19,5501,5249,252,4.6
12593,CN5170000000000,51,700,"Newport News city, VA",Jun-19,89936,86729,3207,3.6
12594,CN5171000000000,51,710,"Norfolk city, VA",Jun-19,113114,109010,4104,3.6
12595,CN5172000000000,51,720,"Norton city, VA",Jun-19,1685,1621,64,3.8
12596,CN5173000000000,51,730,"Petersburg city, VA",Jun-19,13153,12390,763,5.8
12597,CN5173500000000,51,735,"Poquoson city, VA",Jun-19,6511,6349,162,2.5
12598,CN5174000000000,51,740,"Portsmouth city, VA",Jun-19,44826,43054,1772,4.0
12599,CN5175000000000,51,750,"Radford city, VA",Jun-19,8439,8089,350,4.1
12600,CN5176000000000,51,760,"Richmond city, VA",Jun-19,119520,115416,4104,3.4
12601,CN5177000000000,51,770,"Roanoke city, VA",Jun-19,49277,47580,1697,3.4
12602,CN5177500000000,51,775,"Salem city, VA",Jun-19,12952,12570,382,2.9
12603,CN5179000000000,51,790,"Staunton city, VA",Jun-19,12299,11947,352,2.9
12604,CN5180000000000,51,800,"Suffolk city, VA",Jun-19,45257,43819,1438,3.2
12605,CN5181000000000,51,810,"Virginia Beach city, VA",Jun-19,236312,229727,6585,2.8
12606,CN5182000000000,51,820,"Waynesboro city, VA",Jun-19,10714,10398,316,2.9
12607,CN5183000000000,51,830,"Williamsburg city, VA",Jun-19,6805,6513,292,4.3
12608,CN5184000000000,51,840,"Winchester city, VA",Jun-19,14966,14531,435,2.9
12609,CN5300100000000,53,1,"Adams County, WA",Jun-19,11077,10596,481,4.3
12610,CN5300300000000,53,3,"Asotin County, WA",Jun-19,10278,9864,414,4.0
12611,CN5300500000000,53,5,"Benton County, WA",Jun-19,106329,101209,5120,4.8
12612,CN5300700000000,53,7,"Chelan County, WA",Jun-19,47914,45937,1977,4.1
12613,CN5300900000000,53,9,"Clallam County, WA",Jun-19,28865,26997,1868,6.5
12614,CN5301100000000,53,11,"Clark County, WA",Jun-19,239487,227714,11773,4.9
12615,CN5301300000000,53,13,"Columbia County, WA",Jun-19,1864,1770,94,5.0
12616,CN5301500000000,53,15,"Cowlitz County, WA",Jun-19,47638,44672,2966,6.2
12617,CN5301700000000,53,17,"Douglas County, WA",Jun-19,22802,21712,1090,4.8
12618,CN5301900000000,53,19,"Ferry County, WA",Jun-19,2573,2317,256,9.9
12619,CN5302100000000,53,21,"Franklin County, WA",Jun-19,45874,43347,2527,5.5
12620,CN5302300000000,53,23,"Garfield County, WA",Jun-19,936,893,43,4.6
12621,CN5302500000000,53,25,"Grant County, WA",Jun-19,49963,47202,2761,5.5
12622,CN5302700000000,53,27,"Grays Harbor County, WA",Jun-19,29054,27060,1994,6.9
12623,CN5302900000000,53,29,"Island County, WA",Jun-19,35965,34088,1877,5.2
12624,CN5303100000000,53,31,"Jefferson County, WA",Jun-19,12947,12210,737,5.7
12625,CN5303300000000,53,33,"King County, WA",Jun-19,1287036,1250770,36266,2.8
12626,CN5303500000000,53,35,"Kitsap County, WA",Jun-19,127845,121693,6152,4.8
12627,CN5303700000000,53,37,"Kittitas County, WA",Jun-19,23477,22222,1255,5.3
12628,CN5303900000000,53,39,"Klickitat County, WA",Jun-19,11075,10472,603,5.4
12629,CN5304100000000,53,41,"Lewis County, WA",Jun-19,34884,32797,2087,6.0
12630,CN5304300000000,53,43,"Lincoln County, WA",Jun-19,5110,4872,238,4.7
12631,CN5304500000000,53,45,"Mason County, WA",Jun-19,24910,23300,1610,6.5
12632,CN5304700000000,53,47,"Okanogan County, WA",Jun-19,21218,20022,1196,5.6
12633,CN5304900000000,53,49,"Pacific County, WA",Jun-19,8644,8062,582,6.7
12634,CN5305100000000,53,51,"Pend Oreille County, WA",Jun-19,4994,4659,335,6.7
12635,CN5305300000000,53,53,"Pierce County, WA",Jun-19,438243,415121,23122,5.3
12636,CN5305500000000,53,55,"San Juan County, WA",Jun-19,9188,8869,319,3.5
12637,CN5305700000000,53,57,"Skagit County, WA",Jun-19,63521,60058,3463,5.5
12638,CN5305900000000,53,59,"Skamania County, WA",Jun-19,5495,5196,299,5.4
12639,CN5306100000000,53,61,"Snohomish County, WA",Jun-19,438192,424926,13266,3.0
12640,CN5306300000000,53,63,"Spokane County, WA",Jun-19,253127,240047,13080,5.2
12641,CN5306500000000,53,65,"Stevens County, WA",Jun-19,18865,17693,1172,6.2
12642,CN5306700000000,53,67,"Thurston County, WA",Jun-19,141189,134142,7047,5.0
12643,CN5306900000000,53,69,"Wahkiakum County, WA",Jun-19,1348,1267,81,6.0
12644,CN5307100000000,53,71,"Walla Walla County, WA",Jun-19,30500,29007,1493,4.9
12645,CN5307300000000,53,73,"Whatcom County, WA",Jun-19,115468,109588,5880,5.1
12646,CN5307500000000,53,75,"Whitman County, WA",Jun-19,21528,20426,1102,5.1
12647,CN5307700000000,53,77,"Yakima County, WA",Jun-19,140204,132028,8176,5.8
12648,CN5400100000000,54,1,"Barbour County, WV",Jun-19,7036,6599,437,6.2
12649,CN5400300000000,54,3,"Berkeley County, WV",Jun-19,59487,57242,2245,3.8
12650,CN5400500000000,54,5,"Boone County, WV",Jun-19,7620,7182,438,5.7
12651,CN5400700000000,54,7,"Braxton County, WV",Jun-19,5350,5024,326,6.1
12652,CN5400900000000,54,9,"Brooke County, WV",Jun-19,10158,9610,548,5.4
12653,CN5401100000000,54,11,"Cabell County, WV",Jun-19,42099,40149,1950,4.6
12654,CN5401300000000,54,13,"Calhoun County, WV",Jun-19,2472,2231,241,9.7
12655,CN5401500000000,54,15,"Clay County, WV",Jun-19,3166,2941,225,7.1
12656,CN5401700000000,54,17,"Doddridge County, WV",Jun-19,4097,3927,170,4.1
12657,CN5401900000000,54,19,"Fayette County, WV",Jun-19,16592,15694,898,5.4
12658,CN5402100000000,54,21,"Gilmer County, WV",Jun-19,2305,2152,153,6.6
12659,CN5402300000000,54,23,"Grant County, WV",Jun-19,6129,5795,334,5.4
12660,CN5402500000000,54,25,"Greenbrier County, WV",Jun-19,16444,15742,702,4.3
12661,CN5402700000000,54,27,"Hampshire County, WV",Jun-19,10938,10491,447,4.1
12662,CN5402900000000,54,29,"Hancock County, WV",Jun-19,13253,12575,678,5.1
12663,CN5403100000000,54,31,"Hardy County, WV",Jun-19,5913,5622,291,4.9
12664,CN5403300000000,54,33,"Harrison County, WV",Jun-19,35357,33866,1491,4.2
12665,CN5403500000000,54,35,"Jackson County, WV",Jun-19,14181,13531,650,4.6
12666,CN5403700000000,54,37,"Jefferson County, WV",Jun-19,31459,30425,1034,3.3
12667,CN5403900000000,54,39,"Kanawha County, WV",Jun-19,84155,80317,3838,4.6
12668,CN5404100000000,54,41,"Lewis County, WV",Jun-19,6973,6574,399,5.7
12669,CN5404300000000,54,43,"Lincoln County, WV",Jun-19,7272,6812,460,6.3
12670,CN5404500000000,54,45,"Logan County, WV",Jun-19,11378,10710,668,5.9
12671,CN5404700000000,54,47,"McDowell County, WV",Jun-19,4536,4106,430,9.5
12672,CN5404900000000,54,49,"Marion County, WV",Jun-19,25557,24223,1334,5.2
12673,CN5405100000000,54,51,"Marshall County, WV",Jun-19,14533,13685,848,5.8
12674,CN5405300000000,54,53,"Mason County, WV",Jun-19,10441,9800,641,6.1
12675,CN5405500000000,54,55,"Mercer County, WV",Jun-19,21537,20224,1313,6.1
12676,CN5405700000000,54,57,"Mineral County, WV",Jun-19,12788,12002,786,6.1
12677,CN5405900000000,54,59,"Mingo County, WV",Jun-19,7089,6582,507,7.2
12678,CN5406100000000,54,61,"Monongalia County, WV",Jun-19,53360,51147,2213,4.1
12679,CN5406300000000,54,63,"Monroe County, WV",Jun-19,6047,5793,254,4.2
12680,CN5406500000000,54,65,"Morgan County, WV",Jun-19,8371,8036,335,4.0
12681,CN5406700000000,54,67,"Nicholas County, WV",Jun-19,9656,9109,547,5.7
12682,CN5406900000000,54,69,"Ohio County, WV",Jun-19,21883,20890,993,4.5
12683,CN5407100000000,54,71,"Pendleton County, WV",Jun-19,3791,3647,144,3.8
12684,CN5407300000000,54,73,"Pleasants County, WV",Jun-19,2975,2792,183,6.2
12685,CN5407500000000,54,75,"Pocahontas County, WV",Jun-19,3830,3652,178,4.6
12686,CN5407700000000,54,77,"Preston County, WV",Jun-19,15235,14534,701,4.6
12687,CN5407900000000,54,79,"Putnam County, WV",Jun-19,26971,25745,1226,4.5
12688,CN5408100000000,54,81,"Raleigh County, WV",Jun-19,31143,29674,1469,4.7
12689,CN5408300000000,54,83,"Randolph County, WV",Jun-19,12471,11772,699,5.6
12690,CN5408500000000,54,85,"Ritchie County, WV",Jun-19,4428,4212,216,4.9
12691,CN5408700000000,54,87,"Roane County, WV",Jun-19,5071,4664,407,8.0
12692,CN5408900000000,54,89,"Summers County, WV",Jun-19,4520,4289,231,5.1
12693,CN5409100000000,54,91,"Taylor County, WV",Jun-19,8013,7632,381,4.8
12694,CN5409300000000,54,93,"Tucker County, WV",Jun-19,3459,3295,164,4.7
12695,CN5409500000000,54,95,"Tyler County, WV",Jun-19,3185,2947,238,7.5
12696,CN5409700000000,54,97,"Upshur County, WV",Jun-19,9588,8999,589,6.1
12697,CN5409900000000,54,99,"Wayne County, WV",Jun-19,15941,15064,877,5.5
12698,CN5410100000000,54,101,"Webster County, WV",Jun-19,3352,3162,190,5.7
12699,CN5410300000000,54,103,"Wetzel County, WV",Jun-19,6665,6234,431,6.5
12700,CN5410500000000,54,105,"Wirt County, WV",Jun-19,2302,2139,163,7.1
12701,CN5410700000000,54,107,"Wood County, WV",Jun-19,37325,35436,1889,5.1
12702,CN5410900000000,54,109,"Wyoming County, WV",Jun-19,6846,6353,493,7.2
12703,CN5500100000000,55,1,"Adams County, WI",Jun-19,8471,8061,410,4.8
12704,CN5500300000000,55,3,"Ashland County, WI",Jun-19,8205,7819,386,4.7
12705,CN5500500000000,55,5,"Barron County, WI",Jun-19,25101,24186,915,3.6
12706,CN5500700000000,55,7,"Bayfield County, WI",Jun-19,7809,7433,376,4.8
12707,CN5500900000000,55,9,"Brown County, WI",Jun-19,143903,138671,5232,3.6
12708,CN5501100000000,55,11,"Buffalo County, WI",Jun-19,6740,6457,283,4.2
12709,CN5501300000000,55,13,"Burnett County, WI",Jun-19,7385,7018,367,5.0
12710,CN5501500000000,55,15,"Calumet County, WI",Jun-19,28255,27335,920,3.3
12711,CN5501700000000,55,17,"Chippewa County, WI",Jun-19,33107,31900,1207,3.6
12712,CN5501900000000,55,19,"Clark County, WI",Jun-19,18636,18009,627,3.4
12713,CN5502100000000,55,21,"Columbia County, WI",Jun-19,31945,30856,1089,3.4
12714,CN5502300000000,55,23,"Crawford County, WI",Jun-19,7817,7510,307,3.9
12715,CN5502500000000,55,25,"Dane County, WI",Jun-19,324180,314369,9811,3.0
12716,CN5502700000000,55,27,"Dodge County, WI",Jun-19,48794,47179,1615,3.3
12717,CN5502900000000,55,29,"Door County, WI",Jun-19,17002,16435,567,3.3
12718,CN5503100000000,55,31,"Douglas County, WI",Jun-19,23067,22049,1018,4.4
12719,CN5503300000000,55,33,"Dunn County, WI",Jun-19,23466,22541,925,3.9
12720,CN5503500000000,55,35,"Eau Claire County, WI",Jun-19,58827,56686,2141,3.6
12721,CN5503700000000,55,37,"Florence County, WI",Jun-19,2284,2185,99,4.3
12722,CN5503900000000,55,39,"Fond du Lac County, WI",Jun-19,58938,56962,1976,3.4
12723,CN5504100000000,55,41,"Forest County, WI",Jun-19,4177,3962,215,5.1
12724,CN5504300000000,55,43,"Grant County, WI",Jun-19,27820,26797,1023,3.7
12725,CN5504500000000,55,45,"Green County, WI",Jun-19,21430,20740,690,3.2
12726,CN5504700000000,55,47,"Green Lake County, WI",Jun-19,9911,9530,381,3.8
12727,CN5504900000000,55,49,"Iowa County, WI",Jun-19,14040,13611,429,3.1
12728,CN5505100000000,55,51,"Iron County, WI",Jun-19,2585,2442,143,5.5
12729,CN5505300000000,55,53,"Jackson County, WI",Jun-19,10705,10326,379,3.5
12730,CN5505500000000,55,55,"Jefferson County, WI",Jun-19,46637,44964,1673,3.6
12731,CN5505700000000,55,57,"Juneau County, WI",Jun-19,13989,13537,452,3.2
12732,CN5505900000000,55,59,"Kenosha County, WI",Jun-19,90934,86959,3975,4.4
12733,CN5506100000000,55,61,"Kewaunee County, WI",Jun-19,11354,10973,381,3.4
12734,CN5506300000000,55,63,"La Crosse County, WI",Jun-19,66067,63707,2360,3.6
12735,CN5506500000000,55,65,"Lafayette County, WI",Jun-19,10550,10249,301,2.9
12736,CN5506700000000,55,67,"Langlade County, WI",Jun-19,9633,9239,394,4.1
12737,CN5506900000000,55,69,"Lincoln County, WI",Jun-19,15272,14720,552,3.6
12738,CN5507100000000,55,71,"Manitowoc County, WI",Jun-19,41820,40290,1530,3.7
12739,CN5507300000000,55,73,"Marathon County, WI",Jun-19,74620,72161,2459,3.3
12740,CN5507500000000,55,75,"Marinette County, WI",Jun-19,19890,19009,881,4.4
12741,CN5507700000000,55,77,"Marquette County, WI",Jun-19,7895,7613,282,3.6
12742,CN5507800000000,55,78,"Menominee County, WI",Jun-19,1710,1556,154,9.0
12743,CN5507900000000,55,79,"Milwaukee County, WI",Jun-19,470607,449000,21607,4.6
12744,CN5508100000000,55,81,"Monroe County, WI",Jun-19,23994,23203,791,3.3
12745,CN5508300000000,55,83,"Oconto County, WI",Jun-19,20905,20143,762,3.6
12746,CN5508500000000,55,85,"Oneida County, WI",Jun-19,18670,17900,770,4.1
12747,CN5508700000000,55,87,"Outagamie County, WI",Jun-19,105025,101460,3565,3.4
12748,CN5508900000000,55,89,"Ozaukee County, WI",Jun-19,49520,47785,1735,3.5
12749,CN5509100000000,55,91,"Pepin County, WI",Jun-19,4359,4197,162,3.7
12750,CN5509300000000,55,93,"Pierce County, WI",Jun-19,25684,24765,919,3.6
12751,CN5509500000000,55,95,"Polk County, WI",Jun-19,24959,24086,873,3.5
12752,CN5509700000000,55,97,"Portage County, WI",Jun-19,38218,36741,1477,3.9
12753,CN5509900000000,55,99,"Price County, WI",Jun-19,6743,6453,290,4.3
12754,CN5510100000000,55,101,"Racine County, WI",Jun-19,99883,95498,4385,4.4
12755,CN5510300000000,55,103,"Richland County, WI",Jun-19,9545,9227,318,3.3
12756,CN5510500000000,55,105,"Rock County, WI",Jun-19,86443,82849,3594,4.2
12757,CN5510700000000,55,107,"Rusk County, WI",Jun-19,6734,6415,319,4.7
12758,CN5510900000000,55,109,"St. Croix County, WI",Jun-19,50786,49049,1737,3.4
12759,CN5511100000000,55,111,"Sauk County, WI",Jun-19,37217,36046,1171,3.1
12760,CN5511300000000,55,113,"Sawyer County, WI",Jun-19,8412,8065,347,4.1
12761,CN5511500000000,55,115,"Shawano County, WI",Jun-19,21790,21039,751,3.4
12762,CN5511700000000,55,117,"Sheboygan County, WI",Jun-19,63844,61783,2061,3.2
12763,CN5511900000000,55,119,"Taylor County, WI",Jun-19,11345,10959,386,3.4
12764,CN5512100000000,55,121,"Trempealeau County, WI",Jun-19,16376,15789,587,3.6
12765,CN5512300000000,55,123,"Vernon County, WI",Jun-19,15895,15369,526,3.3
12766,CN5512500000000,55,125,"Vilas County, WI",Jun-19,10976,10564,412,3.8
12767,CN5512700000000,55,127,"Walworth County, WI",Jun-19,58655,56456,2199,3.7
12768,CN5512900000000,55,129,"Washburn County, WI",Jun-19,8272,7963,309,3.7
12769,CN5513100000000,55,131,"Washington County, WI",Jun-19,77885,75273,2612,3.4
12770,CN5513300000000,55,133,"Waukesha County, WI",Jun-19,226330,218472,7858,3.5
12771,CN5513500000000,55,135,"Waupaca County, WI",Jun-19,26826,25889,937,3.5
12772,CN5513700000000,55,137,"Waushara County, WI",Jun-19,11763,11281,482,4.1
12773,CN5513900000000,55,139,"Winnebago County, WI",Jun-19,92133,88865,3268,3.5
12774,CN5514100000000,55,141,"Wood County, WI",Jun-19,35920,34491,1429,4.0
12775,CN5600100000000,56,1,"Albany County, WY",Jun-19,19308,18556,752,3.9
12776,CN5600300000000,56,3,"Big Horn County, WY",Jun-19,5555,5323,232,4.2
12777,CN5600500000000,56,5,"Campbell County, WY",Jun-19,23369,22541,828,3.5
12778,CN5600700000000,56,7,"Carbon County, WY",Jun-19,8290,8029,261,3.1
12779,CN5600900000000,56,9,"Converse County, WY",Jun-19,8752,8502,250,2.9
12780,CN5601100000000,56,11,"Crook County, WY",Jun-19,3909,3796,113,2.9
12781,CN5601300000000,56,13,"Fremont County, WY",Jun-19,18767,17920,847,4.5
12782,CN5601500000000,56,15,"Goshen County, WY",Jun-19,6720,6452,268,4.0
12783,CN5601700000000,56,17,"Hot Springs County, WY",Jun-19,2232,2152,80,3.6
12784,CN5601900000000,56,19,"Johnson County, WY",Jun-19,4453,4308,145,3.3
12785,CN5602100000000,56,21,"Laramie County, WY",Jun-19,48383,46635,1748,3.6
12786,CN5602300000000,56,23,"Lincoln County, WY",Jun-19,9342,9034,308,3.3
12787,CN5602500000000,56,25,"Natrona County, WY",Jun-19,39460,37860,1600,4.1
12788,CN5602700000000,56,27,"Niobrara County, WY",Jun-19,1279,1239,40,3.1
12789,CN5602900000000,56,29,"Park County, WY",Jun-19,16952,16370,582,3.4
12790,CN5603100000000,56,31,"Platte County, WY",Jun-19,4786,4616,170,3.6
12791,CN5603300000000,56,33,"Sheridan County, WY",Jun-19,16060,15502,558,3.5
12792,CN5603500000000,56,35,"Sublette County, WY",Jun-19,4309,4127,182,4.2
12793,CN5603700000000,56,37,"Sweetwater County, WY",Jun-19,21386,20544,842,3.9
12794,CN5603900000000,56,39,"Teton County, WY",Jun-19,16961,16586,375,2.2
12795,CN5604100000000,56,41,"Uinta County, WY",Jun-19,9221,8843,378,4.1
12796,CN5604300000000,56,43,"Washakie County, WY",Jun-19,4015,3849,166,4.1
12797,CN5604500000000,56,45,"Weston County, WY",Jun-19,3899,3784,115,2.9
12798,CN7200100000000,72,1,"Adjuntas Municipio, PR",Jun-19,4124,3550,574,13.9
12799,CN7200300000000,72,3,"Aguada Municipio, PR",Jun-19,12155,10935,1220,10.0
12800,CN7200500000000,72,5,"Aguadilla Municipio, PR",Jun-19,14894,13313,1581,10.6
12801,CN7200700000000,72,7,"Aguas Buenas Municipio, PR",Jun-19,6658,6066,592,8.9
12802,CN7200900000000,72,9,"Aibonito Municipio, PR",Jun-19,6565,5896,669,10.2
12803,CN7201100000000,72,11,"Anasco Municipio, PR",Jun-19,8986,8247,739,8.2
12804,CN7201300000000,72,13,"Arecibo Municipio, PR",Jun-19,24308,22088,2220,9.1
12805,CN7201500000000,72,15,"Arroyo Municipio, PR",Jun-19,4774,4140,634,13.3
12806,CN7201700000000,72,17,"Barceloneta Municipio, PR",Jun-19,5995,5347,648,10.8
12807,CN7201900000000,72,19,"Barranquitas Municipio, PR",Jun-19,7428,6803,625,8.4
12808,CN7202100000000,72,21,"Bayamon Municipio, PR",Jun-19,66528,62478,4050,6.1
12809,CN7202300000000,72,23,"Cabo Rojo Municipio, PR",Jun-19,13799,12633,1166,8.4
12810,CN7202500000000,72,25,"Caguas Municipio, PR",Jun-19,48681,45435,3246,6.7
12811,CN7202700000000,72,27,"Camuy Municipio, PR",Jun-19,9678,8874,804,8.3
12812,CN7202900000000,72,29,"Canovanas Municipio, PR",Jun-19,16329,15284,1045,6.4
12813,CN7203100000000,72,31,"Carolina Municipio, PR",Jun-19,62674,59036,3638,5.8
12814,CN7203300000000,72,33,"Catano Municipio, PR",Jun-19,7987,7432,555,6.9
12815,CN7203500000000,72,35,"Cayey Municipio, PR",Jun-19,16449,15316,1133,6.9
12816,CN7203700000000,72,37,"Ceiba Municipio, PR",Jun-19,3803,3414,389,10.2
12817,CN7203900000000,72,39,"Ciales Municipio, PR",Jun-19,3773,3349,424,11.2
12818,CN7204100000000,72,41,"Cidra Municipio, PR",Jun-19,15808,14726,1082,6.8
12819,CN7204300000000,72,43,"Coamo Municipio, PR",Jun-19,10036,8861,1175,11.7
12820,CN7204500000000,72,45,"Comerio Municipio, PR",Jun-19,4938,4537,401,8.1
12821,CN7204700000000,72,47,"Corozal Municipio, PR",Jun-19,9068,8240,828,9.1
12822,CN7204900000000,72,49,"Culebra Municipio, PR",Jun-19,933,907,26,2.8
12823,CN7205100000000,72,51,"Dorado Municipio, PR",Jun-19,13398,12668,730,5.4
12824,CN7205300000000,72,53,"Fajardo Municipio, PR",Jun-19,11233,10025,1208,10.8
12825,CN7205400000000,72,54,"Florida Municipio, PR",Jun-19,3357,3012,345,10.3
12826,CN7205500000000,72,55,"Guanica Municipio, PR",Jun-19,3983,3435,548,13.8
12827,CN7205700000000,72,57,"Guayama Municipio, PR",Jun-19,11331,9979,1352,11.9
12828,CN7205900000000,72,59,"Guayanilla Municipio, PR",Jun-19,5289,4627,662,12.5
12829,CN7206100000000,72,61,"Guaynabo Municipio, PR",Jun-19,38387,36895,1492,3.9
12830,CN7206300000000,72,63,"Gurabo Municipio, PR",Jun-19,18371,17364,1007,5.5
12831,CN7206500000000,72,65,"Hatillo Municipio, PR",Jun-19,13573,12144,1429,10.5
12832,CN7206700000000,72,67,"Hormigueros Municipio, PR",Jun-19,5553,5070,483,8.7
12833,CN7206900000000,72,69,"Humacao Municipio, PR",Jun-19,17536,15780,1756,10.0
12834,CN7207100000000,72,71,"Isabela Municipio, PR",Jun-19,12502,11336,1166,9.3
12835,CN7207300000000,72,73,"Jayuya Municipio, PR",Jun-19,4280,3664,616,14.4
12836,CN7207500000000,72,75,"Juana Diaz Municipio, PR",Jun-19,15361,13852,1509,9.8
12837,CN7207700000000,72,77,"Juncos Municipio, PR",Jun-19,12440,11435,1005,8.1
12838,CN7207900000000,72,79,"Lajas Municipio, PR",Jun-19,5245,4590,655,12.5
12839,CN7208100000000,72,81,"Lares Municipio, PR",Jun-19,6853,5899,954,13.9
12840,CN7208300000000,72,83,"Las Marias Municipio, PR",Jun-19,2660,2390,270,10.2
12841,CN7208500000000,72,85,"Las Piedras Municipio, PR",Jun-19,11521,10476,1045,9.1
12842,CN7208700000000,72,87,"Loiza Municipio, PR",Jun-19,8540,7920,620,7.3
12843,CN7208900000000,72,89,"Luquillo Municipio, PR",Jun-19,6317,5734,583,9.2
12844,CN7209100000000,72,91,"Manati Municipio, PR",Jun-19,11636,10710,926,8.0
12845,CN7209300000000,72,93,"Maricao Municipio, PR",Jun-19,1925,1643,282,14.6
12846,CN7209500000000,72,95,"Maunabo Municipio, PR",Jun-19,3012,2557,455,15.1
12847,CN7209700000000,72,97,"Mayaguez Municipio, PR",Jun-19,22445,20153,2292,10.2
12848,CN7209900000000,72,99,"Moca Municipio, PR",Jun-19,10730,9562,1168,10.9
12849,CN7210100000000,72,101,"Morovis Municipio, PR",Jun-19,8096,7361,735,9.1
12850,CN7210300000000,72,103,"Naguabo Municipio, PR",Jun-19,8246,7565,681,8.3
12851,CN7210500000000,72,105,"Naranjito Municipio, PR",Jun-19,7166,6574,592,8.3
12852,CN7210700000000,72,107,"Orocovis Municipio, PR",Jun-19,4989,4527,462,9.3
12853,CN7210900000000,72,109,"Patillas Municipio, PR",Jun-19,4385,3734,651,14.8
12854,CN7211100000000,72,111,"Penuelas Municipio, PR",Jun-19,6045,5192,853,14.1
12855,CN7211300000000,72,113,"Ponce Municipio, PR",Jun-19,46631,42280,4351,9.3
12856,CN7211500000000,72,115,"Quebradillas Municipio, PR",Jun-19,6188,5495,693,11.2
12857,CN7211700000000,72,117,"Rincon Municipio, PR",Jun-19,4703,4192,511,10.9
12858,CN7211900000000,72,119,"Rio Grande Municipio, PR",Jun-19,17165,15962,1203,7.0
12859,CN7212100000000,72,121,"Sabana Grande Municipio, PR",Jun-19,6272,5416,856,13.6
12860,CN7212300000000,72,123,"Salinas Municipio, PR",Jun-19,7179,6162,1017,14.2
12861,CN7212500000000,72,125,"San German Municipio, PR",Jun-19,9926,8809,1117,11.3
12862,CN7212700000000,72,127,"San Juan Municipio, PR",Jun-19,137084,129779,7305,5.3
12863,CN7212900000000,72,129,"San Lorenzo Municipio, PR",Jun-19,11898,10858,1040,8.7
12864,CN7213100000000,72,131,"San Sebastian Municipio, PR",Jun-19,10358,9010,1348,13.0
12865,CN7213300000000,72,133,"Santa Isabel Municipio, PR",Jun-19,9023,8144,879,9.7
12866,CN7213500000000,72,135,"Toa Alta Municipio, PR",Jun-19,27552,26046,1506,5.5
12867,CN7213700000000,72,137,"Toa Baja Municipio, PR",Jun-19,29696,28029,1667,5.6
12868,CN7213900000000,72,139,"Trujillo Alto Municipio, PR",Jun-19,27570,26267,1303,4.7
12869,CN7214100000000,72,141,"Utuado Municipio, PR",Jun-19,6715,5980,735,10.9
12870,CN7214300000000,72,143,"Vega Alta Municipio, PR",Jun-19,9859,9085,774,7.9
12871,CN7214500000000,72,145,"Vega Baja Municipio, PR",Jun-19,13479,12176,1303,9.7
12872,CN7214700000000,72,147,"Vieques Municipio, PR",Jun-19,2648,2480,168,6.3
12873,CN7214900000000,72,149,"Villalba Municipio, PR",Jun-19,7522,6466,1056,14.0
12874,CN7215100000000,72,151,"Yabucoa Municipio, PR",Jun-19,8996,7828,1168,13.0
12875,CN7215300000000,72,153,"Yauco Municipio, PR",Jun-19,9986,8545,1441,14.4
12876,CN0100100000000,01,1,"Autauga County, AL",Jul-19,26279,25552,727,2.8
12877,CN0100300000000,01,3,"Baldwin County, AL",Jul-19,99665,97121,2544,2.6
12878,CN0100500000000,01,5,"Barbour County, AL",Jul-19,8625,8271,354,4.1
12879,CN0100700000000,01,7,"Bibb County, AL",Jul-19,8713,8444,269,3.1
12880,CN0100900000000,01,9,"Blount County, AL",Jul-19,25535,24859,676,2.6
12881,CN0101100000000,01,11,"Bullock County, AL",Jul-19,4926,4733,193,3.9
12882,CN0101300000000,01,13,"Butler County, AL",Jul-19,9319,8954,365,3.9
12883,CN0101500000000,01,15,"Calhoun County, AL",Jul-19,46131,44470,1661,3.6
12884,CN0101700000000,01,17,"Chambers County, AL",Jul-19,15789,15266,523,3.3
12885,CN0101900000000,01,19,"Cherokee County, AL",Jul-19,11633,11291,342,2.9
12886,CN0102100000000,01,21,"Chilton County, AL",Jul-19,19978,19425,553,2.8
12887,CN0102300000000,01,23,"Choctaw County, AL",Jul-19,4559,4320,239,5.2
12888,CN0102500000000,01,25,"Clarke County, AL",Jul-19,7547,7059,488,6.5
12889,CN0102700000000,01,27,"Clay County, AL",Jul-19,6097,5896,201,3.3
12890,CN0102900000000,01,29,"Cleburne County, AL",Jul-19,5860,5684,176,3.0
12891,CN0103100000000,01,31,"Coffee County, AL",Jul-19,21455,20853,602,2.8
12892,CN0103300000000,01,33,"Colbert County, AL",Jul-19,23692,22713,979,4.1
12893,CN0103500000000,01,35,"Conecuh County, AL",Jul-19,4622,4435,187,4.0
12894,CN0103700000000,01,37,"Coosa County, AL",Jul-19,4589,4443,146,3.2
12895,CN0103900000000,01,39,"Covington County, AL",Jul-19,15778,15235,543,3.4
12896,CN0104100000000,01,41,"Crenshaw County, AL",Jul-19,6597,6398,199,3.0
12897,CN0104300000000,01,43,"Cullman County, AL",Jul-19,38527,37511,1016,2.6
12898,CN0104500000000,01,45,"Dale County, AL",Jul-19,20775,20128,647,3.1
12899,CN0104700000000,01,47,"Dallas County, AL",Jul-19,14934,13981,953,6.4
12900,CN0104900000000,01,49,"DeKalb County, AL",Jul-19,31758,30877,881,2.8
12901,CN0105100000000,01,51,"Elmore County, AL",Jul-19,37641,36661,980,2.6
12902,CN0105300000000,01,53,"Escambia County, AL",Jul-19,14852,14318,534,3.6
12903,CN0105500000000,01,55,"Etowah County, AL",Jul-19,42549,41065,1484,3.5
12904,CN0105700000000,01,57,"Fayette County, AL",Jul-19,6542,6323,219,3.3
12905,CN0105900000000,01,59,"Franklin County, AL",Jul-19,14743,14328,415,2.8
12906,CN0106100000000,01,61,"Geneva County, AL",Jul-19,11266,10967,299,2.7
12907,CN0106300000000,01,63,"Greene County, AL",Jul-19,2929,2724,205,7.0
12908,CN0106500000000,01,65,"Hale County, AL",Jul-19,6186,5902,284,4.6
12909,CN0106700000000,01,67,"Henry County, AL",Jul-19,7047,6796,251,3.6
12910,CN0106900000000,01,69,"Houston County, AL",Jul-19,46538,45113,1425,3.1
12911,CN0107100000000,01,71,"Jackson County, AL",Jul-19,23515,22708,807,3.4
12912,CN0107300000000,01,73,"Jefferson County, AL",Jul-19,319233,309785,9448,3.0
12913,CN0107500000000,01,75,"Lamar County, AL",Jul-19,5903,5715,188,3.2
12914,CN0107700000000,01,77,"Lauderdale County, AL",Jul-19,42651,41149,1502,3.5
12915,CN0107900000000,01,79,"Lawrence County, AL",Jul-19,14376,13910,466,3.2
12916,CN0108100000000,01,81,"Lee County, AL",Jul-19,76138,74009,2129,2.8
12917,CN0108300000000,01,83,"Limestone County, AL",Jul-19,43911,42724,1187,2.7
12918,CN0108500000000,01,85,"Lowndes County, AL",Jul-19,3625,3406,219,6.0
12919,CN0108700000000,01,87,"Macon County, AL",Jul-19,7869,7495,374,4.8
12920,CN0108900000000,01,89,"Madison County, AL",Jul-19,185041,180133,4908,2.7
12921,CN0109100000000,01,91,"Marengo County, AL",Jul-19,7711,7428,283,3.7
12922,CN0109300000000,01,93,"Marion County, AL",Jul-19,13067,12603,464,3.6
12923,CN0109500000000,01,95,"Marshall County, AL",Jul-19,44488,43408,1080,2.4
12924,CN0109700000000,01,97,"Mobile County, AL",Jul-19,188081,180694,7387,3.9
12925,CN0109900000000,01,99,"Monroe County, AL",Jul-19,7435,7062,373,5.0
12926,CN0110100000000,01,101,"Montgomery County, AL",Jul-19,105847,102506,3341,3.2
12927,CN0110300000000,01,103,"Morgan County, AL",Jul-19,58199,56657,1542,2.6
12928,CN0110500000000,01,105,"Perry County, AL",Jul-19,3443,3206,237,6.9
12929,CN0110700000000,01,107,"Pickens County, AL",Jul-19,7915,7588,327,4.1
12930,CN0110900000000,01,109,"Pike County, AL",Jul-19,15273,14773,500,3.3
12931,CN0111100000000,01,111,"Randolph County, AL",Jul-19,9695,9396,299,3.1
12932,CN0111300000000,01,113,"Russell County, AL",Jul-19,23650,22950,700,3.0
12933,CN0111500000000,01,115,"St. Clair County, AL",Jul-19,40654,39546,1108,2.7
12934,CN0111700000000,01,117,"Shelby County, AL",Jul-19,116011,113517,2494,2.1
12935,CN0111900000000,01,119,"Sumter County, AL",Jul-19,4905,4624,281,5.7
12936,CN0112100000000,01,121,"Talladega County, AL",Jul-19,35817,34538,1279,3.6
12937,CN0112300000000,01,123,"Tallapoosa County, AL",Jul-19,18909,18303,606,3.2
12938,CN0112500000000,01,125,"Tuscaloosa County, AL",Jul-19,103307,100190,3117,3.0
12939,CN0112700000000,01,127,"Walker County, AL",Jul-19,25465,24632,833,3.3
12940,CN0112900000000,01,129,"Washington County, AL",Jul-19,6750,6417,333,4.9
12941,CN0113100000000,01,131,"Wilcox County, AL",Jul-19,2800,2592,208,7.4
12942,CN0113300000000,01,133,"Winston County, AL",Jul-19,10114,9777,337,3.3
12943,CN0201300000000,02,13,"Aleutians East Borough, AK",Jul-19,3696,3632,64,1.7
12944,CN0201600000000,02,16,"Aleutians West Census Area, AK",Jul-19,3927,3820,107,2.7
12945,CN0202000000000,02,20,"Anchorage Borough/municipality, AK",Jul-19,146936,139805,7131,4.9
12946,CN0205000000000,02,50,"Bethel Census Area, AK",Jul-19,6832,5885,947,13.9
12947,CN0206000000000,02,60,"Bristol Bay Borough, AK",Jul-19,1245,1224,21,1.7
12948,CN0206800000000,02,68,"Denali Borough, AK",Jul-19,1758,1697,61,3.5
12949,CN0207000000000,02,70,"Dillingham Census Area, AK",Jul-19,2732,2569,163,6.0
12950,CN0209000000000,02,90,"Fairbanks North Star Borough, AK",Jul-19,45041,42821,2220,4.9
12951,CN0210000000000,02,100,"Haines Borough, AK",Jul-19,1462,1394,68,4.7
12952,CN0210500000000,02,105,"Hoonah-Angoon Census Area, AK",Jul-19,1438,1340,98,6.8
12953,CN0211000000000,02,110,"Juneau Borough/city, AK",Jul-19,17849,17157,692,3.9
12954,CN0212200000000,02,122,"Kenai Peninsula Borough, AK",Jul-19,27934,26406,1528,5.5
12955,CN0213000000000,02,130,"Ketchikan Gateway Borough, AK",Jul-19,7847,7468,379,4.8
12956,CN0215000000000,02,150,"Kodiak Island Borough, AK",Jul-19,6529,6265,264,4.0
12957,CN0215800000000,02,158,"Kusilvak Census Area, AK",Jul-19,2363,1821,542,22.9
12958,CN0216400000000,02,164,"Lake and Peninsula Borough, AK",Jul-19,970,900,70,7.2
12959,CN0217000000000,02,170,"Matanuska-Susitna Borough, AK",Jul-19,46840,43727,3113,6.6
12960,CN0218000000000,02,180,"Nome Census Area, AK",Jul-19,3841,3356,485,12.6
12961,CN0218500000000,02,185,"North Slope Borough, AK",Jul-19,3350,3115,235,7.0
12962,CN0218800000000,02,188,"Northwest Arctic Borough, AK",Jul-19,2989,2528,461,15.4
12963,CN0219500000000,02,195,"Petersburg Borough, AK",Jul-19,1621,1522,99,6.1
12964,CN0219800000000,02,198,"Prince of Wales-Hyder Census Area, AK",Jul-19,2839,2569,270,9.5
12965,CN0222000000000,02,220,"Sitka Borough/city, AK",Jul-19,5012,4843,169,3.4
12966,CN0223000000000,02,230,"Skagway Municipality, AK",Jul-19,1116,1086,30,2.7
12967,CN0224000000000,02,240,"Southeast Fairbanks Census Area, AK",Jul-19,2892,2656,236,8.2
12968,CN0226100000000,02,261,"Valdez-Cordova Census Area, AK",Jul-19,6293,6007,286,4.5
12969,CN0227500000000,02,275,"Wrangell Borough/city, AK",Jul-19,1073,1006,67,6.2
12970,CN0228200000000,02,282,"Yakutat Borough/city, AK",Jul-19,272,258,14,5.1
12971,CN0229000000000,02,290,"Yukon-Koyukuk Census Area, AK",Jul-19,2416,2085,331,13.7
12972,CN0400100000000,04,1,"Apache County, AZ",Jul-19,19923,17700,2223,11.2
12973,CN0400300000000,04,3,"Cochise County, AZ",Jul-19,49803,46760,3043,6.1
12974,CN0400500000000,04,5,"Coconino County, AZ",Jul-19,77592,72957,4635,6.0
12975,CN0400700000000,04,7,"Gila County, AZ",Jul-19,21462,20240,1222,5.7
12976,CN0400900000000,04,9,"Graham County, AZ",Jul-19,14124,13315,809,5.7
12977,CN0401100000000,04,11,"Greenlee County, AZ",Jul-19,4588,4389,199,4.3
12978,CN0401200000000,04,12,"La Paz County, AZ",Jul-19,8870,8323,547,6.2
12979,CN0401300000000,04,13,"Maricopa County, AZ",Jul-19,2316300,2216877,99423,4.3
12980,CN0401500000000,04,15,"Mohave County, AZ",Jul-19,88808,83593,5215,5.9
12981,CN0401700000000,04,17,"Navajo County, AZ",Jul-19,39585,36434,3151,8.0
12982,CN0401900000000,04,19,"Pima County, AZ",Jul-19,498093,474345,23748,4.8
12983,CN0402100000000,04,21,"Pinal County, AZ",Jul-19,186085,176432,9653,5.2
12984,CN0402300000000,04,23,"Santa Cruz County, AZ",Jul-19,18718,16883,1835,9.8
12985,CN0402500000000,04,25,"Yavapai County, AZ",Jul-19,107835,102792,5043,4.7
12986,CN0402700000000,04,27,"Yuma County, AZ",Jul-19,98365,78268,20097,20.4
12987,CN0500100000000,05,1,"Arkansas County, AR",Jul-19,9602,9301,301,3.1
12988,CN0500300000000,05,3,"Ashley County, AR",Jul-19,7784,7289,495,6.4
12989,CN0500500000000,05,5,"Baxter County, AR",Jul-19,16313,15643,670,4.1
12990,CN0500700000000,05,7,"Benton County, AR",Jul-19,139305,135164,4141,3.0
12991,CN0500900000000,05,9,"Boone County, AR",Jul-19,15919,15352,567,3.6
12992,CN0501100000000,05,11,"Bradley County, AR",Jul-19,4417,4219,198,4.5
12993,CN0501300000000,05,13,"Calhoun County, AR",Jul-19,2462,2351,111,4.5
12994,CN0501500000000,05,15,"Carroll County, AR",Jul-19,13255,12861,394,3.0
12995,CN0501700000000,05,17,"Chicot County, AR",Jul-19,3340,3071,269,8.1
12996,CN0501900000000,05,19,"Clark County, AR",Jul-19,9575,9071,504,5.3
12997,CN0502100000000,05,21,"Clay County, AR",Jul-19,5792,5492,300,5.2
12998,CN0502300000000,05,23,"Cleburne County, AR",Jul-19,9301,8869,432,4.6
12999,CN0502500000000,05,25,"Cleveland County, AR",Jul-19,3272,3134,138,4.2
13000,CN0502700000000,05,27,"Columbia County, AR",Jul-19,8824,8310,514,5.8
13001,CN0502900000000,05,29,"Conway County, AR",Jul-19,8280,7856,424,5.1
13002,CN0503100000000,05,31,"Craighead County, AR",Jul-19,56703,54808,1895,3.3
13003,CN0503300000000,05,33,"Crawford County, AR",Jul-19,27365,26320,1045,3.8
13004,CN0503500000000,05,35,"Crittenden County, AR",Jul-19,22068,20924,1144,5.2
13005,CN0503700000000,05,37,"Cross County, AR",Jul-19,7413,7061,352,4.7
13006,CN0503900000000,05,39,"Dallas County, AR",Jul-19,2850,2704,146,5.1
13007,CN0504100000000,05,41,"Desha County, AR",Jul-19,5347,5064,283,5.3
13008,CN0504300000000,05,43,"Drew County, AR",Jul-19,7757,7288,469,6.0
13009,CN0504500000000,05,45,"Faulkner County, AR",Jul-19,63605,61465,2140,3.4
13010,CN0504700000000,05,47,"Franklin County, AR",Jul-19,7510,7213,297,4.0
13011,CN0504900000000,05,49,"Fulton County, AR",Jul-19,5021,4789,232,4.6
13012,CN0505100000000,05,51,"Garland County, AR",Jul-19,42818,40992,1826,4.3
13013,CN0505300000000,05,53,"Grant County, AR",Jul-19,8574,8260,314,3.7
13014,CN0505500000000,05,55,"Greene County, AR",Jul-19,20290,19447,843,4.2
13015,CN0505700000000,05,57,"Hempstead County, AR",Jul-19,9907,9469,438,4.4
13016,CN0505900000000,05,59,"Hot Spring County, AR",Jul-19,14330,13704,626,4.4
13017,CN0506100000000,05,61,"Howard County, AR",Jul-19,5661,5439,222,3.9
13018,CN0506300000000,05,63,"Independence County, AR",Jul-19,16311,15540,771,4.7
13019,CN0506500000000,05,65,"Izard County, AR",Jul-19,4814,4526,288,6.0
13020,CN0506700000000,05,67,"Jackson County, AR",Jul-19,5805,5373,432,7.4
13021,CN0506900000000,05,69,"Jefferson County, AR",Jul-19,28110,26314,1796,6.4
13022,CN0507100000000,05,71,"Johnson County, AR",Jul-19,10096,9523,573,5.7
13023,CN0507300000000,05,73,"Lafayette County, AR",Jul-19,2435,2306,129,5.3
13024,CN0507500000000,05,75,"Lawrence County, AR",Jul-19,6597,6262,335,5.1
13025,CN0507700000000,05,77,"Lee County, AR",Jul-19,2893,2762,131,4.5
13026,CN0507900000000,05,79,"Lincoln County, AR",Jul-19,4036,3838,198,4.9
13027,CN0508100000000,05,81,"Little River County, AR",Jul-19,5606,5337,269,4.8
13028,CN0508300000000,05,83,"Logan County, AR",Jul-19,8645,8192,453,5.2
13029,CN0508500000000,05,85,"Lonoke County, AR",Jul-19,35424,33923,1501,4.2
13030,CN0508700000000,05,87,"Madison County, AR",Jul-19,7619,7404,215,2.8
13031,CN0508900000000,05,89,"Marion County, AR",Jul-19,6724,6441,283,4.2
13032,CN0509100000000,05,91,"Miller County, AR",Jul-19,20122,19200,922,4.6
13033,CN0509300000000,05,93,"Mississippi County, AR",Jul-19,17592,16327,1265,7.2
13034,CN0509500000000,05,95,"Monroe County, AR",Jul-19,2785,2639,146,5.2
13035,CN0509700000000,05,97,"Montgomery County, AR",Jul-19,3033,2885,148,4.9
13036,CN0509900000000,05,99,"Nevada County, AR",Jul-19,3658,3467,191,5.2
13037,CN0510100000000,05,101,"Newton County, AR",Jul-19,3336,3211,125,3.7
13038,CN0510300000000,05,103,"Ouachita County, AR",Jul-19,9814,9275,539,5.5
13039,CN0510500000000,05,105,"Perry County, AR",Jul-19,4384,4184,200,4.6
13040,CN0510700000000,05,107,"Phillips County, AR",Jul-19,6269,5830,439,7.0
13041,CN0510900000000,05,109,"Pike County, AR",Jul-19,4206,4012,194,4.6
13042,CN0511100000000,05,111,"Poinsett County, AR",Jul-19,10532,10120,412,3.9
13043,CN0511300000000,05,113,"Polk County, AR",Jul-19,8107,7741,366,4.5
13044,CN0511500000000,05,115,"Pope County, AR",Jul-19,28613,27029,1584,5.5
13045,CN0511700000000,05,117,"Prairie County, AR",Jul-19,3599,3396,203,5.6
13046,CN0511900000000,05,119,"Pulaski County, AR",Jul-19,193905,186276,7629,3.9
13047,CN0512100000000,05,121,"Randolph County, AR",Jul-19,7311,6975,336,4.6
13048,CN0512300000000,05,123,"St. Francis County, AR",Jul-19,8260,7777,483,5.8
13049,CN0512500000000,05,125,"Saline County, AR",Jul-19,60169,58247,1922,3.2
13050,CN0512700000000,05,127,"Scott County, AR",Jul-19,4273,4100,173,4.0
13051,CN0512900000000,05,129,"Searcy County, AR",Jul-19,2956,2811,145,4.9
13052,CN0513100000000,05,131,"Sebastian County, AR",Jul-19,57526,55386,2140,3.7
13053,CN0513300000000,05,133,"Sevier County, AR",Jul-19,5594,5291,303,5.4
13054,CN0513500000000,05,135,"Sharp County, AR",Jul-19,5683,5361,322,5.7
13055,CN0513700000000,05,137,"Stone County, AR",Jul-19,4810,4583,227,4.7
13056,CN0513900000000,05,139,"Union County, AR",Jul-19,15654,14686,968,6.2
13057,CN0514100000000,05,141,"Van Buren County, AR",Jul-19,5750,5435,315,5.5
13058,CN0514300000000,05,143,"Washington County, AR",Jul-19,127088,123397,3691,2.9
13059,CN0514500000000,05,145,"White County, AR",Jul-19,33340,31651,1689,5.1
13060,CN0514700000000,05,147,"Woodruff County, AR",Jul-19,2748,2595,153,5.6
13061,CN0514900000000,05,149,"Yell County, AR",Jul-19,8387,7986,401,4.8
13062,CN0600100000000,06,1,"Alameda County, CA",Jul-19,849110,821164,27946,3.3
13063,CN0600300000000,06,3,"Alpine County, CA",Jul-19,482,447,35,7.3
13064,CN0600500000000,06,5,"Amador County, CA",Jul-19,15029,14434,595,4.0
13065,CN0600700000000,06,7,"Butte County, CA",Jul-19,97842,92381,5461,5.6
13066,CN0600900000000,06,9,"Calaveras County, CA",Jul-19,21841,21002,839,3.8
13067,CN0601100000000,06,11,"Colusa County, CA",Jul-19,11012,9888,1124,10.2
13068,CN0601300000000,06,13,"Contra Costa County, CA",Jul-19,564917,545585,19332,3.4
13069,CN0601500000000,06,15,"Del Norte County, CA",Jul-19,9664,9092,572,5.9
13070,CN0601700000000,06,17,"El Dorado County, CA",Jul-19,92256,88809,3447,3.7
13071,CN0601900000000,06,19,"Fresno County, CA",Jul-19,451656,418960,32696,7.2
13072,CN0602100000000,06,21,"Glenn County, CA",Jul-19,12866,12037,829,6.4
13073,CN0602300000000,06,23,"Humboldt County, CA",Jul-19,61421,58946,2475,4.0
13074,CN0602500000000,06,25,"Imperial County, CA",Jul-19,70275,56051,14224,20.2
13075,CN0602700000000,06,27,"Inyo County, CA",Jul-19,8947,8628,319,3.6
13076,CN0602900000000,06,29,"Kern County, CA",Jul-19,384070,351552,32518,8.5
13077,CN0603100000000,06,31,"Kings County, CA",Jul-19,57888,53389,4499,7.8
13078,CN0603300000000,06,33,"Lake County, CA",Jul-19,28851,27378,1473,5.1
13079,CN0603500000000,06,35,"Lassen County, CA",Jul-19,9693,9234,459,4.7
13080,CN0603700000000,06,37,"Los Angeles County, CA",Jul-19,5130244,4874249,255995,5.0
13081,CN0603900000000,06,39,"Madera County, CA",Jul-19,61042,56629,4413,7.2
13082,CN0604100000000,06,41,"Marin County, CA",Jul-19,141379,137782,3597,2.5
13083,CN0604300000000,06,43,"Mariposa County, CA",Jul-19,8130,7809,321,3.9
13084,CN0604500000000,06,45,"Mendocino County, CA",Jul-19,39120,37568,1552,4.0
13085,CN0604700000000,06,47,"Merced County, CA",Jul-19,112782,103357,9425,8.4
13086,CN0604900000000,06,49,"Modoc County, CA",Jul-19,3275,3077,198,6.0
13087,CN0605100000000,06,51,"Mono County, CA",Jul-19,8677,8351,326,3.8
13088,CN0605300000000,06,53,"Monterey County, CA",Jul-19,231408,220536,10872,4.7
13089,CN0605500000000,06,55,"Napa County, CA",Jul-19,75942,73708,2234,2.9
13090,CN0605700000000,06,57,"Nevada County, CA",Jul-19,48453,46738,1715,3.5
13091,CN0605900000000,06,59,"Orange County, CA",Jul-19,1626509,1575770,50739,3.1
13092,CN0606100000000,06,61,"Placer County, CA",Jul-19,188478,182077,6401,3.4
13093,CN0606300000000,06,63,"Plumas County, CA",Jul-19,8512,7990,522,6.1
13094,CN0606500000000,06,65,"Riverside County, CA",Jul-19,1105813,1053713,52100,4.7
13095,CN0606700000000,06,67,"Sacramento County, CA",Jul-19,715527,686469,29058,4.1
13096,CN0606900000000,06,69,"San Benito County, CA",Jul-19,31740,30170,1570,4.9
13097,CN0607100000000,06,71,"San Bernardino County, CA",Jul-19,968630,925942,42688,4.4
13098,CN0607300000000,06,73,"San Diego County, CA",Jul-19,1595803,1539067,56736,3.6
13099,CN0607500000000,06,75,"San Francisco County/city, CA",Jul-19,587789,573583,14206,2.4
13100,CN0607700000000,06,77,"San Joaquin County, CA",Jul-19,327810,307642,20168,6.2
13101,CN0607900000000,06,79,"San Luis Obispo County, CA",Jul-19,140314,135791,4523,3.2
13102,CN0608100000000,06,81,"San Mateo County, CA",Jul-19,463724,453125,10599,2.3
13103,CN0608300000000,06,83,"Santa Barbara County, CA",Jul-19,220335,212333,8002,3.6
13104,CN0608500000000,06,85,"Santa Clara County, CA",Jul-19,1061057,1031795,29262,2.8
13105,CN0608700000000,06,87,"Santa Cruz County, CA",Jul-19,144340,138125,6215,4.3
13106,CN0608900000000,06,89,"Shasta County, CA",Jul-19,73839,70308,3531,4.8
13107,CN0609100000000,06,91,"Sierra County, CA",Jul-19,1386,1320,66,4.8
13108,CN0609300000000,06,93,"Siskiyou County, CA",Jul-19,17892,16861,1031,5.8
13109,CN0609500000000,06,95,"Solano County, CA",Jul-19,209831,201267,8564,4.1
13110,CN0609700000000,06,97,"Sonoma County, CA",Jul-19,260892,253210,7682,2.9
13111,CN0609900000000,06,99,"Stanislaus County, CA",Jul-19,244386,228601,15785,6.5
13112,CN0610100000000,06,101,"Sutter County, CA",Jul-19,46490,43312,3178,6.8
13113,CN0610300000000,06,103,"Tehama County, CA",Jul-19,25526,24004,1522,6.0
13114,CN0610500000000,06,105,"Trinity County, CA",Jul-19,4882,4644,238,4.9
13115,CN0610700000000,06,107,"Tulare County, CA",Jul-19,202033,181949,20084,9.9
13116,CN0610900000000,06,109,"Tuolumne County, CA",Jul-19,21551,20569,982,4.6
13117,CN0611100000000,06,111,"Ventura County, CA",Jul-19,422938,406550,16388,3.9
13118,CN0611300000000,06,113,"Yolo County, CA",Jul-19,109565,104954,4611,4.2
13119,CN0611500000000,06,115,"Yuba County, CA",Jul-19,29756,27924,1832,6.2
13120,CN0800100000000,08,1,"Adams County, CO",Jul-19,277317,269330,7987,2.9
13121,CN0800300000000,08,3,"Alamosa County, CO",Jul-19,8761,8434,327,3.7
13122,CN0800500000000,08,5,"Arapahoe County, CO",Jul-19,371069,361069,10000,2.7
13123,CN0800700000000,08,7,"Archuleta County, CO",Jul-19,7339,7122,217,3.0
13124,CN0800900000000,08,9,"Baca County, CO",Jul-19,2325,2292,33,1.4
13125,CN0801100000000,08,11,"Bent County, CO",Jul-19,2019,1957,62,3.1
13126,CN0801300000000,08,13,"Boulder County, CO",Jul-19,196219,191613,4606,2.3
13127,CN0801400000000,08,14,"Broomfield County/city, CO",Jul-19,40713,39740,973,2.4
13128,CN0801500000000,08,15,"Chaffee County, CO",Jul-19,10810,10591,219,2.0
13129,CN0801700000000,08,17,"Cheyenne County, CO",Jul-19,1240,1221,19,1.5
13130,CN0801900000000,08,19,"Clear Creek County, CO",Jul-19,6180,6013,167,2.7
13131,CN0802100000000,08,21,"Conejos County, CO",Jul-19,4236,4086,150,3.5
13132,CN0802300000000,08,23,"Costilla County, CO",Jul-19,1973,1902,71,3.6
13133,CN0802500000000,08,25,"Crowley County, CO",Jul-19,1533,1466,67,4.4
13134,CN0802700000000,08,27,"Custer County, CO",Jul-19,2192,2127,65,3.0
13135,CN0802900000000,08,29,"Delta County, CO",Jul-19,15078,14634,444,2.9
13136,CN0803100000000,08,31,"Denver County/city, CO",Jul-19,424017,412794,11223,2.6
13137,CN0803300000000,08,33,"Dolores County, CO",Jul-19,1233,1202,31,2.5
13138,CN0803500000000,08,35,"Douglas County, CO",Jul-19,197497,192859,4638,2.3
13139,CN0803700000000,08,37,"Eagle County, CO",Jul-19,37971,37248,723,1.9
13140,CN0803900000000,08,39,"Elbert County, CO",Jul-19,15616,15299,317,2.0
13141,CN0804100000000,08,41,"El Paso County, CO",Jul-19,343653,332041,11612,3.4
13142,CN0804300000000,08,43,"Fremont County, CO",Jul-19,15730,15010,720,4.6
13143,CN0804500000000,08,45,"Garfield County, CO",Jul-19,33943,33163,780,2.3
13144,CN0804700000000,08,47,"Gilpin County, CO",Jul-19,3858,3767,91,2.4
13145,CN0804900000000,08,49,"Grand County, CO",Jul-19,10573,10377,196,1.9
13146,CN0805100000000,08,51,"Gunnison County, CO",Jul-19,12078,11878,200,1.7
13147,CN0805300000000,08,53,"Hinsdale County, CO",Jul-19,570,553,17,3.0
13148,CN0805500000000,08,55,"Huerfano County, CO",Jul-19,2688,2550,138,5.1
13149,CN0805700000000,08,57,"Jackson County, CO",Jul-19,1102,1078,24,2.2
13150,CN0805900000000,08,59,"Jefferson County, CO",Jul-19,341086,332691,8395,2.5
13151,CN0806100000000,08,61,"Kiowa County, CO",Jul-19,1004,990,14,1.4
13152,CN0806300000000,08,63,"Kit Carson County, CO",Jul-19,4648,4576,72,1.5
13153,CN0806500000000,08,65,"Lake County, CO",Jul-19,4965,4860,105,2.1
13154,CN0806700000000,08,67,"La Plata County, CO",Jul-19,33254,32553,701,2.1
13155,CN0806900000000,08,69,"Larimer County, CO",Jul-19,206484,201906,4578,2.2
13156,CN0807100000000,08,71,"Las Animas County, CO",Jul-19,6692,6406,286,4.3
13157,CN0807300000000,08,73,"Lincoln County, CO",Jul-19,2540,2492,48,1.9
13158,CN0807500000000,08,75,"Logan County, CO",Jul-19,11198,10916,282,2.5
13159,CN0807700000000,08,77,"Mesa County, CO",Jul-19,76401,73737,2664,3.5
13160,CN0807900000000,08,79,"Mineral County, CO",Jul-19,550,540,10,1.8
13161,CN0808100000000,08,81,"Moffat County, CO",Jul-19,7532,7306,226,3.0
13162,CN0808300000000,08,83,"Montezuma County, CO",Jul-19,13533,13083,450,3.3
13163,CN0808500000000,08,85,"Montrose County, CO",Jul-19,22549,21926,623,2.8
13164,CN0808700000000,08,87,"Morgan County, CO",Jul-19,16998,16550,448,2.6
13165,CN0808900000000,08,89,"Otero County, CO",Jul-19,8653,8296,357,4.1
13166,CN0809100000000,08,91,"Ouray County, CO",Jul-19,2791,2724,67,2.4
13167,CN0809300000000,08,93,"Park County, CO",Jul-19,11461,11192,269,2.3
13168,CN0809500000000,08,95,"Phillips County, CO",Jul-19,2880,2839,41,1.4
13169,CN0809700000000,08,97,"Pitkin County, CO",Jul-19,11707,11443,264,2.3
13170,CN0809900000000,08,99,"Prowers County, CO",Jul-19,6627,6446,181,2.7
13171,CN0810100000000,08,101,"Pueblo County, CO",Jul-19,75745,72483,3262,4.3
13172,CN0810300000000,08,103,"Rio Blanco County, CO",Jul-19,3102,2992,110,3.5
13173,CN0810500000000,08,105,"Rio Grande County, CO",Jul-19,5888,5657,231,3.9
13174,CN0810700000000,08,107,"Routt County, CO",Jul-19,17038,16709,329,1.9
13175,CN0810900000000,08,109,"Saguache County, CO",Jul-19,3761,3615,146,3.9
13176,CN0811100000000,08,111,"San Juan County, CO",Jul-19,741,727,14,1.9
13177,CN0811300000000,08,113,"San Miguel County, CO",Jul-19,6170,6051,119,1.9
13178,CN0811500000000,08,115,"Sedgwick County, CO",Jul-19,1271,1243,28,2.2
13179,CN0811700000000,08,117,"Summit County, CO",Jul-19,22404,22027,377,1.7
13180,CN0811900000000,08,119,"Teller County, CO",Jul-19,12881,12490,391,3.0
13181,CN0812100000000,08,121,"Washington County, CO",Jul-19,3108,3049,59,1.9
13182,CN0812300000000,08,123,"Weld County, CO",Jul-19,170232,165880,4352,2.6
13183,CN0812500000000,08,125,"Yuma County, CO",Jul-19,6414,6319,95,1.5
13184,CN0900100000000,09,1,"Fairfield County, CT",Jul-19,492238,473724,18514,3.8
13185,CN0900300000000,09,3,"Hartford County, CT",Jul-19,488531,468363,20168,4.1
13186,CN0900500000000,09,5,"Litchfield County, CT",Jul-19,107600,103921,3679,3.4
13187,CN0900700000000,09,7,"Middlesex County, CT",Jul-19,94503,91535,2968,3.1
13188,CN0900900000000,09,9,"New Haven County, CT",Jul-19,467585,448102,19483,4.2
13189,CN0901100000000,09,11,"New London County, CT",Jul-19,141326,136068,5258,3.7
13190,CN0901300000000,09,13,"Tolland County, CT",Jul-19,87864,84905,2959,3.4
13191,CN0901500000000,09,15,"Windham County, CT",Jul-19,65421,62674,2747,4.2
13192,CN1000100000000,10,1,"Kent County, DE",Jul-19,79191,75275,3916,4.9
13193,CN1000300000000,10,3,"New Castle County, DE",Jul-19,299148,286785,12363,4.1
13194,CN1000500000000,10,5,"Sussex County, DE",Jul-19,114601,110637,3964,3.5
13195,CN1100100000000,11,1,District of Columbia,Jul-19,416468,392330,24138,5.8
13196,CN1200100000000,12,1,"Alachua County, FL",Jul-19,137640,132965,4675,3.4
13197,CN1200300000000,12,3,"Baker County, FL",Jul-19,11994,11575,419,3.5
13198,CN1200500000000,12,5,"Bay County, FL",Jul-19,86508,83303,3205,3.7
13199,CN1200700000000,12,7,"Bradford County, FL",Jul-19,11124,10745,379,3.4
13200,CN1200900000000,12,9,"Brevard County, FL",Jul-19,287648,277903,9745,3.4
13201,CN1201100000000,12,11,"Broward County, FL",Jul-19,1046699,1012468,34231,3.3
13202,CN1201300000000,12,13,"Calhoun County, FL",Jul-19,4720,4511,209,4.4
13203,CN1201500000000,12,15,"Charlotte County, FL",Jul-19,71184,68436,2748,3.9
13204,CN1201700000000,12,17,"Citrus County, FL",Jul-19,46672,44217,2455,5.3
13205,CN1201900000000,12,19,"Clay County, FL",Jul-19,108860,105296,3564,3.3
13206,CN1202100000000,12,21,"Collier County, FL",Jul-19,175679,169419,6260,3.6
13207,CN1202300000000,12,23,"Columbia County, FL",Jul-19,29316,28237,1079,3.7
13208,CN1202700000000,12,27,"DeSoto County, FL",Jul-19,13689,13154,535,3.9
13209,CN1202900000000,12,29,"Dixie County, FL",Jul-19,5556,5306,250,4.5
13210,CN1203100000000,12,31,"Duval County, FL",Jul-19,498056,479695,18361,3.7
13211,CN1203300000000,12,33,"Escambia County, FL",Jul-19,148131,143005,5126,3.5
13212,CN1203500000000,12,35,"Flagler County, FL",Jul-19,47294,45374,1920,4.1
13213,CN1203700000000,12,37,"Franklin County, FL",Jul-19,4729,4565,164,3.5
13214,CN1203900000000,12,39,"Gadsden County, FL",Jul-19,18686,17833,853,4.6
13215,CN1204100000000,12,41,"Gilchrist County, FL",Jul-19,7071,6800,271,3.8
13216,CN1204300000000,12,43,"Glades County, FL",Jul-19,4818,4575,243,5.0
13217,CN1204500000000,12,45,"Gulf County, FL",Jul-19,5919,5648,271,4.6
13218,CN1204700000000,12,47,"Hamilton County, FL",Jul-19,4228,4035,193,4.6
13219,CN1204900000000,12,49,"Hardee County, FL",Jul-19,7828,7319,509,6.5
13220,CN1205100000000,12,51,"Hendry County, FL",Jul-19,14654,13429,1225,8.4
13221,CN1205300000000,12,53,"Hernando County, FL",Jul-19,72495,69264,3231,4.5
13222,CN1205500000000,12,55,"Highlands County, FL",Jul-19,35501,33681,1820,5.1
13223,CN1205700000000,12,57,"Hillsborough County, FL",Jul-19,753312,727872,25440,3.4
13224,CN1205900000000,12,59,"Holmes County, FL",Jul-19,6787,6519,268,3.9
13225,CN1206100000000,12,61,"Indian River County, FL",Jul-19,65378,62578,2800,4.3
13226,CN1206300000000,12,63,"Jackson County, FL",Jul-19,16607,15933,674,4.1
13227,CN1206500000000,12,65,"Jefferson County, FL",Jul-19,5582,5378,204,3.7
13228,CN1206700000000,12,67,"Lafayette County, FL",Jul-19,2761,2660,101,3.7
13229,CN1206900000000,12,69,"Lake County, FL",Jul-19,160398,154838,5560,3.5
13230,CN1207100000000,12,71,"Lee County, FL",Jul-19,345699,333879,11820,3.4
13231,CN1207300000000,12,73,"Leon County, FL",Jul-19,154671,149135,5536,3.6
13232,CN1207500000000,12,75,"Levy County, FL",Jul-19,16321,15654,667,4.1
13233,CN1207700000000,12,77,"Liberty County, FL",Jul-19,2591,2492,99,3.8
13234,CN1207900000000,12,79,"Madison County, FL",Jul-19,7495,7175,320,4.3
13235,CN1208100000000,12,81,"Manatee County, FL",Jul-19,179241,173097,6144,3.4
13236,CN1208300000000,12,83,"Marion County, FL",Jul-19,138538,132849,5689,4.1
13237,CN1208500000000,12,85,"Martin County, FL",Jul-19,74122,71540,2582,3.5
13238,CN1208600000000,12,86,"Miami-Dade County, FL",Jul-19,1384625,1349121,35504,2.6
13239,CN1208700000000,12,87,"Monroe County, FL",Jul-19,46569,45572,997,2.1
13240,CN1208900000000,12,89,"Nassau County, FL",Jul-19,41648,40314,1334,3.2
13241,CN1209100000000,12,91,"Okaloosa County, FL",Jul-19,100695,97893,2802,2.8
13242,CN1209300000000,12,93,"Okeechobee County, FL",Jul-19,17087,16380,707,4.1
13243,CN1209500000000,12,95,"Orange County, FL",Jul-19,769813,745361,24452,3.2
13244,CN1209700000000,12,97,"Osceola County, FL",Jul-19,186151,179445,6706,3.6
13245,CN1209900000000,12,99,"Palm Beach County, FL",Jul-19,733996,707456,26540,3.6
13246,CN1210100000000,12,101,"Pasco County, FL",Jul-19,239631,230657,8974,3.7
13247,CN1210300000000,12,103,"Pinellas County, FL",Jul-19,497493,481850,15643,3.1
13248,CN1210500000000,12,105,"Polk County, FL",Jul-19,306720,294118,12602,4.1
13249,CN1210700000000,12,107,"Putnam County, FL",Jul-19,26071,24828,1243,4.8
13250,CN1210900000000,12,109,"St. Johns County, FL",Jul-19,133704,129860,3844,2.9
13251,CN1211100000000,12,111,"St. Lucie County, FL",Jul-19,145234,138910,6324,4.4
13252,CN1211300000000,12,113,"Santa Rosa County, FL",Jul-19,84266,81481,2785,3.3
13253,CN1211500000000,12,115,"Sarasota County, FL",Jul-19,188569,182317,6252,3.3
13254,CN1211700000000,12,117,"Seminole County, FL",Jul-19,257777,249660,8117,3.1
13255,CN1211900000000,12,119,"Sumter County, FL",Jul-19,32201,30649,1552,4.8
13256,CN1212100000000,12,121,"Suwannee County, FL",Jul-19,17725,17048,677,3.8
13257,CN1212300000000,12,123,"Taylor County, FL",Jul-19,8286,7956,330,4.0
13258,CN1212500000000,12,125,"Union County, FL",Jul-19,4518,4364,154,3.4
13259,CN1212700000000,12,127,"Volusia County, FL",Jul-19,255926,246484,9442,3.7
13260,CN1212900000000,12,129,"Wakulla County, FL",Jul-19,14817,14334,483,3.3
13261,CN1213100000000,12,131,"Walton County, FL",Jul-19,32764,31816,948,2.9
13262,CN1213300000000,12,133,"Washington County, FL",Jul-19,9665,9318,347,3.6
13263,CN1300100000000,13,1,"Appling County, GA",Jul-19,9179,8714,465,5.1
13264,CN1300300000000,13,3,"Atkinson County, GA",Jul-19,4760,4481,279,5.9
13265,CN1300500000000,13,5,"Bacon County, GA",Jul-19,4905,4698,207,4.2
13266,CN1300700000000,13,7,"Baker County, GA",Jul-19,1136,1073,63,5.5
13267,CN1300900000000,13,9,"Baldwin County, GA",Jul-19,17080,16263,817,4.8
13268,CN1301100000000,13,11,"Banks County, GA",Jul-19,9450,9144,306,3.2
13269,CN1301300000000,13,13,"Barrow County, GA",Jul-19,40538,39290,1248,3.1
13270,CN1301500000000,13,15,"Bartow County, GA",Jul-19,50733,48915,1818,3.6
13271,CN1301700000000,13,17,"Ben Hill County, GA",Jul-19,5413,5040,373,6.9
13272,CN1301900000000,13,19,"Berrien County, GA",Jul-19,7315,6988,327,4.5
13273,CN1302100000000,13,21,"Bibb County, GA",Jul-19,68073,65104,2969,4.4
13274,CN1302300000000,13,23,"Bleckley County, GA",Jul-19,4422,4160,262,5.9
13275,CN1302500000000,13,25,"Brantley County, GA",Jul-19,7355,7025,330,4.5
13276,CN1302700000000,13,27,"Brooks County, GA",Jul-19,6806,6547,259,3.8
13277,CN1302900000000,13,29,"Bryan County, GA",Jul-19,18437,17811,626,3.4
13278,CN1303100000000,13,31,"Bulloch County, GA",Jul-19,35876,34219,1657,4.6
13279,CN1303300000000,13,33,"Burke County, GA",Jul-19,9175,8609,566,6.2
13280,CN1303500000000,13,35,"Butts County, GA",Jul-19,10765,10381,384,3.6
13281,CN1303700000000,13,37,"Calhoun County, GA",Jul-19,2148,2055,93,4.3
13282,CN1303900000000,13,39,"Camden County, GA",Jul-19,20871,20048,823,3.9
13283,CN1304300000000,13,43,"Candler County, GA",Jul-19,5471,5258,213,3.9
13284,CN1304500000000,13,45,"Carroll County, GA",Jul-19,55482,53373,2109,3.8
13285,CN1304700000000,13,47,"Catoosa County, GA",Jul-19,33555,32463,1092,3.3
13286,CN1304900000000,13,49,"Charlton County, GA",Jul-19,4760,4567,193,4.1
13287,CN1305100000000,13,51,"Chatham County, GA",Jul-19,140719,135675,5044,3.6
13288,CN1305300000000,13,53,"Chattahoochee County, GA",Jul-19,1990,1888,102,5.1
13289,CN1305500000000,13,55,"Chattooga County, GA",Jul-19,10169,9701,468,4.6
13290,CN1305700000000,13,57,"Cherokee County, GA",Jul-19,136465,132380,4085,3.0
13291,CN1305900000000,13,59,"Clarke County, GA",Jul-19,58613,56221,2392,4.1
13292,CN1306100000000,13,61,"Clay County, GA",Jul-19,877,807,70,8.0
13293,CN1306300000000,13,63,"Clayton County, GA",Jul-19,138658,132154,6504,4.7
13294,CN1306500000000,13,65,"Clinch County, GA",Jul-19,2639,2513,126,4.8
13295,CN1306700000000,13,67,"Cobb County, GA",Jul-19,427191,413401,13790,3.2
13296,CN1306900000000,13,69,"Coffee County, GA",Jul-19,18828,17917,911,4.8
13297,CN1307100000000,13,71,"Colquitt County, GA",Jul-19,21179,20352,827,3.9
13298,CN1307300000000,13,73,"Columbia County, GA",Jul-19,75154,72584,2570,3.4
13299,CN1307500000000,13,75,"Cook County, GA",Jul-19,7924,7621,303,3.8
13300,CN1307700000000,13,77,"Coweta County, GA",Jul-19,74960,72502,2458,3.3
13301,CN1307900000000,13,79,"Crawford County, GA",Jul-19,5606,5371,235,4.2
13302,CN1308100000000,13,81,"Crisp County, GA",Jul-19,9505,9118,387,4.1
13303,CN1308300000000,13,83,"Dade County, GA",Jul-19,8228,7936,292,3.5
13304,CN1308500000000,13,85,"Dawson County, GA",Jul-19,12366,11981,385,3.1
13305,CN1308700000000,13,87,"Decatur County, GA",Jul-19,11392,10929,463,4.1
13306,CN1308900000000,13,89,"DeKalb County, GA",Jul-19,401528,386463,15065,3.8
13307,CN1309100000000,13,91,"Dodge County, GA",Jul-19,7092,6594,498,7.0
13308,CN1309300000000,13,93,"Dooly County, GA",Jul-19,5021,4816,205,4.1
13309,CN1309500000000,13,95,"Dougherty County, GA",Jul-19,38340,36332,2008,5.2
13310,CN1309700000000,13,97,"Douglas County, GA",Jul-19,73615,70778,2837,3.9
13311,CN1309900000000,13,99,"Early County, GA",Jul-19,4331,4148,183,4.2
13312,CN1310100000000,13,101,"Echols County, GA",Jul-19,1862,1804,58,3.1
13313,CN1310300000000,13,103,"Effingham County, GA",Jul-19,31102,30122,980,3.2
13314,CN1310500000000,13,105,"Elbert County, GA",Jul-19,7692,7340,352,4.6
13315,CN1310700000000,13,107,"Emanuel County, GA",Jul-19,8309,7636,673,8.1
13316,CN1310900000000,13,109,"Evans County, GA",Jul-19,4871,4688,183,3.8
13317,CN1311100000000,13,111,"Fannin County, GA",Jul-19,11667,11208,459,3.9
13318,CN1311300000000,13,113,"Fayette County, GA",Jul-19,58248,56348,1900,3.3
13319,CN1311500000000,13,115,"Floyd County, GA",Jul-19,44436,42353,2083,4.7
13320,CN1311700000000,13,117,"Forsyth County, GA",Jul-19,122616,118906,3710,3.0
13321,CN1311900000000,13,119,"Franklin County, GA",Jul-19,9842,9451,391,4.0
13322,CN1312100000000,13,121,"Fulton County, GA",Jul-19,559994,538503,21491,3.8
13323,CN1312300000000,13,123,"Gilmer County, GA",Jul-19,11855,11399,456,3.8
13324,CN1312500000000,13,125,"Glascock County, GA",Jul-19,1251,1196,55,4.4
13325,CN1312700000000,13,127,"Glynn County, GA",Jul-19,40005,38623,1382,3.5
13326,CN1312900000000,13,129,"Gordon County, GA",Jul-19,28255,27088,1167,4.1
13327,CN1313100000000,13,131,"Grady County, GA",Jul-19,10281,9881,400,3.9
13328,CN1313300000000,13,133,"Greene County, GA",Jul-19,7150,6859,291,4.1
13329,CN1313500000000,13,135,"Gwinnett County, GA",Jul-19,492279,475847,16432,3.3
13330,CN1313700000000,13,137,"Habersham County, GA",Jul-19,18888,18079,809,4.3
13331,CN1313900000000,13,139,"Hall County, GA",Jul-19,102131,98941,3190,3.1
13332,CN1314100000000,13,141,"Hancock County, GA",Jul-19,2386,2229,157,6.6
13333,CN1314300000000,13,143,"Haralson County, GA",Jul-19,12626,12164,462,3.7
13334,CN1314500000000,13,145,"Harris County, GA",Jul-19,16613,16032,581,3.5
13335,CN1314700000000,13,147,"Hart County, GA",Jul-19,11489,11018,471,4.1
13336,CN1314900000000,13,149,"Heard County, GA",Jul-19,5271,5070,201,3.8
13337,CN1315100000000,13,151,"Henry County, GA",Jul-19,116104,111554,4550,3.9
13338,CN1315300000000,13,153,"Houston County, GA",Jul-19,70481,67924,2557,3.6
13339,CN1315500000000,13,155,"Irwin County, GA",Jul-19,3304,3117,187,5.7
13340,CN1315700000000,13,157,"Jackson County, GA",Jul-19,36050,34982,1068,3.0
13341,CN1315900000000,13,159,"Jasper County, GA",Jul-19,6945,6720,225,3.2
13342,CN1316100000000,13,161,"Jeff Davis County, GA",Jul-19,6128,5786,342,5.6
13343,CN1316300000000,13,163,"Jefferson County, GA",Jul-19,6581,6178,403,6.1
13344,CN1316500000000,13,165,"Jenkins County, GA",Jul-19,3153,2949,204,6.5
13345,CN1316700000000,13,167,"Johnson County, GA",Jul-19,3978,3797,181,4.6
13346,CN1316900000000,13,169,"Jones County, GA",Jul-19,13683,13208,475,3.5
13347,CN1317100000000,13,171,"Lamar County, GA",Jul-19,8276,7931,345,4.2
13348,CN1317300000000,13,173,"Lanier County, GA",Jul-19,3738,3575,163,4.4
13349,CN1317500000000,13,175,"Laurens County, GA",Jul-19,19036,17896,1140,6.0
13350,CN1317700000000,13,177,"Lee County, GA",Jul-19,14671,14193,478,3.3
13351,CN1317900000000,13,179,"Liberty County, GA",Jul-19,26193,25069,1124,4.3
13352,CN1318100000000,13,181,"Lincoln County, GA",Jul-19,3519,3378,141,4.0
13353,CN1318300000000,13,183,"Long County, GA",Jul-19,8135,7787,348,4.3
13354,CN1318500000000,13,185,"Lowndes County, GA",Jul-19,51091,49098,1993,3.9
13355,CN1318700000000,13,187,"Lumpkin County, GA",Jul-19,16479,15893,586,3.6
13356,CN1318900000000,13,189,"McDuffie County, GA",Jul-19,8917,8363,554,6.2
13357,CN1319100000000,13,191,"McIntosh County, GA",Jul-19,6229,5991,238,3.8
13358,CN1319300000000,13,193,"Macon County, GA",Jul-19,4590,4358,232,5.1
13359,CN1319500000000,13,195,"Madison County, GA",Jul-19,13139,12706,433,3.3
13360,CN1319700000000,13,197,"Marion County, GA",Jul-19,3298,3142,156,4.7
13361,CN1319900000000,13,199,"Meriwether County, GA",Jul-19,8980,8503,477,5.3
13362,CN1320100000000,13,201,"Miller County, GA",Jul-19,2723,2629,94,3.5
13363,CN1320500000000,13,205,"Mitchell County, GA",Jul-19,8333,7894,439,5.3
13364,CN1320700000000,13,207,"Monroe County, GA",Jul-19,12982,12526,456,3.5
13365,CN1320900000000,13,209,"Montgomery County, GA",Jul-19,3812,3553,259,6.8
13366,CN1321100000000,13,211,"Morgan County, GA",Jul-19,9244,8928,316,3.4
13367,CN1321300000000,13,213,"Murray County, GA",Jul-19,15544,14730,814,5.2
13368,CN1321500000000,13,215,"Muscogee County, GA",Jul-19,77592,73625,3967,5.1
13369,CN1321700000000,13,217,"Newton County, GA",Jul-19,52453,50235,2218,4.2
13370,CN1321900000000,13,219,"Oconee County, GA",Jul-19,19313,18762,551,2.9
13371,CN1322100000000,13,221,"Oglethorpe County, GA",Jul-19,6839,6586,253,3.7
13372,CN1322300000000,13,223,"Paulding County, GA",Jul-19,86293,83495,2798,3.2
13373,CN1322500000000,13,225,"Peach County, GA",Jul-19,11825,11281,544,4.6
13374,CN1322700000000,13,227,"Pickens County, GA",Jul-19,15349,14841,508,3.3
13375,CN1322900000000,13,229,"Pierce County, GA",Jul-19,8749,8434,315,3.6
13376,CN1323100000000,13,231,"Pike County, GA",Jul-19,8933,8635,298,3.3
13377,CN1323300000000,13,233,"Polk County, GA",Jul-19,18535,17799,736,4.0
13378,CN1323500000000,13,235,"Pulaski County, GA",Jul-19,4050,3872,178,4.4
13379,CN1323700000000,13,237,"Putnam County, GA",Jul-19,8215,7833,382,4.7
13380,CN1323900000000,13,239,"Quitman County, GA",Jul-19,803,758,45,5.6
13381,CN1324100000000,13,241,"Rabun County, GA",Jul-19,7474,7201,273,3.7
13382,CN1324300000000,13,243,"Randolph County, GA",Jul-19,2459,2314,145,5.9
13383,CN1324500000000,13,245,"Richmond County, GA",Jul-19,85315,80909,4406,5.2
13384,CN1324700000000,13,247,"Rockdale County, GA",Jul-19,44975,43138,1837,4.1
13385,CN1324900000000,13,249,"Schley County, GA",Jul-19,2188,2091,97,4.4
13386,CN1325100000000,13,251,"Screven County, GA",Jul-19,5060,4720,340,6.7
13387,CN1325300000000,13,253,"Seminole County, GA",Jul-19,2999,2855,144,4.8
13388,CN1325500000000,13,255,"Spalding County, GA",Jul-19,28776,27558,1218,4.2
13389,CN1325700000000,13,257,"Stephens County, GA",Jul-19,10678,10210,468,4.4
13390,CN1325900000000,13,259,"Stewart County, GA",Jul-19,2392,2284,108,4.5
13391,CN1326100000000,13,261,"Sumter County, GA",Jul-19,12585,11917,668,5.3
13392,CN1326300000000,13,263,"Talbot County, GA",Jul-19,2816,2677,139,4.9
13393,CN1326500000000,13,265,"Taliaferro County, GA",Jul-19,577,547,30,5.2
13394,CN1326700000000,13,267,"Tattnall County, GA",Jul-19,9532,9109,423,4.4
13395,CN1326900000000,13,269,"Taylor County, GA",Jul-19,3137,3001,136,4.3
13396,CN1327100000000,13,271,"Telfair County, GA",Jul-19,4167,3629,538,12.9
13397,CN1327300000000,13,273,"Terrell County, GA",Jul-19,3523,3310,213,6.0
13398,CN1327500000000,13,275,"Thomas County, GA",Jul-19,16275,15524,751,4.6
13399,CN1327700000000,13,277,"Tift County, GA",Jul-19,19716,18989,727,3.7
13400,CN1327900000000,13,279,"Toombs County, GA",Jul-19,11696,10923,773,6.6
13401,CN1328100000000,13,281,"Towns County, GA",Jul-19,3950,3736,214,5.4
13402,CN1328300000000,13,283,"Treutlen County, GA",Jul-19,2706,2489,217,8.0
13403,CN1328500000000,13,285,"Troup County, GA",Jul-19,37853,36330,1523,4.0
13404,CN1328700000000,13,287,"Turner County, GA",Jul-19,3115,2995,120,3.9
13405,CN1328900000000,13,289,"Twiggs County, GA",Jul-19,2892,2708,184,6.4
13406,CN1329100000000,13,291,"Union County, GA",Jul-19,10193,9848,345,3.4
13407,CN1329300000000,13,293,"Upson County, GA",Jul-19,11350,10921,429,3.8
13408,CN1329500000000,13,295,"Walker County, GA",Jul-19,31300,30160,1140,3.6
13409,CN1329700000000,13,297,"Walton County, GA",Jul-19,46206,44653,1553,3.4
13410,CN1329900000000,13,299,"Ware County, GA",Jul-19,15655,15051,604,3.9
13411,CN1330100000000,13,301,"Warren County, GA",Jul-19,2874,2688,186,6.5
13412,CN1330300000000,13,303,"Washington County, GA",Jul-19,7006,6687,319,4.6
13413,CN1330500000000,13,305,"Wayne County, GA",Jul-19,11476,10963,513,4.5
13414,CN1330700000000,13,307,"Webster County, GA",Jul-19,987,932,55,5.6
13415,CN1330900000000,13,309,"Wheeler County, GA",Jul-19,1607,1447,160,10.0
13416,CN1331100000000,13,311,"White County, GA",Jul-19,16324,15856,468,2.9
13417,CN1331300000000,13,313,"Whitfield County, GA",Jul-19,43767,41718,2049,4.7
13418,CN1331500000000,13,315,"Wilcox County, GA",Jul-19,2610,2477,133,5.1
13419,CN1331700000000,13,317,"Wilkes County, GA",Jul-19,3873,3687,186,4.8
13420,CN1331900000000,13,319,"Wilkinson County, GA",Jul-19,4006,3826,180,4.5
13421,CN1332100000000,13,321,"Worth County, GA",Jul-19,8812,8466,346,3.9
13422,CN1500100000000,15,1,"Hawaii County, HI",Jul-19,91668,88240,3428,3.7
13423,CN1500300000000,15,3,"Honolulu County/city, HI",Jul-19,450177,438428,11749,2.6
13424,CN1500700000000,15,7,"Kauai County, HI",Jul-19,37583,36595,988,2.6
13425,CN1500900000000,15,9,"Maui County, HI",Jul-19,87789,85525,2264,2.6
13426,CN1600100000000,16,1,"Ada County, ID",Jul-19,256223,249912,6311,2.5
13427,CN1600300000000,16,3,"Adams County, ID",Jul-19,1816,1726,90,5.0
13428,CN1600500000000,16,5,"Bannock County, ID",Jul-19,42646,41276,1370,3.2
13429,CN1600700000000,16,7,"Bear Lake County, ID",Jul-19,3054,2988,66,2.2
13430,CN1600900000000,16,9,"Benewah County, ID",Jul-19,4186,4038,148,3.5
13431,CN1601100000000,16,11,"Bingham County, ID",Jul-19,23972,23332,640,2.7
13432,CN1601300000000,16,13,"Blaine County, ID",Jul-19,13121,12841,280,2.1
13433,CN1601500000000,16,15,"Boise County, ID",Jul-19,3525,3393,132,3.7
13434,CN1601700000000,16,17,"Bonner County, ID",Jul-19,20723,20063,660,3.2
13435,CN1601900000000,16,19,"Bonneville County, ID",Jul-19,57921,56652,1269,2.2
13436,CN1602100000000,16,21,"Boundary County, ID",Jul-19,5566,5389,177,3.2
13437,CN1602300000000,16,23,"Butte County, ID",Jul-19,1422,1391,31,2.2
13438,CN1602500000000,16,25,"Camas County, ID",Jul-19,725,711,14,1.9
13439,CN1602700000000,16,27,"Canyon County, ID",Jul-19,106166,102741,3425,3.2
13440,CN1602900000000,16,29,"Caribou County, ID",Jul-19,4158,4064,94,2.3
13441,CN1603100000000,16,31,"Cassia County, ID",Jul-19,12459,12168,291,2.3
13442,CN1603300000000,16,33,"Clark County, ID",Jul-19,392,378,14,3.6
13443,CN1603500000000,16,35,"Clearwater County, ID",Jul-19,2981,2813,168,5.6
13444,CN1603700000000,16,37,"Custer County, ID",Jul-19,2574,2507,67,2.6
13445,CN1603900000000,16,39,"Elmore County, ID",Jul-19,11871,11491,380,3.2
13446,CN1604100000000,16,41,"Franklin County, ID",Jul-19,6771,6624,147,2.2
13447,CN1604300000000,16,43,"Fremont County, ID",Jul-19,7997,7851,146,1.8
13448,CN1604500000000,16,45,"Gem County, ID",Jul-19,8393,8139,254,3.0
13449,CN1604700000000,16,47,"Gooding County, ID",Jul-19,8294,8105,189,2.3
13450,CN1604900000000,16,49,"Idaho County, ID",Jul-19,6792,6533,259,3.8
13451,CN1605100000000,16,51,"Jefferson County, ID",Jul-19,14288,13995,293,2.1
13452,CN1605300000000,16,53,"Jerome County, ID",Jul-19,12297,12018,279,2.3
13453,CN1605500000000,16,55,"Kootenai County, ID",Jul-19,82244,79865,2379,2.9
13454,CN1605700000000,16,57,"Latah County, ID",Jul-19,19385,18857,528,2.7
13455,CN1605900000000,16,59,"Lemhi County, ID",Jul-19,3830,3703,127,3.3
13456,CN1606100000000,16,61,"Lewis County, ID",Jul-19,1729,1645,84,4.9
13457,CN1606300000000,16,63,"Lincoln County, ID",Jul-19,2831,2755,76,2.7
13458,CN1606500000000,16,65,"Madison County, ID",Jul-19,22573,22163,410,1.8
13459,CN1606700000000,16,67,"Minidoka County, ID",Jul-19,11594,11321,273,2.4
13460,CN1606900000000,16,69,"Nez Perce County, ID",Jul-19,21128,20572,556,2.6
13461,CN1607100000000,16,71,"Oneida County, ID",Jul-19,2359,2314,45,1.9
13462,CN1607300000000,16,73,"Owyhee County, ID",Jul-19,5830,5656,174,3.0
13463,CN1607500000000,16,75,"Payette County, ID",Jul-19,11700,11283,417,3.6
13464,CN1607700000000,16,77,"Power County, ID",Jul-19,4070,3927,143,3.5
13465,CN1607900000000,16,79,"Shoshone County, ID",Jul-19,5210,4966,244,4.7
13466,CN1608100000000,16,81,"Teton County, ID",Jul-19,7531,7415,116,1.5
13467,CN1608300000000,16,83,"Twin Falls County, ID",Jul-19,41878,40757,1121,2.7
13468,CN1608500000000,16,85,"Valley County, ID",Jul-19,6139,5986,153,2.5
13469,CN1608700000000,16,87,"Washington County, ID",Jul-19,4663,4485,178,3.8
13470,CN1700100000000,17,1,"Adams County, IL",Jul-19,32844,31695,1149,3.5
13471,CN1700300000000,17,3,"Alexander County, IL",Jul-19,2019,1867,152,7.5
13472,CN1700500000000,17,5,"Bond County, IL",Jul-19,7963,7663,300,3.8
13473,CN1700700000000,17,7,"Boone County, IL",Jul-19,27053,25163,1890,7.0
13474,CN1700900000000,17,9,"Brown County, IL",Jul-19,3058,2979,79,2.6
13475,CN1701100000000,17,11,"Bureau County, IL",Jul-19,17739,17013,726,4.1
13476,CN1701300000000,17,13,"Calhoun County, IL",Jul-19,2370,2256,114,4.8
13477,CN1701500000000,17,15,"Carroll County, IL",Jul-19,7635,7367,268,3.5
13478,CN1701700000000,17,17,"Cass County, IL",Jul-19,6233,5981,252,4.0
13479,CN1701900000000,17,19,"Champaign County, IL",Jul-19,106052,101580,4472,4.2
13480,CN1702100000000,17,21,"Christian County, IL",Jul-19,14874,14148,726,4.9
13481,CN1702300000000,17,23,"Clark County, IL",Jul-19,7743,7407,336,4.3
13482,CN1702500000000,17,25,"Clay County, IL",Jul-19,6573,6265,308,4.7
13483,CN1702700000000,17,27,"Clinton County, IL",Jul-19,20819,20181,638,3.1
13484,CN1702900000000,17,29,"Coles County, IL",Jul-19,22873,21811,1062,4.6
13485,CN1703100000000,17,31,"Cook County, IL",Jul-19,2634510,2523036,111474,4.2
13486,CN1703300000000,17,33,"Crawford County, IL",Jul-19,8726,8366,360,4.1
13487,CN1703500000000,17,35,"Cumberland County, IL",Jul-19,6066,5863,203,3.3
13488,CN1703700000000,17,37,"DeKalb County, IL",Jul-19,56561,53964,2597,4.6
13489,CN1703900000000,17,39,"De Witt County, IL",Jul-19,7451,7128,323,4.3
13490,CN1704100000000,17,41,"Douglas County, IL",Jul-19,10311,9903,408,4.0
13491,CN1704300000000,17,43,"DuPage County, IL",Jul-19,515291,498352,16939,3.3
13492,CN1704500000000,17,45,"Edgar County, IL",Jul-19,9143,8746,397,4.3
13493,CN1704700000000,17,47,"Edwards County, IL",Jul-19,2794,2688,106,3.8
13494,CN1704900000000,17,49,"Effingham County, IL",Jul-19,19649,19015,634,3.2
13495,CN1705100000000,17,51,"Fayette County, IL",Jul-19,10106,9688,418,4.1
13496,CN1705300000000,17,53,"Ford County, IL",Jul-19,6390,6109,281,4.4
13497,CN1705500000000,17,55,"Franklin County, IL",Jul-19,16477,15584,893,5.4
13498,CN1705700000000,17,57,"Fulton County, IL",Jul-19,15473,14578,895,5.8
13499,CN1705900000000,17,59,"Gallatin County, IL",Jul-19,2377,2257,120,5.0
13500,CN1706100000000,17,61,"Greene County, IL",Jul-19,6080,5807,273,4.5
13501,CN1706300000000,17,63,"Grundy County, IL",Jul-19,25851,24618,1233,4.8
13502,CN1706500000000,17,65,"Hamilton County, IL",Jul-19,4375,4201,174,4.0
13503,CN1706700000000,17,67,"Hancock County, IL",Jul-19,8661,8211,450,5.2
13504,CN1706900000000,17,69,"Hardin County, IL",Jul-19,1306,1208,98,7.5
13505,CN1707100000000,17,71,"Henderson County, IL",Jul-19,3729,3565,164,4.4
13506,CN1707300000000,17,73,"Henry County, IL",Jul-19,25785,24667,1118,4.3
13507,CN1707500000000,17,75,"Iroquois County, IL",Jul-19,14799,14243,556,3.8
13508,CN1707700000000,17,77,"Jackson County, IL",Jul-19,27940,26791,1149,4.1
13509,CN1707900000000,17,79,"Jasper County, IL",Jul-19,4683,4472,211,4.5
13510,CN1708100000000,17,81,"Jefferson County, IL",Jul-19,17717,16831,886,5.0
13511,CN1708300000000,17,83,"Jersey County, IL",Jul-19,11157,10659,498,4.5
13512,CN1708500000000,17,85,"Jo Daviess County, IL",Jul-19,11224,10847,377,3.4
13513,CN1708700000000,17,87,"Johnson County, IL",Jul-19,4035,3799,236,5.8
13514,CN1708900000000,17,89,"Kane County, IL",Jul-19,277864,266080,11784,4.2
13515,CN1709100000000,17,91,"Kankakee County, IL",Jul-19,56811,54164,2647,4.7
13516,CN1709300000000,17,93,"Kendall County, IL",Jul-19,69867,67271,2596,3.7
13517,CN1709500000000,17,95,"Knox County, IL",Jul-19,22155,21082,1073,4.8
13518,CN1709700000000,17,97,"Lake County, IL",Jul-19,387122,372238,14884,3.8
13519,CN1709900000000,17,99,"LaSalle County, IL",Jul-19,55411,52601,2810,5.1
13520,CN1710100000000,17,101,"Lawrence County, IL",Jul-19,5925,5613,312,5.3
13521,CN1710300000000,17,103,"Lee County, IL",Jul-19,18086,17384,702,3.9
13522,CN1710500000000,17,105,"Livingston County, IL",Jul-19,16921,16239,682,4.0
13523,CN1710700000000,17,107,"Logan County, IL",Jul-19,12732,12126,606,4.8
13524,CN1710900000000,17,109,"McDonough County, IL",Jul-19,12616,11647,969,7.7
13525,CN1711100000000,17,111,"McHenry County, IL",Jul-19,167835,161935,5900,3.5
13526,CN1711300000000,17,113,"McLean County, IL",Jul-19,87773,84188,3585,4.1
13527,CN1711500000000,17,115,"Macon County, IL",Jul-19,49761,46994,2767,5.6
13528,CN1711700000000,17,117,"Macoupin County, IL",Jul-19,23390,22419,971,4.2
13529,CN1711900000000,17,119,"Madison County, IL",Jul-19,136614,130903,5711,4.2
13530,CN1712100000000,17,121,"Marion County, IL",Jul-19,17808,16998,810,4.5
13531,CN1712300000000,17,123,"Marshall County, IL",Jul-19,5467,5231,236,4.3
13532,CN1712500000000,17,125,"Mason County, IL",Jul-19,6456,6119,337,5.2
13533,CN1712700000000,17,127,"Massac County, IL",Jul-19,5752,5401,351,6.1
13534,CN1712900000000,17,129,"Menard County, IL",Jul-19,6599,6382,217,3.3
13535,CN1713100000000,17,131,"Mercer County, IL",Jul-19,8329,7990,339,4.1
13536,CN1713300000000,17,133,"Monroe County, IL",Jul-19,19133,18507,626,3.3
13537,CN1713500000000,17,135,"Montgomery County, IL",Jul-19,11884,11294,590,5.0
13538,CN1713700000000,17,137,"Morgan County, IL",Jul-19,16715,16047,668,4.0
13539,CN1713900000000,17,139,"Moultrie County, IL",Jul-19,7816,7532,284,3.6
13540,CN1714100000000,17,141,"Ogle County, IL",Jul-19,25324,24116,1208,4.8
13541,CN1714300000000,17,143,"Peoria County, IL",Jul-19,87057,82656,4401,5.1
13542,CN1714500000000,17,145,"Perry County, IL",Jul-19,8437,7978,459,5.4
13543,CN1714700000000,17,147,"Piatt County, IL",Jul-19,8429,8115,314,3.7
13544,CN1714900000000,17,149,"Pike County, IL",Jul-19,7208,6919,289,4.0
13545,CN1715100000000,17,151,"Pope County, IL",Jul-19,1678,1580,98,5.8
13546,CN1715300000000,17,153,"Pulaski County, IL",Jul-19,1946,1821,125,6.4
13547,CN1715500000000,17,155,"Putnam County, IL",Jul-19,3096,2961,135,4.4
13548,CN1715700000000,17,157,"Randolph County, IL",Jul-19,14494,13960,534,3.7
13549,CN1715900000000,17,159,"Richland County, IL",Jul-19,7376,7073,303,4.1
13550,CN1716100000000,17,161,"Rock Island County, IL",Jul-19,73285,69906,3379,4.6
13551,CN1716300000000,17,163,"St. Clair County, IL",Jul-19,128900,122729,6171,4.8
13552,CN1716500000000,17,165,"Saline County, IL",Jul-19,9585,9066,519,5.4
13553,CN1716700000000,17,167,"Sangamon County, IL",Jul-19,102774,98562,4212,4.1
13554,CN1716900000000,17,169,"Schuyler County, IL",Jul-19,3346,3199,147,4.4
13555,CN1717100000000,17,171,"Scott County, IL",Jul-19,2565,2463,102,4.0
13556,CN1717300000000,17,173,"Shelby County, IL",Jul-19,10859,10430,429,4.0
13557,CN1717500000000,17,175,"Stark County, IL",Jul-19,2617,2483,134,5.1
13558,CN1717700000000,17,177,"Stephenson County, IL",Jul-19,22292,21309,983,4.4
13559,CN1717900000000,17,179,"Tazewell County, IL",Jul-19,65468,62635,2833,4.3
13560,CN1718100000000,17,181,"Union County, IL",Jul-19,7457,7062,395,5.3
13561,CN1718300000000,17,183,"Vermilion County, IL",Jul-19,33538,31719,1819,5.4
13562,CN1718500000000,17,185,"Wabash County, IL",Jul-19,5975,5732,243,4.1
13563,CN1718700000000,17,187,"Warren County, IL",Jul-19,8656,8274,382,4.4
13564,CN1718900000000,17,189,"Washington County, IL",Jul-19,10577,10312,265,2.5
13565,CN1719100000000,17,191,"Wayne County, IL",Jul-19,7095,6756,339,4.8
13566,CN1719300000000,17,193,"White County, IL",Jul-19,6654,6404,250,3.8
13567,CN1719500000000,17,195,"Whiteside County, IL",Jul-19,29226,27985,1241,4.2
13568,CN1719700000000,17,197,"Will County, IL",Jul-19,363232,348073,15159,4.2
13569,CN1719900000000,17,199,"Williamson County, IL",Jul-19,31901,30482,1419,4.4
13570,CN1720100000000,17,201,"Winnebago County, IL",Jul-19,143053,133481,9572,6.7
13571,CN1720300000000,17,203,"Woodford County, IL",Jul-19,19250,18566,684,3.6
13572,CN1800100000000,18,1,"Adams County, IN",Jul-19,17374,16802,572,3.3
13573,CN1800300000000,18,3,"Allen County, IN",Jul-19,188704,182227,6477,3.4
13574,CN1800500000000,18,5,"Bartholomew County, IN",Jul-19,45627,44453,1174,2.6
13575,CN1800700000000,18,7,"Benton County, IN",Jul-19,4596,4438,158,3.4
13576,CN1800900000000,18,9,"Blackford County, IN",Jul-19,5068,4877,191,3.8
13577,CN1801100000000,18,11,"Boone County, IN",Jul-19,37148,36179,969,2.6
13578,CN1801300000000,18,13,"Brown County, IN",Jul-19,7891,7655,236,3.0
13579,CN1801500000000,18,15,"Carroll County, IN",Jul-19,10204,9891,313,3.1
13580,CN1801700000000,18,17,"Cass County, IN",Jul-19,17974,17355,619,3.4
13581,CN1801900000000,18,19,"Clark County, IN",Jul-19,62933,60669,2264,3.6
13582,CN1802100000000,18,21,"Clay County, IN",Jul-19,12112,11684,428,3.5
13583,CN1802300000000,18,23,"Clinton County, IN",Jul-19,17415,16930,485,2.8
13584,CN1802500000000,18,25,"Crawford County, IN",Jul-19,4903,4712,191,3.9
13585,CN1802700000000,18,27,"Daviess County, IN",Jul-19,17163,16696,467,2.7
13586,CN1802900000000,18,29,"Dearborn County, IN",Jul-19,26482,25503,979,3.7
13587,CN1803100000000,18,31,"Decatur County, IN",Jul-19,15330,14898,432,2.8
13588,CN1803300000000,18,33,"DeKalb County, IN",Jul-19,23244,22537,707,3.0
13589,CN1803500000000,18,35,"Delaware County, IN",Jul-19,52618,50405,2213,4.2
13590,CN1803700000000,18,37,"Dubois County, IN",Jul-19,23783,23172,611,2.6
13591,CN1803900000000,18,39,"Elkhart County, IN",Jul-19,110236,106100,4136,3.8
13592,CN1804100000000,18,41,"Fayette County, IN",Jul-19,8698,8250,448,5.2
13593,CN1804300000000,18,43,"Floyd County, IN",Jul-19,42454,41057,1397,3.3
13594,CN1804500000000,18,45,"Fountain County, IN",Jul-19,8213,7927,286,3.5
13595,CN1804700000000,18,47,"Franklin County, IN",Jul-19,11674,11269,405,3.5
13596,CN1804900000000,18,49,"Fulton County, IN",Jul-19,10301,9999,302,2.9
13597,CN1805100000000,18,51,"Gibson County, IN",Jul-19,19724,19216,508,2.6
13598,CN1805300000000,18,53,"Grant County, IN",Jul-19,31032,29800,1232,4.0
13599,CN1805500000000,18,55,"Greene County, IN",Jul-19,13429,12888,541,4.0
13600,CN1805700000000,18,57,"Hamilton County, IN",Jul-19,187609,182562,5047,2.7
13601,CN1805900000000,18,59,"Hancock County, IN",Jul-19,41201,39948,1253,3.0
13602,CN1806100000000,18,61,"Harrison County, IN",Jul-19,20748,20032,716,3.5
13603,CN1806300000000,18,63,"Hendricks County, IN",Jul-19,91788,89166,2622,2.9
13604,CN1806500000000,18,65,"Henry County, IN",Jul-19,22323,21558,765,3.4
13605,CN1806700000000,18,67,"Howard County, IN",Jul-19,36999,35565,1434,3.9
13606,CN1806900000000,18,69,"Huntington County, IN",Jul-19,18517,17904,613,3.3
13607,CN1807100000000,18,71,"Jackson County, IN",Jul-19,23354,22679,675,2.9
13608,CN1807300000000,18,73,"Jasper County, IN",Jul-19,16674,16069,605,3.6
13609,CN1807500000000,18,75,"Jay County, IN",Jul-19,9701,9419,282,2.9
13610,CN1807700000000,18,77,"Jefferson County, IN",Jul-19,14998,14449,549,3.7
13611,CN1807900000000,18,79,"Jennings County, IN",Jul-19,13769,13323,446,3.2
13612,CN1808100000000,18,81,"Johnson County, IN",Jul-19,84733,82356,2377,2.8
13613,CN1808300000000,18,83,"Knox County, IN",Jul-19,18742,18119,623,3.3
13614,CN1808500000000,18,85,"Kosciusko County, IN",Jul-19,43042,41676,1366,3.2
13615,CN1808700000000,18,87,"LaGrange County, IN",Jul-19,19797,19127,670,3.4
13616,CN1808900000000,18,89,"Lake County, IN",Jul-19,233882,222404,11478,4.9
13617,CN1809100000000,18,91,"LaPorte County, IN",Jul-19,48620,46594,2026,4.2
13618,CN1809300000000,18,93,"Lawrence County, IN",Jul-19,20813,20048,765,3.7
13619,CN1809500000000,18,95,"Madison County, IN",Jul-19,60406,58172,2234,3.7
13620,CN1809700000000,18,97,"Marion County, IN",Jul-19,500782,483288,17494,3.5
13621,CN1809900000000,18,99,"Marshall County, IN",Jul-19,23949,23161,788,3.3
13622,CN1810100000000,18,101,"Martin County, IN",Jul-19,5587,5441,146,2.6
13623,CN1810300000000,18,103,"Miami County, IN",Jul-19,15529,14898,631,4.1
13624,CN1810500000000,18,105,"Monroe County, IN",Jul-19,66723,64208,2515,3.8
13625,CN1810700000000,18,107,"Montgomery County, IN",Jul-19,19177,18533,644,3.4
13626,CN1810900000000,18,109,"Morgan County, IN",Jul-19,37147,35983,1164,3.1
13627,CN1811100000000,18,111,"Newton County, IN",Jul-19,7172,6870,302,4.2
13628,CN1811300000000,18,113,"Noble County, IN",Jul-19,24374,23465,909,3.7
13629,CN1811500000000,18,115,"Ohio County, IN",Jul-19,3256,3145,111,3.4
13630,CN1811700000000,18,117,"Orange County, IN",Jul-19,8687,8368,319,3.7
13631,CN1811900000000,18,119,"Owen County, IN",Jul-19,8980,8606,374,4.2
13632,CN1812100000000,18,121,"Parke County, IN",Jul-19,7342,7064,278,3.8
13633,CN1812300000000,18,123,"Perry County, IN",Jul-19,9476,9143,333,3.5
13634,CN1812500000000,18,125,"Pike County, IN",Jul-19,6265,6051,214,3.4
13635,CN1812700000000,18,127,"Porter County, IN",Jul-19,88209,84844,3365,3.8
13636,CN1812900000000,18,129,"Posey County, IN",Jul-19,13894,13493,401,2.9
13637,CN1813100000000,18,131,"Pulaski County, IN",Jul-19,6780,6570,210,3.1
13638,CN1813300000000,18,133,"Putnam County, IN",Jul-19,17191,16582,609,3.5
13639,CN1813500000000,18,135,"Randolph County, IN",Jul-19,11334,10912,422,3.7
13640,CN1813700000000,18,137,"Ripley County, IN",Jul-19,14708,14221,487,3.3
13641,CN1813900000000,18,139,"Rush County, IN",Jul-19,9264,9005,259,2.8
13642,CN1814100000000,18,141,"St. Joseph County, IN",Jul-19,135395,130043,5352,4.0
13643,CN1814300000000,18,143,"Scott County, IN",Jul-19,10777,10370,407,3.8
13644,CN1814500000000,18,145,"Shelby County, IN",Jul-19,23713,22977,736,3.1
13645,CN1814700000000,18,147,"Spencer County, IN",Jul-19,11601,11239,362,3.1
13646,CN1814900000000,18,149,"Starke County, IN",Jul-19,10088,9654,434,4.3
13647,CN1815100000000,18,151,"Steuben County, IN",Jul-19,21342,20748,594,2.8
13648,CN1815300000000,18,153,"Sullivan County, IN",Jul-19,8468,8106,362,4.3
13649,CN1815500000000,18,155,"Switzerland County, IN",Jul-19,5112,4937,175,3.4
13650,CN1815700000000,18,157,"Tippecanoe County, IN",Jul-19,97004,93890,3114,3.2
13651,CN1815900000000,18,159,"Tipton County, IN",Jul-19,9493,9232,261,2.7
13652,CN1816100000000,18,161,"Union County, IN",Jul-19,3666,3543,123,3.4
13653,CN1816300000000,18,163,"Vanderburgh County, IN",Jul-19,95824,92710,3114,3.2
13654,CN1816500000000,18,165,"Vermillion County, IN",Jul-19,7058,6694,364,5.2
13655,CN1816700000000,18,167,"Vigo County, IN",Jul-19,48330,46179,2151,4.5
13656,CN1816900000000,18,169,"Wabash County, IN",Jul-19,15204,14708,496,3.3
13657,CN1817100000000,18,171,"Warren County, IN",Jul-19,4264,4134,130,3.0
13658,CN1817300000000,18,173,"Warrick County, IN",Jul-19,33563,32510,1053,3.1
13659,CN1817500000000,18,175,"Washington County, IN",Jul-19,14124,13649,475,3.4
13660,CN1817700000000,18,177,"Wayne County, IN",Jul-19,30713,29522,1191,3.9
13661,CN1817900000000,18,179,"Wells County, IN",Jul-19,14725,14324,401,2.7
13662,CN1818100000000,18,181,"White County, IN",Jul-19,13826,13448,378,2.7
13663,CN1818300000000,18,183,"Whitley County, IN",Jul-19,18080,17523,557,3.1
13664,CN1900100000000,19,1,"Adair County, IA",Jul-19,4362,4270,92,2.1
13665,CN1900300000000,19,3,"Adams County, IA",Jul-19,2270,2230,40,1.8
13666,CN1900500000000,19,5,"Allamakee County, IA",Jul-19,7472,7262,210,2.8
13667,CN1900700000000,19,7,"Appanoose County, IA",Jul-19,6207,5975,232,3.7
13668,CN1900900000000,19,9,"Audubon County, IA",Jul-19,3182,3104,78,2.5
13669,CN1901100000000,19,11,"Benton County, IA",Jul-19,13866,13465,401,2.9
13670,CN1901300000000,19,13,"Black Hawk County, IA",Jul-19,70814,68229,2585,3.7
13671,CN1901500000000,19,15,"Boone County, IA",Jul-19,15260,14872,388,2.5
13672,CN1901700000000,19,17,"Bremer County, IA",Jul-19,14129,13768,361,2.6
13673,CN1901900000000,19,19,"Buchanan County, IA",Jul-19,11725,11423,302,2.6
13674,CN1902100000000,19,21,"Buena Vista County, IA",Jul-19,11601,11291,310,2.7
13675,CN1902300000000,19,23,"Butler County, IA",Jul-19,8015,7772,243,3.0
13676,CN1902500000000,19,25,"Calhoun County, IA",Jul-19,4277,4166,111,2.6
13677,CN1902700000000,19,27,"Carroll County, IA",Jul-19,11414,11171,243,2.1
13678,CN1902900000000,19,29,"Cass County, IA",Jul-19,7084,6898,186,2.6
13679,CN1903100000000,19,31,"Cedar County, IA",Jul-19,10989,10716,273,2.5
13680,CN1903300000000,19,33,"Cerro Gordo County, IA",Jul-19,24555,23869,686,2.8
13681,CN1903500000000,19,35,"Cherokee County, IA",Jul-19,6300,6124,176,2.8
13682,CN1903700000000,19,37,"Chickasaw County, IA",Jul-19,6495,6320,175,2.7
13683,CN1903900000000,19,39,"Clarke County, IA",Jul-19,5037,4907,130,2.6
13684,CN1904100000000,19,41,"Clay County, IA",Jul-19,8713,8477,236,2.7
13685,CN1904300000000,19,43,"Clayton County, IA",Jul-19,10447,10173,274,2.6
13686,CN1904500000000,19,45,"Clinton County, IA",Jul-19,23570,22734,836,3.5
13687,CN1904700000000,19,47,"Crawford County, IA",Jul-19,8224,7970,254,3.1
13688,CN1904900000000,19,49,"Dallas County, IA",Jul-19,51580,50475,1105,2.1
13689,CN1905100000000,19,51,"Davis County, IA",Jul-19,4286,4167,119,2.8
13690,CN1905300000000,19,53,"Decatur County, IA",Jul-19,4303,4193,110,2.6
13691,CN1905500000000,19,55,"Delaware County, IA",Jul-19,10893,10645,248,2.3
13692,CN1905700000000,19,57,"Des Moines County, IA",Jul-19,20208,19443,765,3.8
13693,CN1905900000000,19,59,"Dickinson County, IA",Jul-19,11623,11344,279,2.4
13694,CN1906100000000,19,61,"Dubuque County, IA",Jul-19,57512,56067,1445,2.5
13695,CN1906300000000,19,63,"Emmet County, IA",Jul-19,5524,5335,189,3.4
13696,CN1906500000000,19,65,"Fayette County, IA",Jul-19,10334,9962,372,3.6
13697,CN1906700000000,19,67,"Floyd County, IA",Jul-19,9158,8885,273,3.0
13698,CN1906900000000,19,69,"Franklin County, IA",Jul-19,5878,5744,134,2.3
13699,CN1907100000000,19,71,"Fremont County, IA",Jul-19,3749,3627,122,3.3
13700,CN1907300000000,19,73,"Greene County, IA",Jul-19,5566,5395,171,3.1
13701,CN1907500000000,19,75,"Grundy County, IA",Jul-19,6618,6416,202,3.1
13702,CN1907700000000,19,77,"Guthrie County, IA",Jul-19,5766,5616,150,2.6
13703,CN1907900000000,19,79,"Hamilton County, IA",Jul-19,7043,6840,203,2.9
13704,CN1908100000000,19,81,"Hancock County, IA",Jul-19,6045,5901,144,2.4
13705,CN1908300000000,19,83,"Hardin County, IA",Jul-19,8211,7956,255,3.1
13706,CN1908500000000,19,85,"Harrison County, IA",Jul-19,7594,7413,181,2.4
13707,CN1908700000000,19,87,"Henry County, IA",Jul-19,9905,9609,296,3.0
13708,CN1908900000000,19,89,"Howard County, IA",Jul-19,5290,5167,123,2.3
13709,CN1909100000000,19,91,"Humboldt County, IA",Jul-19,5178,5051,127,2.5
13710,CN1909300000000,19,93,"Ida County, IA",Jul-19,4199,4118,81,1.9
13711,CN1909500000000,19,95,"Iowa County, IA",Jul-19,10815,10595,220,2.0
13712,CN1909700000000,19,97,"Jackson County, IA",Jul-19,11364,11052,312,2.7
13713,CN1909900000000,19,99,"Jasper County, IA",Jul-19,20328,19763,565,2.8
13714,CN1910100000000,19,101,"Jefferson County, IA",Jul-19,10141,9878,263,2.6
13715,CN1910300000000,19,103,"Johnson County, IA",Jul-19,89040,86967,2073,2.3
13716,CN1910500000000,19,105,"Jones County, IA",Jul-19,10916,10625,291,2.7
13717,CN1910700000000,19,107,"Keokuk County, IA",Jul-19,5299,5145,154,2.9
13718,CN1910900000000,19,109,"Kossuth County, IA",Jul-19,8576,8406,170,2.0
13719,CN1911100000000,19,111,"Lee County, IA",Jul-19,16628,15936,692,4.2
13720,CN1911300000000,19,113,"Linn County, IA",Jul-19,126263,122488,3775,3.0
13721,CN1911500000000,19,115,"Louisa County, IA",Jul-19,6234,6049,185,3.0
13722,CN1911700000000,19,117,"Lucas County, IA",Jul-19,4820,4710,110,2.3
13723,CN1911900000000,19,119,"Lyon County, IA",Jul-19,7298,7182,116,1.6
13724,CN1912100000000,19,121,"Madison County, IA",Jul-19,8850,8574,276,3.1
13725,CN1912300000000,19,123,"Mahaska County, IA",Jul-19,12195,11860,335,2.7
13726,CN1912500000000,19,125,"Marion County, IA",Jul-19,19034,18616,418,2.2
13727,CN1912700000000,19,127,"Marshall County, IA",Jul-19,18463,17783,680,3.7
13728,CN1912900000000,19,129,"Mills County, IA",Jul-19,7648,7462,186,2.4
13729,CN1913100000000,19,131,"Mitchell County, IA",Jul-19,7391,7274,117,1.6
13730,CN1913300000000,19,133,"Monona County, IA",Jul-19,4533,4390,143,3.2
13731,CN1913500000000,19,135,"Monroe County, IA",Jul-19,4120,4006,114,2.8
13732,CN1913700000000,19,137,"Montgomery County, IA",Jul-19,5141,4994,147,2.9
13733,CN1913900000000,19,139,"Muscatine County, IA",Jul-19,22882,22260,622,2.7
13734,CN1914100000000,19,141,"O'Brien County, IA",Jul-19,8488,8297,191,2.3
13735,CN1914300000000,19,143,"Osceola County, IA",Jul-19,3608,3531,77,2.1
13736,CN1914500000000,19,145,"Page County, IA",Jul-19,6566,6383,183,2.8
13737,CN1914700000000,19,147,"Palo Alto County, IA",Jul-19,4860,4749,111,2.3
13738,CN1914900000000,19,149,"Plymouth County, IA",Jul-19,15244,14893,351,2.3
13739,CN1915100000000,19,151,"Pocahontas County, IA",Jul-19,4662,4573,89,1.9
13740,CN1915300000000,19,153,"Polk County, IA",Jul-19,280036,272155,7881,2.8
13741,CN1915500000000,19,155,"Pottawattamie County, IA",Jul-19,50388,49153,1235,2.5
13742,CN1915700000000,19,157,"Poweshiek County, IA",Jul-19,10298,10022,276,2.7
13743,CN1915900000000,19,159,"Ringgold County, IA",Jul-19,2509,2433,76,3.0
13744,CN1916100000000,19,161,"Sac County, IA",Jul-19,5437,5304,133,2.4
13745,CN1916300000000,19,163,"Scott County, IA",Jul-19,93568,90551,3017,3.2
13746,CN1916500000000,19,165,"Shelby County, IA",Jul-19,6998,6856,142,2.0
13747,CN1916700000000,19,167,"Sioux County, IA",Jul-19,21017,20615,402,1.9
13748,CN1916900000000,19,169,"Story County, IA",Jul-19,56843,55535,1308,2.3
13749,CN1917100000000,19,171,"Tama County, IA",Jul-19,9788,9526,262,2.7
13750,CN1917300000000,19,173,"Taylor County, IA",Jul-19,3281,3211,70,2.1
13751,CN1917500000000,19,175,"Union County, IA",Jul-19,6464,6261,203,3.1
13752,CN1917700000000,19,177,"Van Buren County, IA",Jul-19,3842,3741,101,2.6
13753,CN1917900000000,19,179,"Wapello County, IA",Jul-19,18364,17667,697,3.8
13754,CN1918100000000,19,181,"Warren County, IA",Jul-19,29464,28728,736,2.5
13755,CN1918300000000,19,183,"Washington County, IA",Jul-19,12295,12007,288,2.3
13756,CN1918500000000,19,185,"Wayne County, IA",Jul-19,2861,2784,77,2.7
13757,CN1918700000000,19,187,"Webster County, IA",Jul-19,20141,19474,667,3.3
13758,CN1918900000000,19,189,"Winnebago County, IA",Jul-19,5232,5085,147,2.8
13759,CN1919100000000,19,191,"Winneshiek County, IA",Jul-19,11581,11296,285,2.5
13760,CN1919300000000,19,193,"Woodbury County, IA",Jul-19,57489,55950,1539,2.7
13761,CN1919500000000,19,195,"Worth County, IA",Jul-19,4364,4253,111,2.5
13762,CN1919700000000,19,197,"Wright County, IA",Jul-19,7229,7040,189,2.6
13763,CN2000100000000,20,1,"Allen County, KS",Jul-19,6332,6047,285,4.5
13764,CN2000300000000,20,3,"Anderson County, KS",Jul-19,4363,4188,175,4.0
13765,CN2000500000000,20,5,"Atchison County, KS",Jul-19,7086,6602,484,6.8
13766,CN2000700000000,20,7,"Barber County, KS",Jul-19,2366,2298,68,2.9
13767,CN2000900000000,20,9,"Barton County, KS",Jul-19,13744,13272,472,3.4
13768,CN2001100000000,20,11,"Bourbon County, KS",Jul-19,6741,6416,325,4.8
13769,CN2001300000000,20,13,"Brown County, KS",Jul-19,5440,5237,203,3.7
13770,CN2001500000000,20,15,"Butler County, KS",Jul-19,33200,31938,1262,3.8
13771,CN2001700000000,20,17,"Chase County, KS",Jul-19,1640,1594,46,2.8
13772,CN2001900000000,20,19,"Chautauqua County, KS",Jul-19,1461,1397,64,4.4
13773,CN2002100000000,20,21,"Cherokee County, KS",Jul-19,10341,9873,468,4.5
13774,CN2002300000000,20,23,"Cheyenne County, KS",Jul-19,1310,1270,40,3.1
13775,CN2002500000000,20,25,"Clark County, KS",Jul-19,1076,1046,30,2.8
13776,CN2002700000000,20,27,"Clay County, KS",Jul-19,3698,3543,155,4.2
13777,CN2002900000000,20,29,"Cloud County, KS",Jul-19,3855,3700,155,4.0
13778,CN2003100000000,20,31,"Coffey County, KS",Jul-19,3938,3737,201,5.1
13779,CN2003300000000,20,33,"Comanche County, KS",Jul-19,866,840,26,3.0
13780,CN2003500000000,20,35,"Cowley County, KS",Jul-19,16197,15500,697,4.3
13781,CN2003700000000,20,37,"Crawford County, KS",Jul-19,18981,18073,908,4.8
13782,CN2003900000000,20,39,"Decatur County, KS",Jul-19,1275,1231,44,3.5
13783,CN2004100000000,20,41,"Dickinson County, KS",Jul-19,8829,8491,338,3.8
13784,CN2004300000000,20,43,"Doniphan County, KS",Jul-19,4260,4091,169,4.0
13785,CN2004500000000,20,45,"Douglas County, KS",Jul-19,63017,60715,2302,3.7
13786,CN2004700000000,20,47,"Edwards County, KS",Jul-19,1453,1405,48,3.3
13787,CN2004900000000,20,49,"Elk County, KS",Jul-19,1051,997,54,5.1
13788,CN2005100000000,20,51,"Ellis County, KS",Jul-19,17123,16645,478,2.8
13789,CN2005300000000,20,53,"Ellsworth County, KS",Jul-19,2793,2683,110,3.9
13790,CN2005500000000,20,55,"Finney County, KS",Jul-19,20704,20103,601,2.9
13791,CN2005700000000,20,57,"Ford County, KS",Jul-19,17151,16647,504,2.9
13792,CN2005900000000,20,59,"Franklin County, KS",Jul-19,14187,13614,573,4.0
13793,CN2006100000000,20,61,"Geary County, KS",Jul-19,11075,10510,565,5.1
13794,CN2006300000000,20,63,"Gove County, KS",Jul-19,1469,1433,36,2.5
13795,CN2006500000000,20,65,"Graham County, KS",Jul-19,1134,1092,42,3.7
13796,CN2006700000000,20,67,"Grant County, KS",Jul-19,3222,3107,115,3.6
13797,CN2006900000000,20,69,"Gray County, KS",Jul-19,3045,2971,74,2.4
13798,CN2007100000000,20,71,"Greeley County, KS",Jul-19,786,764,22,2.8
13799,CN2007300000000,20,73,"Greenwood County, KS",Jul-19,3076,2943,133,4.3
13800,CN2007500000000,20,75,"Hamilton County, KS",Jul-19,1588,1550,38,2.4
13801,CN2007700000000,20,77,"Harper County, KS",Jul-19,2786,2696,90,3.2
13802,CN2007900000000,20,79,"Harvey County, KS",Jul-19,17352,16755,597,3.4
13803,CN2008100000000,20,81,"Haskell County, KS",Jul-19,2211,2151,60,2.7
13804,CN2008300000000,20,83,"Hodgeman County, KS",Jul-19,1023,991,32,3.1
13805,CN2008500000000,20,85,"Jackson County, KS",Jul-19,7388,7143,245,3.3
13806,CN2008700000000,20,87,"Jefferson County, KS",Jul-19,10390,10046,344,3.3
13807,CN2008900000000,20,89,"Jewell County, KS",Jul-19,1293,1251,42,3.2
13808,CN2009100000000,20,91,"Johnson County, KS",Jul-19,348267,336795,11472,3.3
13809,CN2009300000000,20,93,"Kearny County, KS",Jul-19,2028,1970,58,2.9
13810,CN2009500000000,20,95,"Kingman County, KS",Jul-19,3495,3374,121,3.5
13811,CN2009700000000,20,97,"Kiowa County, KS",Jul-19,1244,1206,38,3.1
13812,CN2009900000000,20,99,"Labette County, KS",Jul-19,10075,9601,474,4.7
13813,CN2010100000000,20,101,"Lane County, KS",Jul-19,755,733,22,2.9
13814,CN2010300000000,20,103,"Leavenworth County, KS",Jul-19,37518,36005,1513,4.0
13815,CN2010500000000,20,105,"Lincoln County, KS",Jul-19,1639,1595,44,2.7
13816,CN2010700000000,20,107,"Linn County, KS",Jul-19,4545,4266,279,6.1
13817,CN2010900000000,20,109,"Logan County, KS",Jul-19,1505,1467,38,2.5
13818,CN2011100000000,20,111,"Lyon County, KS",Jul-19,16620,15935,685,4.1
13819,CN2011300000000,20,113,"McPherson County, KS",Jul-19,17268,16788,480,2.8
13820,CN2011500000000,20,115,"Marion County, KS",Jul-19,5926,5699,227,3.8
13821,CN2011700000000,20,117,"Marshall County, KS",Jul-19,5623,5442,181,3.2
13822,CN2011900000000,20,119,"Meade County, KS",Jul-19,2169,2109,60,2.8
13823,CN2012100000000,20,121,"Miami County, KS",Jul-19,17916,17273,643,3.6
13824,CN2012300000000,20,123,"Mitchell County, KS",Jul-19,3431,3335,96,2.8
13825,CN2012500000000,20,125,"Montgomery County, KS",Jul-19,14992,14269,723,4.8
13826,CN2012700000000,20,127,"Morris County, KS",Jul-19,2954,2862,92,3.1
13827,CN2012900000000,20,129,"Morton County, KS",Jul-19,1101,1059,42,3.8
13828,CN2013100000000,20,131,"Nemaha County, KS",Jul-19,5423,5238,185,3.4
13829,CN2013300000000,20,133,"Neosho County, KS",Jul-19,6252,5902,350,5.6
13830,CN2013500000000,20,135,"Ness County, KS",Jul-19,1368,1328,40,2.9
13831,CN2013700000000,20,137,"Norton County, KS",Jul-19,2768,2692,76,2.7
13832,CN2013900000000,20,139,"Osage County, KS",Jul-19,8199,7890,309,3.8
13833,CN2014100000000,20,141,"Osborne County, KS",Jul-19,2036,1986,50,2.5
13834,CN2014300000000,20,143,"Ottawa County, KS",Jul-19,3054,2958,96,3.1
13835,CN2014500000000,20,145,"Pawnee County, KS",Jul-19,2979,2889,90,3.0
13836,CN2014700000000,20,147,"Phillips County, KS",Jul-19,2566,2482,84,3.3
13837,CN2014900000000,20,149,"Pottawatomie County, KS",Jul-19,11908,11506,402,3.4
13838,CN2015100000000,20,151,"Pratt County, KS",Jul-19,4880,4729,151,3.1
13839,CN2015300000000,20,153,"Rawlins County, KS",Jul-19,1539,1497,42,2.7
13840,CN2015500000000,20,155,"Reno County, KS",Jul-19,29856,28759,1097,3.7
13841,CN2015700000000,20,157,"Republic County, KS",Jul-19,2296,2222,74,3.2
13842,CN2015900000000,20,159,"Rice County, KS",Jul-19,5402,5227,175,3.2
13843,CN2016100000000,20,161,"Riley County, KS",Jul-19,33609,32408,1201,3.6
13844,CN2016300000000,20,163,"Rooks County, KS",Jul-19,2530,2422,108,4.3
13845,CN2016500000000,20,165,"Rush County, KS",Jul-19,1671,1619,52,3.1
13846,CN2016700000000,20,167,"Russell County, KS",Jul-19,3312,3202,110,3.3
13847,CN2016900000000,20,169,"Saline County, KS",Jul-19,30632,29603,1029,3.4
13848,CN2017100000000,20,171,"Scott County, KS",Jul-19,2955,2885,70,2.4
13849,CN2017300000000,20,173,"Sedgwick County, KS",Jul-19,256515,246335,10180,4.0
13850,CN2017500000000,20,175,"Seward County, KS",Jul-19,9599,9229,370,3.9
13851,CN2017700000000,20,177,"Shawnee County, KS",Jul-19,93251,89765,3486,3.7
13852,CN2017900000000,20,179,"Sheridan County, KS",Jul-19,1394,1360,34,2.4
13853,CN2018100000000,20,181,"Sherman County, KS",Jul-19,2906,2808,98,3.4
13854,CN2018300000000,20,183,"Smith County, KS",Jul-19,1918,1854,64,3.3
13855,CN2018500000000,20,185,"Stafford County, KS",Jul-19,1959,1889,70,3.6
13856,CN2018700000000,20,187,"Stanton County, KS",Jul-19,990,960,30,3.0
13857,CN2018900000000,20,189,"Stevens County, KS",Jul-19,2543,2465,78,3.1
13858,CN2019100000000,20,191,"Sumner County, KS",Jul-19,11140,10700,440,3.9
13859,CN2019300000000,20,193,"Thomas County, KS",Jul-19,4358,4237,121,2.8
13860,CN2019500000000,20,195,"Trego County, KS",Jul-19,1434,1388,46,3.2
13861,CN2019700000000,20,197,"Wabaunsee County, KS",Jul-19,3746,3617,129,3.4
13862,CN2019900000000,20,199,"Wallace County, KS",Jul-19,814,786,28,3.4
13863,CN2020100000000,20,201,"Washington County, KS",Jul-19,2924,2830,94,3.2
13864,CN2020300000000,20,203,"Wichita County, KS",Jul-19,1220,1186,34,2.8
13865,CN2020500000000,20,205,"Wilson County, KS",Jul-19,3946,3761,185,4.7
13866,CN2020700000000,20,207,"Woodson County, KS",Jul-19,1611,1527,84,5.2
13867,CN2020900000000,20,209,"Wyandotte County, KS",Jul-19,79896,75561,4335,5.4
13868,CN2100100000000,21,1,"Adair County, KY",Jul-19,7038,6633,405,5.8
13869,CN2100300000000,21,3,"Allen County, KY",Jul-19,9054,8628,426,4.7
13870,CN2100500000000,21,5,"Anderson County, KY",Jul-19,12214,11679,535,4.4
13871,CN2100700000000,21,7,"Ballard County, KY",Jul-19,3569,3347,222,6.2
13872,CN2100900000000,21,9,"Barren County, KY",Jul-19,18958,18032,926,4.9
13873,CN2101100000000,21,11,"Bath County, KY",Jul-19,4644,4342,302,6.5
13874,CN2101300000000,21,13,"Bell County, KY",Jul-19,8402,7781,621,7.4
13875,CN2101500000000,21,15,"Boone County, KY",Jul-19,72403,69752,2651,3.7
13876,CN2101700000000,21,17,"Bourbon County, KY",Jul-19,10074,9671,403,4.0
13877,CN2101900000000,21,19,"Boyd County, KY",Jul-19,17929,16814,1115,6.2
13878,CN2102100000000,21,21,"Boyle County, KY",Jul-19,12526,11840,686,5.5
13879,CN2102300000000,21,23,"Bracken County, KY",Jul-19,3888,3696,192,4.9
13880,CN2102500000000,21,25,"Breathitt County, KY",Jul-19,3398,3115,283,8.3
13881,CN2102700000000,21,27,"Breckinridge County, KY",Jul-19,8141,7679,462,5.7
13882,CN2102900000000,21,29,"Bullitt County, KY",Jul-19,43741,41621,2120,4.8
13883,CN2103100000000,21,31,"Butler County, KY",Jul-19,5061,4775,286,5.7
13884,CN2103300000000,21,33,"Caldwell County, KY",Jul-19,5463,5166,297,5.4
13885,CN2103500000000,21,35,"Calloway County, KY",Jul-19,18795,17907,888,4.7
13886,CN2103700000000,21,37,"Campbell County, KY",Jul-19,51806,49791,2015,3.9
13887,CN2103900000000,21,39,"Carlisle County, KY",Jul-19,2211,2111,100,4.5
13888,CN2104100000000,21,41,"Carroll County, KY",Jul-19,5385,5152,233,4.3
13889,CN2104300000000,21,43,"Carter County, KY",Jul-19,9755,8853,902,9.2
13890,CN2104500000000,21,45,"Casey County, KY",Jul-19,6769,6450,319,4.7
13891,CN2104700000000,21,47,"Christian County, KY",Jul-19,25326,23738,1588,6.3
13892,CN2104900000000,21,49,"Clark County, KY",Jul-19,17354,16604,750,4.3
13893,CN2105100000000,21,51,"Clay County, KY",Jul-19,5122,4714,408,8.0
13894,CN2105300000000,21,53,"Clinton County, KY",Jul-19,4100,3873,227,5.5
13895,CN2105500000000,21,55,"Crittenden County, KY",Jul-19,3766,3574,192,5.1
13896,CN2105700000000,21,57,"Cumberland County, KY",Jul-19,3234,3109,125,3.9
13897,CN2105900000000,21,59,"Daviess County, KY",Jul-19,48294,46260,2034,4.2
13898,CN2106100000000,21,61,"Edmonson County, KY",Jul-19,4787,4528,259,5.4
13899,CN2106300000000,21,63,"Elliott County, KY",Jul-19,2035,1860,175,8.6
13900,CN2106500000000,21,65,"Estill County, KY",Jul-19,5304,5024,280,5.3
13901,CN2106700000000,21,67,"Fayette County, KY",Jul-19,177166,170515,6651,3.8
13902,CN2106900000000,21,69,"Fleming County, KY",Jul-19,6276,5908,368,5.9
13903,CN2107100000000,21,71,"Floyd County, KY",Jul-19,10963,10193,770,7.0
13904,CN2107300000000,21,73,"Franklin County, KY",Jul-19,25537,24449,1088,4.3
13905,CN2107500000000,21,75,"Fulton County, KY",Jul-19,2119,1973,146,6.9
13906,CN2107700000000,21,77,"Gallatin County, KY",Jul-19,4184,4006,178,4.3
13907,CN2107900000000,21,79,"Garrard County, KY",Jul-19,7630,7238,392,5.1
13908,CN2108100000000,21,81,"Grant County, KY",Jul-19,11940,11435,505,4.2
13909,CN2108300000000,21,83,"Graves County, KY",Jul-19,15934,15138,796,5.0
13910,CN2108500000000,21,85,"Grayson County, KY",Jul-19,11049,10336,713,6.5
13911,CN2108700000000,21,87,"Green County, KY",Jul-19,5156,4888,268,5.2
13912,CN2108900000000,21,89,"Greenup County, KY",Jul-19,13531,12542,989,7.3
13913,CN2109100000000,21,91,"Hancock County, KY",Jul-19,4058,3890,168,4.1
13914,CN2109300000000,21,93,"Hardin County, KY",Jul-19,50370,48034,2336,4.6
13915,CN2109500000000,21,95,"Harlan County, KY",Jul-19,6756,5894,862,12.8
13916,CN2109700000000,21,97,"Harrison County, KY",Jul-19,8894,8476,418,4.7
13917,CN2109900000000,21,99,"Hart County, KY",Jul-19,7908,7514,394,5.0
13918,CN2110100000000,21,101,"Henderson County, KY",Jul-19,22233,21313,920,4.1
13919,CN2110300000000,21,103,"Henry County, KY",Jul-19,8423,8069,354,4.2
13920,CN2110500000000,21,105,"Hickman County, KY",Jul-19,1819,1727,92,5.1
13921,CN2110700000000,21,107,"Hopkins County, KY",Jul-19,18872,17933,939,5.0
13922,CN2110900000000,21,109,"Jackson County, KY",Jul-19,4076,3789,287,7.0
13923,CN2111100000000,21,111,"Jefferson County, KY",Jul-19,408252,388786,19466,4.8
13924,CN2111300000000,21,113,"Jessamine County, KY",Jul-19,26797,25685,1112,4.1
13925,CN2111500000000,21,115,"Johnson County, KY",Jul-19,6835,6363,472,6.9
13926,CN2111700000000,21,117,"Kenton County, KY",Jul-19,89613,86149,3464,3.9
13927,CN2111900000000,21,119,"Knott County, KY",Jul-19,4544,4182,362,8.0
13928,CN2112100000000,21,121,"Knox County, KY",Jul-19,9943,9265,678,6.8
13929,CN2112300000000,21,123,"Larue County, KY",Jul-19,6111,5797,314,5.1
13930,CN2112500000000,21,125,"Laurel County, KY",Jul-19,24635,23258,1377,5.6
13931,CN2112700000000,21,127,"Lawrence County, KY",Jul-19,5171,4790,381,7.4
13932,CN2112900000000,21,129,"Lee County, KY",Jul-19,2090,1952,138,6.6
13933,CN2113100000000,21,131,"Leslie County, KY",Jul-19,2775,2470,305,11.0
13934,CN2113300000000,21,133,"Letcher County, KY",Jul-19,6248,5718,530,8.5
13935,CN2113500000000,21,135,"Lewis County, KY",Jul-19,4668,4228,440,9.4
13936,CN2113700000000,21,137,"Lincoln County, KY",Jul-19,9299,8778,521,5.6
13937,CN2113900000000,21,139,"Livingston County, KY",Jul-19,3697,3489,208,5.6
13938,CN2114100000000,21,141,"Logan County, KY",Jul-19,12621,12064,557,4.4
13939,CN2114300000000,21,143,"Lyon County, KY",Jul-19,3375,3211,164,4.9
13940,CN2114500000000,21,145,"McCracken County, KY",Jul-19,29512,27929,1583,5.4
13941,CN2114700000000,21,147,"McCreary County, KY",Jul-19,4827,4520,307,6.4
13942,CN2114900000000,21,149,"McLean County, KY",Jul-19,4323,4121,202,4.7
13943,CN2115100000000,21,151,"Madison County, KY",Jul-19,47067,44963,2104,4.5
13944,CN2115300000000,21,153,"Magoffin County, KY",Jul-19,3052,2725,327,10.7
13945,CN2115500000000,21,155,"Marion County, KY",Jul-19,9876,9455,421,4.3
13946,CN2115700000000,21,157,"Marshall County, KY",Jul-19,15417,14647,770,5.0
13947,CN2115900000000,21,159,"Martin County, KY",Jul-19,2748,2534,214,7.8
13948,CN2116100000000,21,161,"Mason County, KY",Jul-19,7191,6737,454,6.3
13949,CN2116300000000,21,163,"Meade County, KY",Jul-19,12634,11989,645,5.1
13950,CN2116500000000,21,165,"Menifee County, KY",Jul-19,2315,2158,157,6.8
13951,CN2116700000000,21,167,"Mercer County, KY",Jul-19,10114,9599,515,5.1
13952,CN2116900000000,21,169,"Metcalfe County, KY",Jul-19,4164,3929,235,5.6
13953,CN2117100000000,21,171,"Monroe County, KY",Jul-19,4719,4519,200,4.2
13954,CN2117300000000,21,173,"Montgomery County, KY",Jul-19,11716,11022,694,5.9
13955,CN2117500000000,21,175,"Morgan County, KY",Jul-19,4586,4322,264,5.8
13956,CN2117700000000,21,177,"Muhlenberg County, KY",Jul-19,10396,9672,724,7.0
13957,CN2117900000000,21,179,"Nelson County, KY",Jul-19,23428,22259,1169,5.0
13958,CN2118100000000,21,181,"Nicholas County, KY",Jul-19,3310,3148,162,4.9
13959,CN2118300000000,21,183,"Ohio County, KY",Jul-19,9955,9396,559,5.6
13960,CN2118500000000,21,185,"Oldham County, KY",Jul-19,33939,32640,1299,3.8
13961,CN2118700000000,21,187,"Owen County, KY",Jul-19,5157,4898,259,5.0
13962,CN2118900000000,21,189,"Owsley County, KY",Jul-19,1155,1069,86,7.4
13963,CN2119100000000,21,191,"Pendleton County, KY",Jul-19,7103,6812,291,4.1
13964,CN2119300000000,21,193,"Perry County, KY",Jul-19,8302,7746,556,6.7
13965,CN2119500000000,21,195,"Pike County, KY",Jul-19,20168,18897,1271,6.3
13966,CN2119700000000,21,197,"Powell County, KY",Jul-19,5117,4834,283,5.5
13967,CN2119900000000,21,199,"Pulaski County, KY",Jul-19,26945,25594,1351,5.0
13968,CN2120100000000,21,201,"Robertson County, KY",Jul-19,822,773,49,6.0
13969,CN2120300000000,21,203,"Rockcastle County, KY",Jul-19,6656,6291,365,5.5
13970,CN2120500000000,21,205,"Rowan County, KY",Jul-19,10288,9685,603,5.9
13971,CN2120700000000,21,207,"Russell County, KY",Jul-19,6381,6024,357,5.6
13972,CN2120900000000,21,209,"Scott County, KY",Jul-19,29518,28363,1155,3.9
13973,CN2121100000000,21,211,"Shelby County, KY",Jul-19,26075,25054,1021,3.9
13974,CN2121300000000,21,213,"Simpson County, KY",Jul-19,8921,8486,435,4.9
13975,CN2121500000000,21,215,"Spencer County, KY",Jul-19,10403,9966,437,4.2
13976,CN2121700000000,21,217,"Taylor County, KY",Jul-19,12616,11944,672,5.3
13977,CN2121900000000,21,219,"Todd County, KY",Jul-19,5512,5285,227,4.1
13978,CN2122100000000,21,221,"Trigg County, KY",Jul-19,6107,5797,310,5.1
13979,CN2122300000000,21,223,"Trimble County, KY",Jul-19,3965,3774,191,4.8
13980,CN2122500000000,21,225,"Union County, KY",Jul-19,6207,5907,300,4.8
13981,CN2122700000000,21,227,"Warren County, KY",Jul-19,64631,61785,2846,4.4
13982,CN2122900000000,21,229,"Washington County, KY",Jul-19,6350,6083,267,4.2
13983,CN2123100000000,21,231,"Wayne County, KY",Jul-19,7707,7259,448,5.8
13984,CN2123300000000,21,233,"Webster County, KY",Jul-19,5926,5670,256,4.3
13985,CN2123500000000,21,235,"Whitley County, KY",Jul-19,13734,12935,799,5.8
13986,CN2123700000000,21,237,"Wolfe County, KY",Jul-19,1941,1776,165,8.5
13987,CN2123900000000,21,239,"Woodford County, KY",Jul-19,15289,14755,534,3.5
13988,CN2200100000000,22,1,"Acadia Parish, LA",Jul-19,24168,22756,1412,5.8
13989,CN2200300000000,22,3,"Allen Parish, LA",Jul-19,8636,8069,567,6.6
13990,CN2200500000000,22,5,"Ascension Parish, LA",Jul-19,63906,60964,2942,4.6
13991,CN2200700000000,22,7,"Assumption Parish, LA",Jul-19,8991,8395,596,6.6
13992,CN2200900000000,22,9,"Avoyelles Parish, LA",Jul-19,15299,14229,1070,7.0
13993,CN2201100000000,22,11,"Beauregard Parish, LA",Jul-19,14690,13824,866,5.9
13994,CN2201300000000,22,13,"Bienville Parish, LA",Jul-19,5649,5292,357,6.3
13995,CN2201500000000,22,15,"Bossier Parish, LA",Jul-19,58550,55704,2846,4.9
13996,CN2201700000000,22,17,"Caddo Parish, LA",Jul-19,105226,98930,6296,6.0
13997,CN2201900000000,22,19,"Calcasieu Parish, LA",Jul-19,107127,102152,4975,4.6
13998,CN2202100000000,22,21,"Caldwell Parish, LA",Jul-19,3744,3514,230,6.1
13999,CN2202300000000,22,23,"Cameron Parish, LA",Jul-19,3969,3799,170,4.3
14000,CN2202500000000,22,25,"Catahoula Parish, LA",Jul-19,3480,3220,260,7.5
14001,CN2202700000000,22,27,"Claiborne Parish, LA",Jul-19,5920,5563,357,6.0
14002,CN2202900000000,22,29,"Concordia Parish, LA",Jul-19,7107,6564,543,7.6
14003,CN2203100000000,22,31,"De Soto Parish, LA",Jul-19,11023,10295,728,6.6
14004,CN2203300000000,22,33,"East Baton Rouge Parish, LA",Jul-19,230923,219103,11820,5.1
14005,CN2203500000000,22,35,"East Carroll Parish, LA",Jul-19,1924,1698,226,11.7
14006,CN2203700000000,22,37,"East Feliciana Parish, LA",Jul-19,8010,7581,429,5.4
14007,CN2203900000000,22,39,"Evangeline Parish, LA",Jul-19,11882,11032,850,7.2
14008,CN2204100000000,22,41,"Franklin Parish, LA",Jul-19,7589,6990,599,7.9
14009,CN2204300000000,22,43,"Grant Parish, LA",Jul-19,8367,7786,581,6.9
14010,CN2204500000000,22,45,"Iberia Parish, LA",Jul-19,28595,26891,1704,6.0
14011,CN2204700000000,22,47,"Iberville Parish, LA",Jul-19,14008,13105,903,6.4
14012,CN2204900000000,22,49,"Jackson Parish, LA",Jul-19,6886,6513,373,5.4
14013,CN2205100000000,22,51,"Jefferson Parish, LA",Jul-19,215383,205178,10205,4.7
14014,CN2205300000000,22,53,"Jefferson Davis Parish, LA",Jul-19,13521,12789,732,5.4
14015,CN2205500000000,22,55,"Lafayette Parish, LA",Jul-19,115480,109896,5584,4.8
14016,CN2205700000000,22,57,"Lafourche Parish, LA",Jul-19,42940,40796,2144,5.0
14017,CN2205900000000,22,59,"LaSalle Parish, LA",Jul-19,6853,6493,360,5.3
14018,CN2206100000000,22,61,"Lincoln Parish, LA",Jul-19,21237,19894,1343,6.3
14019,CN2206300000000,22,63,"Livingston Parish, LA",Jul-19,68827,65620,3207,4.7
14020,CN2206500000000,22,65,"Madison Parish, LA",Jul-19,3633,3294,339,9.3
14021,CN2206700000000,22,67,"Morehouse Parish, LA",Jul-19,9849,8938,911,9.2
14022,CN2206900000000,22,69,"Natchitoches Parish, LA",Jul-19,16245,15074,1171,7.2
14023,CN2207100000000,22,71,"Orleans Parish, LA",Jul-19,180896,170658,10238,5.7
14024,CN2207300000000,22,73,"Ouachita Parish, LA",Jul-19,70868,66728,4140,5.8
14025,CN2207500000000,22,75,"Plaquemines Parish, LA",Jul-19,10120,9624,496,4.9
14026,CN2207700000000,22,77,"Pointe Coupee Parish, LA",Jul-19,9923,9305,618,6.2
14027,CN2207900000000,22,79,"Rapides Parish, LA",Jul-19,55939,52741,3198,5.7
14028,CN2208100000000,22,81,"Red River Parish, LA",Jul-19,3819,3586,233,6.1
14029,CN2208300000000,22,83,"Richland Parish, LA",Jul-19,8292,7733,559,6.7
14030,CN2208500000000,22,85,"Sabine Parish, LA",Jul-19,9406,8881,525,5.6
14031,CN2208700000000,22,87,"St. Bernard Parish, LA",Jul-19,20055,18971,1084,5.4
14032,CN2208900000000,22,89,"St. Charles Parish, LA",Jul-19,25350,24088,1262,5.0
14033,CN2209100000000,22,91,"St. Helena Parish, LA",Jul-19,4311,3993,318,7.4
14034,CN2209300000000,22,93,"St. James Parish, LA",Jul-19,9286,8660,626,6.7
14035,CN2209500000000,22,95,"St. John the Baptist Parish, LA",Jul-19,19762,18549,1213,6.1
14036,CN2209700000000,22,97,"St. Landry Parish, LA",Jul-19,32672,30416,2256,6.9
14037,CN2209900000000,22,99,"St. Martin Parish, LA",Jul-19,22492,21191,1301,5.8
14038,CN2210100000000,22,101,"St. Mary Parish, LA",Jul-19,20083,18781,1302,6.5
14039,CN2210300000000,22,103,"St. Tammany Parish, LA",Jul-19,120484,114799,5685,4.7
14040,CN2210500000000,22,105,"Tangipahoa Parish, LA",Jul-19,54975,51447,3528,6.4
14041,CN2210700000000,22,107,"Tensas Parish, LA",Jul-19,1432,1275,157,11.0
14042,CN2210900000000,22,109,"Terrebonne Parish, LA",Jul-19,47170,44800,2370,5.0
14043,CN2211100000000,22,111,"Union Parish, LA",Jul-19,9178,8608,570,6.2
14044,CN2211300000000,22,113,"Vermilion Parish, LA",Jul-19,24553,23188,1365,5.6
14045,CN2211500000000,22,115,"Vernon Parish, LA",Jul-19,16252,15068,1184,7.3
14046,CN2211700000000,22,117,"Washington Parish, LA",Jul-19,16749,15604,1145,6.8
14047,CN2211900000000,22,119,"Webster Parish, LA",Jul-19,14747,13746,1001,6.8
14048,CN2212100000000,22,121,"West Baton Rouge Parish, LA",Jul-19,13672,12951,721,5.3
14049,CN2212300000000,22,123,"West Carroll Parish, LA",Jul-19,3597,3242,355,9.9
14050,CN2212500000000,22,125,"West Feliciana Parish, LA",Jul-19,5383,5132,251,4.7
14051,CN2212700000000,22,127,"Winn Parish, LA",Jul-19,5002,4647,355,7.1
14052,CN2300100000000,23,1,"Androscoggin County, ME",Jul-19,54759,53209,1550,2.8
14053,CN2300300000000,23,3,"Aroostook County, ME",Jul-19,30639,29416,1223,4.0
14054,CN2300500000000,23,5,"Cumberland County, ME",Jul-19,168497,164846,3651,2.2
14055,CN2300700000000,23,7,"Franklin County, ME",Jul-19,14135,13606,529,3.7
14056,CN2300900000000,23,9,"Hancock County, ME",Jul-19,32022,31290,732,2.3
14057,CN2301100000000,23,11,"Kennebec County, ME",Jul-19,62851,61168,1683,2.7
14058,CN2301300000000,23,13,"Knox County, ME",Jul-19,21605,21125,480,2.2
14059,CN2301500000000,23,15,"Lincoln County, ME",Jul-19,18221,17804,417,2.3
14060,CN2301700000000,23,17,"Oxford County, ME",Jul-19,27103,26234,869,3.2
14061,CN2301900000000,23,19,"Penobscot County, ME",Jul-19,76501,74195,2306,3.0
14062,CN2302100000000,23,21,"Piscataquis County, ME",Jul-19,7433,7205,228,3.1
14063,CN2302300000000,23,23,"Sagadahoc County, ME",Jul-19,19768,19386,382,1.9
14064,CN2302500000000,23,25,"Somerset County, ME",Jul-19,23199,22222,977,4.2
14065,CN2302700000000,23,27,"Waldo County, ME",Jul-19,21356,20741,615,2.9
14066,CN2302900000000,23,29,"Washington County, ME",Jul-19,14159,13561,598,4.2
14067,CN2303100000000,23,31,"York County, ME",Jul-19,116541,113896,2645,2.3
14068,CN2400100000000,24,1,"Allegany County, MD",Jul-19,32782,30903,1879,5.7
14069,CN2400300000000,24,3,"Anne Arundel County, MD",Jul-19,322394,311348,11046,3.4
14070,CN2400500000000,24,5,"Baltimore County, MD",Jul-19,463977,445482,18495,4.0
14071,CN2400900000000,24,9,"Calvert County, MD",Jul-19,51430,49548,1882,3.7
14072,CN2401100000000,24,11,"Caroline County, MD",Jul-19,18382,17669,713,3.9
14073,CN2401300000000,24,13,"Carroll County, MD",Jul-19,97447,94194,3253,3.3
14074,CN2401500000000,24,15,"Cecil County, MD",Jul-19,54108,51693,2415,4.5
14075,CN2401700000000,24,17,"Charles County, MD",Jul-19,89848,86195,3653,4.1
14076,CN2401900000000,24,19,"Dorchester County, MD",Jul-19,15980,15224,756,4.7
14077,CN2402100000000,24,21,"Frederick County, MD",Jul-19,138315,133519,4796,3.5
14078,CN2402300000000,24,23,"Garrett County, MD",Jul-19,16332,15592,740,4.5
14079,CN2402500000000,24,25,"Harford County, MD",Jul-19,144389,138827,5562,3.9
14080,CN2402700000000,24,27,"Howard County, MD",Jul-19,191908,185950,5958,3.1
14081,CN2402900000000,24,29,"Kent County, MD",Jul-19,10354,9949,405,3.9
14082,CN2403100000000,24,31,"Montgomery County, MD",Jul-19,576387,558021,18366,3.2
14083,CN2403300000000,24,33,"Prince George's County, MD",Jul-19,522224,501652,20572,3.9
14084,CN2403500000000,24,35,"Queen Anne's County, MD",Jul-19,28124,27161,963,3.4
14085,CN2403700000000,24,37,"St. Mary's County, MD",Jul-19,58397,56072,2325,4.0
14086,CN2403900000000,24,39,"Somerset County, MD",Jul-19,9776,9169,607,6.2
14087,CN2404100000000,24,41,"Talbot County, MD",Jul-19,19617,18918,699,3.6
14088,CN2404300000000,24,43,"Washington County, MD",Jul-19,75776,72695,3081,4.1
14089,CN2404500000000,24,45,"Wicomico County, MD",Jul-19,55579,53102,2477,4.5
14090,CN2404700000000,24,47,"Worcester County, MD",Jul-19,26928,25589,1339,5.0
14091,CN2451000000000,24,510,"Baltimore city, MD",Jul-19,295652,279307,16345,5.5
14092,CN2500100000000,25,1,"Barnstable County, MA",Jul-19,130016,126407,3609,2.8
14093,CN2500300000000,25,3,"Berkshire County, MA",Jul-19,68184,65961,2223,3.3
14094,CN2500500000000,25,5,"Bristol County, MA",Jul-19,304687,292829,11858,3.9
14095,CN2500700000000,25,7,"Dukes County, MA",Jul-19,12627,12363,264,2.1
14096,CN2500900000000,25,9,"Essex County, MA",Jul-19,433536,419799,13737,3.2
14097,CN2501100000000,25,11,"Franklin County, MA",Jul-19,41507,40390,1117,2.7
14098,CN2501300000000,25,13,"Hampden County, MA",Jul-19,228837,218327,10510,4.6
14099,CN2501500000000,25,15,"Hampshire County, MA",Jul-19,90435,87528,2907,3.2
14100,CN2501700000000,25,17,"Middlesex County, MA",Jul-19,938772,914353,24419,2.6
14101,CN2501900000000,25,19,"Nantucket County/town, MA",Jul-19,10360,10197,163,1.6
14102,CN2502100000000,25,21,"Norfolk County, MA",Jul-19,399417,388169,11248,2.8
14103,CN2502300000000,25,23,"Plymouth County, MA",Jul-19,290466,281010,9456,3.3
14104,CN2502500000000,25,25,"Suffolk County, MA",Jul-19,466599,452475,14124,3.0
14105,CN2502700000000,25,27,"Worcester County, MA",Jul-19,449820,434316,15504,3.4
14106,CN2600100000000,26,1,"Alcona County, MI",Jul-19,4091,3825,266,6.5
14107,CN2600300000000,26,3,"Alger County, MI",Jul-19,3490,3242,248,7.1
14108,CN2600500000000,26,5,"Allegan County, MI",Jul-19,63356,60898,2458,3.9
14109,CN2600700000000,26,7,"Alpena County, MI",Jul-19,13215,12453,762,5.8
14110,CN2600900000000,26,9,"Antrim County, MI",Jul-19,11550,10985,565,4.9
14111,CN2601100000000,26,11,"Arenac County, MI",Jul-19,6320,5915,405,6.4
14112,CN2601300000000,26,13,"Baraga County, MI",Jul-19,3338,3107,231,6.9
14113,CN2601500000000,26,15,"Barry County, MI",Jul-19,31888,30588,1300,4.1
14114,CN2601700000000,26,17,"Bay County, MI",Jul-19,50485,47755,2730,5.4
14115,CN2601900000000,26,19,"Benzie County, MI",Jul-19,9505,9057,448,4.7
14116,CN2602100000000,26,21,"Berrien County, MI",Jul-19,75001,71284,3717,5.0
14117,CN2602300000000,26,23,"Branch County, MI",Jul-19,19726,18722,1004,5.1
14118,CN2602500000000,26,25,"Calhoun County, MI",Jul-19,62631,59368,3263,5.2
14119,CN2602700000000,26,27,"Cass County, MI",Jul-19,24260,22920,1340,5.5
14120,CN2602900000000,26,29,"Charlevoix County, MI",Jul-19,14164,13555,609,4.3
14121,CN2603100000000,26,31,"Cheboygan County, MI",Jul-19,11523,11025,498,4.3
14122,CN2603300000000,26,33,"Chippewa County, MI",Jul-19,16190,15143,1047,6.5
14123,CN2603500000000,26,35,"Clare County, MI",Jul-19,11807,11014,793,6.7
14124,CN2603700000000,26,37,"Clinton County, MI",Jul-19,40385,38841,1544,3.8
14125,CN2603900000000,26,39,"Crawford County, MI",Jul-19,5775,5430,345,6.0
14126,CN2604100000000,26,41,"Delta County, MI",Jul-19,17567,16566,1001,5.7
14127,CN2604300000000,26,43,"Dickinson County, MI",Jul-19,12623,11829,794,6.3
14128,CN2604500000000,26,45,"Eaton County, MI",Jul-19,56058,53478,2580,4.6
14129,CN2604700000000,26,47,"Emmet County, MI",Jul-19,19445,18570,875,4.5
14130,CN2604900000000,26,49,"Genesee County, MI",Jul-19,184551,173328,11223,6.1
14131,CN2605100000000,26,51,"Gladwin County, MI",Jul-19,10169,9507,662,6.5
14132,CN2605300000000,26,53,"Gogebic County, MI",Jul-19,5975,5595,380,6.4
14133,CN2605500000000,26,55,"Grand Traverse County, MI",Jul-19,53567,51597,1970,3.7
14134,CN2605700000000,26,57,"Gratiot County, MI",Jul-19,17835,16735,1100,6.2
14135,CN2605900000000,26,59,"Hillsdale County, MI",Jul-19,20820,19730,1090,5.2
14136,CN2606100000000,26,61,"Houghton County, MI",Jul-19,15798,14827,971,6.1
14137,CN2606300000000,26,63,"Huron County, MI",Jul-19,15985,15141,844,5.3
14138,CN2606500000000,26,65,"Ingham County, MI",Jul-19,148271,141110,7161,4.8
14139,CN2606700000000,26,67,"Ionia County, MI",Jul-19,30731,29224,1507,4.9
14140,CN2606900000000,26,69,"Iosco County, MI",Jul-19,10746,10078,668,6.2
14141,CN2607100000000,26,71,"Iron County, MI",Jul-19,5317,5006,311,5.8
14142,CN2607300000000,26,73,"Isabella County, MI",Jul-19,34945,33182,1763,5.0
14143,CN2607500000000,26,75,"Jackson County, MI",Jul-19,74064,70443,3621,4.9
14144,CN2607700000000,26,77,"Kalamazoo County, MI",Jul-19,132780,126956,5824,4.4
14145,CN2607900000000,26,79,"Kalkaska County, MI",Jul-19,8503,8036,467,5.5
14146,CN2608100000000,26,81,"Kent County, MI",Jul-19,361442,347427,14015,3.9
14147,CN2608300000000,26,83,"Keweenaw County, MI",Jul-19,865,801,64,7.4
14148,CN2608500000000,26,85,"Lake County, MI",Jul-19,3778,3506,272,7.2
14149,CN2608700000000,26,87,"Lapeer County, MI",Jul-19,42260,39660,2600,6.2
14150,CN2608900000000,26,89,"Leelanau County, MI",Jul-19,11317,10918,399,3.5
14151,CN2609100000000,26,91,"Lenawee County, MI",Jul-19,46372,44085,2287,4.9
14152,CN2609300000000,26,93,"Livingston County, MI",Jul-19,105498,101522,3976,3.8
14153,CN2609500000000,26,95,"Luce County, MI",Jul-19,2442,2299,143,5.9
14154,CN2609700000000,26,97,"Mackinac County, MI",Jul-19,6375,6162,213,3.3
14155,CN2609900000000,26,99,"Macomb County, MI",Jul-19,457382,434330,23052,5.0
14156,CN2610100000000,26,101,"Manistee County, MI",Jul-19,11078,10460,618,5.6
14157,CN2610300000000,26,103,"Marquette County, MI",Jul-19,32242,30475,1767,5.5
14158,CN2610500000000,26,105,"Mason County, MI",Jul-19,14553,13836,717,4.9
14159,CN2610700000000,26,107,"Mecosta County, MI",Jul-19,17838,16794,1044,5.9
14160,CN2610900000000,26,109,"Menominee County, MI",Jul-19,11304,10742,562,5.0
14161,CN2611100000000,26,111,"Midland County, MI",Jul-19,40500,38687,1813,4.5
14162,CN2611300000000,26,113,"Missaukee County, MI",Jul-19,7220,6859,361,5.0
14163,CN2611500000000,26,115,"Monroe County, MI",Jul-19,75969,71665,4304,5.7
14164,CN2611700000000,26,117,"Montcalm County, MI",Jul-19,28680,27154,1526,5.3
14165,CN2611900000000,26,119,"Montmorency County, MI",Jul-19,3106,2858,248,8.0
14166,CN2612100000000,26,121,"Muskegon County, MI",Jul-19,78973,74669,4304,5.4
14167,CN2612300000000,26,123,"Newaygo County, MI",Jul-19,23839,22637,1202,5.0
14168,CN2612500000000,26,125,"Oakland County, MI",Jul-19,689748,660975,28773,4.2
14169,CN2612700000000,26,127,"Oceana County, MI",Jul-19,13227,12468,759,5.7
14170,CN2612900000000,26,129,"Ogemaw County, MI",Jul-19,8435,7870,565,6.7
14171,CN2613100000000,26,131,"Ontonagon County, MI",Jul-19,2144,1996,148,6.9
14172,CN2613300000000,26,133,"Osceola County, MI",Jul-19,11374,10843,531,4.7
14173,CN2613500000000,26,135,"Oscoda County, MI",Jul-19,3317,3046,271,8.2
14174,CN2613700000000,26,137,"Otsego County, MI",Jul-19,12205,11415,790,6.5
14175,CN2613900000000,26,139,"Ottawa County, MI",Jul-19,162105,156190,5915,3.6
14176,CN2614100000000,26,141,"Presque Isle County, MI",Jul-19,5213,4842,371,7.1
14177,CN2614300000000,26,143,"Roscommon County, MI",Jul-19,8176,7561,615,7.5
14178,CN2614500000000,26,145,"Saginaw County, MI",Jul-19,87275,82339,4936,5.7
14179,CN2614700000000,26,147,"St. Clair County, MI",Jul-19,77409,73105,4304,5.6
14180,CN2614900000000,26,149,"St. Joseph County, MI",Jul-19,28440,26546,1894,6.7
14181,CN2615100000000,26,151,"Sanilac County, MI",Jul-19,20101,19002,1099,5.5
14182,CN2615300000000,26,153,"Schoolcraft County, MI",Jul-19,3424,3192,232,6.8
14183,CN2615500000000,26,155,"Shiawassee County, MI",Jul-19,33397,31661,1736,5.2
14184,CN2615700000000,26,157,"Tuscola County, MI",Jul-19,24132,22665,1467,6.1
14185,CN2615900000000,26,159,"Van Buren County, MI",Jul-19,35309,33400,1909,5.4
14186,CN2616100000000,26,161,"Washtenaw County, MI",Jul-19,197148,188961,8187,4.2
14187,CN2616300000000,26,163,"Wayne County, MI",Jul-19,820208,766745,53463,6.5
14188,CN2616500000000,26,165,"Wexford County, MI",Jul-19,15181,14408,773,5.1
14189,CN2700100000000,27,1,"Aitkin County, MN",Jul-19,7339,7004,335,4.6
14190,CN2700300000000,27,3,"Anoka County, MN",Jul-19,201088,195052,6036,3.0
14191,CN2700500000000,27,5,"Becker County, MN",Jul-19,19070,18426,644,3.4
14192,CN2700700000000,27,7,"Beltrami County, MN",Jul-19,24539,23587,952,3.9
14193,CN2700900000000,27,9,"Benton County, MN",Jul-19,22037,21366,671,3.0
14194,CN2701100000000,27,11,"Big Stone County, MN",Jul-19,2632,2552,80,3.0
14195,CN2701300000000,27,13,"Blue Earth County, MN",Jul-19,39705,38549,1156,2.9
14196,CN2701500000000,27,15,"Brown County, MN",Jul-19,14663,14207,456,3.1
14197,CN2701700000000,27,17,"Carlton County, MN",Jul-19,17822,17097,725,4.1
14198,CN2701900000000,27,19,"Carver County, MN",Jul-19,59911,58197,1714,2.9
14199,CN2702100000000,27,21,"Cass County, MN",Jul-19,15520,14912,608,3.9
14200,CN2702300000000,27,23,"Chippewa County, MN",Jul-19,6906,6628,278,4.0
14201,CN2702500000000,27,25,"Chisago County, MN",Jul-19,30484,29502,982,3.2
14202,CN2702700000000,27,27,"Clay County, MN",Jul-19,36100,35014,1086,3.0
14203,CN2702900000000,27,29,"Clearwater County, MN",Jul-19,4433,4161,272,6.1
14204,CN2703100000000,27,31,"Cook County, MN",Jul-19,3474,3370,104,3.0
14205,CN2703300000000,27,33,"Cottonwood County, MN",Jul-19,6180,5857,323,5.2
14206,CN2703500000000,27,35,"Crow Wing County, MN",Jul-19,33576,32491,1085,3.2
14207,CN2703700000000,27,37,"Dakota County, MN",Jul-19,246168,238840,7328,3.0
14208,CN2703900000000,27,39,"Dodge County, MN",Jul-19,12259,11881,378,3.1
14209,CN2704100000000,27,41,"Douglas County, MN",Jul-19,21944,21348,596,2.7
14210,CN2704300000000,27,43,"Faribault County, MN",Jul-19,7267,6993,274,3.8
14211,CN2704500000000,27,45,"Fillmore County, MN",Jul-19,12018,11691,327,2.7
14212,CN2704700000000,27,47,"Freeborn County, MN",Jul-19,16448,15891,557,3.4
14213,CN2704900000000,27,49,"Goodhue County, MN",Jul-19,27652,26833,819,3.0
14214,CN2705100000000,27,51,"Grant County, MN",Jul-19,3387,3258,129,3.8
14215,CN2705300000000,27,53,"Hennepin County, MN",Jul-19,721882,700026,21856,3.0
14216,CN2705500000000,27,55,"Houston County, MN",Jul-19,10453,10162,291,2.8
14217,CN2705700000000,27,57,"Hubbard County, MN",Jul-19,10612,10197,415,3.9
14218,CN2705900000000,27,59,"Isanti County, MN",Jul-19,21569,20864,705,3.3
14219,CN2706100000000,27,61,"Itasca County, MN",Jul-19,22291,21063,1228,5.5
14220,CN2706300000000,27,63,"Jackson County, MN",Jul-19,5874,5501,373,6.4
14221,CN2706500000000,27,65,"Kanabec County, MN",Jul-19,9067,8721,346,3.8
14222,CN2706700000000,27,67,"Kandiyohi County, MN",Jul-19,24659,23881,778,3.2
14223,CN2706900000000,27,69,"Kittson County, MN",Jul-19,2434,2342,92,3.8
14224,CN2707100000000,27,71,"Koochiching County, MN",Jul-19,6128,5718,410,6.7
14225,CN2707300000000,27,73,"Lac qui Parle County, MN",Jul-19,3570,3442,128,3.6
14226,CN2707500000000,27,75,"Lake County, MN",Jul-19,5832,5653,179,3.1
14227,CN2707700000000,27,77,"Lake of the Woods County, MN",Jul-19,2525,2408,117,4.6
14228,CN2707900000000,27,79,"Le Sueur County, MN",Jul-19,16377,15866,511,3.1
14229,CN2708100000000,27,81,"Lincoln County, MN",Jul-19,3415,3306,109,3.2
14230,CN2708300000000,27,83,"Lyon County, MN",Jul-19,14566,14089,477,3.3
14231,CN2708500000000,27,85,"McLeod County, MN",Jul-19,19551,18889,662,3.4
14232,CN2708700000000,27,87,"Mahnomen County, MN",Jul-19,2267,2173,94,4.1
14233,CN2708900000000,27,89,"Marshall County, MN",Jul-19,5442,5233,209,3.8
14234,CN2709100000000,27,91,"Martin County, MN",Jul-19,10648,10084,564,5.3
14235,CN2709300000000,27,93,"Meeker County, MN",Jul-19,13557,13143,414,3.1
14236,CN2709500000000,27,95,"Mille Lacs County, MN",Jul-19,13019,12524,495,3.8
14237,CN2709700000000,27,97,"Morrison County, MN",Jul-19,17735,17093,642,3.6
14238,CN2709900000000,27,99,"Mower County, MN",Jul-19,20599,19981,618,3.0
14239,CN2710100000000,27,101,"Murray County, MN",Jul-19,4909,4737,172,3.5
14240,CN2710300000000,27,103,"Nicollet County, MN",Jul-19,20619,20062,557,2.7
14241,CN2710500000000,27,105,"Nobles County, MN",Jul-19,11535,11167,368,3.2
14242,CN2710700000000,27,107,"Norman County, MN",Jul-19,3393,3231,162,4.8
14243,CN2710900000000,27,109,"Olmsted County, MN",Jul-19,90784,88399,2385,2.6
14244,CN2711100000000,27,111,"Otter Tail County, MN",Jul-19,33274,31995,1279,3.8
14245,CN2711300000000,27,113,"Pennington County, MN",Jul-19,8597,8333,264,3.1
14246,CN2711500000000,27,115,"Pine County, MN",Jul-19,15245,14639,606,4.0
14247,CN2711700000000,27,117,"Pipestone County, MN",Jul-19,5155,5019,136,2.6
14248,CN2711900000000,27,119,"Polk County, MN",Jul-19,16629,15892,737,4.4
14249,CN2712100000000,27,121,"Pope County, MN",Jul-19,6745,6553,192,2.8
14250,CN2712300000000,27,123,"Ramsey County, MN",Jul-19,295647,286239,9408,3.2
14251,CN2712500000000,27,125,"Red Lake County, MN",Jul-19,2221,2129,92,4.1
14252,CN2712700000000,27,127,"Redwood County, MN",Jul-19,7825,7553,272,3.5
14253,CN2712900000000,27,129,"Renville County, MN",Jul-19,8664,8295,369,4.3
14254,CN2713100000000,27,131,"Rice County, MN",Jul-19,37501,36306,1195,3.2
14255,CN2713300000000,27,133,"Rock County, MN",Jul-19,5773,5647,126,2.2
14256,CN2713500000000,27,135,"Roseau County, MN",Jul-19,7853,7524,329,4.2
14257,CN2713700000000,27,137,"St. Louis County, MN",Jul-19,101865,97840,4025,4.0
14258,CN2713900000000,27,139,"Scott County, MN",Jul-19,85038,82738,2300,2.7
14259,CN2714100000000,27,141,"Sherburne County, MN",Jul-19,53157,51560,1597,3.0
14260,CN2714300000000,27,143,"Sibley County, MN",Jul-19,8872,8610,262,3.0
14261,CN2714500000000,27,145,"Stearns County, MN",Jul-19,91286,88637,2649,2.9
14262,CN2714700000000,27,147,"Steele County, MN",Jul-19,21368,20653,715,3.3
14263,CN2714900000000,27,149,"Stevens County, MN",Jul-19,5595,5455,140,2.5
14264,CN2715100000000,27,151,"Swift County, MN",Jul-19,5151,4911,240,4.7
14265,CN2715300000000,27,153,"Todd County, MN",Jul-19,13741,13246,495,3.6
14266,CN2715500000000,27,155,"Traverse County, MN",Jul-19,1828,1775,53,2.9
14267,CN2715700000000,27,157,"Wabasha County, MN",Jul-19,12822,12437,385,3.0
14268,CN2715900000000,27,159,"Wadena County, MN",Jul-19,5920,5523,397,6.7
14269,CN2716100000000,27,161,"Waseca County, MN",Jul-19,9270,8952,318,3.4
14270,CN2716300000000,27,163,"Washington County, MN",Jul-19,145920,141802,4118,2.8
14271,CN2716500000000,27,165,"Watonwan County, MN",Jul-19,6666,6411,255,3.8
14272,CN2716700000000,27,167,"Wilkin County, MN",Jul-19,3608,3482,126,3.5
14273,CN2716900000000,27,169,"Winona County, MN",Jul-19,28782,27869,913,3.2
14274,CN2717100000000,27,171,"Wright County, MN",Jul-19,76978,74824,2154,2.8
14275,CN2717300000000,27,173,"Yellow Medicine County, MN",Jul-19,5524,5311,213,3.9
14276,CN2800100000000,28,1,"Adams County, MS",Jul-19,11482,10548,934,8.1
14277,CN2800300000000,28,3,"Alcorn County, MS",Jul-19,16111,15240,871,5.4
14278,CN2800500000000,28,5,"Amite County, MS",Jul-19,4482,4120,362,8.1
14279,CN2800700000000,28,7,"Attala County, MS",Jul-19,6989,6509,480,6.9
14280,CN2800900000000,28,9,"Benton County, MS",Jul-19,3104,2884,220,7.1
14281,CN2801100000000,28,11,"Bolivar County, MS",Jul-19,12526,11435,1091,8.7
14282,CN2801300000000,28,13,"Calhoun County, MS",Jul-19,5902,5547,355,6.0
14283,CN2801500000000,28,15,"Carroll County, MS",Jul-19,3530,3279,251,7.1
14284,CN2801700000000,28,17,"Chickasaw County, MS",Jul-19,7091,6599,492,6.9
14285,CN2801900000000,28,19,"Choctaw County, MS",Jul-19,3874,3648,226,5.8
14286,CN2802100000000,28,21,"Claiborne County, MS",Jul-19,3124,2692,432,13.8
14287,CN2802300000000,28,23,"Clarke County, MS",Jul-19,6009,5570,439,7.3
14288,CN2802500000000,28,25,"Clay County, MS",Jul-19,8019,7279,740,9.2
14289,CN2802700000000,28,27,"Coahoma County, MS",Jul-19,8607,7871,736,8.6
14290,CN2802900000000,28,29,"Copiah County, MS",Jul-19,11453,10577,876,7.6
14291,CN2803100000000,28,31,"Covington County, MS",Jul-19,8316,7847,469,5.6
14292,CN2803300000000,28,33,"DeSoto County, MS",Jul-19,92426,87829,4597,5.0
14293,CN2803500000000,28,35,"Forrest County, MS",Jul-19,33390,31306,2084,6.2
14294,CN2803700000000,28,37,"Franklin County, MS",Jul-19,2842,2610,232,8.2
14295,CN2803900000000,28,39,"George County, MS",Jul-19,9039,8251,788,8.7
14296,CN2804100000000,28,41,"Greene County, MS",Jul-19,4468,4057,411,9.2
14297,CN2804300000000,28,43,"Grenada County, MS",Jul-19,9567,8999,568,5.9
14298,CN2804500000000,28,45,"Hancock County, MS",Jul-19,19244,18050,1194,6.2
14299,CN2804700000000,28,47,"Harrison County, MS",Jul-19,88461,83387,5074,5.7
14300,CN2804900000000,28,49,"Hinds County, MS",Jul-19,108572,101921,6651,6.1
14301,CN2805100000000,28,51,"Holmes County, MS",Jul-19,5805,5080,725,12.5
14302,CN2805300000000,28,53,"Humphreys County, MS",Jul-19,2299,2050,249,10.8
14303,CN2805500000000,28,55,"Issaquena County, MS",Jul-19,397,348,49,12.3
14304,CN2805700000000,28,57,"Itawamba County, MS",Jul-19,10755,10153,602,5.6
14305,CN2805900000000,28,59,"Jackson County, MS",Jul-19,59979,55932,4047,6.7
14306,CN2806100000000,28,61,"Jasper County, MS",Jul-19,6340,5852,488,7.7
14307,CN2806300000000,28,63,"Jefferson County, MS",Jul-19,2130,1722,408,19.2
14308,CN2806500000000,28,65,"Jefferson Davis County, MS",Jul-19,4206,3835,371,8.8
14309,CN2806700000000,28,67,"Jones County, MS",Jul-19,26813,25174,1639,6.1
14310,CN2806900000000,28,69,"Kemper County, MS",Jul-19,3648,3296,352,9.6
14311,CN2807100000000,28,71,"Lafayette County, MS",Jul-19,27191,25618,1573,5.8
14312,CN2807300000000,28,73,"Lamar County, MS",Jul-19,30636,29152,1484,4.8
14313,CN2807500000000,28,75,"Lauderdale County, MS",Jul-19,30747,28786,1961,6.4
14314,CN2807700000000,28,77,"Lawrence County, MS",Jul-19,4631,4256,375,8.1
14315,CN2807900000000,28,79,"Leake County, MS",Jul-19,8217,7711,506,6.2
14316,CN2808100000000,28,81,"Lee County, MS",Jul-19,41930,39749,2181,5.2
14317,CN2808300000000,28,83,"Leflore County, MS",Jul-19,10159,9293,866,8.5
14318,CN2808500000000,28,85,"Lincoln County, MS",Jul-19,14943,14020,923,6.2
14319,CN2808700000000,28,87,"Lowndes County, MS",Jul-19,25450,23823,1627,6.4
14320,CN2808900000000,28,89,"Madison County, MS",Jul-19,54013,51232,2781,5.1
14321,CN2809100000000,28,91,"Marion County, MS",Jul-19,10197,9563,634,6.2
14322,CN2809300000000,28,93,"Marshall County, MS",Jul-19,14766,13770,996,6.7
14323,CN2809500000000,28,95,"Monroe County, MS",Jul-19,15865,14802,1063,6.7
14324,CN2809700000000,28,97,"Montgomery County, MS",Jul-19,4013,3741,272,6.8
14325,CN2809900000000,28,99,"Neshoba County, MS",Jul-19,10784,10091,693,6.4
14326,CN2810100000000,28,101,"Newton County, MS",Jul-19,8992,8430,562,6.3
14327,CN2810300000000,28,103,"Noxubee County, MS",Jul-19,3870,3536,334,8.6
14328,CN2810500000000,28,105,"Oktibbeha County, MS",Jul-19,22743,21169,1574,6.9
14329,CN2810700000000,28,107,"Panola County, MS",Jul-19,12898,11918,980,7.6
14330,CN2810900000000,28,109,"Pearl River County, MS",Jul-19,24155,22770,1385,5.7
14331,CN2811100000000,28,111,"Perry County, MS",Jul-19,4326,3983,343,7.9
14332,CN2811300000000,28,113,"Pike County, MS",Jul-19,14624,13518,1106,7.6
14333,CN2811500000000,28,115,"Pontotoc County, MS",Jul-19,15040,14297,743,4.9
14334,CN2811700000000,28,117,"Prentiss County, MS",Jul-19,11548,10857,691,6.0
14335,CN2811900000000,28,119,"Quitman County, MS",Jul-19,2468,2226,242,9.8
14336,CN2812100000000,28,121,"Rankin County, MS",Jul-19,76913,73515,3398,4.4
14337,CN2812300000000,28,123,"Scott County, MS",Jul-19,13115,12432,683,5.2
14338,CN2812500000000,28,125,"Sharkey County, MS",Jul-19,1660,1514,146,8.8
14339,CN2812700000000,28,127,"Simpson County, MS",Jul-19,10938,10290,648,5.9
14340,CN2812900000000,28,129,"Smith County, MS",Jul-19,6982,6591,391,5.6
14341,CN2813100000000,28,131,"Stone County, MS",Jul-19,6907,6350,557,8.1
14342,CN2813300000000,28,133,"Sunflower County, MS",Jul-19,7917,7164,753,9.5
14343,CN2813500000000,28,135,"Tallahatchie County, MS",Jul-19,5355,4998,357,6.7
14344,CN2813700000000,28,137,"Tate County, MS",Jul-19,12624,11805,819,6.5
14345,CN2813900000000,28,139,"Tippah County, MS",Jul-19,9589,9013,576,6.0
14346,CN2814100000000,28,141,"Tishomingo County, MS",Jul-19,8632,8109,523,6.1
14347,CN2814300000000,28,143,"Tunica County, MS",Jul-19,4557,4235,322,7.1
14348,CN2814500000000,28,145,"Union County, MS",Jul-19,14480,13820,660,4.6
14349,CN2814700000000,28,147,"Walthall County, MS",Jul-19,5029,4583,446,8.9
14350,CN2814900000000,28,149,"Warren County, MS",Jul-19,20348,18941,1407,6.9
14351,CN2815100000000,28,151,"Washington County, MS",Jul-19,17416,15951,1465,8.4
14352,CN2815300000000,28,153,"Wayne County, MS",Jul-19,7713,7154,559,7.2
14353,CN2815500000000,28,155,"Webster County, MS",Jul-19,4019,3767,252,6.3
14354,CN2815700000000,28,157,"Wilkinson County, MS",Jul-19,2777,2449,328,11.8
14355,CN2815900000000,28,159,"Winston County, MS",Jul-19,7623,7081,542,7.1
14356,CN2816100000000,28,161,"Yalobusha County, MS",Jul-19,4920,4575,345,7.0
14357,CN2816300000000,28,163,"Yazoo County, MS",Jul-19,9701,8948,753,7.8
14358,CN2900100000000,29,1,"Adair County, MO",Jul-19,10140,9613,527,5.2
14359,CN2900300000000,29,3,"Andrew County, MO",Jul-19,9941,9614,327,3.3
14360,CN2900500000000,29,5,"Atchison County, MO",Jul-19,2623,2469,154,5.9
14361,CN2900700000000,29,7,"Audrain County, MO",Jul-19,10659,10239,420,3.9
14362,CN2900900000000,29,9,"Barry County, MO",Jul-19,15378,14804,574,3.7
14363,CN2901100000000,29,11,"Barton County, MO",Jul-19,5084,4848,236,4.6
14364,CN2901300000000,29,13,"Bates County, MO",Jul-19,7991,7608,383,4.8
14365,CN2901500000000,29,15,"Benton County, MO",Jul-19,6935,6578,357,5.1
14366,CN2901700000000,29,17,"Bollinger County, MO",Jul-19,5370,5134,236,4.4
14367,CN2901900000000,29,19,"Boone County, MO",Jul-19,97250,94392,2858,2.9
14368,CN2902100000000,29,21,"Buchanan County, MO",Jul-19,45581,43984,1597,3.5
14369,CN2902300000000,29,23,"Butler County, MO",Jul-19,17821,16928,893,5.0
14370,CN2902500000000,29,25,"Caldwell County, MO",Jul-19,4395,4233,162,3.7
14371,CN2902700000000,29,27,"Callaway County, MO",Jul-19,21803,21075,728,3.3
14372,CN2902900000000,29,29,"Camden County, MO",Jul-19,20653,19936,717,3.5
14373,CN2903100000000,29,31,"Cape Girardeau County, MO",Jul-19,40166,38781,1385,3.4
14374,CN2903300000000,29,33,"Carroll County, MO",Jul-19,4571,4400,171,3.7
14375,CN2903500000000,29,35,"Carter County, MO",Jul-19,2539,2411,128,5.0
14376,CN2903700000000,29,37,"Cass County, MO",Jul-19,55783,53813,1970,3.5
14377,CN2903900000000,29,39,"Cedar County, MO",Jul-19,5711,5447,264,4.6
14378,CN2904100000000,29,41,"Chariton County, MO",Jul-19,3522,3390,132,3.7
14379,CN2904300000000,29,43,"Christian County, MO",Jul-19,45633,44270,1363,3.0
14380,CN2904500000000,29,45,"Clark County, MO",Jul-19,3086,2965,121,3.9
14381,CN2904700000000,29,47,"Clay County, MO",Jul-19,139808,134274,5534,4.0
14382,CN2904900000000,29,49,"Clinton County, MO",Jul-19,10963,10480,483,4.4
14383,CN2905100000000,29,51,"Cole County, MO",Jul-19,39910,38710,1200,3.0
14384,CN2905300000000,29,53,"Cooper County, MO",Jul-19,7348,7060,288,3.9
14385,CN2905500000000,29,55,"Crawford County, MO",Jul-19,11135,10678,457,4.1
14386,CN2905700000000,29,57,"Dade County, MO",Jul-19,3383,3262,121,3.6
14387,CN2905900000000,29,59,"Dallas County, MO",Jul-19,7064,6782,282,4.0
14388,CN2906100000000,29,61,"Daviess County, MO",Jul-19,3924,3762,162,4.1
14389,CN2906300000000,29,63,"DeKalb County, MO",Jul-19,4894,4712,182,3.7
14390,CN2906500000000,29,65,"Dent County, MO",Jul-19,6062,5817,245,4.0
14391,CN2906700000000,29,67,"Douglas County, MO",Jul-19,4986,4776,210,4.2
14392,CN2906900000000,29,69,"Dunklin County, MO",Jul-19,11137,10389,748,6.7
14393,CN2907100000000,29,71,"Franklin County, MO",Jul-19,54209,52306,1903,3.5
14394,CN2907300000000,29,73,"Gasconade County, MO",Jul-19,7594,7332,262,3.5
14395,CN2907500000000,29,75,"Gentry County, MO",Jul-19,3525,3393,132,3.7
14396,CN2907700000000,29,77,"Greene County, MO",Jul-19,153320,149049,4271,2.8
14397,CN2907900000000,29,79,"Grundy County, MO",Jul-19,4241,4037,204,4.8
14398,CN2908100000000,29,81,"Harrison County, MO",Jul-19,3683,3544,139,3.8
14399,CN2908300000000,29,83,"Henry County, MO",Jul-19,9601,9187,414,4.3
14400,CN2908500000000,29,85,"Hickory County, MO",Jul-19,3883,3721,162,4.2
14401,CN2908700000000,29,87,"Holt County, MO",Jul-19,2500,2389,111,4.4
14402,CN2908900000000,29,89,"Howard County, MO",Jul-19,4721,4533,188,4.0
14403,CN2909100000000,29,91,"Howell County, MO",Jul-19,16304,15526,778,4.8
14404,CN2909300000000,29,93,"Iron County, MO",Jul-19,3510,3282,228,6.5
14405,CN2909500000000,29,95,"Jackson County, MO",Jul-19,371169,354459,16710,4.5
14406,CN2909700000000,29,97,"Jasper County, MO",Jul-19,57815,55771,2044,3.5
14407,CN2909900000000,29,99,"Jefferson County, MO",Jul-19,120563,116515,4048,3.4
14408,CN2910100000000,29,101,"Johnson County, MO",Jul-19,22833,21728,1105,4.8
14409,CN2910300000000,29,103,"Knox County, MO",Jul-19,1712,1651,61,3.6
14410,CN2910500000000,29,105,"Laclede County, MO",Jul-19,16771,16067,704,4.2
14411,CN2910700000000,29,107,"Lafayette County, MO",Jul-19,17051,16412,639,3.7
14412,CN2910900000000,29,109,"Lawrence County, MO",Jul-19,17778,17024,754,4.2
14413,CN2911100000000,29,111,"Lewis County, MO",Jul-19,4864,4689,175,3.6
14414,CN2911300000000,29,113,"Lincoln County, MO",Jul-19,28901,27882,1019,3.5
14415,CN2911500000000,29,115,"Linn County, MO",Jul-19,4956,4651,305,6.2
14416,CN2911700000000,29,117,"Livingston County, MO",Jul-19,7354,7168,186,2.5
14417,CN2911900000000,29,119,"McDonald County, MO",Jul-19,10827,10344,483,4.5
14418,CN2912100000000,29,121,"Macon County, MO",Jul-19,7466,7197,269,3.6
14419,CN2912300000000,29,123,"Madison County, MO",Jul-19,5433,5201,232,4.3
14420,CN2912500000000,29,125,"Maries County, MO",Jul-19,3757,3582,175,4.7
14421,CN2912700000000,29,127,"Marion County, MO",Jul-19,14520,14024,496,3.4
14422,CN2912900000000,29,129,"Mercer County, MO",Jul-19,1671,1617,54,3.2
14423,CN2913100000000,29,131,"Miller County, MO",Jul-19,12153,11711,442,3.6
14424,CN2913300000000,29,133,"Mississippi County, MO",Jul-19,5608,5274,334,6.0
14425,CN2913500000000,29,135,"Moniteau County, MO",Jul-19,7407,7134,273,3.7
14426,CN2913700000000,29,137,"Monroe County, MO",Jul-19,3715,3537,178,4.8
14427,CN2913900000000,29,139,"Montgomery County, MO",Jul-19,5658,5450,208,3.7
14428,CN2914100000000,29,141,"Morgan County, MO",Jul-19,8272,7930,342,4.1
14429,CN2914300000000,29,143,"New Madrid County, MO",Jul-19,8066,7635,431,5.3
14430,CN2914500000000,29,145,"Newton County, MO",Jul-19,27700,26512,1188,4.3
14431,CN2914700000000,29,147,"Nodaway County, MO",Jul-19,10498,10043,455,4.3
14432,CN2914900000000,29,149,"Oregon County, MO",Jul-19,3710,3537,173,4.7
14433,CN2915100000000,29,151,"Osage County, MO",Jul-19,7203,7002,201,2.8
14434,CN2915300000000,29,153,"Ozark County, MO",Jul-19,3184,2996,188,5.9
14435,CN2915500000000,29,155,"Pemiscot County, MO",Jul-19,6183,5780,403,6.5
14436,CN2915700000000,29,157,"Perry County, MO",Jul-19,9981,9693,288,2.9
14437,CN2915900000000,29,159,"Pettis County, MO",Jul-19,20651,19728,923,4.5
14438,CN2916100000000,29,161,"Phelps County, MO",Jul-19,19570,18831,739,3.8
14439,CN2916300000000,29,163,"Pike County, MO",Jul-19,7293,6996,297,4.1
14440,CN2916500000000,29,165,"Platte County, MO",Jul-19,60086,57897,2189,3.6
14441,CN2916700000000,29,167,"Polk County, MO",Jul-19,14708,14175,533,3.6
14442,CN2916900000000,29,169,"Pulaski County, MO",Jul-19,14535,13939,596,4.1
14443,CN2917100000000,29,171,"Putnam County, MO",Jul-19,2227,2142,85,3.8
14444,CN2917300000000,29,173,"Ralls County, MO",Jul-19,5612,5437,175,3.1
14445,CN2917500000000,29,175,"Randolph County, MO",Jul-19,10304,9823,481,4.7
14446,CN2917700000000,29,177,"Ray County, MO",Jul-19,11320,10733,587,5.2
14447,CN2917900000000,29,179,"Reynolds County, MO",Jul-19,3051,2934,117,3.8
14448,CN2918100000000,29,181,"Ripley County, MO",Jul-19,4929,4604,325,6.6
14449,CN2918300000000,29,183,"St. Charles County, MO",Jul-19,231144,224831,6313,2.7
14450,CN2918500000000,29,185,"St. Clair County, MO",Jul-19,3654,3450,204,5.6
14451,CN2918600000000,29,186,"Ste. Genevieve County, MO",Jul-19,9204,8922,282,3.1
14452,CN2918700000000,29,187,"St. Francois County, MO",Jul-19,26605,25509,1096,4.1
14453,CN2918900000000,29,189,"St. Louis County, MO",Jul-19,544124,525536,18588,3.4
14454,CN2919500000000,29,195,"Saline County, MO",Jul-19,10298,9882,416,4.0
14455,CN2919700000000,29,197,"Schuyler County, MO",Jul-19,1895,1785,110,5.8
14456,CN2919900000000,29,199,"Scotland County, MO",Jul-19,2346,2274,72,3.1
14457,CN2920100000000,29,201,"Scott County, MO",Jul-19,19700,18798,902,4.6
14458,CN2920300000000,29,203,"Shannon County, MO",Jul-19,3224,3038,186,5.8
14459,CN2920500000000,29,205,"Shelby County, MO",Jul-19,2902,2817,85,2.9
14460,CN2920700000000,29,207,"Stoddard County, MO",Jul-19,12909,12215,694,5.4
14461,CN2920900000000,29,209,"Stone County, MO",Jul-19,14945,14380,565,3.8
14462,CN2921100000000,29,211,"Sullivan County, MO",Jul-19,2603,2506,97,3.7
14463,CN2921300000000,29,213,"Taney County, MO",Jul-19,29220,28175,1045,3.6
14464,CN2921500000000,29,215,"Texas County, MO",Jul-19,8405,7982,423,5.0
14465,CN2921700000000,29,217,"Vernon County, MO",Jul-19,9110,8727,383,4.2
14466,CN2921900000000,29,219,"Warren County, MO",Jul-19,18247,17697,550,3.0
14467,CN2922100000000,29,221,"Washington County, MO",Jul-19,10041,9551,490,4.9
14468,CN2922300000000,29,223,"Wayne County, MO",Jul-19,5168,4888,280,5.4
14469,CN2922500000000,29,225,"Webster County, MO",Jul-19,17464,16783,681,3.9
14470,CN2922700000000,29,227,"Worth County, MO",Jul-19,1102,1056,46,4.2
14471,CN2922900000000,29,229,"Wright County, MO",Jul-19,6954,6594,360,5.2
14472,CN2951000000000,29,510,"St. Louis city, MO",Jul-19,156762,149613,7149,4.6
14473,CN3000100000000,30,1,"Beaverhead County, MT",Jul-19,5164,5038,126,2.4
14474,CN3000300000000,30,3,"Big Horn County, MT",Jul-19,4768,4430,338,7.1
14475,CN3000500000000,30,5,"Blaine County, MT",Jul-19,2388,2315,73,3.1
14476,CN3000700000000,30,7,"Broadwater County, MT",Jul-19,2676,2568,108,4.0
14477,CN3000900000000,30,9,"Carbon County, MT",Jul-19,5480,5319,161,2.9
14478,CN3001100000000,30,11,"Carter County, MT",Jul-19,607,591,16,2.6
14479,CN3001300000000,30,13,"Cascade County, MT",Jul-19,37674,36475,1199,3.2
14480,CN3001500000000,30,15,"Chouteau County, MT",Jul-19,2423,2367,56,2.3
14481,CN3001700000000,30,17,"Custer County, MT",Jul-19,6169,6007,162,2.6
14482,CN3001900000000,30,19,"Daniels County, MT",Jul-19,907,893,14,1.5
14483,CN3002100000000,30,21,"Dawson County, MT",Jul-19,4588,4483,105,2.3
14484,CN3002300000000,30,23,"Deer Lodge County, MT",Jul-19,5248,5093,155,3.0
14485,CN3002500000000,30,25,"Fallon County, MT",Jul-19,1706,1684,22,1.3
14486,CN3002700000000,30,27,"Fergus County, MT",Jul-19,6133,5978,155,2.5
14487,CN3002900000000,30,29,"Flathead County, MT",Jul-19,50466,48612,1854,3.7
14488,CN3003100000000,30,31,"Gallatin County, MT",Jul-19,72563,71249,1314,1.8
14489,CN3003300000000,30,33,"Garfield County, MT",Jul-19,734,720,14,1.9
14490,CN3003500000000,30,35,"Glacier County, MT",Jul-19,6057,5624,433,7.1
14491,CN3003700000000,30,37,"Golden Valley County, MT",Jul-19,362,352,10,2.8
14492,CN3003900000000,30,39,"Granite County, MT",Jul-19,1672,1600,72,4.3
14493,CN3004100000000,30,41,"Hill County, MT",Jul-19,7693,7386,307,4.0
14494,CN3004300000000,30,43,"Jefferson County, MT",Jul-19,5852,5689,163,2.8
14495,CN3004500000000,30,45,"Judith Basin County, MT",Jul-19,912,890,22,2.4
14496,CN3004700000000,30,47,"Lake County, MT",Jul-19,13480,12952,528,3.9
14497,CN3004900000000,30,49,"Lewis and Clark County, MT",Jul-19,36990,35990,1000,2.7
14498,CN3005100000000,30,51,"Liberty County, MT",Jul-19,938,915,23,2.5
14499,CN3005300000000,30,53,"Lincoln County, MT",Jul-19,8211,7736,475,5.8
14500,CN3005500000000,30,55,"McCone County, MT",Jul-19,953,927,26,2.7
14501,CN3005700000000,30,57,"Madison County, MT",Jul-19,4783,4667,116,2.4
14502,CN3005900000000,30,59,"Meagher County, MT",Jul-19,983,957,26,2.6
14503,CN3006100000000,30,61,"Mineral County, MT",Jul-19,1854,1777,77,4.2
14504,CN3006300000000,30,63,"Missoula County, MT",Jul-19,63386,61580,1806,2.8
14505,CN3006500000000,30,65,"Musselshell County, MT",Jul-19,2266,2183,83,3.7
14506,CN3006700000000,30,67,"Park County, MT",Jul-19,9467,9226,241,2.5
14507,CN3006900000000,30,69,"Petroleum County, MT",Jul-19,274,267,7,2.6
14508,CN3007100000000,30,71,"Phillips County, MT",Jul-19,1838,1773,65,3.5
14509,CN3007300000000,30,73,"Pondera County, MT",Jul-19,2626,2523,103,3.9
14510,CN3007500000000,30,75,"Powder River County, MT",Jul-19,946,927,19,2.0
14511,CN3007700000000,30,77,"Powell County, MT",Jul-19,3094,3007,87,2.8
14512,CN3007900000000,30,79,"Prairie County, MT",Jul-19,477,458,19,4.0
14513,CN3008100000000,30,81,"Ravalli County, MT",Jul-19,20435,19727,708,3.5
14514,CN3008300000000,30,83,"Richland County, MT",Jul-19,5880,5729,151,2.6
14515,CN3008500000000,30,85,"Roosevelt County, MT",Jul-19,4464,4245,219,4.9
14516,CN3008700000000,30,87,"Rosebud County, MT",Jul-19,3902,3690,212,5.4
14517,CN3008900000000,30,89,"Sanders County, MT",Jul-19,4913,4672,241,4.9
14518,CN3009100000000,30,91,"Sheridan County, MT",Jul-19,1675,1645,30,1.8
14519,CN3009300000000,30,93,"Silver Bow County, MT",Jul-19,17766,17154,612,3.4
14520,CN3009500000000,30,95,"Stillwater County, MT",Jul-19,5208,5063,145,2.8
14521,CN3009700000000,30,97,"Sweet Grass County, MT",Jul-19,1811,1765,46,2.5
14522,CN3009900000000,30,99,"Teton County, MT",Jul-19,2726,2651,75,2.8
14523,CN3010100000000,30,101,"Toole County, MT",Jul-19,2155,2106,49,2.3
14524,CN3010300000000,30,103,"Treasure County, MT",Jul-19,326,319,7,2.1
14525,CN3010500000000,30,105,"Valley County, MT",Jul-19,4187,4065,122,2.9
14526,CN3010700000000,30,107,"Wheatland County, MT",Jul-19,769,740,29,3.8
14527,CN3010900000000,30,109,"Wibaux County, MT",Jul-19,483,470,13,2.7
14528,CN3011100000000,30,111,"Yellowstone County, MT",Jul-19,82360,79763,2597,3.2
14529,CN3100100000000,31,1,"Adams County, NE",Jul-19,17221,16606,615,3.6
14530,CN3100300000000,31,3,"Antelope County, NE",Jul-19,3627,3531,96,2.6
14531,CN3100500000000,31,5,"Arthur County, NE",Jul-19,225,213,12,5.3
14532,CN3100700000000,31,7,"Banner County, NE",Jul-19,380,361,19,5.0
14533,CN3100900000000,31,9,"Blaine County, NE",Jul-19,254,239,15,5.9
14534,CN3101100000000,31,11,"Boone County, NE",Jul-19,2971,2890,81,2.7
14535,CN3101300000000,31,13,"Box Butte County, NE",Jul-19,5518,5304,214,3.9
14536,CN3101500000000,31,15,"Boyd County, NE",Jul-19,1056,1019,37,3.5
14537,CN3101700000000,31,17,"Brown County, NE",Jul-19,1407,1351,56,4.0
14538,CN3101900000000,31,19,"Buffalo County, NE",Jul-19,27981,27159,822,2.9
14539,CN3102100000000,31,21,"Burt County, NE",Jul-19,3477,3365,112,3.2
14540,CN3102300000000,31,23,"Butler County, NE",Jul-19,4689,4560,129,2.8
14541,CN3102500000000,31,25,"Cass County, NE",Jul-19,13854,13339,515,3.7
14542,CN3102700000000,31,27,"Cedar County, NE",Jul-19,4569,4442,127,2.8
14543,CN3102900000000,31,29,"Chase County, NE",Jul-19,2297,2241,56,2.4
14544,CN3103100000000,31,31,"Cherry County, NE",Jul-19,3471,3378,93,2.7
14545,CN3103300000000,31,33,"Cheyenne County, NE",Jul-19,4509,4328,181,4.0
14546,CN3103500000000,31,35,"Clay County, NE",Jul-19,3341,3237,104,3.1
14547,CN3103700000000,31,37,"Colfax County, NE",Jul-19,5631,5459,172,3.1
14548,CN3103900000000,31,39,"Cuming County, NE",Jul-19,4756,4619,137,2.9
14549,CN3104100000000,31,41,"Custer County, NE",Jul-19,6477,6313,164,2.5
14550,CN3104300000000,31,43,"Dakota County, NE",Jul-19,11004,10512,492,4.5
14551,CN3104500000000,31,45,"Dawes County, NE",Jul-19,4826,4645,181,3.8
14552,CN3104700000000,31,47,"Dawson County, NE",Jul-19,13194,12770,424,3.2
14553,CN3104900000000,31,49,"Deuel County, NE",Jul-19,980,949,31,3.2
14554,CN3105100000000,31,51,"Dixon County, NE",Jul-19,3038,2947,91,3.0
14555,CN3105300000000,31,53,"Dodge County, NE",Jul-19,19866,19237,629,3.2
14556,CN3105500000000,31,55,"Douglas County, NE",Jul-19,306323,295442,10881,3.6
14557,CN3105700000000,31,57,"Dundy County, NE",Jul-19,1149,1118,31,2.7
14558,CN3105900000000,31,59,"Fillmore County, NE",Jul-19,3220,3133,87,2.7
14559,CN3106100000000,31,61,"Franklin County, NE",Jul-19,1462,1406,56,3.8
14560,CN3106300000000,31,63,"Frontier County, NE",Jul-19,1561,1505,56,3.6
14561,CN3106500000000,31,65,"Furnas County, NE",Jul-19,2635,2548,87,3.3
14562,CN3106700000000,31,67,"Gage County, NE",Jul-19,11228,10821,407,3.6
14563,CN3106900000000,31,69,"Garden County, NE",Jul-19,1151,1122,29,2.5
14564,CN3107100000000,31,71,"Garfield County, NE",Jul-19,1197,1162,35,2.9
14565,CN3107300000000,31,73,"Gosper County, NE",Jul-19,1178,1143,35,3.0
14566,CN3107500000000,31,75,"Grant County, NE",Jul-19,402,390,12,3.0
14567,CN3107700000000,31,77,"Greeley County, NE",Jul-19,1223,1186,37,3.0
14568,CN3107900000000,31,79,"Hall County, NE",Jul-19,32363,31250,1113,3.4
14569,CN3108100000000,31,81,"Hamilton County, NE",Jul-19,4808,4656,152,3.2
14570,CN3108300000000,31,83,"Harlan County, NE",Jul-19,1848,1792,56,3.0
14571,CN3108500000000,31,85,"Hayes County, NE",Jul-19,595,578,17,2.9
14572,CN3108700000000,31,87,"Hitchcock County, NE",Jul-19,1289,1243,46,3.6
14573,CN3108900000000,31,89,"Holt County, NE",Jul-19,5796,5632,164,2.8
14574,CN3109100000000,31,91,"Hooker County, NE",Jul-19,454,442,12,2.6
14575,CN3109300000000,31,93,"Howard County, NE",Jul-19,3389,3269,120,3.5
14576,CN3109500000000,31,95,"Jefferson County, NE",Jul-19,4195,4073,122,2.9
14577,CN3109700000000,31,97,"Johnson County, NE",Jul-19,2073,1994,79,3.8
14578,CN3109900000000,31,99,"Kearney County, NE",Jul-19,3835,3725,110,2.9
14579,CN3110100000000,31,101,"Keith County, NE",Jul-19,4830,4693,137,2.8
14580,CN3110300000000,31,103,"Keya Paha County, NE",Jul-19,564,547,17,3.0
14581,CN3110500000000,31,105,"Kimball County, NE",Jul-19,2069,2000,69,3.3
14582,CN3110700000000,31,107,"Knox County, NE",Jul-19,4669,4536,133,2.8
14583,CN3110900000000,31,109,"Lancaster County, NE",Jul-19,178757,173386,5371,3.0
14584,CN3111100000000,31,111,"Lincoln County, NE",Jul-19,18884,18097,787,4.2
14585,CN3111300000000,31,113,"Logan County, NE",Jul-19,463,448,15,3.2
14586,CN3111500000000,31,115,"Loup County, NE",Jul-19,399,382,17,4.3
14587,CN3111700000000,31,117,"McPherson County, NE",Jul-19,438,423,15,3.4
14588,CN3111900000000,31,119,"Madison County, NE",Jul-19,20105,19453,652,3.2
14589,CN3112100000000,31,121,"Merrick County, NE",Jul-19,4038,3909,129,3.2
14590,CN3112300000000,31,123,"Morrill County, NE",Jul-19,2650,2581,69,2.6
14591,CN3112500000000,31,125,"Nance County, NE",Jul-19,1970,1918,52,2.6
14592,CN3112700000000,31,127,"Nemaha County, NE",Jul-19,3531,3365,166,4.7
14593,CN3112900000000,31,129,"Nuckolls County, NE",Jul-19,2432,2363,69,2.8
14594,CN3113100000000,31,131,"Otoe County, NE",Jul-19,8628,8290,338,3.9
14595,CN3113300000000,31,133,"Pawnee County, NE",Jul-19,1469,1415,54,3.7
14596,CN3113500000000,31,135,"Perkins County, NE",Jul-19,1818,1770,48,2.6
14597,CN3113700000000,31,137,"Phelps County, NE",Jul-19,5012,4854,158,3.2
14598,CN3113900000000,31,139,"Pierce County, NE",Jul-19,4161,4043,118,2.8
14599,CN3114100000000,31,141,"Platte County, NE",Jul-19,17947,17395,552,3.1
14600,CN3114300000000,31,143,"Polk County, NE",Jul-19,2926,2837,89,3.0
14601,CN3114500000000,31,145,"Red Willow County, NE",Jul-19,5976,5773,203,3.4
14602,CN3114700000000,31,147,"Richardson County, NE",Jul-19,4268,4112,156,3.7
14603,CN3114900000000,31,149,"Rock County, NE",Jul-19,865,838,27,3.1
14604,CN3115100000000,31,151,"Saline County, NE",Jul-19,7404,7149,255,3.4
14605,CN3115300000000,31,153,"Sarpy County, NE",Jul-19,98679,95617,3062,3.1
14606,CN3115500000000,31,155,"Saunders County, NE",Jul-19,11358,11024,334,2.9
14607,CN3115700000000,31,157,"Scotts Bluff County, NE",Jul-19,18646,17915,731,3.9
14608,CN3115900000000,31,159,"Seward County, NE",Jul-19,8995,8677,318,3.5
14609,CN3116100000000,31,161,"Sheridan County, NE",Jul-19,2684,2591,93,3.5
14610,CN3116300000000,31,163,"Sherman County, NE",Jul-19,1703,1645,58,3.4
14611,CN3116500000000,31,165,"Sioux County, NE",Jul-19,760,739,21,2.8
14612,CN3116700000000,31,167,"Stanton County, NE",Jul-19,3551,3443,108,3.0
14613,CN3116900000000,31,169,"Thayer County, NE",Jul-19,2788,2707,81,2.9
14614,CN3117100000000,31,171,"Thomas County, NE",Jul-19,427,408,19,4.4
14615,CN3117300000000,31,173,"Thurston County, NE",Jul-19,3124,2960,164,5.2
14616,CN3117500000000,31,175,"Valley County, NE",Jul-19,2196,2121,75,3.4
14617,CN3117700000000,31,177,"Washington County, NE",Jul-19,11490,11123,367,3.2
14618,CN3117900000000,31,179,"Wayne County, NE",Jul-19,5510,5319,191,3.5
14619,CN3118100000000,31,181,"Webster County, NE",Jul-19,1699,1622,77,4.5
14620,CN3118300000000,31,183,"Wheeler County, NE",Jul-19,543,524,19,3.5
14621,CN3118500000000,31,185,"York County, NE",Jul-19,7470,7229,241,3.2
14622,CN3200100000000,32,1,"Churchill County, NV",Jul-19,10980,10581,399,3.6
14623,CN3200300000000,32,3,"Clark County, NV",Jul-19,1139458,1090602,48856,4.3
14624,CN3200500000000,32,5,"Douglas County, NV",Jul-19,23651,22783,868,3.7
14625,CN3200700000000,32,7,"Elko County, NV",Jul-19,27279,26422,857,3.1
14626,CN3200900000000,32,9,"Esmeralda County, NV",Jul-19,423,406,17,4.0
14627,CN3201100000000,32,11,"Eureka County, NV",Jul-19,1018,990,28,2.8
14628,CN3201300000000,32,13,"Humboldt County, NV",Jul-19,8118,7837,281,3.5
14629,CN3201500000000,32,15,"Lander County, NV",Jul-19,3207,3107,100,3.1
14630,CN3201700000000,32,17,"Lincoln County, NV",Jul-19,2105,2019,86,4.1
14631,CN3201900000000,32,19,"Lyon County, NV",Jul-19,23234,22150,1084,4.7
14632,CN3202100000000,32,21,"Mineral County, NV",Jul-19,2066,1980,86,4.2
14633,CN3202300000000,32,23,"Nye County, NV",Jul-19,16899,15999,900,5.3
14634,CN3202700000000,32,27,"Pershing County, NV",Jul-19,2509,2409,100,4.0
14635,CN3202900000000,32,29,"Storey County, NV",Jul-19,2039,1966,73,3.6
14636,CN3203100000000,32,31,"Washoe County, NV",Jul-19,256439,248134,8305,3.2
14637,CN3203300000000,32,33,"White Pine County, NV",Jul-19,4676,4531,145,3.1
14638,CN3251000000000,32,510,"Carson City, NV",Jul-19,26541,25523,1018,3.8
14639,CN3300100000000,33,1,"Belknap County, NH",Jul-19,33710,32945,765,2.3
14640,CN3300300000000,33,3,"Carroll County, NH",Jul-19,26610,26033,577,2.2
14641,CN3300500000000,33,5,"Cheshire County, NH",Jul-19,40745,39667,1078,2.6
14642,CN3300700000000,33,7,"Coos County, NH",Jul-19,15306,14875,431,2.8
14643,CN3300900000000,33,9,"Grafton County, NH",Jul-19,50947,49858,1089,2.1
14644,CN3301100000000,33,11,"Hillsborough County, NH",Jul-19,243646,237170,6476,2.7
14645,CN3301300000000,33,13,"Merrimack County, NH",Jul-19,84579,82734,1845,2.2
14646,CN3301500000000,33,15,"Rockingham County, NH",Jul-19,192923,187651,5272,2.7
14647,CN3301700000000,33,17,"Strafford County, NH",Jul-19,75295,73514,1781,2.4
14648,CN3301900000000,33,19,"Sullivan County, NH",Jul-19,23432,22896,536,2.3
14649,CN3400100000000,34,1,"Atlantic County, NJ",Jul-19,124700,118419,6281,5.0
14650,CN3400300000000,34,3,"Bergen County, NJ",Jul-19,484670,468476,16194,3.3
14651,CN3400500000000,34,5,"Burlington County, NJ",Jul-19,231420,222934,8486,3.7
14652,CN3400700000000,34,7,"Camden County, NJ",Jul-19,254169,242821,11348,4.5
14653,CN3400900000000,34,9,"Cape May County, NJ",Jul-19,57280,54955,2325,4.1
14654,CN3401100000000,34,11,"Cumberland County, NJ",Jul-19,63596,59823,3773,5.9
14655,CN3401300000000,34,13,"Essex County, NJ",Jul-19,373799,355556,18243,4.9
14656,CN3401500000000,34,15,"Gloucester County, NJ",Jul-19,150444,144229,6215,4.1
14657,CN3401700000000,34,17,"Hudson County, NJ",Jul-19,362971,349921,13050,3.6
14658,CN3401900000000,34,19,"Hunterdon County, NJ",Jul-19,65153,63192,1961,3.0
14659,CN3402100000000,34,21,"Mercer County, NJ",Jul-19,204653,197246,7407,3.6
14660,CN3402300000000,34,23,"Middlesex County, NJ",Jul-19,449363,433726,15637,3.5
14661,CN3402500000000,34,25,"Monmouth County, NJ",Jul-19,335354,323884,11470,3.4
14662,CN3402700000000,34,27,"Morris County, NJ",Jul-19,259819,251694,8125,3.1
14663,CN3402900000000,34,29,"Ocean County, NJ",Jul-19,280250,269614,10636,3.8
14664,CN3403100000000,34,31,"Passaic County, NJ",Jul-19,243656,232124,11532,4.7
14665,CN3403300000000,34,33,"Salem County, NJ",Jul-19,29409,27885,1524,5.2
14666,CN3403500000000,34,35,"Somerset County, NJ",Jul-19,173499,167751,5748,3.3
14667,CN3403700000000,34,37,"Sussex County, NJ",Jul-19,74728,71980,2748,3.7
14668,CN3403900000000,34,39,"Union County, NJ",Jul-19,279992,268729,11263,4.0
14669,CN3404100000000,34,41,"Warren County, NJ",Jul-19,56239,54127,2112,3.8
14670,CN3500100000000,35,1,"Bernalillo County, NM",Jul-19,335114,318187,16927,5.1
14671,CN3500300000000,35,3,"Catron County, NM",Jul-19,1214,1138,76,6.3
14672,CN3500500000000,35,5,"Chaves County, NM",Jul-19,27468,25857,1611,5.9
14673,CN3500600000000,35,6,"Cibola County, NM",Jul-19,9032,8385,647,7.2
14674,CN3500700000000,35,7,"Colfax County, NM",Jul-19,6379,6085,294,4.6
14675,CN3500900000000,35,9,"Curry County, NM",Jul-19,21687,20622,1065,4.9
14676,CN3501100000000,35,11,"De Baca County, NM",Jul-19,798,758,40,5.0
14677,CN3501300000000,35,13,"Dona Ana County, NM",Jul-19,96423,90354,6069,6.3
14678,CN3501500000000,35,15,"Eddy County, NM",Jul-19,35083,33793,1290,3.7
14679,CN3501700000000,35,17,"Grant County, NM",Jul-19,11999,11344,655,5.5
14680,CN3501900000000,35,19,"Guadalupe County, NM",Jul-19,1606,1510,96,6.0
14681,CN3502100000000,35,21,"Harding County, NM",Jul-19,274,258,16,5.8
14682,CN3502300000000,35,23,"Hidalgo County, NM",Jul-19,2162,2058,104,4.8
14683,CN3502500000000,35,25,"Lea County, NM",Jul-19,31302,29803,1499,4.8
14684,CN3502700000000,35,27,"Lincoln County, NM",Jul-19,9410,8946,464,4.9
14685,CN3502800000000,35,28,"Los Alamos County, NM",Jul-19,9748,9381,367,3.8
14686,CN3502900000000,35,29,"Luna County, NM",Jul-19,11026,10051,975,8.8
14687,CN3503100000000,35,31,"McKinley County, NM",Jul-19,23798,21803,1995,8.4
14688,CN3503300000000,35,33,"Mora County, NM",Jul-19,2265,2132,133,5.9
14689,CN3503500000000,35,35,"Otero County, NM",Jul-19,24786,23352,1434,5.8
14690,CN3503700000000,35,37,"Quay County, NM",Jul-19,3227,3031,196,6.1
14691,CN3503900000000,35,39,"Rio Arriba County, NM",Jul-19,17331,16354,977,5.6
14692,CN3504100000000,35,41,"Roosevelt County, NM",Jul-19,7839,7385,454,5.8
14693,CN3504300000000,35,43,"Sandoval County, NM",Jul-19,66931,63183,3748,5.6
14694,CN3504500000000,35,45,"San Juan County, NM",Jul-19,51601,48274,3327,6.4
14695,CN3504700000000,35,47,"San Miguel County, NM",Jul-19,10667,9941,726,6.8
14696,CN3504900000000,35,49,"Santa Fe County, NM",Jul-19,76902,73486,3416,4.4
14697,CN3505100000000,35,51,"Sierra County, NM",Jul-19,4051,3790,261,6.4
14698,CN3505300000000,35,53,"Socorro County, NM",Jul-19,6426,5970,456,7.1
14699,CN3505500000000,35,55,"Taos County, NM",Jul-19,15308,14350,958,6.3
14700,CN3505700000000,35,57,"Torrance County, NM",Jul-19,5671,5266,405,7.1
14701,CN3505900000000,35,59,"Union County, NM",Jul-19,1939,1867,72,3.7
14702,CN3506100000000,35,61,"Valencia County, NM",Jul-19,31039,29128,1911,6.2
14703,CN3600100000000,36,1,"Albany County, NY",Jul-19,158028,151866,6162,3.9
14704,CN3600300000000,36,3,"Allegany County, NY",Jul-19,19125,18120,1005,5.3
14705,CN3600500000000,36,5,"Bronx County, NY",Jul-19,600775,565794,34981,5.8
14706,CN3600700000000,36,7,"Broome County, NY",Jul-19,83344,79215,4129,5.0
14707,CN3600900000000,36,9,"Cattaraugus County, NY",Jul-19,33988,32371,1617,4.8
14708,CN3601100000000,36,11,"Cayuga County, NY",Jul-19,36898,35348,1550,4.2
14709,CN3601300000000,36,13,"Chautauqua County, NY",Jul-19,56736,54183,2553,4.5
14710,CN3601500000000,36,15,"Chemung County, NY",Jul-19,34662,33147,1515,4.4
14711,CN3601700000000,36,17,"Chenango County, NY",Jul-19,22624,21677,947,4.2
14712,CN3601900000000,36,19,"Clinton County, NY",Jul-19,36436,34815,1621,4.4
14713,CN3602100000000,36,21,"Columbia County, NY",Jul-19,32168,31172,996,3.1
14714,CN3602300000000,36,23,"Cortland County, NY",Jul-19,22540,21486,1054,4.7
14715,CN3602500000000,36,25,"Delaware County, NY",Jul-19,19974,19026,948,4.7
14716,CN3602700000000,36,27,"Dutchess County, NY",Jul-19,146104,140639,5465,3.7
14717,CN3602900000000,36,29,"Erie County, NY",Jul-19,443918,424005,19913,4.5
14718,CN3603100000000,36,31,"Essex County, NY",Jul-19,18164,17471,693,3.8
14719,CN3603300000000,36,33,"Franklin County, NY",Jul-19,19980,19049,931,4.7
14720,CN3603500000000,36,35,"Fulton County, NY",Jul-19,22657,21582,1075,4.7
14721,CN3603700000000,36,37,"Genesee County, NY",Jul-19,30427,29360,1067,3.5
14722,CN3603900000000,36,39,"Greene County, NY",Jul-19,20693,19773,920,4.4
14723,CN3604100000000,36,41,"Hamilton County, NY",Jul-19,2526,2443,83,3.3
14724,CN3604300000000,36,43,"Herkimer County, NY",Jul-19,28212,26920,1292,4.6
14725,CN3604500000000,36,45,"Jefferson County, NY",Jul-19,45199,42966,2233,4.9
14726,CN3604700000000,36,47,"Kings County, NY",Jul-19,1202326,1149062,53264,4.4
14727,CN3604900000000,36,49,"Lewis County, NY",Jul-19,11754,11226,528,4.5
14728,CN3605100000000,36,51,"Livingston County, NY",Jul-19,30838,29559,1279,4.1
14729,CN3605300000000,36,53,"Madison County, NY",Jul-19,33142,31717,1425,4.3
14730,CN3605500000000,36,55,"Monroe County, NY",Jul-19,361991,345981,16010,4.4
14731,CN3605700000000,36,57,"Montgomery County, NY",Jul-19,22291,21171,1120,5.0
14732,CN3605900000000,36,59,"Nassau County, NY",Jul-19,720233,693795,26438,3.7
14733,CN3606100000000,36,61,"New York County, NY",Jul-19,913299,879242,34057,3.7
14734,CN3606300000000,36,63,"Niagara County, NY",Jul-19,99178,94310,4868,4.9
14735,CN3606500000000,36,65,"Oneida County, NY",Jul-19,102409,98018,4391,4.3
14736,CN3606700000000,36,67,"Onondaga County, NY",Jul-19,222879,213907,8972,4.0
14737,CN3606900000000,36,69,"Ontario County, NY",Jul-19,55376,53295,2081,3.8
14738,CN3607100000000,36,71,"Orange County, NY",Jul-19,188781,181156,7625,4.0
14739,CN3607300000000,36,73,"Orleans County, NY",Jul-19,17754,16871,883,5.0
14740,CN3607500000000,36,75,"Oswego County, NY",Jul-19,53453,50605,2848,5.3
14741,CN3607700000000,36,77,"Otsego County, NY",Jul-19,28871,27648,1223,4.2
14742,CN3607900000000,36,79,"Putnam County, NY",Jul-19,51925,49924,2001,3.9
14743,CN3608100000000,36,81,"Queens County, NY",Jul-19,1142317,1099855,42462,3.7
14744,CN3608300000000,36,83,"Rensselaer County, NY",Jul-19,81317,78131,3186,3.9
14745,CN3608500000000,36,85,"Richmond County, NY",Jul-19,223566,213820,9746,4.4
14746,CN3608700000000,36,87,"Rockland County, NY",Jul-19,158135,152039,6096,3.9
14747,CN3608900000000,36,89,"St. Lawrence County, NY",Jul-19,42613,40164,2449,5.7
14748,CN3609100000000,36,91,"Saratoga County, NY",Jul-19,118997,115062,3935,3.3
14749,CN3609300000000,36,93,"Schenectady County, NY",Jul-19,76228,73185,3043,4.0
14750,CN3609500000000,36,95,"Schoharie County, NY",Jul-19,14722,14040,682,4.6
14751,CN3609700000000,36,97,"Schuyler County, NY",Jul-19,8362,8036,326,3.9
14752,CN3609900000000,36,99,"Seneca County, NY",Jul-19,16321,15733,588,3.6
14753,CN3610100000000,36,101,"Steuben County, NY",Jul-19,42502,40714,1788,4.2
14754,CN3610300000000,36,103,"Suffolk County, NY",Jul-19,792358,760908,31450,4.0
14755,CN3610500000000,36,105,"Sullivan County, NY",Jul-19,38706,37280,1426,3.7
14756,CN3610700000000,36,107,"Tioga County, NY",Jul-19,22620,21708,912,4.0
14757,CN3610900000000,36,109,"Tompkins County, NY",Jul-19,48128,46127,2001,4.2
14758,CN3611100000000,36,111,"Ulster County, NY",Jul-19,88568,85008,3560,4.0
14759,CN3611300000000,36,113,"Warren County, NY",Jul-19,32823,31627,1196,3.6
14760,CN3611500000000,36,115,"Washington County, NY",Jul-19,29417,28345,1072,3.6
14761,CN3611700000000,36,117,"Wayne County, NY",Jul-19,43970,42284,1686,3.8
14762,CN3611900000000,36,119,"Westchester County, NY",Jul-19,492994,473152,19842,4.0
14763,CN3612100000000,36,121,"Wyoming County, NY",Jul-19,18653,17927,726,3.9
14764,CN3612300000000,36,123,"Yates County, NY",Jul-19,11953,11547,406,3.4
14765,CN3700100000000,37,1,"Alamance County, NC",Jul-19,83371,79733,3638,4.4
14766,CN3700300000000,37,3,"Alexander County, NC",Jul-19,18249,17589,660,3.6
14767,CN3700500000000,37,5,"Alleghany County, NC",Jul-19,4491,4265,226,5.0
14768,CN3700700000000,37,7,"Anson County, NC",Jul-19,10801,10312,489,4.5
14769,CN3700900000000,37,9,"Ashe County, NC",Jul-19,12947,12440,507,3.9
14770,CN3701100000000,37,11,"Avery County, NC",Jul-19,7989,7683,306,3.8
14771,CN3701300000000,37,13,"Beaufort County, NC",Jul-19,19752,18747,1005,5.1
14772,CN3701500000000,37,15,"Bertie County, NC",Jul-19,7866,7457,409,5.2
14773,CN3701700000000,37,17,"Bladen County, NC",Jul-19,14913,14125,788,5.3
14774,CN3701900000000,37,19,"Brunswick County, NC",Jul-19,57830,54783,3047,5.3
14775,CN3702100000000,37,21,"Buncombe County, NC",Jul-19,143084,138409,4675,3.3
14776,CN3702300000000,37,23,"Burke County, NC",Jul-19,41518,39791,1727,4.2
14777,CN3702500000000,37,25,"Cabarrus County, NC",Jul-19,111054,106723,4331,3.9
14778,CN3702700000000,37,27,"Caldwell County, NC",Jul-19,37000,35356,1644,4.4
14779,CN3702900000000,37,29,"Camden County, NC",Jul-19,4671,4477,194,4.2
14780,CN3703100000000,37,31,"Carteret County, NC",Jul-19,33864,32445,1419,4.2
14781,CN3703300000000,37,33,"Caswell County, NC",Jul-19,9847,9356,491,5.0
14782,CN3703500000000,37,35,"Catawba County, NC",Jul-19,79770,76586,3184,4.0
14783,CN3703700000000,37,37,"Chatham County, NC",Jul-19,36207,34857,1350,3.7
14784,CN3703900000000,37,39,"Cherokee County, NC",Jul-19,11207,10664,543,4.8
14785,CN3704100000000,37,41,"Chowan County, NC",Jul-19,5654,5371,283,5.0
14786,CN3704300000000,37,43,"Clay County, NC",Jul-19,4159,3946,213,5.1
14787,CN3704500000000,37,45,"Cleveland County, NC",Jul-19,48852,46673,2179,4.5
14788,CN3704700000000,37,47,"Columbus County, NC",Jul-19,23636,22391,1245,5.3
14789,CN3704900000000,37,49,"Craven County, NC",Jul-19,42939,41027,1912,4.5
14790,CN3705100000000,37,51,"Cumberland County, NC",Jul-19,128693,121372,7321,5.7
14791,CN3705300000000,37,53,"Currituck County, NC",Jul-19,14427,13895,532,3.7
14792,CN3705500000000,37,55,"Dare County, NC",Jul-19,23487,22628,859,3.7
14793,CN3705700000000,37,57,"Davidson County, NC",Jul-19,82038,78724,3314,4.0
14794,CN3705900000000,37,59,"Davie County, NC",Jul-19,20972,20180,792,3.8
14795,CN3706100000000,37,61,"Duplin County, NC",Jul-19,25951,24822,1129,4.4
14796,CN3706300000000,37,63,"Durham County, NC",Jul-19,173250,166670,6580,3.8
14797,CN3706500000000,37,65,"Edgecombe County, NC",Jul-19,21498,20086,1412,6.6
14798,CN3706700000000,37,67,"Forsyth County, NC",Jul-19,190517,182513,8004,4.2
14799,CN3706900000000,37,69,"Franklin County, NC",Jul-19,32049,30633,1416,4.4
14800,CN3707100000000,37,71,"Gaston County, NC",Jul-19,113075,108294,4781,4.2
14801,CN3707300000000,37,73,"Gates County, NC",Jul-19,5507,5270,237,4.3
14802,CN3707500000000,37,75,"Graham County, NC",Jul-19,3383,3194,189,5.6
14803,CN3707700000000,37,77,"Granville County, NC",Jul-19,30312,29172,1140,3.8
14804,CN3707900000000,37,79,"Greene County, NC",Jul-19,9611,9188,423,4.4
14805,CN3708100000000,37,81,"Guilford County, NC",Jul-19,264486,252083,12403,4.7
14806,CN3708300000000,37,83,"Halifax County, NC",Jul-19,20541,19235,1306,6.4
14807,CN3708500000000,37,85,"Harnett County, NC",Jul-19,53678,50862,2816,5.2
14808,CN3708700000000,37,87,"Haywood County, NC",Jul-19,30515,29412,1103,3.6
14809,CN3708900000000,37,89,"Henderson County, NC",Jul-19,56233,54212,2021,3.6
14810,CN3709100000000,37,91,"Hertford County, NC",Jul-19,9276,8703,573,6.2
14811,CN3709300000000,37,93,"Hoke County, NC",Jul-19,20318,19197,1121,5.5
14812,CN3709500000000,37,95,"Hyde County, NC",Jul-19,2218,2086,132,6.0
14813,CN3709700000000,37,97,"Iredell County, NC",Jul-19,91151,87572,3579,3.9
14814,CN3709900000000,37,99,"Jackson County, NC",Jul-19,20312,19373,939,4.6
14815,CN3710100000000,37,101,"Johnston County, NC",Jul-19,101531,97499,4032,4.0
14816,CN3710300000000,37,103,"Jones County, NC",Jul-19,4568,4376,192,4.2
14817,CN3710500000000,37,105,"Lee County, NC",Jul-19,25895,24602,1293,5.0
14818,CN3710700000000,37,107,"Lenoir County, NC",Jul-19,28400,27240,1160,4.1
14819,CN3710900000000,37,109,"Lincoln County, NC",Jul-19,44286,42594,1692,3.8
14820,CN3711100000000,37,111,"McDowell County, NC",Jul-19,20890,20036,854,4.1
14821,CN3711300000000,37,113,"Macon County, NC",Jul-19,16187,15538,649,4.0
14822,CN3711500000000,37,115,"Madison County, NC",Jul-19,10396,9969,427,4.1
14823,CN3711700000000,37,117,"Martin County, NC",Jul-19,9028,8503,525,5.8
14824,CN3711900000000,37,119,"Mecklenburg County, NC",Jul-19,633212,607573,25639,4.0
14825,CN3712100000000,37,121,"Mitchell County, NC",Jul-19,6016,5710,306,5.1
14826,CN3712300000000,37,123,"Montgomery County, NC",Jul-19,11608,11098,510,4.4
14827,CN3712500000000,37,125,"Moore County, NC",Jul-19,43193,41379,1814,4.2
14828,CN3712700000000,37,127,"Nash County, NC",Jul-19,43628,41252,2376,5.4
14829,CN3712900000000,37,129,"New Hanover County, NC",Jul-19,127296,122367,4929,3.9
14830,CN3713100000000,37,131,"Northampton County, NC",Jul-19,7829,7379,450,5.7
14831,CN3713300000000,37,133,"Onslow County, NC",Jul-19,63597,60301,3296,5.2
14832,CN3713500000000,37,135,"Orange County, NC",Jul-19,79936,76917,3019,3.8
14833,CN3713700000000,37,137,"Pamlico County, NC",Jul-19,5513,5280,233,4.2
14834,CN3713900000000,37,139,"Pasquotank County, NC",Jul-19,16787,15937,850,5.1
14835,CN3714100000000,37,141,"Pender County, NC",Jul-19,29754,28486,1268,4.3
14836,CN3714300000000,37,143,"Perquimans County, NC",Jul-19,5022,4757,265,5.3
14837,CN3714500000000,37,145,"Person County, NC",Jul-19,18722,17854,868,4.6
14838,CN3714700000000,37,147,"Pitt County, NC",Jul-19,89686,85102,4584,5.1
14839,CN3714900000000,37,149,"Polk County, NC",Jul-19,9209,8828,381,4.1
14840,CN3715100000000,37,151,"Randolph County, NC",Jul-19,66814,63973,2841,4.3
14841,CN3715300000000,37,153,"Richmond County, NC",Jul-19,16677,15716,961,5.8
14842,CN3715500000000,37,155,"Robeson County, NC",Jul-19,50586,47537,3049,6.0
14843,CN3715700000000,37,157,"Rockingham County, NC",Jul-19,40452,38488,1964,4.9
14844,CN3715900000000,37,159,"Rowan County, NC",Jul-19,67479,64548,2931,4.3
14845,CN3716100000000,37,161,"Rutherford County, NC",Jul-19,25015,23656,1359,5.4
14846,CN3716300000000,37,163,"Sampson County, NC",Jul-19,29692,28383,1309,4.4
14847,CN3716500000000,37,165,"Scotland County, NC",Jul-19,11608,10776,832,7.2
14848,CN3716700000000,37,167,"Stanly County, NC",Jul-19,30685,29458,1227,4.0
14849,CN3716900000000,37,169,"Stokes County, NC",Jul-19,22009,21157,852,3.9
14850,CN3717100000000,37,171,"Surry County, NC",Jul-19,34262,32907,1355,4.0
14851,CN3717300000000,37,173,"Swain County, NC",Jul-19,7413,7128,285,3.8
14852,CN3717500000000,37,175,"Transylvania County, NC",Jul-19,15629,15028,601,3.8
14853,CN3717700000000,37,177,"Tyrrell County, NC",Jul-19,1737,1652,85,4.9
14854,CN3717900000000,37,179,"Union County, NC",Jul-19,126297,121448,4849,3.8
14855,CN3718100000000,37,181,"Vance County, NC",Jul-19,17629,16489,1140,6.5
14856,CN3718300000000,37,183,"Wake County, NC",Jul-19,608994,586361,22633,3.7
14857,CN3718500000000,37,185,"Warren County, NC",Jul-19,6742,6317,425,6.3
14858,CN3718700000000,37,187,"Washington County, NC",Jul-19,4644,4363,281,6.1
14859,CN3718900000000,37,189,"Watauga County, NC",Jul-19,30232,29012,1220,4.0
14860,CN3719100000000,37,191,"Wayne County, NC",Jul-19,52517,50107,2410,4.6
14861,CN3719300000000,37,193,"Wilkes County, NC",Jul-19,29714,28394,1320,4.4
14862,CN3719500000000,37,195,"Wilson County, NC",Jul-19,35278,32907,2371,6.7
14863,CN3719700000000,37,197,"Yadkin County, NC",Jul-19,18049,17361,688,3.8
14864,CN3719900000000,37,199,"Yancey County, NC",Jul-19,8373,8019,354,4.2
14865,CN3800100000000,38,1,"Adams County, ND",Jul-19,1062,1043,19,1.8
14866,CN3800300000000,38,3,"Barnes County, ND",Jul-19,5061,4806,255,5.0
14867,CN3800500000000,38,5,"Benson County, ND",Jul-19,2199,2112,87,4.0
14868,CN3800700000000,38,7,"Billings County, ND",Jul-19,569,560,9,1.6
14869,CN3800900000000,38,9,"Bottineau County, ND",Jul-19,3008,2913,95,3.2
14870,CN3801100000000,38,11,"Bowman County, ND",Jul-19,1691,1669,22,1.3
14871,CN3801300000000,38,13,"Burke County, ND",Jul-19,1025,1005,20,2.0
14872,CN3801500000000,38,15,"Burleigh County, ND",Jul-19,50846,49818,1028,2.0
14873,CN3801700000000,38,17,"Cass County, ND",Jul-19,104181,102268,1913,1.8
14874,CN3801900000000,38,19,"Cavalier County, ND",Jul-19,1877,1832,45,2.4
14875,CN3802100000000,38,21,"Dickey County, ND",Jul-19,2327,2283,44,1.9
14876,CN3802300000000,38,23,"Divide County, ND",Jul-19,1482,1465,17,1.1
14877,CN3802500000000,38,25,"Dunn County, ND",Jul-19,3168,3119,49,1.5
14878,CN3802700000000,38,27,"Eddy County, ND",Jul-19,1167,1123,44,3.8
14879,CN3802900000000,38,29,"Emmons County, ND",Jul-19,1408,1366,42,3.0
14880,CN3803100000000,38,31,"Foster County, ND",Jul-19,1522,1490,32,2.1
14881,CN3803300000000,38,33,"Golden Valley County, ND",Jul-19,821,809,12,1.5
14882,CN3803500000000,38,35,"Grand Forks County, ND",Jul-19,37061,36280,781,2.1
14883,CN3803700000000,38,37,"Grant County, ND",Jul-19,1177,1157,20,1.7
14884,CN3803900000000,38,39,"Griggs County, ND",Jul-19,1020,999,21,2.1
14885,CN3804100000000,38,41,"Hettinger County, ND",Jul-19,1338,1314,24,1.8
14886,CN3804300000000,38,43,"Kidder County, ND",Jul-19,1242,1206,36,2.9
14887,CN3804500000000,38,45,"LaMoure County, ND",Jul-19,1979,1932,47,2.4
14888,CN3804700000000,38,47,"Logan County, ND",Jul-19,829,813,16,1.9
14889,CN3804900000000,38,49,"McHenry County, ND",Jul-19,2988,2906,82,2.7
14890,CN3805100000000,38,51,"McIntosh County, ND",Jul-19,1114,1084,30,2.7
14891,CN3805300000000,38,53,"McKenzie County, ND",Jul-19,10896,10741,155,1.4
14892,CN3805500000000,38,55,"McLean County, ND",Jul-19,4726,4593,133,2.8
14893,CN3805700000000,38,57,"Mercer County, ND",Jul-19,3691,3543,148,4.0
14894,CN3805900000000,38,59,"Morton County, ND",Jul-19,16667,16266,401,2.4
14895,CN3806100000000,38,61,"Mountrail County, ND",Jul-19,7514,7417,97,1.3
14896,CN3806300000000,38,63,"Nelson County, ND",Jul-19,1390,1351,39,2.8
14897,CN3806500000000,38,65,"Oliver County, ND",Jul-19,887,856,31,3.5
14898,CN3806700000000,38,67,"Pembina County, ND",Jul-19,3334,3208,126,3.8
14899,CN3806900000000,38,69,"Pierce County, ND",Jul-19,1757,1707,50,2.8
14900,CN3807100000000,38,71,"Ramsey County, ND",Jul-19,5757,5619,138,2.4
14901,CN3807300000000,38,73,"Ransom County, ND",Jul-19,2857,2808,49,1.7
14902,CN3807500000000,38,75,"Renville County, ND",Jul-19,1183,1157,26,2.2
14903,CN3807700000000,38,77,"Richland County, ND",Jul-19,8653,8454,199,2.3
14904,CN3807900000000,38,79,"Rolette County, ND",Jul-19,4643,4053,590,12.7
14905,CN3808100000000,38,81,"Sargent County, ND",Jul-19,2736,2690,46,1.7
14906,CN3808300000000,38,83,"Sheridan County, ND",Jul-19,651,632,19,2.9
14907,CN3808500000000,38,85,"Sioux County, ND",Jul-19,1283,1227,56,4.4
14908,CN3808700000000,38,87,"Slope County, ND",Jul-19,400,391,9,2.3
14909,CN3808900000000,38,89,"Stark County, ND",Jul-19,19085,18732,353,1.8
14910,CN3809100000000,38,91,"Steele County, ND",Jul-19,972,952,20,2.1
14911,CN3809300000000,38,93,"Stutsman County, ND",Jul-19,10447,10225,222,2.1
14912,CN3809500000000,38,95,"Towner County, ND",Jul-19,1125,1094,31,2.8
14913,CN3809700000000,38,97,"Traill County, ND",Jul-19,4289,4154,135,3.1
14914,CN3809900000000,38,99,"Walsh County, ND",Jul-19,5180,4989,191,3.7
14915,CN3810100000000,38,101,"Ward County, ND",Jul-19,32209,31541,668,2.1
14916,CN3810300000000,38,103,"Wells County, ND",Jul-19,1933,1884,49,2.5
14917,CN3810500000000,38,105,"Williams County, ND",Jul-19,25500,25082,418,1.6
14918,CN3900100000000,39,1,"Adams County, OH",Jul-19,10796,10061,735,6.8
14919,CN3900300000000,39,3,"Allen County, OH",Jul-19,48641,46333,2308,4.7
14920,CN3900500000000,39,5,"Ashland County, OH",Jul-19,27008,25817,1191,4.4
14921,CN3900700000000,39,7,"Ashtabula County, OH",Jul-19,45296,43119,2177,4.8
14922,CN3900900000000,39,9,"Athens County, OH",Jul-19,25123,23379,1744,6.9
14923,CN3901100000000,39,11,"Auglaize County, OH",Jul-19,25367,24513,854,3.4
14924,CN3901300000000,39,13,"Belmont County, OH",Jul-19,30492,28903,1589,5.2
14925,CN3901500000000,39,15,"Brown County, OH",Jul-19,19802,18787,1015,5.1
14926,CN3901700000000,39,17,"Butler County, OH",Jul-19,197827,189048,8779,4.4
14927,CN3901900000000,39,19,"Carroll County, OH",Jul-19,13032,12419,613,4.7
14928,CN3902100000000,39,21,"Champaign County, OH",Jul-19,20264,19416,848,4.2
14929,CN3902300000000,39,23,"Clark County, OH",Jul-19,63579,60414,3165,5.0
14930,CN3902500000000,39,25,"Clermont County, OH",Jul-19,108228,103664,4564,4.2
14931,CN3902700000000,39,27,"Clinton County, OH",Jul-19,17851,16936,915,5.1
14932,CN3902900000000,39,29,"Columbiana County, OH",Jul-19,48200,45556,2644,5.5
14933,CN3903100000000,39,31,"Coshocton County, OH",Jul-19,14561,13639,922,6.3
14934,CN3903300000000,39,33,"Crawford County, OH",Jul-19,18579,17608,971,5.2
14935,CN3903500000000,39,35,"Cuyahoga County, OH",Jul-19,629425,599328,30097,4.8
14936,CN3903700000000,39,37,"Darke County, OH",Jul-19,25936,24908,1028,4.0
14937,CN3903900000000,39,39,"Defiance County, OH",Jul-19,18316,17451,865,4.7
14938,CN3904100000000,39,41,"Delaware County, OH",Jul-19,112211,108136,4075,3.6
14939,CN3904300000000,39,43,"Erie County, OH",Jul-19,39880,37802,2078,5.2
14940,CN3904500000000,39,45,"Fairfield County, OH",Jul-19,79113,75912,3201,4.0
14941,CN3904700000000,39,47,"Fayette County, OH",Jul-19,14030,13430,600,4.3
14942,CN3904900000000,39,49,"Franklin County, OH",Jul-19,708505,680579,27926,3.9
14943,CN3905100000000,39,51,"Fulton County, OH",Jul-19,22464,21517,947,4.2
14944,CN3905300000000,39,53,"Gallia County, OH",Jul-19,11985,11294,691,5.8
14945,CN3905500000000,39,55,"Geauga County, OH",Jul-19,50504,48526,1978,3.9
14946,CN3905700000000,39,57,"Greene County, OH",Jul-19,84390,80796,3594,4.3
14947,CN3905900000000,39,59,"Guernsey County, OH",Jul-19,18781,17814,967,5.1
14948,CN3906100000000,39,61,"Hamilton County, OH",Jul-19,421659,403498,18161,4.3
14949,CN3906300000000,39,63,"Hancock County, OH",Jul-19,41985,40465,1520,3.6
14950,CN3906500000000,39,65,"Hardin County, OH",Jul-19,13509,12790,719,5.3
14951,CN3906700000000,39,67,"Harrison County, OH",Jul-19,6905,6541,364,5.3
14952,CN3906900000000,39,69,"Henry County, OH",Jul-19,13340,12727,613,4.6
14953,CN3907100000000,39,71,"Highland County, OH",Jul-19,17055,16126,929,5.4
14954,CN3907300000000,39,73,"Hocking County, OH",Jul-19,13228,12636,592,4.5
14955,CN3907500000000,39,75,"Holmes County, OH",Jul-19,21208,20461,747,3.5
14956,CN3907700000000,39,77,"Huron County, OH",Jul-19,28923,27026,1897,6.6
14957,CN3907900000000,39,79,"Jackson County, OH",Jul-19,12754,11941,813,6.4
14958,CN3908100000000,39,81,"Jefferson County, OH",Jul-19,28082,26380,1702,6.1
14959,CN3908300000000,39,83,"Knox County, OH",Jul-19,31633,30228,1405,4.4
14960,CN3908500000000,39,85,"Lake County, OH",Jul-19,129576,124157,5419,4.2
14961,CN3908700000000,39,87,"Lawrence County, OH",Jul-19,23906,22492,1414,5.9
14962,CN3908900000000,39,89,"Licking County, OH",Jul-19,91934,88155,3779,4.1
14963,CN3909100000000,39,91,"Logan County, OH",Jul-19,23131,22208,923,4.0
14964,CN3909300000000,39,93,"Lorain County, OH",Jul-19,157966,150085,7881,5.0
14965,CN3909500000000,39,95,"Lucas County, OH",Jul-19,210796,200566,10230,4.9
14966,CN3909700000000,39,97,"Madison County, OH",Jul-19,21039,20269,770,3.7
14967,CN3909900000000,39,99,"Mahoning County, OH",Jul-19,104240,97865,6375,6.1
14968,CN3910100000000,39,101,"Marion County, OH",Jul-19,28694,27414,1280,4.5
14969,CN3910300000000,39,103,"Medina County, OH",Jul-19,100088,96158,3930,3.9
14970,CN3910500000000,39,105,"Meigs County, OH",Jul-19,8809,8177,632,7.2
14971,CN3910700000000,39,107,"Mercer County, OH",Jul-19,23870,23169,701,2.9
14972,CN3910900000000,39,109,"Miami County, OH",Jul-19,54671,52514,2157,3.9
14973,CN3911100000000,39,111,"Monroe County, OH",Jul-19,5396,4988,408,7.6
14974,CN3911300000000,39,113,"Montgomery County, OH",Jul-19,255882,244023,11859,4.6
14975,CN3911500000000,39,115,"Morgan County, OH",Jul-19,6732,6342,390,5.8
14976,CN3911700000000,39,117,"Morrow County, OH",Jul-19,17036,16313,723,4.2
14977,CN3911900000000,39,119,"Muskingum County, OH",Jul-19,39679,37742,1937,4.9
14978,CN3912100000000,39,121,"Noble County, OH",Jul-19,4708,4414,294,6.2
14979,CN3912300000000,39,123,"Ottawa County, OH",Jul-19,22602,21613,989,4.4
14980,CN3912500000000,39,125,"Paulding County, OH",Jul-19,8717,8335,382,4.4
14981,CN3912700000000,39,127,"Perry County, OH",Jul-19,16069,15240,829,5.2
14982,CN3912900000000,39,129,"Pickaway County, OH",Jul-19,26780,25667,1113,4.2
14983,CN3913100000000,39,131,"Pike County, OH",Jul-19,10923,10242,681,6.2
14984,CN3913300000000,39,133,"Portage County, OH",Jul-19,88268,84227,4041,4.6
14985,CN3913500000000,39,135,"Preble County, OH",Jul-19,21385,20538,847,4.0
14986,CN3913700000000,39,137,"Putnam County, OH",Jul-19,19095,18449,646,3.4
14987,CN3913900000000,39,139,"Richland County, OH",Jul-19,52955,50332,2623,5.0
14988,CN3914100000000,39,141,"Ross County, OH",Jul-19,35737,34167,1570,4.4
14989,CN3914300000000,39,143,"Sandusky County, OH",Jul-19,30980,29623,1357,4.4
14990,CN3914500000000,39,145,"Scioto County, OH",Jul-19,28870,26959,1911,6.6
14991,CN3914700000000,39,147,"Seneca County, OH",Jul-19,27620,26351,1269,4.6
14992,CN3914900000000,39,149,"Shelby County, OH",Jul-19,24588,23619,969,3.9
14993,CN3915100000000,39,151,"Stark County, OH",Jul-19,187477,178822,8655,4.6
14994,CN3915300000000,39,153,"Summit County, OH",Jul-19,275058,262511,12547,4.6
14995,CN3915500000000,39,155,"Trumbull County, OH",Jul-19,87803,82060,5743,6.5
14996,CN3915700000000,39,157,"Tuscarawas County, OH",Jul-19,45657,43675,1982,4.3
14997,CN3915900000000,39,159,"Union County, OH",Jul-19,29407,28344,1063,3.6
14998,CN3916100000000,39,161,"Van Wert County, OH",Jul-19,15341,14788,553,3.6
14999,CN3916300000000,39,163,"Vinton County, OH",Jul-19,5590,5286,304,5.4
15000,CN3916500000000,39,165,"Warren County, OH",Jul-19,120691,115870,4821,4.0
15001,CN3916700000000,39,167,"Washington County, OH",Jul-19,27688,26173,1515,5.5
15002,CN3916900000000,39,169,"Wayne County, OH",Jul-19,62381,60152,2229,3.6
15003,CN3917100000000,39,171,"Williams County, OH",Jul-19,19330,18631,699,3.6
15004,CN3917300000000,39,173,"Wood County, OH",Jul-19,71541,68578,2963,4.1
15005,CN3917500000000,39,175,"Wyandot County, OH",Jul-19,13146,12723,423,3.2
15006,CN4000100000000,40,1,"Adair County, OK",Jul-19,7778,7435,343,4.4
15007,CN4000300000000,40,3,"Alfalfa County, OK",Jul-19,2748,2689,59,2.1
15008,CN4000500000000,40,5,"Atoka County, OK",Jul-19,4838,4620,218,4.5
15009,CN4000700000000,40,7,"Beaver County, OK",Jul-19,2758,2698,60,2.2
15010,CN4000900000000,40,9,"Beckham County, OK",Jul-19,10418,10102,316,3.0
15011,CN4001100000000,40,11,"Blaine County, OK",Jul-19,4818,4715,103,2.1
15012,CN4001300000000,40,13,"Bryan County, OK",Jul-19,22193,21488,705,3.2
15013,CN4001500000000,40,15,"Caddo County, OK",Jul-19,11380,10926,454,4.0
15014,CN4001700000000,40,17,"Canadian County, OK",Jul-19,74744,72533,2211,3.0
15015,CN4001900000000,40,19,"Carter County, OK",Jul-19,21231,20475,756,3.6
15016,CN4002100000000,40,21,"Cherokee County, OK",Jul-19,18945,18107,838,4.4
15017,CN4002300000000,40,23,"Choctaw County, OK",Jul-19,5509,5231,278,5.0
15018,CN4002500000000,40,25,"Cimarron County, OK",Jul-19,1305,1281,24,1.8
15019,CN4002700000000,40,27,"Cleveland County, OK",Jul-19,143782,139527,4255,3.0
15020,CN4002900000000,40,29,"Coal County, OK",Jul-19,2316,2221,95,4.1
15021,CN4003100000000,40,31,"Comanche County, OK",Jul-19,48488,46613,1875,3.9
15022,CN4003300000000,40,33,"Cotton County, OK",Jul-19,2748,2661,87,3.2
15023,CN4003500000000,40,35,"Craig County, OK",Jul-19,5919,5711,208,3.5
15024,CN4003700000000,40,37,"Creek County, OK",Jul-19,32070,30887,1183,3.7
15025,CN4003900000000,40,39,"Custer County, OK",Jul-19,15617,15204,413,2.6
15026,CN4004100000000,40,41,"Delaware County, OK",Jul-19,18510,17792,718,3.9
15027,CN4004300000000,40,43,"Dewey County, OK",Jul-19,2837,2778,59,2.1
15028,CN4004500000000,40,45,"Ellis County, OK",Jul-19,2117,2061,56,2.6
15029,CN4004700000000,40,47,"Garfield County, OK",Jul-19,27549,26713,836,3.0
15030,CN4004900000000,40,49,"Garvin County, OK",Jul-19,12380,11983,397,3.2
15031,CN4005100000000,40,51,"Grady County, OK",Jul-19,26697,25872,825,3.1
15032,CN4005300000000,40,53,"Grant County, OK",Jul-19,2664,2605,59,2.2
15033,CN4005500000000,40,55,"Greer County, OK",Jul-19,1785,1704,81,4.5
15034,CN4005700000000,40,57,"Harmon County, OK",Jul-19,1162,1122,40,3.4
15035,CN4005900000000,40,59,"Harper County, OK",Jul-19,1716,1669,47,2.7
15036,CN4006100000000,40,61,"Haskell County, OK",Jul-19,4091,3864,227,5.5
15037,CN4006300000000,40,63,"Hughes County, OK",Jul-19,5147,4876,271,5.3
15038,CN4006500000000,40,65,"Jackson County, OK",Jul-19,10325,10005,320,3.1
15039,CN4006700000000,40,67,"Jefferson County, OK",Jul-19,2394,2302,92,3.8
15040,CN4006900000000,40,69,"Johnston County, OK",Jul-19,3677,3519,158,4.3
15041,CN4007100000000,40,71,"Kay County, OK",Jul-19,18195,17385,810,4.5
15042,CN4007300000000,40,73,"Kingfisher County, OK",Jul-19,9072,8874,198,2.2
15043,CN4007500000000,40,75,"Kiowa County, OK",Jul-19,3474,3336,138,4.0
15044,CN4007700000000,40,77,"Latimer County, OK",Jul-19,3109,2906,203,6.5
15045,CN4007900000000,40,79,"Le Flore County, OK",Jul-19,19140,18224,916,4.8
15046,CN4008100000000,40,81,"Lincoln County, OK",Jul-19,15932,15370,562,3.5
15047,CN4008300000000,40,83,"Logan County, OK",Jul-19,22260,21600,660,3.0
15048,CN4008500000000,40,85,"Love County, OK",Jul-19,6129,5974,155,2.5
15049,CN4008700000000,40,87,"McClain County, OK",Jul-19,19821,19279,542,2.7
15050,CN4008900000000,40,89,"McCurtain County, OK",Jul-19,14293,13434,859,6.0
15051,CN4009100000000,40,91,"McIntosh County, OK",Jul-19,7148,6709,439,6.1
15052,CN4009300000000,40,93,"Major County, OK",Jul-19,3886,3802,84,2.2
15053,CN4009500000000,40,95,"Marshall County, OK",Jul-19,6933,6682,251,3.6
15054,CN4009700000000,40,97,"Mayes County, OK",Jul-19,19211,18581,630,3.3
15055,CN4009900000000,40,99,"Murray County, OK",Jul-19,6319,6125,194,3.1
15056,CN4010100000000,40,101,"Muskogee County, OK",Jul-19,30340,28865,1475,4.9
15057,CN4010300000000,40,103,"Noble County, OK",Jul-19,5650,5511,139,2.5
15058,CN4010500000000,40,105,"Nowata County, OK",Jul-19,4478,4315,163,3.6
15059,CN4010700000000,40,107,"Okfuskee County, OK",Jul-19,4513,4290,223,4.9
15060,CN4010900000000,40,109,"Oklahoma County, OK",Jul-19,387444,374887,12557,3.2
15061,CN4011100000000,40,111,"Okmulgee County, OK",Jul-19,15951,15150,801,5.0
15062,CN4011300000000,40,113,"Osage County, OK",Jul-19,20984,20178,806,3.8
15063,CN4011500000000,40,115,"Ottawa County, OK",Jul-19,13907,13401,506,3.6
15064,CN4011700000000,40,117,"Pawnee County, OK",Jul-19,7478,7187,291,3.9
15065,CN4011900000000,40,119,"Payne County, OK",Jul-19,38078,36916,1162,3.1
15066,CN4012100000000,40,121,"Pittsburg County, OK",Jul-19,16522,15788,734,4.4
15067,CN4012300000000,40,123,"Pontotoc County, OK",Jul-19,18626,18043,583,3.1
15068,CN4012500000000,40,125,"Pottawatomie County, OK",Jul-19,31746,30542,1204,3.8
15069,CN4012700000000,40,127,"Pushmataha County, OK",Jul-19,4190,3972,218,5.2
15070,CN4012900000000,40,129,"Roger Mills County, OK",Jul-19,1825,1769,56,3.1
15071,CN4013100000000,40,131,"Rogers County, OK",Jul-19,45690,44260,1430,3.1
15072,CN4013300000000,40,133,"Seminole County, OK",Jul-19,9050,8596,454,5.0
15073,CN4013500000000,40,135,"Sequoyah County, OK",Jul-19,16265,15592,673,4.1
15074,CN4013700000000,40,137,"Stephens County, OK",Jul-19,18619,17811,808,4.3
15075,CN4013900000000,40,139,"Texas County, OK",Jul-19,11136,10901,235,2.1
15076,CN4014100000000,40,141,"Tillman County, OK",Jul-19,2924,2801,123,4.2
15077,CN4014300000000,40,143,"Tulsa County, OK",Jul-19,327915,317550,10365,3.2
15078,CN4014500000000,40,145,"Wagoner County, OK",Jul-19,38494,37280,1214,3.2
15079,CN4014700000000,40,147,"Washington County, OK",Jul-19,22630,21821,809,3.6
15080,CN4014900000000,40,149,"Washita County, OK",Jul-19,5057,4891,166,3.3
15081,CN4015100000000,40,151,"Woods County, OK",Jul-19,4525,4416,109,2.4
15082,CN4015300000000,40,153,"Woodward County, OK",Jul-19,9136,8900,236,2.6
15083,CN4100100000000,41,1,"Baker County, OR",Jul-19,7108,6799,309,4.3
15084,CN4100300000000,41,3,"Benton County, OR",Jul-19,46188,44474,1714,3.7
15085,CN4100500000000,41,5,"Clackamas County, OR",Jul-19,221108,212948,8160,3.7
15086,CN4100700000000,41,7,"Clatsop County, OR",Jul-19,20228,19510,718,3.5
15087,CN4100900000000,41,9,"Columbia County, OR",Jul-19,24569,23380,1189,4.8
15088,CN4101100000000,41,11,"Coos County, OR",Jul-19,26185,24788,1397,5.3
15089,CN4101300000000,41,13,"Crook County, OR",Jul-19,9810,9314,496,5.1
15090,CN4101500000000,41,15,"Curry County, OR",Jul-19,9100,8658,442,4.9
15091,CN4101700000000,41,17,"Deschutes County, OR",Jul-19,97698,94019,3679,3.8
15092,CN4101900000000,41,19,"Douglas County, OR",Jul-19,46695,44278,2417,5.2
15093,CN4102100000000,41,21,"Gilliam County, OR",Jul-19,996,964,32,3.2
15094,CN4102300000000,41,23,"Grant County, OR",Jul-19,3264,3115,149,4.6
15095,CN4102500000000,41,25,"Harney County, OR",Jul-19,3669,3512,157,4.3
15096,CN4102700000000,41,27,"Hood River County, OR",Jul-19,16399,15890,509,3.1
15097,CN4102900000000,41,29,"Jackson County, OR",Jul-19,103568,98246,5322,5.1
15098,CN4103100000000,41,31,"Jefferson County, OR",Jul-19,10290,9817,473,4.6
15099,CN4103300000000,41,33,"Josephine County, OR",Jul-19,35865,34035,1830,5.1
15100,CN4103500000000,41,35,"Klamath County, OR",Jul-19,29548,27866,1682,5.7
15101,CN4103700000000,41,37,"Lake County, OR",Jul-19,3826,3655,171,4.5
15102,CN4103900000000,41,39,"Lane County, OR",Jul-19,179377,171416,7961,4.4
15103,CN4104100000000,41,41,"Lincoln County, OR",Jul-19,21506,20568,938,4.4
15104,CN4104300000000,41,43,"Linn County, OR",Jul-19,58253,55461,2792,4.8
15105,CN4104500000000,41,45,"Malheur County, OR",Jul-19,12414,11845,569,4.6
15106,CN4104700000000,41,47,"Marion County, OR",Jul-19,164971,157860,7111,4.3
15107,CN4104900000000,41,49,"Morrow County, OR",Jul-19,5971,5658,313,5.2
15108,CN4105100000000,41,51,"Multnomah County, OR",Jul-19,457534,441397,16137,3.5
15109,CN4105300000000,41,53,"Polk County, OR",Jul-19,40372,38522,1850,4.6
15110,CN4105500000000,41,55,"Sherman County, OR",Jul-19,994,961,33,3.3
15111,CN4105700000000,41,57,"Tillamook County, OR",Jul-19,12244,11781,463,3.8
15112,CN4105900000000,41,59,"Umatilla County, OR",Jul-19,38721,36439,2282,5.9
15113,CN4106100000000,41,61,"Union County, OR",Jul-19,12008,11470,538,4.5
15114,CN4106300000000,41,63,"Wallowa County, OR",Jul-19,3644,3487,157,4.3
15115,CN4106500000000,41,65,"Wasco County, OR",Jul-19,18388,17853,535,2.9
15116,CN4106700000000,41,67,"Washington County, OR",Jul-19,327465,316364,11101,3.4
15117,CN4106900000000,41,69,"Wheeler County, OR",Jul-19,719,688,31,4.3
15118,CN4107100000000,41,71,"Yamhill County, OR",Jul-19,55715,53616,2099,3.8
15119,CN4200100000000,42,1,"Adams County, PA",Jul-19,56165,53975,2190,3.9
15120,CN4200300000000,42,3,"Allegheny County, PA",Jul-19,658352,628036,30316,4.6
15121,CN4200500000000,42,5,"Armstrong County, PA",Jul-19,32766,31058,1708,5.2
15122,CN4200700000000,42,7,"Beaver County, PA",Jul-19,85288,81097,4191,4.9
15123,CN4200900000000,42,9,"Bedford County, PA",Jul-19,24181,23005,1176,4.9
15124,CN4201100000000,42,11,"Berks County, PA",Jul-19,219663,209028,10635,4.8
15125,CN4201300000000,42,13,"Blair County, PA",Jul-19,60843,57573,3270,5.4
15126,CN4201500000000,42,15,"Bradford County, PA",Jul-19,29759,28393,1366,4.6
15127,CN4201700000000,42,17,"Bucks County, PA",Jul-19,351667,336557,15110,4.3
15128,CN4201900000000,42,19,"Butler County, PA",Jul-19,101491,97099,4392,4.3
15129,CN4202100000000,42,21,"Cambria County, PA",Jul-19,58394,54741,3653,6.3
15130,CN4202300000000,42,23,"Cameron County, PA",Jul-19,2163,2034,129,6.0
15131,CN4202500000000,42,25,"Carbon County, PA",Jul-19,32513,30654,1859,5.7
15132,CN4202700000000,42,27,"Centre County, PA",Jul-19,77590,74383,3207,4.1
15133,CN4202900000000,42,29,"Chester County, PA",Jul-19,295072,283911,11161,3.8
15134,CN4203100000000,42,31,"Clarion County, PA",Jul-19,17130,16225,905,5.3
15135,CN4203300000000,42,33,"Clearfield County, PA",Jul-19,36209,34290,1919,5.3
15136,CN4203500000000,42,35,"Clinton County, PA",Jul-19,18482,17467,1015,5.5
15137,CN4203700000000,42,37,"Columbia County, PA",Jul-19,33686,31912,1774,5.3
15138,CN4203900000000,42,39,"Crawford County, PA",Jul-19,39381,37335,2046,5.2
15139,CN4204100000000,42,41,"Cumberland County, PA",Jul-19,135903,130575,5328,3.9
15140,CN4204300000000,42,43,"Dauphin County, PA",Jul-19,148058,141299,6759,4.6
15141,CN4204500000000,42,45,"Delaware County, PA",Jul-19,301599,287707,13892,4.6
15142,CN4204700000000,42,47,"Elk County, PA",Jul-19,16109,15273,836,5.2
15143,CN4204900000000,42,49,"Erie County, PA",Jul-19,130267,123664,6603,5.1
15144,CN4205100000000,42,51,"Fayette County, PA",Jul-19,57976,54436,3540,6.1
15145,CN4205300000000,42,53,"Forest County, PA",Jul-19,1880,1752,128,6.8
15146,CN4205500000000,42,55,"Franklin County, PA",Jul-19,79077,75602,3475,4.4
15147,CN4205700000000,42,57,"Fulton County, PA",Jul-19,8124,7777,347,4.3
15148,CN4205900000000,42,59,"Greene County, PA",Jul-19,16700,15738,962,5.8
15149,CN4206100000000,42,61,"Huntingdon County, PA",Jul-19,20242,19106,1136,5.6
15150,CN4206300000000,42,63,"Indiana County, PA",Jul-19,38984,36698,2286,5.9
15151,CN4206500000000,42,65,"Jefferson County, PA",Jul-19,21018,19982,1036,4.9
15152,CN4206700000000,42,67,"Juniata County, PA",Jul-19,13007,12429,578,4.4
15153,CN4206900000000,42,69,"Lackawanna County, PA",Jul-19,106167,100261,5906,5.6
15154,CN4207100000000,42,71,"Lancaster County, PA",Jul-19,292146,280307,11839,4.1
15155,CN4207300000000,42,73,"Lawrence County, PA",Jul-19,41380,39236,2144,5.2
15156,CN4207500000000,42,75,"Lebanon County, PA",Jul-19,74280,71110,3170,4.3
15157,CN4207700000000,42,77,"Lehigh County, PA",Jul-19,194854,185200,9654,5.0
15158,CN4207900000000,42,79,"Luzerne County, PA",Jul-19,158751,149046,9705,6.1
15159,CN4208100000000,42,81,"Lycoming County, PA",Jul-19,57189,54363,2826,4.9
15160,CN4208300000000,42,83,"McKean County, PA",Jul-19,17677,16690,987,5.6
15161,CN4208500000000,42,85,"Mercer County, PA",Jul-19,50262,47527,2735,5.4
15162,CN4208700000000,42,87,"Mifflin County, PA",Jul-19,21516,20454,1062,4.9
15163,CN4208900000000,42,89,"Monroe County, PA",Jul-19,84978,80019,4959,5.8
15164,CN4209100000000,42,91,"Montgomery County, PA",Jul-19,464707,446046,18661,4.0
15165,CN4209300000000,42,93,"Montour County, PA",Jul-19,9160,8785,375,4.1
15166,CN4209500000000,42,95,"Northampton County, PA",Jul-19,163271,155100,8171,5.0
15167,CN4209700000000,42,97,"Northumberland County, PA",Jul-19,44370,41804,2566,5.8
15168,CN4209900000000,42,99,"Perry County, PA",Jul-19,25338,24314,1024,4.0
15169,CN4210100000000,42,101,"Philadelphia County/city, PA",Jul-19,723626,678020,45606,6.3
15170,CN4210300000000,42,103,"Pike County, PA",Jul-19,25786,24291,1495,5.8
15171,CN4210500000000,42,105,"Potter County, PA",Jul-19,7474,7072,402,5.4
15172,CN4210700000000,42,107,"Schuylkill County, PA",Jul-19,67917,63936,3981,5.9
15173,CN4210900000000,42,109,"Snyder County, PA",Jul-19,20212,18818,1394,6.9
15174,CN4211100000000,42,111,"Somerset County, PA",Jul-19,34066,32196,1870,5.5
15175,CN4211300000000,42,113,"Sullivan County, PA",Jul-19,2761,2627,134,4.9
15176,CN4211500000000,42,115,"Susquehanna County, PA",Jul-19,21329,20453,876,4.1
15177,CN4211700000000,42,117,"Tioga County, PA",Jul-19,19501,18442,1059,5.4
15178,CN4211900000000,42,119,"Union County, PA",Jul-19,19878,18877,1001,5.0
15179,CN4212100000000,42,121,"Venango County, PA",Jul-19,22822,21617,1205,5.3
15180,CN4212300000000,42,123,"Warren County, PA",Jul-19,19438,18515,923,4.7
15181,CN4212500000000,42,125,"Washington County, PA",Jul-19,108744,103462,5282,4.9
15182,CN4212700000000,42,127,"Wayne County, PA",Jul-19,24548,23501,1047,4.3
15183,CN4212900000000,42,129,"Westmoreland County, PA",Jul-19,184039,174944,9095,4.9
15184,CN4213100000000,42,131,"Wyoming County, PA",Jul-19,13757,13078,679,4.9
15185,CN4213300000000,42,133,"York County, PA",Jul-19,239871,229110,10761,4.5
15186,CN4400100000000,44,1,"Bristol County, RI",Jul-19,26243,25403,840,3.2
15187,CN4400300000000,44,3,"Kent County, RI",Jul-19,91677,88435,3242,3.5
15188,CN4400500000000,44,5,"Newport County, RI",Jul-19,44516,43206,1310,2.9
15189,CN4400700000000,44,7,"Providence County, RI",Jul-19,329289,315137,14152,4.3
15190,CN4400900000000,44,9,"Washington County, RI",Jul-19,70456,68199,2257,3.2
15191,CN4500100000000,45,1,"Abbeville County, SC",Jul-19,9792,9441,351,3.6
15192,CN4500300000000,45,3,"Aiken County, SC",Jul-19,75454,73104,2350,3.1
15193,CN4500500000000,45,5,"Allendale County, SC",Jul-19,2699,2551,148,5.5
15194,CN4500700000000,45,7,"Anderson County, SC",Jul-19,92340,89689,2651,2.9
15195,CN4500900000000,45,9,"Bamberg County, SC",Jul-19,4955,4652,303,6.1
15196,CN4501100000000,45,11,"Barnwell County, SC",Jul-19,8297,7927,370,4.5
15197,CN4501300000000,45,13,"Beaufort County, SC",Jul-19,80433,78146,2287,2.8
15198,CN4501500000000,45,15,"Berkeley County, SC",Jul-19,106064,103244,2820,2.7
15199,CN4501700000000,45,17,"Calhoun County, SC",Jul-19,6678,6426,252,3.8
15200,CN4501900000000,45,19,"Charleston County, SC",Jul-19,215888,210555,5333,2.5
15201,CN4502100000000,45,21,"Cherokee County, SC",Jul-19,24679,23799,880,3.6
15202,CN4502300000000,45,23,"Chester County, SC",Jul-19,13526,12912,614,4.5
15203,CN4502500000000,45,25,"Chesterfield County, SC",Jul-19,22312,21590,722,3.2
15204,CN4502700000000,45,27,"Clarendon County, SC",Jul-19,12407,11864,543,4.4
15205,CN4502900000000,45,29,"Colleton County, SC",Jul-19,17019,16448,571,3.4
15206,CN4503100000000,45,31,"Darlington County, SC",Jul-19,30894,29746,1148,3.7
15207,CN4503300000000,45,33,"Dillon County, SC",Jul-19,12693,12157,536,4.2
15208,CN4503500000000,45,35,"Dorchester County, SC",Jul-19,79705,77604,2101,2.6
15209,CN4503700000000,45,37,"Edgefield County, SC",Jul-19,10834,10513,321,3.0
15210,CN4503900000000,45,39,"Fairfield County, SC",Jul-19,9707,9266,441,4.5
15211,CN4504100000000,45,41,"Florence County, SC",Jul-19,67754,65650,2104,3.1
15212,CN4504300000000,45,43,"Georgetown County, SC",Jul-19,26676,25736,940,3.5
15213,CN4504500000000,45,45,"Greenville County, SC",Jul-19,257808,251238,6570,2.5
15214,CN4504700000000,45,47,"Greenwood County, SC",Jul-19,30592,29556,1036,3.4
15215,CN4504900000000,45,49,"Hampton County, SC",Jul-19,8515,8252,263,3.1
15216,CN4505100000000,45,51,"Horry County, SC",Jul-19,156579,151458,5121,3.3
15217,CN4505300000000,45,53,"Jasper County, SC",Jul-19,13132,12760,372,2.8
15218,CN4505500000000,45,55,"Kershaw County, SC",Jul-19,29601,28647,954,3.2
15219,CN4505700000000,45,57,"Lancaster County, SC",Jul-19,41459,40020,1439,3.5
15220,CN4505900000000,45,59,"Laurens County, SC",Jul-19,30594,29630,964,3.2
15221,CN4506100000000,45,61,"Lee County, SC",Jul-19,6735,6447,288,4.3
15222,CN4506300000000,45,63,"Lexington County, SC",Jul-19,151458,147677,3781,2.5
15223,CN4506500000000,45,65,"McCormick County, SC",Jul-19,3384,3276,108,3.2
15224,CN4506700000000,45,67,"Marion County, SC",Jul-19,13361,12761,600,4.5
15225,CN4506900000000,45,69,"Marlboro County, SC",Jul-19,9072,8558,514,5.7
15226,CN4507100000000,45,71,"Newberry County, SC",Jul-19,19445,18883,562,2.9
15227,CN4507300000000,45,73,"Oconee County, SC",Jul-19,34866,33773,1093,3.1
15228,CN4507500000000,45,75,"Orangeburg County, SC",Jul-19,34611,32914,1697,4.9
15229,CN4507700000000,45,77,"Pickens County, SC",Jul-19,58171,56424,1747,3.0
15230,CN4507900000000,45,79,"Richland County, SC",Jul-19,200420,194443,5977,3.0
15231,CN4508100000000,45,81,"Saluda County, SC",Jul-19,9088,8836,252,2.8
15232,CN4508300000000,45,83,"Spartanburg County, SC",Jul-19,153824,149471,4353,2.8
15233,CN4508500000000,45,85,"Sumter County, SC",Jul-19,43834,42257,1577,3.6
15234,CN4508700000000,45,87,"Union County, SC",Jul-19,11709,11270,439,3.7
15235,CN4508900000000,45,89,"Williamsburg County, SC",Jul-19,12231,11652,579,4.7
15236,CN4509100000000,45,91,"York County, SC",Jul-19,140877,136707,4170,3.0
15237,CN4600300000000,46,3,"Aurora County, SD",Jul-19,1531,1499,32,2.1
15238,CN4600500000000,46,5,"Beadle County, SD",Jul-19,9832,9574,258,2.6
15239,CN4600700000000,46,7,"Bennett County, SD",Jul-19,1115,1059,56,5.0
15240,CN4600900000000,46,9,"Bon Homme County, SD",Jul-19,2940,2853,87,3.0
15241,CN4601100000000,46,11,"Brookings County, SD",Jul-19,18862,18236,626,3.3
15242,CN4601300000000,46,13,"Brown County, SD",Jul-19,20813,20233,580,2.8
15243,CN4601500000000,46,15,"Brule County, SD",Jul-19,2504,2424,80,3.2
15244,CN4601700000000,46,17,"Buffalo County, SD",Jul-19,700,642,58,8.3
15245,CN4601900000000,46,19,"Butte County, SD",Jul-19,5142,4986,156,3.0
15246,CN4602100000000,46,21,"Campbell County, SD",Jul-19,787,761,26,3.3
15247,CN4602300000000,46,23,"Charles Mix County, SD",Jul-19,3860,3717,143,3.7
15248,CN4602500000000,46,25,"Clark County, SD",Jul-19,1946,1875,71,3.6
15249,CN4602700000000,46,27,"Clay County, SD",Jul-19,6973,6741,232,3.3
15250,CN4602900000000,46,29,"Codington County, SD",Jul-19,15612,15188,424,2.7
15251,CN4603100000000,46,31,"Corson County, SD",Jul-19,1363,1253,110,8.1
15252,CN4603300000000,46,33,"Custer County, SD",Jul-19,4116,3975,141,3.4
15253,CN4603500000000,46,35,"Davison County, SD",Jul-19,11320,11034,286,2.5
15254,CN4603700000000,46,37,"Day County, SD",Jul-19,2850,2748,102,3.6
15255,CN4603900000000,46,39,"Deuel County, SD",Jul-19,2298,2216,82,3.6
15256,CN4604100000000,46,41,"Dewey County, SD",Jul-19,2379,1961,418,17.6
15257,CN4604300000000,46,43,"Douglas County, SD",Jul-19,1616,1581,35,2.2
15258,CN4604500000000,46,45,"Edmunds County, SD",Jul-19,2039,1983,56,2.7
15259,CN4604700000000,46,47,"Fall River County, SD",Jul-19,3136,3023,113,3.6
15260,CN4604900000000,46,49,"Faulk County, SD",Jul-19,1063,1031,32,3.0
15261,CN4605100000000,46,51,"Grant County, SD",Jul-19,4453,4340,113,2.5
15262,CN4605300000000,46,53,"Gregory County, SD",Jul-19,2041,1985,56,2.7
15263,CN4605500000000,46,55,"Haakon County, SD",Jul-19,1056,1030,26,2.5
15264,CN4605700000000,46,57,"Hamlin County, SD",Jul-19,3384,3293,91,2.7
15265,CN4605900000000,46,59,"Hand County, SD",Jul-19,1750,1705,45,2.6
15266,CN4606100000000,46,61,"Hanson County, SD",Jul-19,1768,1692,76,4.3
15267,CN4606300000000,46,63,"Harding County, SD",Jul-19,726,707,19,2.6
15268,CN4606500000000,46,65,"Hughes County, SD",Jul-19,10228,10001,227,2.2
15269,CN4606700000000,46,67,"Hutchinson County, SD",Jul-19,3683,3599,84,2.3
15270,CN4606900000000,46,69,"Hyde County, SD",Jul-19,668,649,19,2.8
15271,CN4607100000000,46,71,"Jackson County, SD",Jul-19,1349,1280,69,5.1
15272,CN4607300000000,46,73,"Jerauld County, SD",Jul-19,1132,1104,28,2.5
15273,CN4607500000000,46,75,"Jones County, SD",Jul-19,593,578,15,2.5
15274,CN4607700000000,46,77,"Kingsbury County, SD",Jul-19,2694,2623,71,2.6
15275,CN4607900000000,46,79,"Lake County, SD",Jul-19,6653,6415,238,3.6
15276,CN4608100000000,46,81,"Lawrence County, SD",Jul-19,13750,13365,385,2.8
15277,CN4608300000000,46,83,"Lincoln County, SD",Jul-19,35124,34360,764,2.2
15278,CN4608500000000,46,85,"Lyman County, SD",Jul-19,1795,1700,95,5.3
15279,CN4608700000000,46,87,"McCook County, SD",Jul-19,3102,3037,65,2.1
15280,CN4608900000000,46,89,"McPherson County, SD",Jul-19,988,949,39,3.9
15281,CN4609100000000,46,91,"Marshall County, SD",Jul-19,2432,2354,78,3.2
15282,CN4609300000000,46,93,"Meade County, SD",Jul-19,14705,14244,461,3.1
15283,CN4609500000000,46,95,"Mellette County, SD",Jul-19,732,682,50,6.8
15284,CN4609700000000,46,97,"Miner County, SD",Jul-19,1184,1147,37,3.1
15285,CN4609900000000,46,99,"Minnehaha County, SD",Jul-19,114826,111998,2828,2.5
15286,CN4610100000000,46,101,"Moody County, SD",Jul-19,4122,3903,219,5.3
15287,CN4610200000000,46,102,"Oglala Lakota County, SD",Jul-19,3728,3215,513,13.8
15288,CN4610300000000,46,103,"Pennington County, SD",Jul-19,59096,57340,1756,3.0
15289,CN4610500000000,46,105,"Perkins County, SD",Jul-19,1418,1379,39,2.8
15290,CN4610700000000,46,107,"Potter County, SD",Jul-19,1086,1058,28,2.6
15291,CN4610900000000,46,109,"Roberts County, SD",Jul-19,4744,4564,180,3.8
15292,CN4611100000000,46,111,"Sanborn County, SD",Jul-19,1164,1129,35,3.0
15293,CN4611500000000,46,115,"Spink County, SD",Jul-19,3225,3138,87,2.7
15294,CN4611700000000,46,117,"Stanley County, SD",Jul-19,1872,1829,43,2.3
15295,CN4611900000000,46,119,"Sully County, SD",Jul-19,805,786,19,2.4
15296,CN4612100000000,46,121,"Todd County, SD",Jul-19,3199,2935,264,8.3
15297,CN4612300000000,46,123,"Tripp County, SD",Jul-19,3164,3062,102,3.2
15298,CN4612500000000,46,125,"Turner County, SD",Jul-19,4759,4638,121,2.5
15299,CN4612700000000,46,127,"Union County, SD",Jul-19,8502,8223,279,3.3
15300,CN4612900000000,46,129,"Walworth County, SD",Jul-19,2198,2083,115,5.2
15301,CN4613500000000,46,135,"Yankton County, SD",Jul-19,12230,11942,288,2.4
15302,CN4613700000000,46,137,"Ziebach County, SD",Jul-19,923,841,82,8.9
15303,CN4700100000000,47,1,"Anderson County, TN",Jul-19,35377,33867,1510,4.3
15304,CN4700300000000,47,3,"Bedford County, TN",Jul-19,21459,20496,963,4.5
15305,CN4700500000000,47,5,"Benton County, TN",Jul-19,6890,6535,355,5.2
15306,CN4700700000000,47,7,"Bledsoe County, TN",Jul-19,4301,4037,264,6.1
15307,CN4700900000000,47,9,"Blount County, TN",Jul-19,64724,62332,2392,3.7
15308,CN4701100000000,47,11,"Bradley County, TN",Jul-19,52791,50602,2189,4.1
15309,CN4701300000000,47,13,"Campbell County, TN",Jul-19,15119,14354,765,5.1
15310,CN4701500000000,47,15,"Cannon County, TN",Jul-19,6773,6515,258,3.8
15311,CN4701700000000,47,17,"Carroll County, TN",Jul-19,12128,11433,695,5.7
15312,CN4701900000000,47,19,"Carter County, TN",Jul-19,24203,23081,1122,4.6
15313,CN4702100000000,47,21,"Cheatham County, TN",Jul-19,22443,21768,675,3.0
15314,CN4702300000000,47,23,"Chester County, TN",Jul-19,8740,8398,342,3.9
15315,CN4702500000000,47,25,"Claiborne County, TN",Jul-19,13204,12532,672,5.1
15316,CN4702700000000,47,27,"Clay County, TN",Jul-19,2731,2536,195,7.1
15317,CN4702900000000,47,29,"Cocke County, TN",Jul-19,15418,14672,746,4.8
15318,CN4703100000000,47,31,"Coffee County, TN",Jul-19,26090,25085,1005,3.9
15319,CN4703300000000,47,33,"Crockett County, TN",Jul-19,7112,6844,268,3.8
15320,CN4703500000000,47,35,"Cumberland County, TN",Jul-19,23906,22759,1147,4.8
15321,CN4703700000000,47,37,"Davidson County, TN",Jul-19,414455,402332,12123,2.9
15322,CN4703900000000,47,39,"Decatur County, TN",Jul-19,4654,4399,255,5.5
15323,CN4704100000000,47,41,"DeKalb County, TN",Jul-19,7923,7541,382,4.8
15324,CN4704300000000,47,43,"Dickson County, TN",Jul-19,27711,26760,951,3.4
15325,CN4704500000000,47,45,"Dyer County, TN",Jul-19,16580,15659,921,5.6
15326,CN4704700000000,47,47,"Fayette County, TN",Jul-19,19530,18744,786,4.0
15327,CN4704900000000,47,49,"Fentress County, TN",Jul-19,7499,7112,387,5.2
15328,CN4705100000000,47,51,"Franklin County, TN",Jul-19,20475,19681,794,3.9
15329,CN4705300000000,47,53,"Gibson County, TN",Jul-19,22333,21277,1056,4.7
15330,CN4705500000000,47,55,"Giles County, TN",Jul-19,14900,14198,702,4.7
15331,CN4705700000000,47,57,"Grainger County, TN",Jul-19,9697,9252,445,4.6
15332,CN4705900000000,47,59,"Greene County, TN",Jul-19,30186,28571,1615,5.4
15333,CN4706100000000,47,61,"Grundy County, TN",Jul-19,4909,4653,256,5.2
15334,CN4706300000000,47,63,"Hamblen County, TN",Jul-19,28401,27147,1254,4.4
15335,CN4706500000000,47,65,"Hamilton County, TN",Jul-19,187940,180798,7142,3.8
15336,CN4706700000000,47,67,"Hancock County, TN",Jul-19,2107,1954,153,7.3
15337,CN4706900000000,47,69,"Hardeman County, TN",Jul-19,9635,9143,492,5.1
15338,CN4707100000000,47,71,"Hardin County, TN",Jul-19,10637,10111,526,4.9
15339,CN4707300000000,47,73,"Hawkins County, TN",Jul-19,24118,22949,1169,4.8
15340,CN4707500000000,47,75,"Haywood County, TN",Jul-19,7654,7246,408,5.3
15341,CN4707700000000,47,77,"Henderson County, TN",Jul-19,12463,11890,573,4.6
15342,CN4707900000000,47,79,"Henry County, TN",Jul-19,14461,13820,641,4.4
15343,CN4708100000000,47,81,"Hickman County, TN",Jul-19,11736,11316,420,3.6
15344,CN4708300000000,47,83,"Houston County, TN",Jul-19,3263,3095,168,5.1
15345,CN4708500000000,47,85,"Humphreys County, TN",Jul-19,9012,8640,372,4.1
15346,CN4708700000000,47,87,"Jackson County, TN",Jul-19,4697,4449,248,5.3
15347,CN4708900000000,47,89,"Jefferson County, TN",Jul-19,24804,23757,1047,4.2
15348,CN4709100000000,47,91,"Johnson County, TN",Jul-19,7700,7402,298,3.9
15349,CN4709300000000,47,93,"Knox County, TN",Jul-19,248900,240154,8746,3.5
15350,CN4709500000000,47,95,"Lake County, TN",Jul-19,1774,1663,111,6.3
15351,CN4709700000000,47,97,"Lauderdale County, TN",Jul-19,9793,9204,589,6.0
15352,CN4709900000000,47,99,"Lawrence County, TN",Jul-19,19456,18532,924,4.7
15353,CN4710100000000,47,101,"Lewis County, TN",Jul-19,5228,5005,223,4.3
15354,CN4710300000000,47,103,"Lincoln County, TN",Jul-19,17024,16406,618,3.6
15355,CN4710500000000,47,105,"Loudon County, TN",Jul-19,23894,22944,950,4.0
15356,CN4710700000000,47,107,"McMinn County, TN",Jul-19,24531,23465,1066,4.3
15357,CN4710900000000,47,109,"McNairy County, TN",Jul-19,8567,8076,491,5.7
15358,CN4711100000000,47,111,"Macon County, TN",Jul-19,11539,11094,445,3.9
15359,CN4711300000000,47,113,"Madison County, TN",Jul-19,50164,48145,2019,4.0
15360,CN4711500000000,47,115,"Marion County, TN",Jul-19,12787,12154,633,5.0
15361,CN4711700000000,47,117,"Marshall County, TN",Jul-19,15789,15194,595,3.8
15362,CN4711900000000,47,119,"Maury County, TN",Jul-19,50492,48882,1610,3.2
15363,CN4712100000000,47,121,"Meigs County, TN",Jul-19,5241,4964,277,5.3
15364,CN4712300000000,47,123,"Monroe County, TN",Jul-19,20510,19608,902,4.4
15365,CN4712500000000,47,125,"Montgomery County, TN",Jul-19,87190,83275,3915,4.5
15366,CN4712700000000,47,127,"Moore County, TN",Jul-19,3595,3468,127,3.5
15367,CN4712900000000,47,129,"Morgan County, TN",Jul-19,8031,7649,382,4.8
15368,CN4713100000000,47,131,"Obion County, TN",Jul-19,12657,11956,701,5.5
15369,CN4713300000000,47,133,"Overton County, TN",Jul-19,9979,9527,452,4.5
15370,CN4713500000000,47,135,"Perry County, TN",Jul-19,3072,2919,153,5.0
15371,CN4713700000000,47,137,"Pickett County, TN",Jul-19,2446,2324,122,5.0
15372,CN4713900000000,47,139,"Polk County, TN",Jul-19,7641,7263,378,4.9
15373,CN4714100000000,47,141,"Putnam County, TN",Jul-19,35240,33767,1473,4.2
15374,CN4714300000000,47,143,"Rhea County, TN",Jul-19,13324,12484,840,6.3
15375,CN4714500000000,47,145,"Roane County, TN",Jul-19,23871,22743,1128,4.7
15376,CN4714700000000,47,147,"Robertson County, TN",Jul-19,38907,37614,1293,3.3
15377,CN4714900000000,47,149,"Rutherford County, TN",Jul-19,188832,183080,5752,3.0
15378,CN4715100000000,47,151,"Scott County, TN",Jul-19,8523,8102,421,4.9
15379,CN4715300000000,47,153,"Sequatchie County, TN",Jul-19,6356,6035,321,5.1
15380,CN4715500000000,47,155,"Sevier County, TN",Jul-19,57888,56155,1733,3.0
15381,CN4715700000000,47,157,"Shelby County, TN",Jul-19,455900,435012,20888,4.6
15382,CN4715900000000,47,159,"Smith County, TN",Jul-19,9691,9352,339,3.5
15383,CN4716100000000,47,161,"Stewart County, TN",Jul-19,5561,5282,279,5.0
15384,CN4716300000000,47,163,"Sullivan County, TN",Jul-19,71376,68253,3123,4.4
15385,CN4716500000000,47,165,"Sumner County, TN",Jul-19,104983,101747,3236,3.1
15386,CN4716700000000,47,167,"Tipton County, TN",Jul-19,28785,27519,1266,4.4
15387,CN4716900000000,47,169,"Trousdale County, TN",Jul-19,5565,5364,201,3.6
15388,CN4717100000000,47,171,"Unicoi County, TN",Jul-19,7123,6735,388,5.4
15389,CN4717300000000,47,173,"Union County, TN",Jul-19,7818,7427,391,5.0
15390,CN4717500000000,47,175,"Van Buren County, TN",Jul-19,2072,1962,110,5.3
15391,CN4717700000000,47,177,"Warren County, TN",Jul-19,17130,16289,841,4.9
15392,CN4717900000000,47,179,"Washington County, TN",Jul-19,60790,58333,2457,4.0
15393,CN4718100000000,47,181,"Wayne County, TN",Jul-19,6267,5959,308,4.9
15394,CN4718300000000,47,183,"Weakley County, TN",Jul-19,15982,15013,969,6.1
15395,CN4718500000000,47,185,"White County, TN",Jul-19,12312,11757,555,4.5
15396,CN4718700000000,47,187,"Williamson County, TN",Jul-19,131763,127968,3795,2.9
15397,CN4718900000000,47,189,"Wilson County, TN",Jul-19,78557,76101,2456,3.1
15398,CN4800100000000,48,1,"Anderson County, TX",Jul-19,24070,23310,760,3.2
15399,CN4800300000000,48,3,"Andrews County, TX",Jul-19,9912,9666,246,2.5
15400,CN4800500000000,48,5,"Angelina County, TX",Jul-19,35800,34240,1560,4.4
15401,CN4800700000000,48,7,"Aransas County, TX",Jul-19,9427,8992,435,4.6
15402,CN4800900000000,48,9,"Archer County, TX",Jul-19,4148,4019,129,3.1
15403,CN4801100000000,48,11,"Armstrong County, TX",Jul-19,926,900,26,2.8
15404,CN4801300000000,48,13,"Atascosa County, TX",Jul-19,21757,20906,851,3.9
15405,CN4801500000000,48,15,"Austin County, TX",Jul-19,14122,13583,539,3.8
15406,CN4801700000000,48,17,"Bailey County, TX",Jul-19,2523,2412,111,4.4
15407,CN4801900000000,48,19,"Bandera County, TX",Jul-19,10078,9728,350,3.5
15408,CN4802100000000,48,21,"Bastrop County, TX",Jul-19,43111,41601,1510,3.5
15409,CN4802300000000,48,23,"Baylor County, TX",Jul-19,1788,1745,43,2.4
15410,CN4802500000000,48,25,"Bee County, TX",Jul-19,9740,9273,467,4.8
15411,CN4802700000000,48,27,"Bell County, TX",Jul-19,143926,137945,5981,4.2
15412,CN4802900000000,48,29,"Bexar County, TX",Jul-19,952247,919342,32905,3.5
15413,CN4803100000000,48,31,"Blanco County, TX",Jul-19,6515,6335,180,2.8
15414,CN4803300000000,48,33,"Borden County, TX",Jul-19,440,429,11,2.5
15415,CN4803500000000,48,35,"Bosque County, TX",Jul-19,8424,8115,309,3.7
15416,CN4803700000000,48,37,"Bowie County, TX",Jul-19,39503,37559,1944,4.9
15417,CN4803900000000,48,39,"Brazoria County, TX",Jul-19,180092,171749,8343,4.6
15418,CN4804100000000,48,41,"Brazos County, TX",Jul-19,114926,111278,3648,3.2
15419,CN4804300000000,48,43,"Brewster County, TX",Jul-19,4184,4040,144,3.4
15420,CN4804500000000,48,45,"Briscoe County, TX",Jul-19,567,546,21,3.7
15421,CN4804700000000,48,47,"Brooks County, TX",Jul-19,2616,2442,174,6.7
15422,CN4804900000000,48,49,"Brown County, TX",Jul-19,15659,14996,663,4.2
15423,CN4805100000000,48,51,"Burleson County, TX",Jul-19,8071,7797,274,3.4
15424,CN4805300000000,48,53,"Burnet County, TX",Jul-19,23891,23171,720,3.0
15425,CN4805500000000,48,55,"Caldwell County, TX",Jul-19,19768,19008,760,3.8
15426,CN4805700000000,48,57,"Calhoun County, TX",Jul-19,12234,11795,439,3.6
15427,CN4805900000000,48,59,"Callahan County, TX",Jul-19,6116,5904,212,3.5
15428,CN4806100000000,48,61,"Cameron County, TX",Jul-19,167732,157789,9943,5.9
15429,CN4806300000000,48,63,"Camp County, TX",Jul-19,5011,4773,238,4.7
15430,CN4806500000000,48,65,"Carson County, TX",Jul-19,3005,2922,83,2.8
15431,CN4806700000000,48,67,"Cass County, TX",Jul-19,12464,11885,579,4.6
15432,CN4806900000000,48,69,"Castro County, TX",Jul-19,3372,3267,105,3.1
15433,CN4807100000000,48,71,"Chambers County, TX",Jul-19,19572,18575,997,5.1
15434,CN4807300000000,48,73,"Cherokee County, TX",Jul-19,20938,20103,835,4.0
15435,CN4807500000000,48,75,"Childress County, TX",Jul-19,3021,2935,86,2.8
15436,CN4807700000000,48,77,"Clay County, TX",Jul-19,4951,4775,176,3.6
15437,CN4807900000000,48,79,"Cochran County, TX",Jul-19,1127,1079,48,4.3
15438,CN4808100000000,48,81,"Coke County, TX",Jul-19,1473,1420,53,3.6
15439,CN4808300000000,48,83,"Coleman County, TX",Jul-19,2893,2767,126,4.4
15440,CN4808500000000,48,85,"Collin County, TX",Jul-19,566346,547316,19030,3.4
15441,CN4808700000000,48,87,"Collingsworth County, TX",Jul-19,1161,1122,39,3.4
15442,CN4808900000000,48,89,"Colorado County, TX",Jul-19,10069,9741,328,3.3
15443,CN4809100000000,48,91,"Comal County, TX",Jul-19,73493,71080,2413,3.3
15444,CN4809300000000,48,93,"Comanche County, TX",Jul-19,5587,5392,195,3.5
15445,CN4809500000000,48,95,"Concho County, TX",Jul-19,1283,1236,47,3.7
15446,CN4809700000000,48,97,"Cooke County, TX",Jul-19,19996,19387,609,3.0
15447,CN4809900000000,48,99,"Coryell County, TX",Jul-19,24148,23100,1048,4.3
15448,CN4810100000000,48,101,"Cottle County, TX",Jul-19,542,521,21,3.9
15449,CN4810300000000,48,103,"Crane County, TX",Jul-19,1588,1517,71,4.5
15450,CN4810500000000,48,105,"Crockett County, TX",Jul-19,1650,1602,48,2.9
15451,CN4810700000000,48,107,"Crosby County, TX",Jul-19,2511,2389,122,4.9
15452,CN4810900000000,48,109,"Culberson County, TX",Jul-19,1086,1033,53,4.9
15453,CN4811100000000,48,111,"Dallam County, TX",Jul-19,3972,3885,87,2.2
15454,CN4811300000000,48,113,"Dallas County, TX",Jul-19,1371036,1319740,51296,3.7
15455,CN4811500000000,48,115,"Dawson County, TX",Jul-19,4627,4432,195,4.2
15456,CN4811700000000,48,117,"Deaf Smith County, TX",Jul-19,8496,8220,276,3.2
15457,CN4811900000000,48,119,"Delta County, TX",Jul-19,2419,2332,87,3.6
15458,CN4812100000000,48,121,"Denton County, TX",Jul-19,497065,480939,16126,3.2
15459,CN4812300000000,48,123,"DeWitt County, TX",Jul-19,9860,9584,276,2.8
15460,CN4812500000000,48,125,"Dickens County, TX",Jul-19,691,661,30,4.3
15461,CN4812700000000,48,127,"Dimmit County, TX",Jul-19,8012,7788,224,2.8
15462,CN4812900000000,48,129,"Donley County, TX",Jul-19,1401,1343,58,4.1
15463,CN4813100000000,48,131,"Duval County, TX",Jul-19,4948,4708,240,4.9
15464,CN4813300000000,48,133,"Eastland County, TX",Jul-19,8176,7871,305,3.7
15465,CN4813500000000,48,135,"Ector County, TX",Jul-19,88454,85933,2521,2.9
15466,CN4813700000000,48,137,"Edwards County, TX",Jul-19,1075,1050,25,2.3
15467,CN4813900000000,48,139,"Ellis County, TX",Jul-19,93193,89969,3224,3.5
15468,CN4814100000000,48,141,"El Paso County, TX",Jul-19,360254,345434,14820,4.1
15469,CN4814300000000,48,143,"Erath County, TX",Jul-19,20027,19270,757,3.8
15470,CN4814500000000,48,145,"Falls County, TX",Jul-19,6611,6376,235,3.6
15471,CN4814700000000,48,147,"Fannin County, TX",Jul-19,17482,16963,519,3.0
15472,CN4814900000000,48,149,"Fayette County, TX",Jul-19,12219,11851,368,3.0
15473,CN4815100000000,48,151,"Fisher County, TX",Jul-19,1655,1595,60,3.6
15474,CN4815300000000,48,153,"Floyd County, TX",Jul-19,2605,2482,123,4.7
15475,CN4815500000000,48,155,"Foard County, TX",Jul-19,601,582,19,3.2
15476,CN4815700000000,48,157,"Fort Bend County, TX",Jul-19,392806,378023,14783,3.8
15477,CN4815900000000,48,159,"Franklin County, TX",Jul-19,4725,4537,188,4.0
15478,CN4816100000000,48,161,"Freestone County, TX",Jul-19,6440,6106,334,5.2
15479,CN4816300000000,48,163,"Frio County, TX",Jul-19,10523,10202,321,3.1
15480,CN4816500000000,48,165,"Gaines County, TX",Jul-19,9821,9555,266,2.7
15481,CN4816700000000,48,167,"Galveston County, TX",Jul-19,165810,158539,7271,4.4
15482,CN4816900000000,48,169,"Garza County, TX",Jul-19,2191,2129,62,2.8
15483,CN4817100000000,48,171,"Gillespie County, TX",Jul-19,13699,13343,356,2.6
15484,CN4817300000000,48,173,"Glasscock County, TX",Jul-19,796,777,19,2.4
15485,CN4817500000000,48,175,"Goliad County, TX",Jul-19,3265,3147,118,3.6
15486,CN4817700000000,48,177,"Gonzales County, TX",Jul-19,9549,9265,284,3.0
15487,CN4817900000000,48,179,"Gray County, TX",Jul-19,8166,7855,311,3.8
15488,CN4818100000000,48,181,"Grayson County, TX",Jul-19,64573,62456,2117,3.3
15489,CN4818300000000,48,183,"Gregg County, TX",Jul-19,58408,56034,2374,4.1
15490,CN4818500000000,48,185,"Grimes County, TX",Jul-19,11121,10613,508,4.6
15491,CN4818700000000,48,187,"Guadalupe County, TX",Jul-19,81730,79061,2669,3.3
15492,CN4818900000000,48,189,"Hale County, TX",Jul-19,12122,11462,660,5.4
15493,CN4819100000000,48,191,"Hall County, TX",Jul-19,1067,1023,44,4.1
15494,CN4819300000000,48,193,"Hamilton County, TX",Jul-19,3705,3582,123,3.3
15495,CN4819500000000,48,195,"Hansford County, TX",Jul-19,2782,2713,69,2.5
15496,CN4819700000000,48,197,"Hardeman County, TX",Jul-19,1735,1678,57,3.3
15497,CN4819900000000,48,199,"Hardin County, TX",Jul-19,25148,23844,1304,5.2
15498,CN4820100000000,48,201,"Harris County, TX",Jul-19,2320496,2224686,95810,4.1
15499,CN4820300000000,48,203,"Harrison County, TX",Jul-19,29332,28079,1253,4.3
15500,CN4820500000000,48,205,"Hartley County, TX",Jul-19,2824,2774,50,1.8
15501,CN4820700000000,48,207,"Haskell County, TX",Jul-19,2270,2191,79,3.5
15502,CN4820900000000,48,209,"Hays County, TX",Jul-19,120192,116580,3612,3.0
15503,CN4821100000000,48,211,"Hemphill County, TX",Jul-19,1962,1904,58,3.0
15504,CN4821300000000,48,213,"Henderson County, TX",Jul-19,36612,35183,1429,3.9
15505,CN4821500000000,48,215,"Hidalgo County, TX",Jul-19,348112,324042,24070,6.9
15506,CN4821700000000,48,217,"Hill County, TX",Jul-19,16460,15851,609,3.7
15507,CN4821900000000,48,219,"Hockley County, TX",Jul-19,11240,10865,375,3.3
15508,CN4822100000000,48,221,"Hood County, TX",Jul-19,27609,26580,1029,3.7
15509,CN4822300000000,48,223,"Hopkins County, TX",Jul-19,17551,16976,575,3.3
15510,CN4822500000000,48,225,"Houston County, TX",Jul-19,10627,10256,371,3.5
15511,CN4822700000000,48,227,"Howard County, TX",Jul-19,14079,13589,490,3.5
15512,CN4822900000000,48,229,"Hudspeth County, TX",Jul-19,1819,1730,89,4.9
15513,CN4823100000000,48,231,"Hunt County, TX",Jul-19,43634,41935,1699,3.9
15514,CN4823300000000,48,233,"Hutchinson County, TX",Jul-19,8866,8426,440,5.0
15515,CN4823500000000,48,235,"Irion County, TX",Jul-19,754,732,22,2.9
15516,CN4823700000000,48,237,"Jack County, TX",Jul-19,3534,3420,114,3.2
15517,CN4823900000000,48,239,"Jackson County, TX",Jul-19,7698,7435,263,3.4
15518,CN4824100000000,48,241,"Jasper County, TX",Jul-19,12845,11982,863,6.7
15519,CN4824300000000,48,243,"Jeff Davis County, TX",Jul-19,1080,1047,33,3.1
15520,CN4824500000000,48,245,"Jefferson County, TX",Jul-19,106477,99433,7044,6.6
15521,CN4824700000000,48,247,"Jim Hogg County, TX",Jul-19,1857,1764,93,5.0
15522,CN4824900000000,48,249,"Jim Wells County, TX",Jul-19,16818,15954,864,5.1
15523,CN4825100000000,48,251,"Johnson County, TX",Jul-19,82360,79449,2911,3.5
15524,CN4825300000000,48,253,"Jones County, TX",Jul-19,5749,5476,273,4.7
15525,CN4825500000000,48,255,"Karnes County, TX",Jul-19,7228,7029,199,2.8
15526,CN4825700000000,48,257,"Kaufman County, TX",Jul-19,64944,62608,2336,3.6
15527,CN4825900000000,48,259,"Kendall County, TX",Jul-19,22169,21499,670,3.0
15528,CN4826100000000,48,261,"Kenedy County, TX",Jul-19,207,196,11,5.3
15529,CN4826300000000,48,263,"Kent County, TX",Jul-19,490,480,10,2.0
15530,CN4826500000000,48,265,"Kerr County, TX",Jul-19,22705,21984,721,3.2
15531,CN4826700000000,48,267,"Kimble County, TX",Jul-19,1936,1871,65,3.4
15532,CN4826900000000,48,269,"King County, TX",Jul-19,237,231,6,2.5
15533,CN4827100000000,48,271,"Kinney County, TX",Jul-19,1384,1333,51,3.7
15534,CN4827300000000,48,273,"Kleberg County, TX",Jul-19,13138,12486,652,5.0
15535,CN4827500000000,48,275,"Knox County, TX",Jul-19,1441,1391,50,3.5
15536,CN4827700000000,48,277,"Lamar County, TX",Jul-19,23980,23124,856,3.6
15537,CN4827900000000,48,279,"Lamb County, TX",Jul-19,5288,5073,215,4.1
15538,CN4828100000000,48,281,"Lampasas County, TX",Jul-19,9207,8876,331,3.6
15539,CN4828300000000,48,283,"La Salle County, TX",Jul-19,4529,4421,108,2.4
15540,CN4828500000000,48,285,"Lavaca County, TX",Jul-19,8680,8398,282,3.2
15541,CN4828700000000,48,287,"Lee County, TX",Jul-19,10065,9770,295,2.9
15542,CN4828900000000,48,289,"Leon County, TX",Jul-19,6379,6074,305,4.8
15543,CN4829100000000,48,291,"Liberty County, TX",Jul-19,33217,31374,1843,5.5
15544,CN4829300000000,48,293,"Limestone County, TX",Jul-19,8588,8232,356,4.1
15545,CN4829500000000,48,295,"Lipscomb County, TX",Jul-19,1613,1562,51,3.2
15546,CN4829700000000,48,297,"Live Oak County, TX",Jul-19,5698,5508,190,3.3
15547,CN4829900000000,48,299,"Llano County, TX",Jul-19,8936,8608,328,3.7
15548,CN4830100000000,48,301,"Loving County, TX",Jul-19,590,586,4,0.7
15549,CN4830300000000,48,303,"Lubbock County, TX",Jul-19,158287,152951,5336,3.4
15550,CN4830500000000,48,305,"Lynn County, TX",Jul-19,2766,2677,89,3.2
15551,CN4830700000000,48,307,"McCulloch County, TX",Jul-19,3415,3207,208,6.1
15552,CN4830900000000,48,309,"McLennan County, TX",Jul-19,120620,116079,4541,3.8
15553,CN4831100000000,48,311,"McMullen County, TX",Jul-19,850,836,14,1.6
15554,CN4831300000000,48,313,"Madison County, TX",Jul-19,4482,4247,235,5.2
15555,CN4831500000000,48,315,"Marion County, TX",Jul-19,4249,4068,181,4.3
15556,CN4831700000000,48,317,"Martin County, TX",Jul-19,2914,2835,79,2.7
15557,CN4831900000000,48,319,"Mason County, TX",Jul-19,1772,1706,66,3.7
15558,CN4832100000000,48,321,"Matagorda County, TX",Jul-19,16694,15643,1051,6.3
15559,CN4832300000000,48,323,"Maverick County, TX",Jul-19,22865,21083,1782,7.8
15560,CN4832500000000,48,325,"Medina County, TX",Jul-19,21872,21124,748,3.4
15561,CN4832700000000,48,327,"Menard County, TX",Jul-19,869,836,33,3.8
15562,CN4832900000000,48,329,"Midland County, TX",Jul-19,108676,106270,2406,2.2
15563,CN4833100000000,48,331,"Milam County, TX",Jul-19,9779,9271,508,5.2
15564,CN4833300000000,48,333,"Mills County, TX",Jul-19,1927,1861,66,3.4
15565,CN4833500000000,48,335,"Mitchell County, TX",Jul-19,2317,2227,90,3.9
15566,CN4833700000000,48,337,"Montague County, TX",Jul-19,9404,9122,282,3.0
15567,CN4833900000000,48,339,"Montgomery County, TX",Jul-19,284446,273898,10548,3.7
15568,CN4834100000000,48,341,"Moore County, TX",Jul-19,10983,10698,285,2.6
15569,CN4834300000000,48,343,"Morris County, TX",Jul-19,4861,4583,278,5.7
15570,CN4834500000000,48,345,"Motley County, TX",Jul-19,493,475,18,3.7
15571,CN4834700000000,48,347,"Nacogdoches County, TX",Jul-19,28074,26829,1245,4.4
15572,CN4834900000000,48,349,"Navarro County, TX",Jul-19,24151,23324,827,3.4
15573,CN4835100000000,48,351,"Newton County, TX",Jul-19,5169,4795,374,7.2
15574,CN4835300000000,48,353,"Nolan County, TX",Jul-19,7191,6965,226,3.1
15575,CN4835500000000,48,355,"Nueces County, TX",Jul-19,167471,160113,7358,4.4
15576,CN4835700000000,48,357,"Ochiltree County, TX",Jul-19,4317,4190,127,2.9
15577,CN4835900000000,48,359,"Oldham County, TX",Jul-19,916,886,30,3.3
15578,CN4836100000000,48,361,"Orange County, TX",Jul-19,36175,34071,2104,5.8
15579,CN4836300000000,48,363,"Palo Pinto County, TX",Jul-19,13712,13236,476,3.5
15580,CN4836500000000,48,365,"Panola County, TX",Jul-19,10080,9626,454,4.5
15581,CN4836700000000,48,367,"Parker County, TX",Jul-19,67428,65289,2139,3.2
15582,CN4836900000000,48,369,"Parmer County, TX",Jul-19,4911,4789,122,2.5
15583,CN4837100000000,48,371,"Pecos County, TX",Jul-19,6441,6215,226,3.5
15584,CN4837300000000,48,373,"Polk County, TX",Jul-19,18070,17129,941,5.2
15585,CN4837500000000,48,375,"Potter County, TX",Jul-19,55230,53495,1735,3.1
15586,CN4837700000000,48,377,"Presidio County, TX",Jul-19,3120,2907,213,6.8
15587,CN4837900000000,48,379,"Rains County, TX",Jul-19,5988,5793,195,3.3
15588,CN4838100000000,48,381,"Randall County, TX",Jul-19,72062,70111,1951,2.7
15589,CN4838300000000,48,383,"Reagan County, TX",Jul-19,1936,1885,51,2.6
15590,CN4838500000000,48,385,"Real County, TX",Jul-19,1171,1125,46,3.9
15591,CN4838700000000,48,387,"Red River County, TX",Jul-19,5099,4850,249,4.9
15592,CN4838900000000,48,389,"Reeves County, TX",Jul-19,11215,11000,215,1.9
15593,CN4839100000000,48,391,"Refugio County, TX",Jul-19,3144,3019,125,4.0
15594,CN4839300000000,48,393,"Roberts County, TX",Jul-19,428,413,15,3.5
15595,CN4839500000000,48,395,"Robertson County, TX",Jul-19,7396,7107,289,3.9
15596,CN4839700000000,48,397,"Rockwall County, TX",Jul-19,52299,50563,1736,3.3
15597,CN4839900000000,48,399,"Runnels County, TX",Jul-19,4638,4502,136,2.9
15598,CN4840100000000,48,401,"Rusk County, TX",Jul-19,23085,22187,898,3.9
15599,CN4840300000000,48,403,"Sabine County, TX",Jul-19,3847,3567,280,7.3
15600,CN4840500000000,48,405,"San Augustine County, TX",Jul-19,3339,3171,168,5.0
15601,CN4840700000000,48,407,"San Jacinto County, TX",Jul-19,11697,11122,575,4.9
15602,CN4840900000000,48,409,"San Patricio County, TX",Jul-19,29951,28208,1743,5.8
15603,CN4841100000000,48,411,"San Saba County, TX",Jul-19,2497,2419,78,3.1
15604,CN4841300000000,48,413,"Schleicher County, TX",Jul-19,1292,1246,46,3.6
15605,CN4841500000000,48,415,"Scurry County, TX",Jul-19,6805,6542,263,3.9
15606,CN4841700000000,48,417,"Shackelford County, TX",Jul-19,1940,1896,44,2.3
15607,CN4841900000000,48,419,"Shelby County, TX",Jul-19,11266,10773,493,4.4
15608,CN4842100000000,48,421,"Sherman County, TX",Jul-19,1369,1332,37,2.7
15609,CN4842300000000,48,423,"Smith County, TX",Jul-19,107191,103276,3915,3.7
15610,CN4842500000000,48,425,"Somervell County, TX",Jul-19,4366,4204,162,3.7
15611,CN4842700000000,48,427,"Starr County, TX",Jul-19,24693,22011,2682,10.9
15612,CN4842900000000,48,429,"Stephens County, TX",Jul-19,4089,3955,134,3.3
15613,CN4843100000000,48,431,"Sterling County, TX",Jul-19,572,554,18,3.1
15614,CN4843300000000,48,433,"Stonewall County, TX",Jul-19,614,595,19,3.1
15615,CN4843500000000,48,435,"Sutton County, TX",Jul-19,1327,1273,54,4.1
15616,CN4843700000000,48,437,"Swisher County, TX",Jul-19,2611,2510,101,3.9
15617,CN4843900000000,48,439,"Tarrant County, TX",Jul-19,1084792,1045899,38893,3.6
15618,CN4844100000000,48,441,"Taylor County, TX",Jul-19,66961,64825,2136,3.2
15619,CN4844300000000,48,443,"Terrell County, TX",Jul-19,369,357,12,3.3
15620,CN4844500000000,48,445,"Terry County, TX",Jul-19,4982,4783,199,4.0
15621,CN4844700000000,48,447,"Throckmorton County, TX",Jul-19,660,631,29,4.4
15622,CN4844900000000,48,449,"Titus County, TX",Jul-19,13043,12435,608,4.7
15623,CN4845100000000,48,451,"Tom Green County, TX",Jul-19,54076,52228,1848,3.4
15624,CN4845300000000,48,453,"Travis County, TX",Jul-19,742943,721984,20959,2.8
15625,CN4845500000000,48,455,"Trinity County, TX",Jul-19,5318,5058,260,4.9
15626,CN4845700000000,48,457,"Tyler County, TX",Jul-19,7209,6758,451,6.3
15627,CN4845900000000,48,459,"Upshur County, TX",Jul-19,17915,17203,712,4.0
15628,CN4846100000000,48,461,"Upton County, TX",Jul-19,1712,1659,53,3.1
15629,CN4846300000000,48,463,"Uvalde County, TX",Jul-19,11675,11189,486,4.2
15630,CN4846500000000,48,465,"Val Verde County, TX",Jul-19,22930,22127,803,3.5
15631,CN4846700000000,48,467,"Van Zandt County, TX",Jul-19,26315,25379,936,3.6
15632,CN4846900000000,48,469,"Victoria County, TX",Jul-19,42772,41194,1578,3.7
15633,CN4847100000000,48,471,"Walker County, TX",Jul-19,23848,22763,1085,4.5
15634,CN4847300000000,48,473,"Waller County, TX",Jul-19,23540,22554,986,4.2
15635,CN4847500000000,48,475,"Ward County, TX",Jul-19,7500,7309,191,2.5
15636,CN4847700000000,48,477,"Washington County, TX",Jul-19,15317,14726,591,3.9
15637,CN4847900000000,48,479,"Webb County, TX",Jul-19,118394,113600,4794,4.0
15638,CN4848100000000,48,481,"Wharton County, TX",Jul-19,21797,20969,828,3.8
15639,CN4848300000000,48,483,"Wheeler County, TX",Jul-19,2360,2285,75,3.2
15640,CN4848500000000,48,485,"Wichita County, TX",Jul-19,56523,54488,2035,3.6
15641,CN4848700000000,48,487,"Wilbarger County, TX",Jul-19,4989,4785,204,4.1
15642,CN4848900000000,48,489,"Willacy County, TX",Jul-19,6506,5879,627,9.6
15643,CN4849100000000,48,491,"Williamson County, TX",Jul-19,314705,305213,9492,3.0
15644,CN4849300000000,48,493,"Wilson County, TX",Jul-19,24940,24155,785,3.1
15645,CN4849500000000,48,495,"Winkler County, TX",Jul-19,4034,3912,122,3.0
15646,CN4849700000000,48,497,"Wise County, TX",Jul-19,32032,30822,1210,3.8
15647,CN4849900000000,48,499,"Wood County, TX",Jul-19,17715,16985,730,4.1
15648,CN4850100000000,48,501,"Yoakum County, TX",Jul-19,3745,3629,116,3.1
15649,CN4850300000000,48,503,"Young County, TX",Jul-19,8080,7813,267,3.3
15650,CN4850500000000,48,505,"Zapata County, TX",Jul-19,4855,4560,295,6.1
15651,CN4850700000000,48,507,"Zavala County, TX",Jul-19,3318,2995,323,9.7
15652,CN4900100000000,49,1,"Beaver County, UT",Jul-19,2725,2635,90,3.3
15653,CN4900300000000,49,3,"Box Elder County, UT",Jul-19,26139,25444,695,2.7
15654,CN4900500000000,49,5,"Cache County, UT",Jul-19,61246,59747,1499,2.4
15655,CN4900700000000,49,7,"Carbon County, UT",Jul-19,8487,8165,322,3.8
15656,CN4900900000000,49,9,"Daggett County, UT",Jul-19,442,430,12,2.7
15657,CN4901100000000,49,11,"Davis County, UT",Jul-19,176599,172176,4423,2.5
15658,CN4901300000000,49,13,"Duchesne County, UT",Jul-19,7781,7463,318,4.1
15659,CN4901500000000,49,15,"Emery County, UT",Jul-19,4284,4119,165,3.9
15660,CN4901700000000,49,17,"Garfield County, UT",Jul-19,3171,3063,108,3.4
15661,CN4901900000000,49,19,"Grand County, UT",Jul-19,6834,6674,160,2.3
15662,CN4902100000000,49,21,"Iron County, UT",Jul-19,23500,22747,753,3.2
15663,CN4902300000000,49,23,"Juab County, UT",Jul-19,5661,5513,148,2.6
15664,CN4902500000000,49,25,"Kane County, UT",Jul-19,4201,4101,100,2.4
15665,CN4902700000000,49,27,"Millard County, UT",Jul-19,6017,5850,167,2.8
15666,CN4902900000000,49,29,"Morgan County, UT",Jul-19,5649,5501,148,2.6
15667,CN4903100000000,49,31,"Piute County, UT",Jul-19,471,451,20,4.2
15668,CN4903300000000,49,33,"Rich County, UT",Jul-19,1562,1530,32,2.0
15669,CN4903500000000,49,35,"Salt Lake County, UT",Jul-19,642182,625576,16606,2.6
15670,CN4903700000000,49,37,"San Juan County, UT",Jul-19,5773,5503,270,4.7
15671,CN4903900000000,49,39,"Sanpete County, UT",Jul-19,12151,11714,437,3.6
15672,CN4904100000000,49,41,"Sevier County, UT",Jul-19,9761,9448,313,3.2
15673,CN4904300000000,49,43,"Summit County, UT",Jul-19,24963,24367,596,2.4
15674,CN4904500000000,49,45,"Tooele County, UT",Jul-19,34418,33358,1060,3.1
15675,CN4904700000000,49,47,"Uintah County, UT",Jul-19,13903,13310,593,4.3
15676,CN4904900000000,49,49,"Utah County, UT",Jul-19,305084,297162,7922,2.6
15677,CN4905100000000,49,51,"Wasatch County, UT",Jul-19,16493,16050,443,2.7
15678,CN4905300000000,49,53,"Washington County, UT",Jul-19,76101,73700,2401,3.2
15679,CN4905500000000,49,55,"Wayne County, UT",Jul-19,1500,1448,52,3.5
15680,CN4905700000000,49,57,"Weber County, UT",Jul-19,129321,125539,3782,2.9
15681,CN5000100000000,50,1,"Addison County, VT",Jul-19,21189,20700,489,2.3
15682,CN5000300000000,50,3,"Bennington County, VT",Jul-19,18365,17839,526,2.9
15683,CN5000500000000,50,5,"Caledonia County, VT",Jul-19,14809,14396,413,2.8
15684,CN5000700000000,50,7,"Chittenden County, VT",Jul-19,97751,95840,1911,2.0
15685,CN5000900000000,50,9,"Essex County, VT",Jul-19,2745,2661,84,3.1
15686,CN5001100000000,50,11,"Franklin County, VT",Jul-19,27573,26882,691,2.5
15687,CN5001300000000,50,13,"Grand Isle County, VT",Jul-19,4070,3972,98,2.4
15688,CN5001500000000,50,15,"Lamoille County, VT",Jul-19,14067,13706,361,2.6
15689,CN5001700000000,50,17,"Orange County, VT",Jul-19,16207,15853,354,2.2
15690,CN5001900000000,50,19,"Orleans County, VT",Jul-19,13212,12735,477,3.6
15691,CN5002100000000,50,21,"Rutland County, VT",Jul-19,31052,30160,892,2.9
15692,CN5002300000000,50,23,"Washington County, VT",Jul-19,34476,33753,723,2.1
15693,CN5002500000000,50,25,"Windham County, VT",Jul-19,22144,21584,560,2.5
15694,CN5002700000000,50,27,"Windsor County, VT",Jul-19,29049,28418,631,2.2
15695,CN5100100000000,51,1,"Accomack County, VA",Jul-19,17272,16711,561,3.2
15696,CN5100300000000,51,3,"Albemarle County, VA",Jul-19,57765,56162,1603,2.8
15697,CN5100500000000,51,5,"Alleghany County, VA",Jul-19,6798,6553,245,3.6
15698,CN5100700000000,51,7,"Amelia County, VA",Jul-19,6432,6215,217,3.4
15699,CN5100900000000,51,9,"Amherst County, VA",Jul-19,15201,14642,559,3.7
15700,CN5101100000000,51,11,"Appomattox County, VA",Jul-19,7233,6964,269,3.7
15701,CN5101300000000,51,13,"Arlington County, VA",Jul-19,158146,155069,3077,1.9
15702,CN5101500000000,51,15,"Augusta County, VA",Jul-19,37924,36970,954,2.5
15703,CN5101700000000,51,17,"Bath County, VA",Jul-19,2611,2553,58,2.2
15704,CN5101900000000,51,19,"Bedford County, VA",Jul-19,38758,37587,1171,3.0
15705,CN5102100000000,51,21,"Bland County, VA",Jul-19,2832,2745,87,3.1
15706,CN5102300000000,51,23,"Botetourt County, VA",Jul-19,17613,17159,454,2.6
15707,CN5102500000000,51,25,"Brunswick County, VA",Jul-19,6120,5833,287,4.7
15708,CN5102700000000,51,27,"Buchanan County, VA",Jul-19,6780,6327,453,6.7
15709,CN5102900000000,51,29,"Buckingham County, VA",Jul-19,6493,6208,285,4.4
15710,CN5103100000000,51,31,"Campbell County, VA",Jul-19,26208,25314,894,3.4
15711,CN5103300000000,51,33,"Caroline County, VA",Jul-19,15569,15041,528,3.4
15712,CN5103500000000,51,35,"Carroll County, VA",Jul-19,13291,12838,453,3.4
15713,CN5103600000000,51,36,"Charles City County, VA",Jul-19,3745,3616,129,3.4
15714,CN5103700000000,51,37,"Charlotte County, VA",Jul-19,5323,5112,211,4.0
15715,CN5104100000000,51,41,"Chesterfield County, VA",Jul-19,191298,185623,5675,3.0
15716,CN5104300000000,51,43,"Clarke County, VA",Jul-19,7825,7627,198,2.5
15717,CN5104500000000,51,45,"Craig County, VA",Jul-19,2337,2255,82,3.5
15718,CN5104700000000,51,47,"Culpeper County, VA",Jul-19,25291,24616,675,2.7
15719,CN5104900000000,51,49,"Cumberland County, VA",Jul-19,4722,4569,153,3.2
15720,CN5105100000000,51,51,"Dickenson County, VA",Jul-19,4714,4464,250,5.3
15721,CN5105300000000,51,53,"Dinwiddie County, VA",Jul-19,13969,13492,477,3.4
15722,CN5105700000000,51,57,"Essex County, VA",Jul-19,5571,5383,188,3.4
15723,CN5105900000000,51,59,"Fairfax County, VA",Jul-19,651558,635931,15627,2.4
15724,CN5106100000000,51,61,"Fauquier County, VA",Jul-19,38329,37351,978,2.6
15725,CN5106300000000,51,63,"Floyd County, VA",Jul-19,8148,7940,208,2.6
15726,CN5106500000000,51,65,"Fluvanna County, VA",Jul-19,14007,13654,353,2.5
15727,CN5106700000000,51,67,"Franklin County, VA",Jul-19,26755,25954,801,3.0
15728,CN5106900000000,51,69,"Frederick County, VA",Jul-19,48980,47730,1250,2.6
15729,CN5107100000000,51,71,"Giles County, VA",Jul-19,7783,7532,251,3.2
15730,CN5107300000000,51,73,"Gloucester County, VA",Jul-19,20057,19537,520,2.6
15731,CN5107500000000,51,75,"Goochland County, VA",Jul-19,11462,11129,333,2.9
15732,CN5107700000000,51,77,"Grayson County, VA",Jul-19,7973,7736,237,3.0
15733,CN5107900000000,51,79,"Greene County, VA",Jul-19,10587,10315,272,2.6
15734,CN5108100000000,51,81,"Greensville County, VA",Jul-19,4336,4183,153,3.5
15735,CN5108300000000,51,83,"Halifax County, VA",Jul-19,15544,14842,702,4.5
15736,CN5108500000000,51,85,"Hanover County, VA",Jul-19,60428,58880,1548,2.6
15737,CN5108700000000,51,87,"Henrico County, VA",Jul-19,185531,180056,5475,3.0
15738,CN5108900000000,51,89,"Henry County, VA",Jul-19,23846,23005,841,3.5
15739,CN5109100000000,51,91,"Highland County, VA",Jul-19,1312,1278,34,2.6
15740,CN5109300000000,51,93,"Isle of Wight County, VA",Jul-19,19960,19361,599,3.0
15741,CN5109500000000,51,95,"James City County, VA",Jul-19,37510,36447,1063,2.8
15742,CN5109700000000,51,97,"King and Queen County, VA",Jul-19,3928,3810,118,3.0
15743,CN5109900000000,51,99,"King George County, VA",Jul-19,13744,13382,362,2.6
15744,CN5110100000000,51,101,"King William County, VA",Jul-19,9347,9091,256,2.7
15745,CN5110300000000,51,103,"Lancaster County, VA",Jul-19,5599,5404,195,3.5
15746,CN5110500000000,51,105,"Lee County, VA",Jul-19,8291,7906,385,4.6
15747,CN5110700000000,51,107,"Loudoun County, VA",Jul-19,228311,222749,5562,2.4
15748,CN5110900000000,51,109,"Louisa County, VA",Jul-19,20021,19464,557,2.8
15749,CN5111100000000,51,111,"Lunenburg County, VA",Jul-19,5371,5179,192,3.6
15750,CN5111300000000,51,113,"Madison County, VA",Jul-19,7501,7330,171,2.3
15751,CN5111500000000,51,115,"Mathews County, VA",Jul-19,4235,4117,118,2.8
15752,CN5111700000000,51,117,"Mecklenburg County, VA",Jul-19,12789,12241,548,4.3
15753,CN5111900000000,51,119,"Middlesex County, VA",Jul-19,5473,5334,139,2.5
15754,CN5112100000000,51,121,"Montgomery County, VA",Jul-19,49471,47870,1601,3.2
15755,CN5112500000000,51,125,"Nelson County, VA",Jul-19,7569,7332,237,3.1
15756,CN5112700000000,51,127,"New Kent County, VA",Jul-19,12742,12413,329,2.6
15757,CN5113100000000,51,131,"Northampton County, VA",Jul-19,5872,5635,237,4.0
15758,CN5113300000000,51,133,"Northumberland County, VA",Jul-19,5853,5653,200,3.4
15759,CN5113500000000,51,135,"Nottoway County, VA",Jul-19,7316,7105,211,2.9
15760,CN5113700000000,51,137,"Orange County, VA",Jul-19,17774,17215,559,3.1
15761,CN5113900000000,51,139,"Page County, VA",Jul-19,12276,11870,406,3.3
15762,CN5114100000000,51,141,"Patrick County, VA",Jul-19,7192,6923,269,3.7
15763,CN5114300000000,51,143,"Pittsylvania County, VA",Jul-19,29752,28566,1186,4.0
15764,CN5114500000000,51,145,"Powhatan County, VA",Jul-19,14431,14044,387,2.7
15765,CN5114700000000,51,147,"Prince Edward County, VA",Jul-19,10594,10106,488,4.6
15766,CN5114900000000,51,149,"Prince George County, VA",Jul-19,15399,14842,557,3.6
15767,CN5115300000000,51,153,"Prince William County, VA",Jul-19,251730,245137,6593,2.6
15768,CN5115500000000,51,155,"Pulaski County, VA",Jul-19,15798,15265,533,3.4
15769,CN5115700000000,51,157,"Rappahannock County, VA",Jul-19,3816,3715,101,2.6
15770,CN5115900000000,51,159,"Richmond County, VA",Jul-19,4170,4041,129,3.1
15771,CN5116100000000,51,161,"Roanoke County, VA",Jul-19,49944,48588,1356,2.7
15772,CN5116300000000,51,163,"Rockbridge County, VA",Jul-19,11087,10778,309,2.8
15773,CN5116500000000,51,165,"Rockingham County, VA",Jul-19,41770,40686,1084,2.6
15774,CN5116700000000,51,167,"Russell County, VA",Jul-19,11142,10641,501,4.5
15775,CN5116900000000,51,169,"Scott County, VA",Jul-19,9127,8832,295,3.2
15776,CN5117100000000,51,171,"Shenandoah County, VA",Jul-19,22882,22304,578,2.5
15777,CN5117300000000,51,173,"Smyth County, VA",Jul-19,14005,13446,559,4.0
15778,CN5117500000000,51,175,"Southampton County, VA",Jul-19,9291,9020,271,2.9
15779,CN5117700000000,51,177,"Spotsylvania County, VA",Jul-19,68874,66712,2162,3.1
15780,CN5117900000000,51,179,"Stafford County, VA",Jul-19,73867,71739,2128,2.9
15781,CN5118100000000,51,181,"Surry County, VA",Jul-19,3751,3603,148,3.9
15782,CN5118300000000,51,183,"Sussex County, VA",Jul-19,3930,3743,187,4.8
15783,CN5118500000000,51,185,"Tazewell County, VA",Jul-19,15424,14657,767,5.0
15784,CN5118700000000,51,187,"Warren County, VA",Jul-19,20974,20362,612,2.9
15785,CN5119100000000,51,191,"Washington County, VA",Jul-19,26766,25799,967,3.6
15786,CN5119300000000,51,193,"Westmoreland County, VA",Jul-19,9840,9508,332,3.4
15787,CN5119500000000,51,195,"Wise County, VA",Jul-19,13348,12642,706,5.3
15788,CN5119700000000,51,197,"Wythe County, VA",Jul-19,13842,13327,515,3.7
15789,CN5119900000000,51,199,"York County, VA",Jul-19,33528,32605,923,2.8
15790,CN5151000000000,51,510,"Alexandria city, VA",Jul-19,103813,101587,2226,2.1
15791,CN5152000000000,51,520,"Bristol city, VA",Jul-19,7207,6911,296,4.1
15792,CN5153000000000,51,530,"Buena Vista city, VA",Jul-19,3388,3274,114,3.4
15793,CN5154000000000,51,540,"Charlottesville city, VA",Jul-19,26596,25895,701,2.6
15794,CN5155000000000,51,550,"Chesapeake city, VA",Jul-19,125623,121808,3815,3.0
15795,CN5157000000000,51,570,"Colonial Heights city, VA",Jul-19,8975,8675,300,3.3
15796,CN5158000000000,51,580,"Covington city, VA",Jul-19,2357,2252,105,4.5
15797,CN5159000000000,51,590,"Danville city, VA",Jul-19,19064,17980,1084,5.7
15798,CN5159500000000,51,595,"Emporia city, VA",Jul-19,2328,2207,121,5.2
15799,CN5160000000000,51,600,"Fairfax city, VA",Jul-19,13774,13486,288,2.1
15800,CN5161000000000,51,610,"Falls Church city, VA",Jul-19,8828,8628,200,2.3
15801,CN5162000000000,51,620,"Franklin city, VA",Jul-19,3662,3504,158,4.3
15802,CN5163000000000,51,630,"Fredericksburg city, VA",Jul-19,14528,14001,527,3.6
15803,CN5164000000000,51,640,"Galax city, VA",Jul-19,2963,2850,113,3.8
15804,CN5165000000000,51,650,"Hampton city, VA",Jul-19,65905,63305,2600,3.9
15805,CN5166000000000,51,660,"Harrisonburg city, VA",Jul-19,24870,23929,941,3.8
15806,CN5167000000000,51,670,"Hopewell city, VA",Jul-19,9866,9426,440,4.5
15807,CN5167800000000,51,678,"Lexington city, VA",Jul-19,2122,1998,124,5.8
15808,CN5168000000000,51,680,"Lynchburg city, VA",Jul-19,36754,35146,1608,4.4
15809,CN5168300000000,51,683,"Manassas city, VA",Jul-19,22599,22019,580,2.6
15810,CN5168500000000,51,685,"Manassas Park city, VA",Jul-19,9615,9372,243,2.5
15811,CN5169000000000,51,690,"Martinsville city, VA",Jul-19,5542,5292,250,4.5
15812,CN5170000000000,51,700,"Newport News city, VA",Jul-19,90920,87606,3314,3.6
15813,CN5171000000000,51,710,"Norfolk city, VA",Jul-19,114357,110114,4243,3.7
15814,CN5172000000000,51,720,"Norton city, VA",Jul-19,1683,1615,68,4.0
15815,CN5173000000000,51,730,"Petersburg city, VA",Jul-19,13326,12514,812,6.1
15816,CN5173500000000,51,735,"Poquoson city, VA",Jul-19,6548,6384,164,2.5
15817,CN5174000000000,51,740,"Portsmouth city, VA",Jul-19,45318,43478,1840,4.1
15818,CN5175000000000,51,750,"Radford city, VA",Jul-19,8542,8178,364,4.3
15819,CN5176000000000,51,760,"Richmond city, VA",Jul-19,120786,116493,4293,3.6
15820,CN5177000000000,51,770,"Roanoke city, VA",Jul-19,49769,48129,1640,3.3
15821,CN5177500000000,51,775,"Salem city, VA",Jul-19,13135,12729,406,3.1
15822,CN5179000000000,51,790,"Staunton city, VA",Jul-19,12345,11997,348,2.8
15823,CN5180000000000,51,800,"Suffolk city, VA",Jul-19,45706,44237,1469,3.2
15824,CN5181000000000,51,810,"Virginia Beach city, VA",Jul-19,238470,231817,6653,2.8
15825,CN5182000000000,51,820,"Waynesboro city, VA",Jul-19,10773,10452,321,3.0
15826,CN5183000000000,51,830,"Williamsburg city, VA",Jul-19,6878,6574,304,4.4
15827,CN5184000000000,51,840,"Winchester city, VA",Jul-19,15080,14637,443,2.9
15828,CN5300100000000,53,1,"Adams County, WA",Jul-19,11548,11099,449,3.9
15829,CN5300300000000,53,3,"Asotin County, WA",Jul-19,10297,9873,424,4.1
15830,CN5300500000000,53,5,"Benton County, WA",Jul-19,105715,100769,4946,4.7
15831,CN5300700000000,53,7,"Chelan County, WA",Jul-19,51952,50099,1853,3.6
15832,CN5300900000000,53,9,"Clallam County, WA",Jul-19,29166,27357,1809,6.2
15833,CN5301100000000,53,11,"Clark County, WA",Jul-19,239896,228202,11694,4.9
15834,CN5301300000000,53,13,"Columbia County, WA",Jul-19,1868,1784,84,4.5
15835,CN5301500000000,53,15,"Cowlitz County, WA",Jul-19,47659,44857,2802,5.9
15836,CN5301700000000,53,17,"Douglas County, WA",Jul-19,25217,24169,1048,4.2
15837,CN5301900000000,53,19,"Ferry County, WA",Jul-19,2505,2273,232,9.3
15838,CN5302100000000,53,21,"Franklin County, WA",Jul-19,45342,42973,2369,5.2
15839,CN5302300000000,53,23,"Garfield County, WA",Jul-19,958,916,42,4.4
15840,CN5302500000000,53,25,"Grant County, WA",Jul-19,51218,48625,2593,5.1
15841,CN5302700000000,53,27,"Grays Harbor County, WA",Jul-19,29048,27184,1864,6.4
15842,CN5302900000000,53,29,"Island County, WA",Jul-19,36222,34382,1840,5.1
15843,CN5303100000000,53,31,"Jefferson County, WA",Jul-19,13134,12418,716,5.5
15844,CN5303300000000,53,33,"King County, WA",Jul-19,1298313,1259313,39000,3.0
15845,CN5303500000000,53,35,"Kitsap County, WA",Jul-19,128283,122403,5880,4.6
15846,CN5303700000000,53,37,"Kittitas County, WA",Jul-19,22095,20932,1163,5.3
15847,CN5303900000000,53,39,"Klickitat County, WA",Jul-19,10960,10393,567,5.2
15848,CN5304100000000,53,41,"Lewis County, WA",Jul-19,35199,33120,2079,5.9
15849,CN5304300000000,53,43,"Lincoln County, WA",Jul-19,5193,4968,225,4.3
15850,CN5304500000000,53,45,"Mason County, WA",Jul-19,25138,23614,1524,6.1
15851,CN5304700000000,53,47,"Okanogan County, WA",Jul-19,23242,22121,1121,4.8
15852,CN5304900000000,53,49,"Pacific County, WA",Jul-19,9054,8513,541,6.0
15853,CN5305100000000,53,51,"Pend Oreille County, WA",Jul-19,4975,4648,327,6.6
15854,CN5305300000000,53,53,"Pierce County, WA",Jul-19,439331,417202,22129,5.0
15855,CN5305500000000,53,55,"San Juan County, WA",Jul-19,9840,9539,301,3.1
15856,CN5305700000000,53,57,"Skagit County, WA",Jul-19,63642,60319,3323,5.2
15857,CN5305900000000,53,59,"Skamania County, WA",Jul-19,5522,5213,309,5.6
15858,CN5306100000000,53,61,"Snohomish County, WA",Jul-19,441932,427741,14191,3.2
15859,CN5306300000000,53,63,"Spokane County, WA",Jul-19,251461,238797,12664,5.0
15860,CN5306500000000,53,65,"Stevens County, WA",Jul-19,18861,17708,1153,6.1
15861,CN5306700000000,53,67,"Thurston County, WA",Jul-19,141080,134273,6807,4.8
15862,CN5306900000000,53,69,"Wahkiakum County, WA",Jul-19,1389,1302,87,6.3
15863,CN5307100000000,53,71,"Walla Walla County, WA",Jul-19,30556,29076,1480,4.8
15864,CN5307300000000,53,73,"Whatcom County, WA",Jul-19,115641,109911,5730,5.0
15865,CN5307500000000,53,75,"Whitman County, WA",Jul-19,21292,20222,1070,5.0
15866,CN5307700000000,53,77,"Yakima County, WA",Jul-19,140212,132485,7727,5.5
15867,CN5400100000000,54,1,"Barbour County, WV",Jul-19,6931,6514,417,6.0
15868,CN5400300000000,54,3,"Berkeley County, WV",Jul-19,59573,57461,2112,3.5
15869,CN5400500000000,54,5,"Boone County, WV",Jul-19,7590,7190,400,5.3
15870,CN5400700000000,54,7,"Braxton County, WV",Jul-19,5224,4908,316,6.0
15871,CN5400900000000,54,9,"Brooke County, WV",Jul-19,10214,9685,529,5.2
15872,CN5401100000000,54,11,"Cabell County, WV",Jul-19,42058,40242,1816,4.3
15873,CN5401300000000,54,13,"Calhoun County, WV",Jul-19,2492,2226,266,10.7
15874,CN5401500000000,54,15,"Clay County, WV",Jul-19,3163,2943,220,7.0
15875,CN5401700000000,54,17,"Doddridge County, WV",Jul-19,4117,3963,154,3.7
15876,CN5401900000000,54,19,"Fayette County, WV",Jul-19,16559,15682,877,5.3
15877,CN5402100000000,54,21,"Gilmer County, WV",Jul-19,2314,2173,141,6.1
15878,CN5402300000000,54,23,"Grant County, WV",Jul-19,6121,5790,331,5.4
15879,CN5402500000000,54,25,"Greenbrier County, WV",Jul-19,16560,15910,650,3.9
15880,CN5402700000000,54,27,"Hampshire County, WV",Jul-19,10962,10534,428,3.9
15881,CN5402900000000,54,29,"Hancock County, WV",Jul-19,13407,12679,728,5.4
15882,CN5403100000000,54,31,"Hardy County, WV",Jul-19,5803,5518,285,4.9
15883,CN5403300000000,54,33,"Harrison County, WV",Jul-19,35521,34038,1483,4.2
15884,CN5403500000000,54,35,"Jackson County, WV",Jul-19,14172,13544,628,4.4
15885,CN5403700000000,54,37,"Jefferson County, WV",Jul-19,30956,29971,985,3.2
15886,CN5403900000000,54,39,"Kanawha County, WV",Jul-19,84086,80401,3685,4.4
15887,CN5404100000000,54,41,"Lewis County, WV",Jul-19,6989,6591,398,5.7
15888,CN5404300000000,54,43,"Lincoln County, WV",Jul-19,7277,6825,452,6.2
15889,CN5404500000000,54,45,"Logan County, WV",Jul-19,11246,10597,649,5.8
15890,CN5404700000000,54,47,"McDowell County, WV",Jul-19,4445,4035,410,9.2
15891,CN5404900000000,54,49,"Marion County, WV",Jul-19,25672,24384,1288,5.0
15892,CN5405100000000,54,51,"Marshall County, WV",Jul-19,14571,13741,830,5.7
15893,CN5405300000000,54,53,"Mason County, WV",Jul-19,9944,9331,613,6.2
15894,CN5405500000000,54,55,"Mercer County, WV",Jul-19,20795,19547,1248,6.0
15895,CN5405700000000,54,57,"Mineral County, WV",Jul-19,12885,12072,813,6.3
15896,CN5405900000000,54,59,"Mingo County, WV",Jul-19,6928,6437,491,7.1
15897,CN5406100000000,54,61,"Monongalia County, WV",Jul-19,54332,52303,2029,3.7
15898,CN5406300000000,54,63,"Monroe County, WV",Jul-19,5921,5683,238,4.0
15899,CN5406500000000,54,65,"Morgan County, WV",Jul-19,8376,8059,317,3.8
15900,CN5406700000000,54,67,"Nicholas County, WV",Jul-19,9573,9054,519,5.4
15901,CN5406900000000,54,69,"Ohio County, WV",Jul-19,21888,20976,912,4.2
15902,CN5407100000000,54,71,"Pendleton County, WV",Jul-19,3710,3581,129,3.5
15903,CN5407300000000,54,73,"Pleasants County, WV",Jul-19,2857,2688,169,5.9
15904,CN5407500000000,54,75,"Pocahontas County, WV",Jul-19,3909,3748,161,4.1
15905,CN5407700000000,54,77,"Preston County, WV",Jul-19,15508,14819,689,4.4
15906,CN5407900000000,54,79,"Putnam County, WV",Jul-19,26941,25817,1124,4.2
15907,CN5408100000000,54,81,"Raleigh County, WV",Jul-19,31068,29666,1402,4.5
15908,CN5408300000000,54,83,"Randolph County, WV",Jul-19,12536,11864,672,5.4
15909,CN5408500000000,54,85,"Ritchie County, WV",Jul-19,4440,4235,205,4.6
15910,CN5408700000000,54,87,"Roane County, WV",Jul-19,5096,4697,399,7.8
15911,CN5408900000000,54,89,"Summers County, WV",Jul-19,4425,4213,212,4.8
15912,CN5409100000000,54,91,"Taylor County, WV",Jul-19,8014,7644,370,4.6
15913,CN5409300000000,54,93,"Tucker County, WV",Jul-19,3454,3287,167,4.8
15914,CN5409500000000,54,95,"Tyler County, WV",Jul-19,3093,2855,238,7.7
15915,CN5409700000000,54,97,"Upshur County, WV",Jul-19,9603,9045,558,5.8
15916,CN5409900000000,54,99,"Wayne County, WV",Jul-19,15930,15104,826,5.2
15917,CN5410100000000,54,101,"Webster County, WV",Jul-19,3276,3095,181,5.5
15918,CN5410300000000,54,103,"Wetzel County, WV",Jul-19,6596,6146,450,6.8
15919,CN5410500000000,54,105,"Wirt County, WV",Jul-19,2300,2136,164,7.1
15920,CN5410700000000,54,107,"Wood County, WV",Jul-19,37169,35357,1812,4.9
15921,CN5410900000000,54,109,"Wyoming County, WV",Jul-19,6749,6274,475,7.0
15922,CN5500100000000,55,1,"Adams County, WI",Jul-19,8397,7976,421,5.0
15923,CN5500300000000,55,3,"Ashland County, WI",Jul-19,8421,7965,456,5.4
15924,CN5500500000000,55,5,"Barron County, WI",Jul-19,24326,23498,828,3.4
15925,CN5500700000000,55,7,"Bayfield County, WI",Jul-19,7965,7568,397,5.0
15926,CN5500900000000,55,9,"Brown County, WI",Jul-19,143470,138450,5020,3.5
15927,CN5501100000000,55,11,"Buffalo County, WI",Jul-19,6511,6241,270,4.1
15928,CN5501300000000,55,13,"Burnett County, WI",Jul-19,7458,7108,350,4.7
15929,CN5501500000000,55,15,"Calumet County, WI",Jul-19,28070,27203,867,3.1
15930,CN5501700000000,55,17,"Chippewa County, WI",Jul-19,33077,31928,1149,3.5
15931,CN5501900000000,55,19,"Clark County, WI",Jul-19,17802,17222,580,3.3
15932,CN5502100000000,55,21,"Columbia County, WI",Jul-19,32037,31017,1020,3.2
15933,CN5502300000000,55,23,"Crawford County, WI",Jul-19,7662,7380,282,3.7
15934,CN5502500000000,55,25,"Dane County, WI",Jul-19,326762,318102,8660,2.7
15935,CN5502700000000,55,27,"Dodge County, WI",Jul-19,48528,47013,1515,3.1
15936,CN5502900000000,55,29,"Door County, WI",Jul-19,17240,16741,499,2.9
15937,CN5503100000000,55,31,"Douglas County, WI",Jul-19,23011,22022,989,4.3
15938,CN5503300000000,55,33,"Dunn County, WI",Jul-19,23282,22442,840,3.6
15939,CN5503500000000,55,35,"Eau Claire County, WI",Jul-19,59114,57062,2052,3.5
15940,CN5503700000000,55,37,"Florence County, WI",Jul-19,2258,2137,121,5.4
15941,CN5503900000000,55,39,"Fond du Lac County, WI",Jul-19,58289,56353,1936,3.3
15942,CN5504100000000,55,41,"Forest County, WI",Jul-19,4089,3874,215,5.3
15943,CN5504300000000,55,43,"Grant County, WI",Jul-19,27034,26169,865,3.2
15944,CN5504500000000,55,45,"Green County, WI",Jul-19,21345,20722,623,2.9
15945,CN5504700000000,55,47,"Green Lake County, WI",Jul-19,9789,9409,380,3.9
15946,CN5504900000000,55,49,"Iowa County, WI",Jul-19,13913,13523,390,2.8
15947,CN5505100000000,55,51,"Iron County, WI",Jul-19,2564,2403,161,6.3
15948,CN5505300000000,55,53,"Jackson County, WI",Jul-19,10404,10054,350,3.4
15949,CN5505500000000,55,55,"Jefferson County, WI",Jul-19,46598,45077,1521,3.3
15950,CN5505700000000,55,57,"Juneau County, WI",Jul-19,13672,13226,446,3.3
15951,CN5505900000000,55,59,"Kenosha County, WI",Jul-19,91488,87557,3931,4.3
15952,CN5506100000000,55,61,"Kewaunee County, WI",Jul-19,11144,10772,372,3.3
15953,CN5506300000000,55,63,"La Crosse County, WI",Jul-19,65902,63797,2105,3.2
15954,CN5506500000000,55,65,"Lafayette County, WI",Jul-19,10102,9826,276,2.7
15955,CN5506700000000,55,67,"Langlade County, WI",Jul-19,9341,8922,419,4.5
15956,CN5506900000000,55,69,"Lincoln County, WI",Jul-19,15125,14528,597,3.9
15957,CN5507100000000,55,71,"Manitowoc County, WI",Jul-19,41330,39881,1449,3.5
15958,CN5507300000000,55,73,"Marathon County, WI",Jul-19,74468,72093,2375,3.2
15959,CN5507500000000,55,75,"Marinette County, WI",Jul-19,19688,18680,1008,5.1
15960,CN5507700000000,55,77,"Marquette County, WI",Jul-19,7744,7478,266,3.4
15961,CN5507800000000,55,78,"Menominee County, WI",Jul-19,1697,1519,178,10.5
15962,CN5507900000000,55,79,"Milwaukee County, WI",Jul-19,473882,451979,21903,4.6
15963,CN5508100000000,55,81,"Monroe County, WI",Jul-19,23815,23124,691,2.9
15964,CN5508300000000,55,83,"Oconto County, WI",Jul-19,20728,19992,736,3.6
15965,CN5508500000000,55,85,"Oneida County, WI",Jul-19,19031,18285,746,3.9
15966,CN5508700000000,55,87,"Outagamie County, WI",Jul-19,105067,101588,3479,3.3
15967,CN5508900000000,55,89,"Ozaukee County, WI",Jul-19,49704,48073,1631,3.3
15968,CN5509100000000,55,91,"Pepin County, WI",Jul-19,4176,4037,139,3.3
15969,CN5509300000000,55,93,"Pierce County, WI",Jul-19,25654,24828,826,3.2
15970,CN5509500000000,55,95,"Polk County, WI",Jul-19,24596,23795,801,3.3
15971,CN5509700000000,55,97,"Portage County, WI",Jul-19,38192,36855,1337,3.5
15972,CN5509900000000,55,99,"Price County, WI",Jul-19,6607,6251,356,5.4
15973,CN5510100000000,55,101,"Racine County, WI",Jul-19,100573,95945,4628,4.6
15974,CN5510300000000,55,103,"Richland County, WI",Jul-19,9276,8994,282,3.0
15975,CN5510500000000,55,105,"Rock County, WI",Jul-19,87131,83646,3485,4.0
15976,CN5510700000000,55,107,"Rusk County, WI",Jul-19,6611,6323,288,4.4
15977,CN5510900000000,55,109,"St. Croix County, WI",Jul-19,50989,49403,1586,3.1
15978,CN5511100000000,55,111,"Sauk County, WI",Jul-19,37180,36109,1071,2.9
15979,CN5511300000000,55,113,"Sawyer County, WI",Jul-19,8537,8161,376,4.4
15980,CN5511500000000,55,115,"Shawano County, WI",Jul-19,21372,20667,705,3.3
15981,CN5511700000000,55,117,"Sheboygan County, WI",Jul-19,64099,62206,1893,3.0
15982,CN5511900000000,55,119,"Taylor County, WI",Jul-19,11047,10677,370,3.3
15983,CN5512100000000,55,121,"Trempealeau County, WI",Jul-19,16002,15440,562,3.5
15984,CN5512300000000,55,123,"Vernon County, WI",Jul-19,15239,14777,462,3.0
15985,CN5512500000000,55,125,"Vilas County, WI",Jul-19,11210,10818,392,3.5
15986,CN5512700000000,55,127,"Walworth County, WI",Jul-19,58539,56485,2054,3.5
15987,CN5512900000000,55,129,"Washburn County, WI",Jul-19,8229,7912,317,3.9
15988,CN5513100000000,55,131,"Washington County, WI",Jul-19,78016,75582,2434,3.1
15989,CN5513300000000,55,133,"Waukesha County, WI",Jul-19,227514,220027,7487,3.3
15990,CN5513500000000,55,135,"Waupaca County, WI",Jul-19,26295,25363,932,3.5
15991,CN5513700000000,55,137,"Waushara County, WI",Jul-19,11401,10919,482,4.2
15992,CN5513900000000,55,139,"Winnebago County, WI",Jul-19,92662,89527,3135,3.4
15993,CN5514100000000,55,141,"Wood County, WI",Jul-19,35609,34092,1517,4.3
15994,CN5600100000000,56,1,"Albany County, WY",Jul-19,19294,18591,703,3.6
15995,CN5600300000000,56,3,"Big Horn County, WY",Jul-19,5579,5355,224,4.0
15996,CN5600500000000,56,5,"Campbell County, WY",Jul-19,23326,22091,1235,5.3
15997,CN5600700000000,56,7,"Carbon County, WY",Jul-19,8568,8318,250,2.9
15998,CN5600900000000,56,9,"Converse County, WY",Jul-19,8816,8584,232,2.6
15999,CN5601100000000,56,11,"Crook County, WY",Jul-19,3918,3783,135,3.4
16000,CN5601300000000,56,13,"Fremont County, WY",Jul-19,18463,17667,796,4.3
16001,CN5601500000000,56,15,"Goshen County, WY",Jul-19,6676,6432,244,3.7
16002,CN5601700000000,56,17,"Hot Springs County, WY",Jul-19,2263,2189,74,3.3
16003,CN5601900000000,56,19,"Johnson County, WY",Jul-19,4418,4280,138,3.1
16004,CN5602100000000,56,21,"Laramie County, WY",Jul-19,49052,47398,1654,3.4
16005,CN5602300000000,56,23,"Lincoln County, WY",Jul-19,9099,8819,280,3.1
16006,CN5602500000000,56,25,"Natrona County, WY",Jul-19,39751,38297,1454,3.7
16007,CN5602700000000,56,27,"Niobrara County, WY",Jul-19,1286,1253,33,2.6
16008,CN5602900000000,56,29,"Park County, WY",Jul-19,17139,16588,551,3.2
16009,CN5603100000000,56,31,"Platte County, WY",Jul-19,4715,4546,169,3.6
16010,CN5603300000000,56,33,"Sheridan County, WY",Jul-19,15873,15354,519,3.3
16011,CN5603500000000,56,35,"Sublette County, WY",Jul-19,4341,4172,169,3.9
16012,CN5603700000000,56,37,"Sweetwater County, WY",Jul-19,20859,20054,805,3.9
16013,CN5603900000000,56,39,"Teton County, WY",Jul-19,17904,17564,340,1.9
16014,CN5604100000000,56,41,"Uinta County, WY",Jul-19,9025,8669,356,3.9
16015,CN5604300000000,56,43,"Washakie County, WY",Jul-19,3975,3812,163,4.1
16016,CN5604500000000,56,45,"Weston County, WY",Jul-19,3744,3635,109,2.9
16017,CN7200100000000,72,1,"Adjuntas Municipio, PR",Jul-19,4098,3560,538,13.1
16018,CN7200300000000,72,3,"Aguada Municipio, PR",Jul-19,11977,10856,1121,9.4
16019,CN7200500000000,72,5,"Aguadilla Municipio, PR",Jul-19,14786,13258,1528,10.3
16020,CN7200700000000,72,7,"Aguas Buenas Municipio, PR",Jul-19,6630,6043,587,8.9
16021,CN7200900000000,72,9,"Aibonito Municipio, PR",Jul-19,6554,5904,650,9.9
16022,CN7201100000000,72,11,"Anasco Municipio, PR",Jul-19,8949,8206,743,8.3
16023,CN7201300000000,72,13,"Arecibo Municipio, PR",Jul-19,24416,22273,2143,8.8
16024,CN7201500000000,72,15,"Arroyo Municipio, PR",Jul-19,4630,4053,577,12.5
16025,CN7201700000000,72,17,"Barceloneta Municipio, PR",Jul-19,5976,5343,633,10.6
16026,CN7201900000000,72,19,"Barranquitas Municipio, PR",Jul-19,7510,6820,690,9.2
16027,CN7202100000000,72,21,"Bayamon Municipio, PR",Jul-19,66141,62099,4042,6.1
16028,CN7202300000000,72,23,"Cabo Rojo Municipio, PR",Jul-19,13765,12555,1210,8.8
16029,CN7202500000000,72,25,"Caguas Municipio, PR",Jul-19,48438,45222,3216,6.6
16030,CN7202700000000,72,27,"Camuy Municipio, PR",Jul-19,9765,8935,830,8.5
16031,CN7202900000000,72,29,"Canovanas Municipio, PR",Jul-19,16261,15223,1038,6.4
16032,CN7203100000000,72,31,"Carolina Municipio, PR",Jul-19,62280,58758,3522,5.7
16033,CN7203300000000,72,33,"Catano Municipio, PR",Jul-19,7915,7375,540,6.8
16034,CN7203500000000,72,35,"Cayey Municipio, PR",Jul-19,16334,15209,1125,6.9
16035,CN7203700000000,72,37,"Ceiba Municipio, PR",Jul-19,3760,3386,374,9.9
16036,CN7203900000000,72,39,"Ciales Municipio, PR",Jul-19,3791,3350,441,11.6
16037,CN7204100000000,72,41,"Cidra Municipio, PR",Jul-19,15706,14668,1038,6.6
16038,CN7204300000000,72,43,"Coamo Municipio, PR",Jul-19,10006,8844,1162,11.6
16039,CN7204500000000,72,45,"Comerio Municipio, PR",Jul-19,4976,4531,445,8.9
16040,CN7204700000000,72,47,"Corozal Municipio, PR",Jul-19,9121,8239,882,9.7
16041,CN7204900000000,72,49,"Culebra Municipio, PR",Jul-19,910,880,30,3.3
16042,CN7205100000000,72,51,"Dorado Municipio, PR",Jul-19,13334,12607,727,5.5
16043,CN7205300000000,72,53,"Fajardo Municipio, PR",Jul-19,11108,9960,1148,10.3
16044,CN7205400000000,72,54,"Florida Municipio, PR",Jul-19,3350,3014,336,10.0
16045,CN7205500000000,72,55,"Guanica Municipio, PR",Jul-19,3976,3450,526,13.2
16046,CN7205700000000,72,57,"Guayama Municipio, PR",Jul-19,11090,9785,1305,11.8
16047,CN7205900000000,72,59,"Guayanilla Municipio, PR",Jul-19,5228,4611,617,11.8
16048,CN7206100000000,72,61,"Guaynabo Municipio, PR",Jul-19,38049,36557,1492,3.9
16049,CN7206300000000,72,63,"Gurabo Municipio, PR",Jul-19,18347,17303,1044,5.7
16050,CN7206500000000,72,65,"Hatillo Municipio, PR",Jul-19,13511,12234,1277,9.5
16051,CN7206700000000,72,67,"Hormigueros Municipio, PR",Jul-19,5496,5045,451,8.2
16052,CN7206900000000,72,69,"Humacao Municipio, PR",Jul-19,17297,15708,1589,9.2
16053,CN7207100000000,72,71,"Isabela Municipio, PR",Jul-19,12537,11383,1154,9.2
16054,CN7207300000000,72,73,"Jayuya Municipio, PR",Jul-19,4245,3676,569,13.4
16055,CN7207500000000,72,75,"Juana Diaz Municipio, PR",Jul-19,15280,13843,1437,9.4
16056,CN7207700000000,72,77,"Juncos Municipio, PR",Jul-19,12437,11431,1006,8.1
16057,CN7207900000000,72,79,"Lajas Municipio, PR",Jul-19,5282,4590,692,13.1
16058,CN7208100000000,72,81,"Lares Municipio, PR",Jul-19,6935,6044,891,12.8
16059,CN7208300000000,72,83,"Las Marias Municipio, PR",Jul-19,2651,2396,255,9.6
16060,CN7208500000000,72,85,"Las Piedras Municipio, PR",Jul-19,11462,10446,1016,8.9
16061,CN7208700000000,72,87,"Loiza Municipio, PR",Jul-19,8509,7902,607,7.1
16062,CN7208900000000,72,89,"Luquillo Municipio, PR",Jul-19,6232,5690,542,8.7
16063,CN7209100000000,72,91,"Manati Municipio, PR",Jul-19,11555,10693,862,7.5
16064,CN7209300000000,72,93,"Maricao Municipio, PR",Jul-19,1916,1679,237,12.4
16065,CN7209500000000,72,95,"Maunabo Municipio, PR",Jul-19,2892,2544,348,12.0
16066,CN7209700000000,72,97,"Mayaguez Municipio, PR",Jul-19,22394,20056,2338,10.4
16067,CN7209900000000,72,99,"Moca Municipio, PR",Jul-19,10641,9534,1107,10.4
16068,CN7210100000000,72,101,"Morovis Municipio, PR",Jul-19,8109,7364,745,9.2
16069,CN7210300000000,72,103,"Naguabo Municipio, PR",Jul-19,8199,7527,672,8.2
16070,CN7210500000000,72,105,"Naranjito Municipio, PR",Jul-19,7210,6574,636,8.8
16071,CN7210700000000,72,107,"Orocovis Municipio, PR",Jul-19,5040,4510,530,10.5
16072,CN7210900000000,72,109,"Patillas Municipio, PR",Jul-19,4242,3663,579,13.6
16073,CN7211100000000,72,111,"Penuelas Municipio, PR",Jul-19,5954,5193,761,12.8
16074,CN7211300000000,72,113,"Ponce Municipio, PR",Jul-19,46321,42127,4194,9.1
16075,CN7211500000000,72,115,"Quebradillas Municipio, PR",Jul-19,6179,5497,682,11.0
16076,CN7211700000000,72,117,"Rincon Municipio, PR",Jul-19,4631,4168,463,10.0
16077,CN7211900000000,72,119,"Rio Grande Municipio, PR",Jul-19,17098,15928,1170,6.8
16078,CN7212100000000,72,121,"Sabana Grande Municipio, PR",Jul-19,6242,5404,838,13.4
16079,CN7212300000000,72,123,"Salinas Municipio, PR",Jul-19,7130,6185,945,13.3
16080,CN7212500000000,72,125,"San German Municipio, PR",Jul-19,9834,8745,1089,11.1
16081,CN7212700000000,72,127,"San Juan Municipio, PR",Jul-19,135485,128411,7074,5.2
16082,CN7212900000000,72,129,"San Lorenzo Municipio, PR",Jul-19,11860,10838,1022,8.6
16083,CN7213100000000,72,131,"San Sebastian Municipio, PR",Jul-19,10252,9046,1206,11.8
16084,CN7213300000000,72,133,"Santa Isabel Municipio, PR",Jul-19,7901,7035,866,11.0
16085,CN7213500000000,72,135,"Toa Alta Municipio, PR",Jul-19,27474,25948,1526,5.6
16086,CN7213700000000,72,137,"Toa Baja Municipio, PR",Jul-19,29556,27927,1629,5.5
16087,CN7213900000000,72,139,"Trujillo Alto Municipio, PR",Jul-19,27440,26120,1320,4.8
16088,CN7214100000000,72,141,"Utuado Municipio, PR",Jul-19,6759,6014,745,11.0
16089,CN7214300000000,72,143,"Vega Alta Municipio, PR",Jul-19,9861,9074,787,8.0
16090,CN7214500000000,72,145,"Vega Baja Municipio, PR",Jul-19,13437,12188,1249,9.3
16091,CN7214700000000,72,147,"Vieques Municipio, PR",Jul-19,2600,2448,152,5.8
16092,CN7214900000000,72,149,"Villalba Municipio, PR",Jul-19,7421,6456,965,13.0
16093,CN7215100000000,72,151,"Yabucoa Municipio, PR",Jul-19,8860,7797,1063,12.0
16094,CN7215300000000,72,153,"Yauco Municipio, PR",Jul-19,9904,8641,1263,12.8
16095,CN0100100000000,01,1,"Autauga County, AL",Aug-19,26079,25368,711,2.7
16096,CN0100300000000,01,3,"Baldwin County, AL",Aug-19,97939,95367,2572,2.6
16097,CN0100500000000,01,5,"Barbour County, AL",Aug-19,8652,8322,330,3.8
16098,CN0100700000000,01,7,"Bibb County, AL",Aug-19,8670,8403,267,3.1
16099,CN0100900000000,01,9,"Blount County, AL",Aug-19,25309,24641,668,2.6
16100,CN0101100000000,01,11,"Bullock County, AL",Aug-19,4836,4653,183,3.8
16101,CN0101300000000,01,13,"Butler County, AL",Aug-19,9324,8955,369,4.0
16102,CN0101500000000,01,15,"Calhoun County, AL",Aug-19,46104,44535,1569,3.4
16103,CN0101700000000,01,17,"Chambers County, AL",Aug-19,15778,15320,458,2.9
16104,CN0101900000000,01,19,"Cherokee County, AL",Aug-19,11589,11264,325,2.8
16105,CN0102100000000,01,21,"Chilton County, AL",Aug-19,19786,19257,529,2.7
16106,CN0102300000000,01,23,"Choctaw County, AL",Aug-19,4486,4274,212,4.7
16107,CN0102500000000,01,25,"Clarke County, AL",Aug-19,7485,7021,464,6.2
16108,CN0102700000000,01,27,"Clay County, AL",Aug-19,6094,5917,177,2.9
16109,CN0102900000000,01,29,"Cleburne County, AL",Aug-19,5777,5612,165,2.9
16110,CN0103100000000,01,31,"Coffee County, AL",Aug-19,21369,20771,598,2.8
16111,CN0103300000000,01,33,"Colbert County, AL",Aug-19,23564,22700,864,3.7
16112,CN0103500000000,01,35,"Conecuh County, AL",Aug-19,4556,4379,177,3.9
16113,CN0103700000000,01,37,"Coosa County, AL",Aug-19,4576,4441,135,3.0
16114,CN0103900000000,01,39,"Covington County, AL",Aug-19,15594,15053,541,3.5
16115,CN0104100000000,01,41,"Crenshaw County, AL",Aug-19,6399,6226,173,2.7
16116,CN0104300000000,01,43,"Cullman County, AL",Aug-19,38204,37201,1003,2.6
16117,CN0104500000000,01,45,"Dale County, AL",Aug-19,20705,20097,608,2.9
16118,CN0104700000000,01,47,"Dallas County, AL",Aug-19,14533,13695,838,5.8
16119,CN0104900000000,01,49,"DeKalb County, AL",Aug-19,30999,30164,835,2.7
16120,CN0105100000000,01,51,"Elmore County, AL",Aug-19,37408,36447,961,2.6
16121,CN0105300000000,01,53,"Escambia County, AL",Aug-19,14766,14253,513,3.5
16122,CN0105500000000,01,55,"Etowah County, AL",Aug-19,42344,40926,1418,3.3
16123,CN0105700000000,01,57,"Fayette County, AL",Aug-19,6553,6345,208,3.2
16124,CN0105900000000,01,59,"Franklin County, AL",Aug-19,14749,14359,390,2.6
16125,CN0106100000000,01,61,"Geneva County, AL",Aug-19,11041,10724,317,2.9
16126,CN0106300000000,01,63,"Greene County, AL",Aug-19,2886,2714,172,6.0
16127,CN0106500000000,01,65,"Hale County, AL",Aug-19,6097,5859,238,3.9
16128,CN0106700000000,01,67,"Henry County, AL",Aug-19,6933,6690,243,3.5
16129,CN0106900000000,01,69,"Houston County, AL",Aug-19,46080,44705,1375,3.0
16130,CN0107100000000,01,71,"Jackson County, AL",Aug-19,23340,22602,738,3.2
16131,CN0107300000000,01,73,"Jefferson County, AL",Aug-19,318116,308988,9128,2.9
16132,CN0107500000000,01,75,"Lamar County, AL",Aug-19,5852,5679,173,3.0
16133,CN0107700000000,01,77,"Lauderdale County, AL",Aug-19,42460,41082,1378,3.2
16134,CN0107900000000,01,79,"Lawrence County, AL",Aug-19,14266,13829,437,3.1
16135,CN0108100000000,01,81,"Lee County, AL",Aug-19,76167,74144,2023,2.7
16136,CN0108300000000,01,83,"Limestone County, AL",Aug-19,43708,42618,1090,2.5
16137,CN0108500000000,01,85,"Lowndes County, AL",Aug-19,3574,3370,204,5.7
16138,CN0108700000000,01,87,"Macon County, AL",Aug-19,7857,7521,336,4.3
16139,CN0108900000000,01,89,"Madison County, AL",Aug-19,184603,180091,4512,2.4
16140,CN0109100000000,01,91,"Marengo County, AL",Aug-19,7627,7354,273,3.6
16141,CN0109300000000,01,93,"Marion County, AL",Aug-19,12860,12414,446,3.5
16142,CN0109500000000,01,95,"Marshall County, AL",Aug-19,44246,43178,1068,2.4
16143,CN0109700000000,01,97,"Mobile County, AL",Aug-19,188145,181220,6925,3.7
16144,CN0109900000000,01,99,"Monroe County, AL",Aug-19,7314,6979,335,4.6
16145,CN0110100000000,01,101,"Montgomery County, AL",Aug-19,105279,102052,3227,3.1
16146,CN0110300000000,01,103,"Morgan County, AL",Aug-19,58061,56583,1478,2.5
16147,CN0110500000000,01,105,"Perry County, AL",Aug-19,3408,3209,199,5.8
16148,CN0110700000000,01,107,"Pickens County, AL",Aug-19,7888,7614,274,3.5
16149,CN0110900000000,01,109,"Pike County, AL",Aug-19,15407,14900,507,3.3
16150,CN0111100000000,01,111,"Randolph County, AL",Aug-19,9685,9392,293,3.0
16151,CN0111300000000,01,113,"Russell County, AL",Aug-19,23614,22921,693,2.9
16152,CN0111500000000,01,115,"St. Clair County, AL",Aug-19,40453,39376,1077,2.7
16153,CN0111700000000,01,117,"Shelby County, AL",Aug-19,115691,113184,2507,2.2
16154,CN0111900000000,01,119,"Sumter County, AL",Aug-19,4829,4615,214,4.4
16155,CN0112100000000,01,121,"Talladega County, AL",Aug-19,35649,34411,1238,3.5
16156,CN0112300000000,01,123,"Tallapoosa County, AL",Aug-19,19066,18526,540,2.8
16157,CN0112500000000,01,125,"Tuscaloosa County, AL",Aug-19,104331,101496,2835,2.7
16158,CN0112700000000,01,127,"Walker County, AL",Aug-19,25334,24494,840,3.3
16159,CN0112900000000,01,129,"Washington County, AL",Aug-19,6699,6389,310,4.6
16160,CN0113100000000,01,131,"Wilcox County, AL",Aug-19,2710,2517,193,7.1
16161,CN0113300000000,01,133,"Winston County, AL",Aug-19,10145,9810,335,3.3
16162,CN0201300000000,02,13,"Aleutians East Borough, AK",Aug-19,3552,3495,57,1.6
16163,CN0201600000000,02,16,"Aleutians West Census Area, AK",Aug-19,3907,3803,104,2.7
16164,CN0202000000000,02,20,"Anchorage Borough/municipality, AK",Aug-19,145090,138245,6845,4.7
16165,CN0205000000000,02,50,"Bethel Census Area, AK",Aug-19,6899,5953,946,13.7
16166,CN0206000000000,02,60,"Bristol Bay Borough, AK",Aug-19,576,555,21,3.6
16167,CN0206800000000,02,68,"Denali Borough, AK",Aug-19,1677,1622,55,3.3
16168,CN0207000000000,02,70,"Dillingham Census Area, AK",Aug-19,2114,1967,147,7.0
16169,CN0209000000000,02,90,"Fairbanks North Star Borough, AK",Aug-19,44963,42907,2056,4.6
16170,CN0210000000000,02,100,"Haines Borough, AK",Aug-19,1385,1319,66,4.8
16171,CN0210500000000,02,105,"Hoonah-Angoon Census Area, AK",Aug-19,1399,1315,84,6.0
16172,CN0211000000000,02,110,"Juneau Borough/city, AK",Aug-19,17769,17106,663,3.7
16173,CN0212200000000,02,122,"Kenai Peninsula Borough, AK",Aug-19,27766,26303,1463,5.3
16174,CN0213000000000,02,130,"Ketchikan Gateway Borough, AK",Aug-19,7608,7259,349,4.6
16175,CN0215000000000,02,150,"Kodiak Island Borough, AK",Aug-19,6328,6072,256,4.0
16176,CN0215800000000,02,158,"Kusilvak Census Area, AK",Aug-19,2762,2263,499,18.1
16177,CN0216400000000,02,164,"Lake and Peninsula Borough, AK",Aug-19,851,791,60,7.1
16178,CN0217000000000,02,170,"Matanuska-Susitna Borough, AK",Aug-19,45944,43196,2748,6.0
16179,CN0218000000000,02,180,"Nome Census Area, AK",Aug-19,3889,3478,411,10.6
16180,CN0218500000000,02,185,"North Slope Borough, AK",Aug-19,3356,3135,221,6.6
16181,CN0218800000000,02,188,"Northwest Arctic Borough, AK",Aug-19,2893,2495,398,13.8
16182,CN0219500000000,02,195,"Petersburg Borough, AK",Aug-19,1551,1452,99,6.4
16183,CN0219800000000,02,198,"Prince of Wales-Hyder Census Area, AK",Aug-19,2846,2606,240,8.4
16184,CN0222000000000,02,220,"Sitka Borough/city, AK",Aug-19,4970,4800,170,3.4
16185,CN0223000000000,02,230,"Skagway Municipality, AK",Aug-19,1078,1050,28,2.6
16186,CN0224000000000,02,240,"Southeast Fairbanks Census Area, AK",Aug-19,2845,2643,202,7.1
16187,CN0226100000000,02,261,"Valdez-Cordova Census Area, AK",Aug-19,6212,5951,261,4.2
16188,CN0227500000000,02,275,"Wrangell Borough/city, AK",Aug-19,1009,947,62,6.1
16189,CN0228200000000,02,282,"Yakutat Borough/city, AK",Aug-19,278,263,15,5.4
16190,CN0229000000000,02,290,"Yukon-Koyukuk Census Area, AK",Aug-19,2341,2061,280,12.0
16191,CN0400100000000,04,1,"Apache County, AZ",Aug-19,20762,18730,2032,9.8
16192,CN0400300000000,04,3,"Cochise County, AZ",Aug-19,50007,47008,2999,6.0
16193,CN0400500000000,04,5,"Coconino County, AZ",Aug-19,77493,73209,4284,5.5
16194,CN0400700000000,04,7,"Gila County, AZ",Aug-19,21659,20442,1217,5.6
16195,CN0400900000000,04,9,"Graham County, AZ",Aug-19,15094,14349,745,4.9
16196,CN0401100000000,04,11,"Greenlee County, AZ",Aug-19,4590,4402,188,4.1
16197,CN0401200000000,04,12,"La Paz County, AZ",Aug-19,9084,8535,549,6.0
16198,CN0401300000000,04,13,"Maricopa County, AZ",Aug-19,2316171,2219376,96795,4.2
16199,CN0401500000000,04,15,"Mohave County, AZ",Aug-19,88067,82946,5121,5.8
16200,CN0401700000000,04,17,"Navajo County, AZ",Aug-19,41536,38582,2954,7.1
16201,CN0401900000000,04,19,"Pima County, AZ",Aug-19,496370,473292,23078,4.6
16202,CN0402100000000,04,21,"Pinal County, AZ",Aug-19,187027,177447,9580,5.1
16203,CN0402300000000,04,23,"Santa Cruz County, AZ",Aug-19,19387,17222,2165,11.2
16204,CN0402500000000,04,25,"Yavapai County, AZ",Aug-19,107395,102442,4953,4.6
16205,CN0402700000000,04,27,"Yuma County, AZ",Aug-19,101414,79668,21746,21.4
16206,CN0500100000000,05,1,"Arkansas County, AR",Aug-19,9518,9259,259,2.7
16207,CN0500300000000,05,3,"Ashley County, AR",Aug-19,7735,7332,403,5.2
16208,CN0500500000000,05,5,"Baxter County, AR",Aug-19,16200,15546,654,4.0
16209,CN0500700000000,05,7,"Benton County, AR",Aug-19,137711,133961,3750,2.7
16210,CN0500900000000,05,9,"Boone County, AR",Aug-19,15812,15276,536,3.4
16211,CN0501100000000,05,11,"Bradley County, AR",Aug-19,4359,4181,178,4.1
16212,CN0501300000000,05,13,"Calhoun County, AR",Aug-19,2428,2328,100,4.1
16213,CN0501500000000,05,15,"Carroll County, AR",Aug-19,13224,12855,369,2.8
16214,CN0501700000000,05,17,"Chicot County, AR",Aug-19,3296,3078,218,6.6
16215,CN0501900000000,05,19,"Clark County, AR",Aug-19,9625,9217,408,4.2
16216,CN0502100000000,05,21,"Clay County, AR",Aug-19,5756,5502,254,4.4
16217,CN0502300000000,05,23,"Cleburne County, AR",Aug-19,9220,8815,405,4.4
16218,CN0502500000000,05,25,"Cleveland County, AR",Aug-19,3218,3092,126,3.9
16219,CN0502700000000,05,27,"Columbia County, AR",Aug-19,8969,8534,435,4.9
16220,CN0502900000000,05,29,"Conway County, AR",Aug-19,8351,7988,363,4.3
16221,CN0503100000000,05,31,"Craighead County, AR",Aug-19,55660,54063,1597,2.9
16222,CN0503300000000,05,33,"Crawford County, AR",Aug-19,27006,26047,959,3.6
16223,CN0503500000000,05,35,"Crittenden County, AR",Aug-19,21685,20740,945,4.4
16224,CN0503700000000,05,37,"Cross County, AR",Aug-19,7573,7263,310,4.1
16225,CN0503900000000,05,39,"Dallas County, AR",Aug-19,2856,2717,139,4.9
16226,CN0504100000000,05,41,"Desha County, AR",Aug-19,5399,5160,239,4.4
16227,CN0504300000000,05,43,"Drew County, AR",Aug-19,7681,7289,392,5.1
16228,CN0504500000000,05,45,"Faulkner County, AR",Aug-19,62701,60760,1941,3.1
16229,CN0504700000000,05,47,"Franklin County, AR",Aug-19,7646,7367,279,3.6
16230,CN0504900000000,05,49,"Fulton County, AR",Aug-19,4874,4674,200,4.1
16231,CN0505100000000,05,51,"Garland County, AR",Aug-19,41798,40210,1588,3.8
16232,CN0505300000000,05,53,"Grant County, AR",Aug-19,8443,8163,280,3.3
16233,CN0505500000000,05,55,"Greene County, AR",Aug-19,19960,19249,711,3.6
16234,CN0505700000000,05,57,"Hempstead County, AR",Aug-19,9829,9437,392,4.0
16235,CN0505900000000,05,59,"Hot Spring County, AR",Aug-19,14150,13604,546,3.9
16236,CN0506100000000,05,61,"Howard County, AR",Aug-19,5700,5516,184,3.2
16237,CN0506300000000,05,63,"Independence County, AR",Aug-19,16059,15363,696,4.3
16238,CN0506500000000,05,65,"Izard County, AR",Aug-19,4918,4658,260,5.3
16239,CN0506700000000,05,67,"Jackson County, AR",Aug-19,5860,5496,364,6.2
16240,CN0506900000000,05,69,"Jefferson County, AR",Aug-19,27737,26183,1554,5.6
16241,CN0507100000000,05,71,"Johnson County, AR",Aug-19,9909,9418,491,5.0
16242,CN0507300000000,05,73,"Lafayette County, AR",Aug-19,2405,2280,125,5.2
16243,CN0507500000000,05,75,"Lawrence County, AR",Aug-19,6669,6366,303,4.5
16244,CN0507700000000,05,77,"Lee County, AR",Aug-19,2863,2730,133,4.6
16245,CN0507900000000,05,79,"Lincoln County, AR",Aug-19,3957,3779,178,4.5
16246,CN0508100000000,05,81,"Little River County, AR",Aug-19,5506,5263,243,4.4
16247,CN0508300000000,05,83,"Logan County, AR",Aug-19,8672,8269,403,4.6
16248,CN0508500000000,05,85,"Lonoke County, AR",Aug-19,34586,33481,1105,3.2
16249,CN0508700000000,05,87,"Madison County, AR",Aug-19,7472,7268,204,2.7
16250,CN0508900000000,05,89,"Marion County, AR",Aug-19,6670,6408,262,3.9
16251,CN0509100000000,05,91,"Miller County, AR",Aug-19,19696,18888,808,4.1
16252,CN0509300000000,05,93,"Mississippi County, AR",Aug-19,17408,16481,927,5.3
16253,CN0509500000000,05,95,"Monroe County, AR",Aug-19,2759,2649,110,4.0
16254,CN0509700000000,05,97,"Montgomery County, AR",Aug-19,2989,2849,140,4.7
16255,CN0509900000000,05,99,"Nevada County, AR",Aug-19,3610,3465,145,4.0
16256,CN0510100000000,05,101,"Newton County, AR",Aug-19,3282,3173,109,3.3
16257,CN0510300000000,05,103,"Ouachita County, AR",Aug-19,9727,9243,484,5.0
16258,CN0510500000000,05,105,"Perry County, AR",Aug-19,4295,4117,178,4.1
16259,CN0510700000000,05,107,"Phillips County, AR",Aug-19,6282,5893,389,6.2
16260,CN0510900000000,05,109,"Pike County, AR",Aug-19,4232,4062,170,4.0
16261,CN0511100000000,05,111,"Poinsett County, AR",Aug-19,10295,9935,360,3.5
16262,CN0511300000000,05,113,"Polk County, AR",Aug-19,8228,7873,355,4.3
16263,CN0511500000000,05,115,"Pope County, AR",Aug-19,28329,27016,1313,4.6
16264,CN0511700000000,05,117,"Prairie County, AR",Aug-19,3620,3484,136,3.8
16265,CN0511900000000,05,119,"Pulaski County, AR",Aug-19,191039,184361,6678,3.5
16266,CN0512100000000,05,121,"Randolph County, AR",Aug-19,7307,7032,275,3.8
16267,CN0512300000000,05,123,"St. Francis County, AR",Aug-19,8298,7883,415,5.0
16268,CN0512500000000,05,125,"Saline County, AR",Aug-19,59380,57636,1744,2.9
16269,CN0512700000000,05,127,"Scott County, AR",Aug-19,4231,4085,146,3.5
16270,CN0512900000000,05,129,"Searcy County, AR",Aug-19,3016,2865,151,5.0
16271,CN0513100000000,05,131,"Sebastian County, AR",Aug-19,56810,54863,1947,3.4
16272,CN0513300000000,05,133,"Sevier County, AR",Aug-19,5594,5305,289,5.2
16273,CN0513500000000,05,135,"Sharp County, AR",Aug-19,5530,5246,284,5.1
16274,CN0513700000000,05,137,"Stone County, AR",Aug-19,4794,4604,190,4.0
16275,CN0513900000000,05,139,"Union County, AR",Aug-19,15785,14938,847,5.4
16276,CN0514100000000,05,141,"Van Buren County, AR",Aug-19,5740,5456,284,4.9
16277,CN0514300000000,05,143,"Washington County, AR",Aug-19,125489,122242,3247,2.6
16278,CN0514500000000,05,145,"White County, AR",Aug-19,33680,32281,1399,4.2
16279,CN0514700000000,05,147,"Woodruff County, AR",Aug-19,2806,2657,149,5.3
16280,CN0514900000000,05,149,"Yell County, AR",Aug-19,8274,7927,347,4.2
16281,CN0600100000000,06,1,"Alameda County, CA",Aug-19,845763,819286,26477,3.1
16282,CN0600300000000,06,3,"Alpine County, CA",Aug-19,479,451,28,5.8
16283,CN0600500000000,06,5,"Amador County, CA",Aug-19,15170,14615,555,3.7
16284,CN0600700000000,06,7,"Butte County, CA",Aug-19,97641,92738,4903,5.0
16285,CN0600900000000,06,9,"Calaveras County, CA",Aug-19,21950,21153,797,3.6
16286,CN0601100000000,06,11,"Colusa County, CA",Aug-19,11554,10634,920,8.0
16287,CN0601300000000,06,13,"Contra Costa County, CA",Aug-19,562586,544361,18225,3.2
16288,CN0601500000000,06,15,"Del Norte County, CA",Aug-19,9804,9249,555,5.7
16289,CN0601700000000,06,17,"El Dorado County, CA",Aug-19,92107,88842,3265,3.5
16290,CN0601900000000,06,19,"Fresno County, CA",Aug-19,452231,422720,29511,6.5
16291,CN0602100000000,06,21,"Glenn County, CA",Aug-19,12900,12128,772,6.0
16292,CN0602300000000,06,23,"Humboldt County, CA",Aug-19,61749,59415,2334,3.8
16293,CN0602500000000,06,25,"Imperial County, CA",Aug-19,72360,56393,15967,22.1
16294,CN0602700000000,06,27,"Inyo County, CA",Aug-19,8906,8615,291,3.3
16295,CN0602900000000,06,29,"Kern County, CA",Aug-19,397036,368204,28832,7.3
16296,CN0603100000000,06,31,"Kings County, CA",Aug-19,57580,53591,3989,6.9
16297,CN0603300000000,06,33,"Lake County, CA",Aug-19,29440,28108,1332,4.5
16298,CN0603500000000,06,35,"Lassen County, CA",Aug-19,9699,9289,410,4.2
16299,CN0603700000000,06,37,"Los Angeles County, CA",Aug-19,5112508,4868200,244308,4.8
16300,CN0603900000000,06,39,"Madera County, CA",Aug-19,61847,57919,3928,6.4
16301,CN0604100000000,06,41,"Marin County, CA",Aug-19,140893,137468,3425,2.4
16302,CN0604300000000,06,43,"Mariposa County, CA",Aug-19,8070,7776,294,3.6
16303,CN0604500000000,06,45,"Mendocino County, CA",Aug-19,39071,37630,1441,3.7
16304,CN0604700000000,06,47,"Merced County, CA",Aug-19,115472,107200,8272,7.2
16305,CN0604900000000,06,49,"Modoc County, CA",Aug-19,3280,3102,178,5.4
16306,CN0605100000000,06,51,"Mono County, CA",Aug-19,8613,8304,309,3.6
16307,CN0605300000000,06,53,"Monterey County, CA",Aug-19,229104,219517,9587,4.2
16308,CN0605500000000,06,55,"Napa County, CA",Aug-19,75369,73364,2005,2.7
16309,CN0605700000000,06,57,"Nevada County, CA",Aug-19,48771,47160,1611,3.3
16310,CN0605900000000,06,59,"Orange County, CA",Aug-19,1617548,1569467,48081,3.0
16311,CN0606100000000,06,61,"Placer County, CA",Aug-19,188158,182133,6025,3.2
16312,CN0606300000000,06,63,"Plumas County, CA",Aug-19,8467,8003,464,5.5
16313,CN0606500000000,06,65,"Riverside County, CA",Aug-19,1101133,1050078,51055,4.6
16314,CN0606700000000,06,67,"Sacramento County, CA",Aug-19,714027,686682,27345,3.8
16315,CN0606900000000,06,69,"San Benito County, CA",Aug-19,31477,30080,1397,4.4
16316,CN0607100000000,06,71,"San Bernardino County, CA",Aug-19,964440,925029,39411,4.1
16317,CN0607300000000,06,73,"San Diego County, CA",Aug-19,1590925,1537267,53658,3.4
16318,CN0607500000000,06,75,"San Francisco County/city, CA",Aug-19,586744,573218,13526,2.3
16319,CN0607700000000,06,77,"San Joaquin County, CA",Aug-19,329199,310576,18623,5.7
16320,CN0607900000000,06,79,"San Luis Obispo County, CA",Aug-19,139474,135294,4180,3.0
16321,CN0608100000000,06,81,"San Mateo County, CA",Aug-19,462827,452850,9977,2.2
16322,CN0608300000000,06,83,"Santa Barbara County, CA",Aug-19,219011,211645,7366,3.4
16323,CN0608500000000,06,85,"Santa Clara County, CA",Aug-19,1058182,1030329,27853,2.6
16324,CN0608700000000,06,87,"Santa Cruz County, CA",Aug-19,143841,138286,5555,3.9
16325,CN0608900000000,06,89,"Shasta County, CA",Aug-19,74708,71482,3226,4.3
16326,CN0609100000000,06,91,"Sierra County, CA",Aug-19,1336,1277,59,4.4
16327,CN0609300000000,06,93,"Siskiyou County, CA",Aug-19,17584,16645,939,5.3
16328,CN0609500000000,06,95,"Solano County, CA",Aug-19,209103,201195,7908,3.8
16329,CN0609700000000,06,97,"Sonoma County, CA",Aug-19,261694,254567,7127,2.7
16330,CN0609900000000,06,99,"Stanislaus County, CA",Aug-19,243873,229821,14052,5.8
16331,CN0610100000000,06,101,"Sutter County, CA",Aug-19,46915,44197,2718,5.8
16332,CN0610300000000,06,103,"Tehama County, CA",Aug-19,25613,24220,1393,5.4
16333,CN0610500000000,06,105,"Trinity County, CA",Aug-19,4920,4703,217,4.4
16334,CN0610700000000,06,107,"Tulare County, CA",Aug-19,205322,186504,18818,9.2
16335,CN0610900000000,06,109,"Tuolumne County, CA",Aug-19,21415,20517,898,4.2
16336,CN0611100000000,06,111,"Ventura County, CA",Aug-19,419649,403492,16157,3.9
16337,CN0611300000000,06,113,"Yolo County, CA",Aug-19,109174,105033,4141,3.8
16338,CN0611500000000,06,115,"Yuba County, CA",Aug-19,30227,28514,1713,5.7
16339,CN0800100000000,08,1,"Adams County, CO",Aug-19,277748,270030,7718,2.8
16340,CN0800300000000,08,3,"Alamosa County, CO",Aug-19,8536,8234,302,3.5
16341,CN0800500000000,08,5,"Arapahoe County, CO",Aug-19,372301,362499,9802,2.6
16342,CN0800700000000,08,7,"Archuleta County, CO",Aug-19,7149,6940,209,2.9
16343,CN0800900000000,08,9,"Baca County, CO",Aug-19,2107,2071,36,1.7
16344,CN0801100000000,08,11,"Bent County, CO",Aug-19,1869,1814,55,2.9
16345,CN0801300000000,08,13,"Boulder County, CO",Aug-19,198688,194068,4620,2.3
16346,CN0801400000000,08,14,"Broomfield County/city, CO",Aug-19,40912,39939,973,2.4
16347,CN0801500000000,08,15,"Chaffee County, CO",Aug-19,10482,10257,225,2.1
16348,CN0801700000000,08,17,"Cheyenne County, CO",Aug-19,1120,1101,19,1.7
16349,CN0801900000000,08,19,"Clear Creek County, CO",Aug-19,6177,6024,153,2.5
16350,CN0802100000000,08,21,"Conejos County, CO",Aug-19,4058,3912,146,3.6
16351,CN0802300000000,08,23,"Costilla County, CO",Aug-19,1908,1844,64,3.4
16352,CN0802500000000,08,25,"Crowley County, CO",Aug-19,1521,1458,63,4.1
16353,CN0802700000000,08,27,"Custer County, CO",Aug-19,2128,2065,63,3.0
16354,CN0802900000000,08,29,"Delta County, CO",Aug-19,14556,14128,428,2.9
16355,CN0803100000000,08,31,"Denver County/city, CO",Aug-19,425520,414428,11092,2.6
16356,CN0803300000000,08,33,"Dolores County, CO",Aug-19,1159,1128,31,2.7
16357,CN0803500000000,08,35,"Douglas County, CO",Aug-19,198266,193634,4632,2.3
16358,CN0803700000000,08,37,"Eagle County, CO",Aug-19,37415,36694,721,1.9
16359,CN0803900000000,08,39,"Elbert County, CO",Aug-19,15427,15103,324,2.1
16360,CN0804100000000,08,41,"El Paso County, CO",Aug-19,344716,333777,10939,3.2
16361,CN0804300000000,08,43,"Fremont County, CO",Aug-19,15541,14862,679,4.4
16362,CN0804500000000,08,45,"Garfield County, CO",Aug-19,33417,32630,787,2.4
16363,CN0804700000000,08,47,"Gilpin County, CO",Aug-19,3855,3775,80,2.1
16364,CN0804900000000,08,49,"Grand County, CO",Aug-19,10318,10131,187,1.8
16365,CN0805100000000,08,51,"Gunnison County, CO",Aug-19,11943,11739,204,1.7
16366,CN0805300000000,08,53,"Hinsdale County, CO",Aug-19,548,529,19,3.5
16367,CN0805500000000,08,55,"Huerfano County, CO",Aug-19,2539,2411,128,5.0
16368,CN0805700000000,08,57,"Jackson County, CO",Aug-19,1020,1001,19,1.9
16369,CN0805900000000,08,59,"Jefferson County, CO",Aug-19,342155,333739,8416,2.5
16370,CN0806100000000,08,61,"Kiowa County, CO",Aug-19,964,949,15,1.6
16371,CN0806300000000,08,63,"Kit Carson County, CO",Aug-19,4310,4236,74,1.7
16372,CN0806500000000,08,65,"Lake County, CO",Aug-19,4918,4803,115,2.3
16373,CN0806700000000,08,67,"La Plata County, CO",Aug-19,32663,31945,718,2.2
16374,CN0806900000000,08,69,"Larimer County, CO",Aug-19,205936,201222,4714,2.3
16375,CN0807100000000,08,71,"Las Animas County, CO",Aug-19,6569,6321,248,3.8
16376,CN0807300000000,08,73,"Lincoln County, CO",Aug-19,2420,2367,53,2.2
16377,CN0807500000000,08,75,"Logan County, CO",Aug-19,10895,10634,261,2.4
16378,CN0807700000000,08,77,"Mesa County, CO",Aug-19,76940,74563,2377,3.1
16379,CN0807900000000,08,79,"Mineral County, CO",Aug-19,535,525,10,1.9
16380,CN0808100000000,08,81,"Moffat County, CO",Aug-19,7374,7176,198,2.7
16381,CN0808300000000,08,83,"Montezuma County, CO",Aug-19,13317,12885,432,3.2
16382,CN0808500000000,08,85,"Montrose County, CO",Aug-19,22020,21432,588,2.7
16383,CN0808700000000,08,87,"Morgan County, CO",Aug-19,16455,16004,451,2.7
16384,CN0808900000000,08,89,"Otero County, CO",Aug-19,8443,8113,330,3.9
16385,CN0809100000000,08,91,"Ouray County, CO",Aug-19,2715,2651,64,2.4
16386,CN0809300000000,08,93,"Park County, CO",Aug-19,11388,11134,254,2.2
16387,CN0809500000000,08,95,"Phillips County, CO",Aug-19,2598,2553,45,1.7
16388,CN0809700000000,08,97,"Pitkin County, CO",Aug-19,11530,11273,257,2.2
16389,CN0809900000000,08,99,"Prowers County, CO",Aug-19,6318,6162,156,2.5
16390,CN0810100000000,08,101,"Pueblo County, CO",Aug-19,76049,73038,3011,4.0
16391,CN0810300000000,08,103,"Rio Blanco County, CO",Aug-19,3015,2916,99,3.3
16392,CN0810500000000,08,105,"Rio Grande County, CO",Aug-19,5499,5277,222,4.0
16393,CN0810700000000,08,107,"Routt County, CO",Aug-19,16649,16329,320,1.9
16394,CN0810900000000,08,109,"Saguache County, CO",Aug-19,3545,3390,155,4.4
16395,CN0811100000000,08,111,"San Juan County, CO",Aug-19,722,709,13,1.8
16396,CN0811300000000,08,113,"San Miguel County, CO",Aug-19,6082,5973,109,1.8
16397,CN0811500000000,08,115,"Sedgwick County, CO",Aug-19,1200,1177,23,1.9
16398,CN0811700000000,08,117,"Summit County, CO",Aug-19,22143,21746,397,1.8
16399,CN0811900000000,08,119,"Teller County, CO",Aug-19,12919,12537,382,3.0
16400,CN0812100000000,08,121,"Washington County, CO",Aug-19,2914,2853,61,2.1
16401,CN0812300000000,08,123,"Weld County, CO",Aug-19,170331,166080,4251,2.5
16402,CN0812500000000,08,125,"Yuma County, CO",Aug-19,5786,5690,96,1.7
16403,CN0900100000000,09,1,"Fairfield County, CT",Aug-19,485911,467958,17953,3.7
16404,CN0900300000000,09,3,"Hartford County, CT",Aug-19,483938,464275,19663,4.1
16405,CN0900500000000,09,5,"Litchfield County, CT",Aug-19,106273,102798,3475,3.3
16406,CN0900700000000,09,7,"Middlesex County, CT",Aug-19,93888,90906,2982,3.2
16407,CN0900900000000,09,9,"New Haven County, CT",Aug-19,463991,445328,18663,4.0
16408,CN0901100000000,09,11,"New London County, CT",Aug-19,139892,134955,4937,3.5
16409,CN0901300000000,09,13,"Tolland County, CT",Aug-19,87017,84160,2857,3.3
16410,CN0901500000000,09,15,"Windham County, CT",Aug-19,64906,62325,2581,4.0
16411,CN1000100000000,10,1,"Kent County, DE",Aug-19,78973,75120,3853,4.9
16412,CN1000300000000,10,3,"New Castle County, DE",Aug-19,298079,285618,12461,4.2
16413,CN1000500000000,10,5,"Sussex County, DE",Aug-19,113772,109852,3920,3.4
16414,CN1100100000000,11,1,District of Columbia,Aug-19,407817,385399,22418,5.5
16415,CN1200100000000,12,1,"Alachua County, FL",Aug-19,136698,132426,4272,3.1
16416,CN1200300000000,12,3,"Baker County, FL",Aug-19,11947,11567,380,3.2
16417,CN1200500000000,12,5,"Bay County, FL",Aug-19,85531,82517,3014,3.5
16418,CN1200700000000,12,7,"Bradford County, FL",Aug-19,11209,10828,381,3.4
16419,CN1200900000000,12,9,"Brevard County, FL",Aug-19,287115,277577,9538,3.3
16420,CN1201100000000,12,11,"Broward County, FL",Aug-19,1046333,1013004,33329,3.2
16421,CN1201300000000,12,13,"Calhoun County, FL",Aug-19,4788,4581,207,4.3
16422,CN1201500000000,12,15,"Charlotte County, FL",Aug-19,71267,68448,2819,4.0
16423,CN1201700000000,12,17,"Citrus County, FL",Aug-19,47414,44998,2416,5.1
16424,CN1201900000000,12,19,"Clay County, FL",Aug-19,108673,105250,3423,3.1
16425,CN1202100000000,12,21,"Collier County, FL",Aug-19,175558,169095,6463,3.7
16426,CN1202300000000,12,23,"Columbia County, FL",Aug-19,30027,29010,1017,3.4
16427,CN1202700000000,12,27,"DeSoto County, FL",Aug-19,13942,13423,519,3.7
16428,CN1202900000000,12,29,"Dixie County, FL",Aug-19,5759,5511,248,4.3
16429,CN1203100000000,12,31,"Duval County, FL",Aug-19,496472,479295,17177,3.5
16430,CN1203300000000,12,33,"Escambia County, FL",Aug-19,147229,142353,4876,3.3
16431,CN1203500000000,12,35,"Flagler County, FL",Aug-19,47249,45355,1894,4.0
16432,CN1203700000000,12,37,"Franklin County, FL",Aug-19,4740,4574,166,3.5
16433,CN1203900000000,12,39,"Gadsden County, FL",Aug-19,18575,17748,827,4.5
16434,CN1204100000000,12,41,"Gilchrist County, FL",Aug-19,7019,6766,253,3.6
16435,CN1204300000000,12,43,"Glades County, FL",Aug-19,5101,4864,237,4.6
16436,CN1204500000000,12,45,"Gulf County, FL",Aug-19,5851,5595,256,4.4
16437,CN1204700000000,12,47,"Hamilton County, FL",Aug-19,4349,4171,178,4.1
16438,CN1204900000000,12,49,"Hardee County, FL",Aug-19,8404,7924,480,5.7
16439,CN1205100000000,12,51,"Hendry County, FL",Aug-19,15090,13863,1227,8.1
16440,CN1205300000000,12,53,"Hernando County, FL",Aug-19,72297,69133,3164,4.4
16441,CN1205500000000,12,55,"Highlands County, FL",Aug-19,35498,33718,1780,5.0
16442,CN1205700000000,12,57,"Hillsborough County, FL",Aug-19,751947,727331,24616,3.3
16443,CN1205900000000,12,59,"Holmes County, FL",Aug-19,6854,6605,249,3.6
16444,CN1206100000000,12,61,"Indian River County, FL",Aug-19,65198,62404,2794,4.3
16445,CN1206300000000,12,63,"Jackson County, FL",Aug-19,17078,16451,627,3.7
16446,CN1206500000000,12,65,"Jefferson County, FL",Aug-19,5538,5345,193,3.5
16447,CN1206700000000,12,67,"Lafayette County, FL",Aug-19,2815,2725,90,3.2
16448,CN1206900000000,12,69,"Lake County, FL",Aug-19,160205,154819,5386,3.4
16449,CN1207100000000,12,71,"Lee County, FL",Aug-19,344870,333213,11657,3.4
16450,CN1207300000000,12,73,"Leon County, FL",Aug-19,153392,148326,5066,3.3
16451,CN1207500000000,12,75,"Levy County, FL",Aug-19,16643,15995,648,3.9
16452,CN1207700000000,12,77,"Liberty County, FL",Aug-19,2606,2516,90,3.5
16453,CN1207900000000,12,79,"Madison County, FL",Aug-19,7539,7244,295,3.9
16454,CN1208100000000,12,81,"Manatee County, FL",Aug-19,178333,172279,6054,3.4
16455,CN1208300000000,12,83,"Marion County, FL",Aug-19,137952,132347,5605,4.1
16456,CN1208500000000,12,85,"Martin County, FL",Aug-19,74133,71626,2507,3.4
16457,CN1208600000000,12,86,"Miami-Dade County, FL",Aug-19,1377292,1341959,35333,2.6
16458,CN1208700000000,12,87,"Monroe County, FL",Aug-19,46583,45583,1000,2.1
16459,CN1208900000000,12,89,"Nassau County, FL",Aug-19,41557,40269,1288,3.1
16460,CN1209100000000,12,91,"Okaloosa County, FL",Aug-19,99066,96369,2697,2.7
16461,CN1209300000000,12,93,"Okeechobee County, FL",Aug-19,17837,17154,683,3.8
16462,CN1209500000000,12,95,"Orange County, FL",Aug-19,769175,745574,23601,3.1
16463,CN1209700000000,12,97,"Osceola County, FL",Aug-19,185995,179531,6464,3.5
16464,CN1209900000000,12,99,"Palm Beach County, FL",Aug-19,733517,707017,26500,3.6
16465,CN1210100000000,12,101,"Pasco County, FL",Aug-19,239031,230286,8745,3.7
16466,CN1210300000000,12,103,"Pinellas County, FL",Aug-19,496511,481009,15502,3.1
16467,CN1210500000000,12,105,"Polk County, FL",Aug-19,308001,295822,12179,4.0
16468,CN1210700000000,12,107,"Putnam County, FL",Aug-19,26633,25423,1210,4.5
16469,CN1210900000000,12,109,"St. Johns County, FL",Aug-19,133356,129699,3657,2.7
16470,CN1211100000000,12,111,"St. Lucie County, FL",Aug-19,145459,139291,6168,4.2
16471,CN1211300000000,12,113,"Santa Rosa County, FL",Aug-19,83686,81123,2563,3.1
16472,CN1211500000000,12,115,"Sarasota County, FL",Aug-19,187494,181287,6207,3.3
16473,CN1211700000000,12,117,"Seminole County, FL",Aug-19,257440,249660,7780,3.0
16474,CN1211900000000,12,119,"Sumter County, FL",Aug-19,32764,31145,1619,4.9
16475,CN1212100000000,12,121,"Suwannee County, FL",Aug-19,18139,17452,687,3.8
16476,CN1212300000000,12,123,"Taylor County, FL",Aug-19,8299,7977,322,3.9
16477,CN1212500000000,12,125,"Union County, FL",Aug-19,4588,4446,142,3.1
16478,CN1212700000000,12,127,"Volusia County, FL",Aug-19,255193,246097,9096,3.6
16479,CN1212900000000,12,129,"Wakulla County, FL",Aug-19,14721,14273,448,3.0
16480,CN1213100000000,12,131,"Walton County, FL",Aug-19,32213,31294,919,2.9
16481,CN1213300000000,12,133,"Washington County, FL",Aug-19,9803,9474,329,3.4
16482,CN1300100000000,13,1,"Appling County, GA",Aug-19,9698,9294,404,4.2
16483,CN1300300000000,13,3,"Atkinson County, GA",Aug-19,4696,4568,128,2.7
16484,CN1300500000000,13,5,"Bacon County, GA",Aug-19,4990,4810,180,3.6
16485,CN1300700000000,13,7,"Baker County, GA",Aug-19,1180,1123,57,4.8
16486,CN1300900000000,13,9,"Baldwin County, GA",Aug-19,17375,16613,762,4.4
16487,CN1301100000000,13,11,"Banks County, GA",Aug-19,9612,9338,274,2.9
16488,CN1301300000000,13,13,"Barrow County, GA",Aug-19,40210,39005,1205,3.0
16489,CN1301500000000,13,15,"Bartow County, GA",Aug-19,50363,48612,1751,3.5
16490,CN1301700000000,13,17,"Ben Hill County, GA",Aug-19,5396,5098,298,5.5
16491,CN1301900000000,13,19,"Berrien County, GA",Aug-19,7425,7130,295,4.0
16492,CN1302100000000,13,21,"Bibb County, GA",Aug-19,67576,64667,2909,4.3
16493,CN1302300000000,13,23,"Bleckley County, GA",Aug-19,4470,4236,234,5.2
16494,CN1302500000000,13,25,"Brantley County, GA",Aug-19,7441,7119,322,4.3
16495,CN1302700000000,13,27,"Brooks County, GA",Aug-19,6977,6725,252,3.6
16496,CN1302900000000,13,29,"Bryan County, GA",Aug-19,18270,17680,590,3.2
16497,CN1303100000000,13,31,"Bulloch County, GA",Aug-19,36586,35137,1449,4.0
16498,CN1303300000000,13,33,"Burke County, GA",Aug-19,9125,8631,494,5.4
16499,CN1303500000000,13,35,"Butts County, GA",Aug-19,10686,10315,371,3.5
16500,CN1303700000000,13,37,"Calhoun County, GA",Aug-19,2279,2193,86,3.8
16501,CN1303900000000,13,39,"Camden County, GA",Aug-19,20841,20031,810,3.9
16502,CN1304300000000,13,43,"Candler County, GA",Aug-19,5614,5446,168,3.0
16503,CN1304500000000,13,45,"Carroll County, GA",Aug-19,55114,53131,1983,3.6
16504,CN1304700000000,13,47,"Catoosa County, GA",Aug-19,33415,32356,1059,3.2
16505,CN1304900000000,13,49,"Charlton County, GA",Aug-19,4829,4619,210,4.3
16506,CN1305100000000,13,51,"Chatham County, GA",Aug-19,139499,134404,5095,3.7
16507,CN1305300000000,13,53,"Chattahoochee County, GA",Aug-19,1977,1883,94,4.8
16508,CN1305500000000,13,55,"Chattooga County, GA",Aug-19,10138,9734,404,4.0
16509,CN1305700000000,13,57,"Cherokee County, GA",Aug-19,135478,131540,3938,2.9
16510,CN1305900000000,13,59,"Clarke County, GA",Aug-19,58443,56184,2259,3.9
16511,CN1306100000000,13,61,"Clay County, GA",Aug-19,922,852,70,7.6
16512,CN1306300000000,13,63,"Clayton County, GA",Aug-19,137369,131072,6297,4.6
16513,CN1306500000000,13,65,"Clinch County, GA",Aug-19,2531,2416,115,4.5
16514,CN1306700000000,13,67,"Cobb County, GA",Aug-19,424024,410532,13492,3.2
16515,CN1306900000000,13,69,"Coffee County, GA",Aug-19,18706,18025,681,3.6
16516,CN1307100000000,13,71,"Colquitt County, GA",Aug-19,21503,20789,714,3.3
16517,CN1307300000000,13,73,"Columbia County, GA",Aug-19,74812,72346,2466,3.3
16518,CN1307500000000,13,75,"Cook County, GA",Aug-19,8032,7741,291,3.6
16519,CN1307700000000,13,77,"Coweta County, GA",Aug-19,74257,71982,2275,3.1
16520,CN1307900000000,13,79,"Crawford County, GA",Aug-19,5585,5373,212,3.8
16521,CN1308100000000,13,81,"Crisp County, GA",Aug-19,9393,9011,382,4.1
16522,CN1308300000000,13,83,"Dade County, GA",Aug-19,8296,7993,303,3.7
16523,CN1308500000000,13,85,"Dawson County, GA",Aug-19,12342,11972,370,3.0
16524,CN1308700000000,13,87,"Decatur County, GA",Aug-19,11513,11037,476,4.1
16525,CN1308900000000,13,89,"DeKalb County, GA",Aug-19,398021,383397,14624,3.7
16526,CN1309100000000,13,91,"Dodge County, GA",Aug-19,7092,6649,443,6.2
16527,CN1309300000000,13,93,"Dooly County, GA",Aug-19,5139,4936,203,4.0
16528,CN1309500000000,13,95,"Dougherty County, GA",Aug-19,38207,36279,1928,5.0
16529,CN1309700000000,13,97,"Douglas County, GA",Aug-19,72991,70244,2747,3.8
16530,CN1309900000000,13,99,"Early County, GA",Aug-19,4429,4252,177,4.0
16531,CN1310100000000,13,101,"Echols County, GA",Aug-19,1925,1871,54,2.8
16532,CN1310300000000,13,103,"Effingham County, GA",Aug-19,30768,29823,945,3.1
16533,CN1310500000000,13,105,"Elbert County, GA",Aug-19,7673,7363,310,4.0
16534,CN1310700000000,13,107,"Emanuel County, GA",Aug-19,8276,7814,462,5.6
16535,CN1310900000000,13,109,"Evans County, GA",Aug-19,4960,4784,176,3.5
16536,CN1311100000000,13,111,"Fannin County, GA",Aug-19,11506,11096,410,3.6
16537,CN1311300000000,13,113,"Fayette County, GA",Aug-19,57748,55893,1855,3.2
16538,CN1311500000000,13,115,"Floyd County, GA",Aug-19,43744,42062,1682,3.8
16539,CN1311700000000,13,117,"Forsyth County, GA",Aug-19,121741,118129,3612,3.0
16540,CN1311900000000,13,119,"Franklin County, GA",Aug-19,9879,9514,365,3.7
16541,CN1312100000000,13,121,"Fulton County, GA",Aug-19,555437,534594,20843,3.8
16542,CN1312300000000,13,123,"Gilmer County, GA",Aug-19,11950,11500,450,3.8
16543,CN1312500000000,13,125,"Glascock County, GA",Aug-19,1282,1227,55,4.3
16544,CN1312700000000,13,127,"Glynn County, GA",Aug-19,39833,38446,1387,3.5
16545,CN1312900000000,13,129,"Gordon County, GA",Aug-19,28071,27109,962,3.4
16546,CN1313100000000,13,131,"Grady County, GA",Aug-19,10429,10020,409,3.9
16547,CN1313300000000,13,133,"Greene County, GA",Aug-19,7063,6786,277,3.9
16548,CN1313500000000,13,135,"Gwinnett County, GA",Aug-19,488676,472828,15848,3.2
16549,CN1313700000000,13,137,"Habersham County, GA",Aug-19,18938,18294,644,3.4
16550,CN1313900000000,13,139,"Hall County, GA",Aug-19,101937,98931,3006,2.9
16551,CN1314100000000,13,141,"Hancock County, GA",Aug-19,2453,2323,130,5.3
16552,CN1314300000000,13,143,"Haralson County, GA",Aug-19,12561,12102,459,3.7
16553,CN1314500000000,13,145,"Harris County, GA",Aug-19,16505,15967,538,3.3
16554,CN1314700000000,13,147,"Hart County, GA",Aug-19,11023,10607,416,3.8
16555,CN1314900000000,13,149,"Heard County, GA",Aug-19,5250,5056,194,3.7
16556,CN1315100000000,13,151,"Henry County, GA",Aug-19,114851,110473,4378,3.8
16557,CN1315300000000,13,153,"Houston County, GA",Aug-19,70030,67517,2513,3.6
16558,CN1315500000000,13,155,"Irwin County, GA",Aug-19,3370,3215,155,4.6
16559,CN1315700000000,13,157,"Jackson County, GA",Aug-19,36221,35203,1018,2.8
16560,CN1315900000000,13,159,"Jasper County, GA",Aug-19,6933,6715,218,3.1
16561,CN1316100000000,13,161,"Jeff Davis County, GA",Aug-19,6055,5739,316,5.2
16562,CN1316300000000,13,163,"Jefferson County, GA",Aug-19,6622,6312,310,4.7
16563,CN1316500000000,13,165,"Jenkins County, GA",Aug-19,3147,2983,164,5.2
16564,CN1316700000000,13,167,"Johnson County, GA",Aug-19,3979,3821,158,4.0
16565,CN1316900000000,13,169,"Jones County, GA",Aug-19,13641,13179,462,3.4
16566,CN1317100000000,13,171,"Lamar County, GA",Aug-19,8231,7893,338,4.1
16567,CN1317300000000,13,173,"Lanier County, GA",Aug-19,3744,3590,154,4.1
16568,CN1317500000000,13,175,"Laurens County, GA",Aug-19,18883,17908,975,5.2
16569,CN1317700000000,13,177,"Lee County, GA",Aug-19,14667,14190,477,3.3
16570,CN1317900000000,13,179,"Liberty County, GA",Aug-19,26110,25018,1092,4.2
16571,CN1318100000000,13,181,"Lincoln County, GA",Aug-19,3557,3412,145,4.1
16572,CN1318300000000,13,183,"Long County, GA",Aug-19,8195,7862,333,4.1
16573,CN1318500000000,13,185,"Lowndes County, GA",Aug-19,50914,48943,1971,3.9
16574,CN1318700000000,13,187,"Lumpkin County, GA",Aug-19,16738,16191,547,3.3
16575,CN1318900000000,13,189,"McDuffie County, GA",Aug-19,8812,8326,486,5.5
16576,CN1319100000000,13,191,"McIntosh County, GA",Aug-19,6273,6033,240,3.8
16577,CN1319300000000,13,193,"Macon County, GA",Aug-19,4714,4484,230,4.9
16578,CN1319500000000,13,195,"Madison County, GA",Aug-19,13191,12751,440,3.3
16579,CN1319700000000,13,197,"Marion County, GA",Aug-19,3290,3142,148,4.5
16580,CN1319900000000,13,199,"Meriwether County, GA",Aug-19,8932,8504,428,4.8
16581,CN1320100000000,13,201,"Miller County, GA",Aug-19,2794,2691,103,3.7
16582,CN1320500000000,13,205,"Mitchell County, GA",Aug-19,8567,8146,421,4.9
16583,CN1320700000000,13,207,"Monroe County, GA",Aug-19,12989,12524,465,3.6
16584,CN1320900000000,13,209,"Montgomery County, GA",Aug-19,3831,3613,218,5.7
16585,CN1321100000000,13,211,"Morgan County, GA",Aug-19,9301,8986,315,3.4
16586,CN1321300000000,13,213,"Murray County, GA",Aug-19,15400,14650,750,4.9
16587,CN1321500000000,13,215,"Muscogee County, GA",Aug-19,76723,72983,3740,4.9
16588,CN1321700000000,13,217,"Newton County, GA",Aug-19,52067,49903,2164,4.2
16589,CN1321900000000,13,219,"Oconee County, GA",Aug-19,19358,18824,534,2.8
16590,CN1322100000000,13,221,"Oglethorpe County, GA",Aug-19,6875,6642,233,3.4
16591,CN1322300000000,13,223,"Paulding County, GA",Aug-19,85554,82855,2699,3.2
16592,CN1322500000000,13,225,"Peach County, GA",Aug-19,11839,11338,501,4.2
16593,CN1322700000000,13,227,"Pickens County, GA",Aug-19,15227,14730,497,3.3
16594,CN1322900000000,13,229,"Pierce County, GA",Aug-19,8756,8444,312,3.6
16595,CN1323100000000,13,231,"Pike County, GA",Aug-19,8905,8614,291,3.3
16596,CN1323300000000,13,233,"Polk County, GA",Aug-19,18344,17657,687,3.7
16597,CN1323500000000,13,235,"Pulaski County, GA",Aug-19,4067,3901,166,4.1
16598,CN1323700000000,13,237,"Putnam County, GA",Aug-19,8216,7855,361,4.4
16599,CN1323900000000,13,239,"Quitman County, GA",Aug-19,804,762,42,5.2
16600,CN1324100000000,13,241,"Rabun County, GA",Aug-19,7327,7072,255,3.5
16601,CN1324300000000,13,243,"Randolph County, GA",Aug-19,2502,2374,128,5.1
16602,CN1324500000000,13,245,"Richmond County, GA",Aug-19,84543,80392,4151,4.9
16603,CN1324700000000,13,247,"Rockdale County, GA",Aug-19,44625,42821,1804,4.0
16604,CN1324900000000,13,249,"Schley County, GA",Aug-19,2211,2119,92,4.2
16605,CN1325100000000,13,251,"Screven County, GA",Aug-19,5085,4833,252,5.0
16606,CN1325300000000,13,253,"Seminole County, GA",Aug-19,3098,2950,148,4.8
16607,CN1325500000000,13,255,"Spalding County, GA",Aug-19,28599,27387,1212,4.2
16608,CN1325700000000,13,257,"Stephens County, GA",Aug-19,10684,10263,421,3.9
16609,CN1325900000000,13,259,"Stewart County, GA",Aug-19,2415,2308,107,4.4
16610,CN1326100000000,13,261,"Sumter County, GA",Aug-19,12710,12079,631,5.0
16611,CN1326300000000,13,263,"Talbot County, GA",Aug-19,2810,2680,130,4.6
16612,CN1326500000000,13,265,"Taliaferro County, GA",Aug-19,568,543,25,4.4
16613,CN1326700000000,13,267,"Tattnall County, GA",Aug-19,9699,9326,373,3.8
16614,CN1326900000000,13,269,"Taylor County, GA",Aug-19,3246,3115,131,4.0
16615,CN1327100000000,13,271,"Telfair County, GA",Aug-19,4043,3569,474,11.7
16616,CN1327300000000,13,273,"Terrell County, GA",Aug-19,3491,3321,170,4.9
16617,CN1327500000000,13,275,"Thomas County, GA",Aug-19,16428,15694,734,4.5
16618,CN1327700000000,13,277,"Tift County, GA",Aug-19,19887,19182,705,3.5
16619,CN1327900000000,13,279,"Toombs County, GA",Aug-19,11728,11124,604,5.2
16620,CN1328100000000,13,281,"Towns County, GA",Aug-19,3975,3775,200,5.0
16621,CN1328300000000,13,283,"Treutlen County, GA",Aug-19,2600,2439,161,6.2
16622,CN1328500000000,13,285,"Troup County, GA",Aug-19,37424,36152,1272,3.4
16623,CN1328700000000,13,287,"Turner County, GA",Aug-19,3142,3021,121,3.9
16624,CN1328900000000,13,289,"Twiggs County, GA",Aug-19,2855,2687,168,5.9
16625,CN1329100000000,13,291,"Union County, GA",Aug-19,10229,9889,340,3.3
16626,CN1329300000000,13,293,"Upson County, GA",Aug-19,11324,10906,418,3.7
16627,CN1329500000000,13,295,"Walker County, GA",Aug-19,31182,30111,1071,3.4
16628,CN1329700000000,13,297,"Walton County, GA",Aug-19,45857,44326,1531,3.3
16629,CN1329900000000,13,299,"Ware County, GA",Aug-19,15604,15021,583,3.7
16630,CN1330100000000,13,301,"Warren County, GA",Aug-19,2813,2689,124,4.4
16631,CN1330300000000,13,303,"Washington County, GA",Aug-19,6977,6674,303,4.3
16632,CN1330500000000,13,305,"Wayne County, GA",Aug-19,11404,10900,504,4.4
16633,CN1330700000000,13,307,"Webster County, GA",Aug-19,998,944,54,5.4
16634,CN1330900000000,13,309,"Wheeler County, GA",Aug-19,1620,1484,136,8.4
16635,CN1331100000000,13,311,"White County, GA",Aug-19,16208,15767,441,2.7
16636,CN1331300000000,13,313,"Whitfield County, GA",Aug-19,43204,41362,1842,4.3
16637,CN1331500000000,13,315,"Wilcox County, GA",Aug-19,2681,2550,131,4.9
16638,CN1331700000000,13,317,"Wilkes County, GA",Aug-19,3863,3689,174,4.5
16639,CN1331900000000,13,319,"Wilkinson County, GA",Aug-19,4043,3879,164,4.1
16640,CN1332100000000,13,321,"Worth County, GA",Aug-19,8898,8534,364,4.1
16641,CN1500100000000,15,1,"Hawaii County, HI",Aug-19,90556,87463,3093,3.4
16642,CN1500300000000,15,3,"Honolulu County/city, HI",Aug-19,448845,437255,11590,2.6
16643,CN1500700000000,15,7,"Kauai County, HI",Aug-19,36821,35876,945,2.6
16644,CN1500900000000,15,9,"Maui County, HI",Aug-19,87484,85291,2193,2.5
16645,CN1600100000000,16,1,"Ada County, ID",Aug-19,255752,249776,5976,2.3
16646,CN1600300000000,16,3,"Adams County, ID",Aug-19,1805,1718,87,4.8
16647,CN1600500000000,16,5,"Bannock County, ID",Aug-19,41837,40793,1044,2.5
16648,CN1600700000000,16,7,"Bear Lake County, ID",Aug-19,3081,3017,64,2.1
16649,CN1600900000000,16,9,"Benewah County, ID",Aug-19,4204,4040,164,3.9
16650,CN1601100000000,16,11,"Bingham County, ID",Aug-19,24006,23402,604,2.5
16651,CN1601300000000,16,13,"Blaine County, ID",Aug-19,12816,12567,249,1.9
16652,CN1601500000000,16,15,"Boise County, ID",Aug-19,3522,3394,128,3.6
16653,CN1601700000000,16,17,"Bonner County, ID",Aug-19,20556,19895,661,3.2
16654,CN1601900000000,16,19,"Bonneville County, ID",Aug-19,57439,56249,1190,2.1
16655,CN1602100000000,16,21,"Boundary County, ID",Aug-19,5524,5342,182,3.3
16656,CN1602300000000,16,23,"Butte County, ID",Aug-19,1419,1389,30,2.1
16657,CN1602500000000,16,25,"Camas County, ID",Aug-19,719,703,16,2.2
16658,CN1602700000000,16,27,"Canyon County, ID",Aug-19,105699,102618,3081,2.9
16659,CN1602900000000,16,29,"Caribou County, ID",Aug-19,4227,4133,94,2.2
16660,CN1603100000000,16,31,"Cassia County, ID",Aug-19,12410,12146,264,2.1
16661,CN1603300000000,16,33,"Clark County, ID",Aug-19,392,378,14,3.6
16662,CN1603500000000,16,35,"Clearwater County, ID",Aug-19,2969,2821,148,5.0
16663,CN1603700000000,16,37,"Custer County, ID",Aug-19,2567,2496,71,2.8
16664,CN1603900000000,16,39,"Elmore County, ID",Aug-19,11905,11558,347,2.9
16665,CN1604100000000,16,41,"Franklin County, ID",Aug-19,6789,6663,126,1.9
16666,CN1604300000000,16,43,"Fremont County, ID",Aug-19,7348,7223,125,1.7
16667,CN1604500000000,16,45,"Gem County, ID",Aug-19,8377,8133,244,2.9
16668,CN1604700000000,16,47,"Gooding County, ID",Aug-19,8326,8139,187,2.2
16669,CN1604900000000,16,49,"Idaho County, ID",Aug-19,6819,6568,251,3.7
16670,CN1605100000000,16,51,"Jefferson County, ID",Aug-19,14223,13933,290,2.0
16671,CN1605300000000,16,53,"Jerome County, ID",Aug-19,12206,11948,258,2.1
16672,CN1605500000000,16,55,"Kootenai County, ID",Aug-19,81725,79406,2319,2.8
16673,CN1605700000000,16,57,"Latah County, ID",Aug-19,19907,19467,440,2.2
16674,CN1605900000000,16,59,"Lemhi County, ID",Aug-19,3849,3712,137,3.6
16675,CN1606100000000,16,61,"Lewis County, ID",Aug-19,1746,1655,91,5.2
16676,CN1606300000000,16,63,"Lincoln County, ID",Aug-19,2783,2717,66,2.4
16677,CN1606500000000,16,65,"Madison County, ID",Aug-19,20391,20076,315,1.5
16678,CN1606700000000,16,67,"Minidoka County, ID",Aug-19,11575,11313,262,2.3
16679,CN1606900000000,16,69,"Nez Perce County, ID",Aug-19,20988,20468,520,2.5
16680,CN1607100000000,16,71,"Oneida County, ID",Aug-19,2334,2298,36,1.5
16681,CN1607300000000,16,73,"Owyhee County, ID",Aug-19,5729,5576,153,2.7
16682,CN1607500000000,16,75,"Payette County, ID",Aug-19,11771,11356,415,3.5
16683,CN1607700000000,16,77,"Power County, ID",Aug-19,4122,4008,114,2.8
16684,CN1607900000000,16,79,"Shoshone County, ID",Aug-19,5153,4911,242,4.7
16685,CN1608100000000,16,81,"Teton County, ID",Aug-19,7429,7324,105,1.4
16686,CN1608300000000,16,83,"Twin Falls County, ID",Aug-19,41525,40510,1015,2.4
16687,CN1608500000000,16,85,"Valley County, ID",Aug-19,6022,5872,150,2.5
16688,CN1608700000000,16,87,"Washington County, ID",Aug-19,4680,4497,183,3.9
16689,CN1700100000000,17,1,"Adams County, IL",Aug-19,32172,31088,1084,3.4
16690,CN1700300000000,17,3,"Alexander County, IL",Aug-19,2020,1890,130,6.4
16691,CN1700500000000,17,5,"Bond County, IL",Aug-19,7868,7566,302,3.8
16692,CN1700700000000,17,7,"Boone County, IL",Aug-19,26364,24927,1437,5.5
16693,CN1700900000000,17,9,"Brown County, IL",Aug-19,3034,2959,75,2.5
16694,CN1701100000000,17,11,"Bureau County, IL",Aug-19,17525,16783,742,4.2
16695,CN1701300000000,17,13,"Calhoun County, IL",Aug-19,2330,2232,98,4.2
16696,CN1701500000000,17,15,"Carroll County, IL",Aug-19,7454,7182,272,3.6
16697,CN1701700000000,17,17,"Cass County, IL",Aug-19,6134,5900,234,3.8
16698,CN1701900000000,17,19,"Champaign County, IL",Aug-19,103297,99268,4029,3.9
16699,CN1702100000000,17,21,"Christian County, IL",Aug-19,14731,14030,701,4.8
16700,CN1702300000000,17,23,"Clark County, IL",Aug-19,7675,7349,326,4.2
16701,CN1702500000000,17,25,"Clay County, IL",Aug-19,6507,6207,300,4.6
16702,CN1702700000000,17,27,"Clinton County, IL",Aug-19,20547,19946,601,2.9
16703,CN1702900000000,17,29,"Coles County, IL",Aug-19,22867,21931,936,4.1
16704,CN1703100000000,17,31,"Cook County, IL",Aug-19,2610328,2506421,103907,4.0
16705,CN1703300000000,17,33,"Crawford County, IL",Aug-19,8621,8253,368,4.3
16706,CN1703500000000,17,35,"Cumberland County, IL",Aug-19,6058,5873,185,3.1
16707,CN1703700000000,17,37,"DeKalb County, IL",Aug-19,55302,53115,2187,4.0
16708,CN1703900000000,17,39,"De Witt County, IL",Aug-19,7412,7108,304,4.1
16709,CN1704100000000,17,41,"Douglas County, IL",Aug-19,10132,9750,382,3.8
16710,CN1704300000000,17,43,"DuPage County, IL",Aug-19,510111,494992,15119,3.0
16711,CN1704500000000,17,45,"Edgar County, IL",Aug-19,8980,8609,371,4.1
16712,CN1704700000000,17,47,"Edwards County, IL",Aug-19,2705,2598,107,4.0
16713,CN1704900000000,17,49,"Effingham County, IL",Aug-19,19376,18781,595,3.1
16714,CN1705100000000,17,51,"Fayette County, IL",Aug-19,9908,9497,411,4.1
16715,CN1705300000000,17,53,"Ford County, IL",Aug-19,6236,5965,271,4.3
16716,CN1705500000000,17,55,"Franklin County, IL",Aug-19,16335,15428,907,5.6
16717,CN1705700000000,17,57,"Fulton County, IL",Aug-19,15278,14469,809,5.3
16718,CN1705900000000,17,59,"Gallatin County, IL",Aug-19,2330,2210,120,5.2
16719,CN1706100000000,17,61,"Greene County, IL",Aug-19,6094,5822,272,4.5
16720,CN1706300000000,17,63,"Grundy County, IL",Aug-19,25484,24436,1048,4.1
16721,CN1706500000000,17,65,"Hamilton County, IL",Aug-19,4306,4140,166,3.9
16722,CN1706700000000,17,67,"Hancock County, IL",Aug-19,8451,8041,410,4.9
16723,CN1706900000000,17,69,"Hardin County, IL",Aug-19,1308,1221,87,6.7
16724,CN1707100000000,17,71,"Henderson County, IL",Aug-19,3697,3512,185,5.0
16725,CN1707300000000,17,73,"Henry County, IL",Aug-19,25379,24267,1112,4.4
16726,CN1707500000000,17,75,"Iroquois County, IL",Aug-19,14480,13916,564,3.9
16727,CN1707700000000,17,77,"Jackson County, IL",Aug-19,27525,26467,1058,3.8
16728,CN1707900000000,17,79,"Jasper County, IL",Aug-19,4745,4558,187,3.9
16729,CN1708100000000,17,81,"Jefferson County, IL",Aug-19,17374,16546,828,4.8
16730,CN1708300000000,17,83,"Jersey County, IL",Aug-19,11019,10550,469,4.3
16731,CN1708500000000,17,85,"Jo Daviess County, IL",Aug-19,11018,10642,376,3.4
16732,CN1708700000000,17,87,"Johnson County, IL",Aug-19,4003,3774,229,5.7
16733,CN1708900000000,17,89,"Kane County, IL",Aug-19,273033,261881,11152,4.1
16734,CN1709100000000,17,91,"Kankakee County, IL",Aug-19,55978,53415,2563,4.6
16735,CN1709300000000,17,93,"Kendall County, IL",Aug-19,68900,66710,2190,3.2
16736,CN1709500000000,17,95,"Knox County, IL",Aug-19,22069,21037,1032,4.7
16737,CN1709700000000,17,97,"Lake County, IL",Aug-19,379473,365218,14255,3.8
16738,CN1709900000000,17,99,"LaSalle County, IL",Aug-19,54734,52090,2644,4.8
16739,CN1710100000000,17,101,"Lawrence County, IL",Aug-19,5846,5542,304,5.2
16740,CN1710300000000,17,103,"Lee County, IL",Aug-19,17754,17075,679,3.8
16741,CN1710500000000,17,105,"Livingston County, IL",Aug-19,16867,16236,631,3.7
16742,CN1710700000000,17,107,"Logan County, IL",Aug-19,12684,12124,560,4.4
16743,CN1710900000000,17,109,"McDonough County, IL",Aug-19,12747,12138,609,4.8
16744,CN1711100000000,17,111,"McHenry County, IL",Aug-19,166043,160824,5219,3.1
16745,CN1711300000000,17,113,"McLean County, IL",Aug-19,87382,84057,3325,3.8
16746,CN1711500000000,17,115,"Macon County, IL",Aug-19,49107,46445,2662,5.4
16747,CN1711700000000,17,117,"Macoupin County, IL",Aug-19,23106,22171,935,4.0
16748,CN1711900000000,17,119,"Madison County, IL",Aug-19,134904,129524,5380,4.0
16749,CN1712100000000,17,121,"Marion County, IL",Aug-19,17536,16734,802,4.6
16750,CN1712300000000,17,123,"Marshall County, IL",Aug-19,5399,5167,232,4.3
16751,CN1712500000000,17,125,"Mason County, IL",Aug-19,6441,6105,336,5.2
16752,CN1712700000000,17,127,"Massac County, IL",Aug-19,5673,5356,317,5.6
16753,CN1712900000000,17,129,"Menard County, IL",Aug-19,6624,6407,217,3.3
16754,CN1713100000000,17,131,"Mercer County, IL",Aug-19,8210,7858,352,4.3
16755,CN1713300000000,17,133,"Monroe County, IL",Aug-19,18896,18303,593,3.1
16756,CN1713500000000,17,135,"Montgomery County, IL",Aug-19,11804,11238,566,4.8
16757,CN1713700000000,17,137,"Morgan County, IL",Aug-19,16664,16003,661,4.0
16758,CN1713900000000,17,139,"Moultrie County, IL",Aug-19,7710,7449,261,3.4
16759,CN1714100000000,17,141,"Ogle County, IL",Aug-19,25061,23955,1106,4.4
16760,CN1714300000000,17,143,"Peoria County, IL",Aug-19,86041,81654,4387,5.1
16761,CN1714500000000,17,145,"Perry County, IL",Aug-19,8291,7870,421,5.1
16762,CN1714700000000,17,147,"Piatt County, IL",Aug-19,8221,7926,295,3.6
16763,CN1714900000000,17,149,"Pike County, IL",Aug-19,7109,6838,271,3.8
16764,CN1715100000000,17,151,"Pope County, IL",Aug-19,1670,1577,93,5.6
16765,CN1715300000000,17,153,"Pulaski County, IL",Aug-19,1995,1866,129,6.5
16766,CN1715500000000,17,155,"Putnam County, IL",Aug-19,3045,2916,129,4.2
16767,CN1715700000000,17,157,"Randolph County, IL",Aug-19,14599,14113,486,3.3
16768,CN1715900000000,17,159,"Richland County, IL",Aug-19,7247,6949,298,4.1
16769,CN1716100000000,17,161,"Rock Island County, IL",Aug-19,72268,68855,3413,4.7
16770,CN1716300000000,17,163,"St. Clair County, IL",Aug-19,127427,121468,5959,4.7
16771,CN1716500000000,17,165,"Saline County, IL",Aug-19,9609,9085,524,5.5
16772,CN1716700000000,17,167,"Sangamon County, IL",Aug-19,103213,99071,4142,4.0
16773,CN1716900000000,17,169,"Schuyler County, IL",Aug-19,3314,3174,140,4.2
16774,CN1717100000000,17,171,"Scott County, IL",Aug-19,2571,2460,111,4.3
16775,CN1717300000000,17,173,"Shelby County, IL",Aug-19,10751,10353,398,3.7
16776,CN1717500000000,17,175,"Stark County, IL",Aug-19,2585,2448,137,5.3
16777,CN1717700000000,17,177,"Stephenson County, IL",Aug-19,21993,21031,962,4.4
16778,CN1717900000000,17,179,"Tazewell County, IL",Aug-19,64633,61847,2786,4.3
16779,CN1718100000000,17,181,"Union County, IL",Aug-19,7385,7016,369,5.0
16780,CN1718300000000,17,183,"Vermilion County, IL",Aug-19,33052,31224,1828,5.5
16781,CN1718500000000,17,185,"Wabash County, IL",Aug-19,5871,5637,234,4.0
16782,CN1718700000000,17,187,"Warren County, IL",Aug-19,8392,8062,330,3.9
16783,CN1718900000000,17,189,"Washington County, IL",Aug-19,10293,10054,239,2.3
16784,CN1719100000000,17,191,"Wayne County, IL",Aug-19,7004,6667,337,4.8
16785,CN1719300000000,17,193,"White County, IL",Aug-19,6626,6364,262,4.0
16786,CN1719500000000,17,195,"Whiteside County, IL",Aug-19,28873,27657,1216,4.2
16787,CN1719700000000,17,197,"Will County, IL",Aug-19,358689,345294,13395,3.7
16788,CN1719900000000,17,199,"Williamson County, IL",Aug-19,31516,30116,1400,4.4
16789,CN1720100000000,17,201,"Winnebago County, IL",Aug-19,140805,132318,8487,6.0
16790,CN1720300000000,17,203,"Woodford County, IL",Aug-19,19036,18330,706,3.7
16791,CN1800100000000,18,1,"Adams County, IN",Aug-19,17361,16862,499,2.9
16792,CN1800300000000,18,3,"Allen County, IN",Aug-19,187094,181136,5958,3.2
16793,CN1800500000000,18,5,"Bartholomew County, IN",Aug-19,45408,44281,1127,2.5
16794,CN1800700000000,18,7,"Benton County, IN",Aug-19,4460,4317,143,3.2
16795,CN1800900000000,18,9,"Blackford County, IN",Aug-19,4937,4748,189,3.8
16796,CN1801100000000,18,11,"Boone County, IN",Aug-19,36768,35821,947,2.6
16797,CN1801300000000,18,13,"Brown County, IN",Aug-19,7814,7590,224,2.9
16798,CN1801500000000,18,15,"Carroll County, IN",Aug-19,10004,9703,301,3.0
16799,CN1801700000000,18,17,"Cass County, IN",Aug-19,17872,17296,576,3.2
16800,CN1801900000000,18,19,"Clark County, IN",Aug-19,62066,59944,2122,3.4
16801,CN1802100000000,18,21,"Clay County, IN",Aug-19,12081,11600,481,4.0
16802,CN1802300000000,18,23,"Clinton County, IN",Aug-19,17239,16765,474,2.7
16803,CN1802500000000,18,25,"Crawford County, IN",Aug-19,4942,4751,191,3.9
16804,CN1802700000000,18,27,"Daviess County, IN",Aug-19,16876,16428,448,2.7
16805,CN1802900000000,18,29,"Dearborn County, IN",Aug-19,26014,25069,945,3.6
16806,CN1803100000000,18,31,"Decatur County, IN",Aug-19,15132,14705,427,2.8
16807,CN1803300000000,18,33,"DeKalb County, IN",Aug-19,22789,22138,651,2.9
16808,CN1803500000000,18,35,"Delaware County, IN",Aug-19,52654,50498,2156,4.1
16809,CN1803700000000,18,37,"Dubois County, IN",Aug-19,23218,22644,574,2.5
16810,CN1803900000000,18,39,"Elkhart County, IN",Aug-19,112661,109048,3613,3.2
16811,CN1804100000000,18,41,"Fayette County, IN",Aug-19,8716,8265,451,5.2
16812,CN1804300000000,18,43,"Floyd County, IN",Aug-19,41867,40546,1321,3.2
16813,CN1804500000000,18,45,"Fountain County, IN",Aug-19,8092,7816,276,3.4
16814,CN1804700000000,18,47,"Franklin County, IN",Aug-19,11535,11143,392,3.4
16815,CN1804900000000,18,49,"Fulton County, IN",Aug-19,10009,9701,308,3.1
16816,CN1805100000000,18,51,"Gibson County, IN",Aug-19,19579,19086,493,2.5
16817,CN1805300000000,18,53,"Grant County, IN",Aug-19,30899,29686,1213,3.9
16818,CN1805500000000,18,55,"Greene County, IN",Aug-19,13526,12985,541,4.0
16819,CN1805700000000,18,57,"Hamilton County, IN",Aug-19,186198,181273,4925,2.6
16820,CN1805900000000,18,59,"Hancock County, IN",Aug-19,40794,39599,1195,2.9
16821,CN1806100000000,18,61,"Harrison County, IN",Aug-19,20418,19767,651,3.2
16822,CN1806300000000,18,63,"Hendricks County, IN",Aug-19,91126,88561,2565,2.8
16823,CN1806500000000,18,65,"Henry County, IN",Aug-19,22366,21656,710,3.2
16824,CN1806700000000,18,67,"Howard County, IN",Aug-19,37037,35670,1367,3.7
16825,CN1806900000000,18,69,"Huntington County, IN",Aug-19,18481,17905,576,3.1
16826,CN1807100000000,18,71,"Jackson County, IN",Aug-19,23098,22459,639,2.8
16827,CN1807300000000,18,73,"Jasper County, IN",Aug-19,16386,15824,562,3.4
16828,CN1807500000000,18,75,"Jay County, IN",Aug-19,9603,9316,287,3.0
16829,CN1807700000000,18,77,"Jefferson County, IN",Aug-19,14930,14395,535,3.6
16830,CN1807900000000,18,79,"Jennings County, IN",Aug-19,13667,13254,413,3.0
16831,CN1808100000000,18,81,"Johnson County, IN",Aug-19,84017,81692,2325,2.8
16832,CN1808300000000,18,83,"Knox County, IN",Aug-19,18498,17889,609,3.3
16833,CN1808500000000,18,85,"Kosciusko County, IN",Aug-19,42477,41254,1223,2.9
16834,CN1808700000000,18,87,"LaGrange County, IN",Aug-19,20035,19449,586,2.9
16835,CN1808900000000,18,89,"Lake County, IN",Aug-19,231891,221144,10747,4.6
16836,CN1809100000000,18,91,"LaPorte County, IN",Aug-19,47782,45852,1930,4.0
16837,CN1809300000000,18,93,"Lawrence County, IN",Aug-19,21074,20339,735,3.5
16838,CN1809500000000,18,95,"Madison County, IN",Aug-19,59797,57662,2135,3.6
16839,CN1809700000000,18,97,"Marion County, IN",Aug-19,497018,480268,16750,3.4
16840,CN1809900000000,18,99,"Marshall County, IN",Aug-19,23248,22520,728,3.1
16841,CN1810100000000,18,101,"Martin County, IN",Aug-19,5434,5284,150,2.8
16842,CN1810300000000,18,103,"Miami County, IN",Aug-19,15467,14886,581,3.8
16843,CN1810500000000,18,105,"Monroe County, IN",Aug-19,67477,64931,2546,3.8
16844,CN1810700000000,18,107,"Montgomery County, IN",Aug-19,18918,18306,612,3.2
16845,CN1810900000000,18,109,"Morgan County, IN",Aug-19,36808,35676,1132,3.1
16846,CN1811100000000,18,111,"Newton County, IN",Aug-19,7027,6752,275,3.9
16847,CN1811300000000,18,113,"Noble County, IN",Aug-19,23881,23130,751,3.1
16848,CN1811500000000,18,115,"Ohio County, IN",Aug-19,3204,3097,107,3.3
16849,CN1811700000000,18,117,"Orange County, IN",Aug-19,8661,8357,304,3.5
16850,CN1811900000000,18,119,"Owen County, IN",Aug-19,9026,8652,374,4.1
16851,CN1812100000000,18,121,"Parke County, IN",Aug-19,7267,6980,287,3.9
16852,CN1812300000000,18,123,"Perry County, IN",Aug-19,9386,9087,299,3.2
16853,CN1812500000000,18,125,"Pike County, IN",Aug-19,6208,6009,199,3.2
16854,CN1812700000000,18,127,"Porter County, IN",Aug-19,87562,84334,3228,3.7
16855,CN1812900000000,18,129,"Posey County, IN",Aug-19,13641,13249,392,2.9
16856,CN1813100000000,18,131,"Pulaski County, IN",Aug-19,6554,6358,196,3.0
16857,CN1813300000000,18,133,"Putnam County, IN",Aug-19,17065,16402,663,3.9
16858,CN1813500000000,18,135,"Randolph County, IN",Aug-19,11235,10815,420,3.7
16859,CN1813700000000,18,137,"Ripley County, IN",Aug-19,14263,13799,464,3.3
16860,CN1813900000000,18,139,"Rush County, IN",Aug-19,9102,8857,245,2.7
16861,CN1814100000000,18,141,"St. Joseph County, IN",Aug-19,134613,129485,5128,3.8
16862,CN1814300000000,18,143,"Scott County, IN",Aug-19,10620,10237,383,3.6
16863,CN1814500000000,18,145,"Shelby County, IN",Aug-19,23470,22761,709,3.0
16864,CN1814700000000,18,147,"Spencer County, IN",Aug-19,11065,10734,331,3.0
16865,CN1814900000000,18,149,"Starke County, IN",Aug-19,9969,9549,420,4.2
16866,CN1815100000000,18,151,"Steuben County, IN",Aug-19,21038,20466,572,2.7
16867,CN1815300000000,18,153,"Sullivan County, IN",Aug-19,8342,8011,331,4.0
16868,CN1815500000000,18,155,"Switzerland County, IN",Aug-19,5049,4881,168,3.3
16869,CN1815700000000,18,157,"Tippecanoe County, IN",Aug-19,96497,93372,3125,3.2
16870,CN1815900000000,18,159,"Tipton County, IN",Aug-19,9386,9139,247,2.6
16871,CN1816100000000,18,161,"Union County, IN",Aug-19,3580,3463,117,3.3
16872,CN1816300000000,18,163,"Vanderburgh County, IN",Aug-19,94563,91566,2997,3.2
16873,CN1816500000000,18,165,"Vermillion County, IN",Aug-19,6963,6622,341,4.9
16874,CN1816700000000,18,167,"Vigo County, IN",Aug-19,48075,46023,2052,4.3
16875,CN1816900000000,18,169,"Wabash County, IN",Aug-19,14784,14317,467,3.2
16876,CN1817100000000,18,171,"Warren County, IN",Aug-19,4242,4106,136,3.2
16877,CN1817300000000,18,173,"Warrick County, IN",Aug-19,33072,32099,973,2.9
16878,CN1817500000000,18,175,"Washington County, IN",Aug-19,13802,13344,458,3.3
16879,CN1817700000000,18,177,"Wayne County, IN",Aug-19,30611,29481,1130,3.7
16880,CN1817900000000,18,179,"Wells County, IN",Aug-19,14513,14137,376,2.6
16881,CN1818100000000,18,181,"White County, IN",Aug-19,13606,13247,359,2.6
16882,CN1818300000000,18,183,"Whitley County, IN",Aug-19,17891,17366,525,2.9
16883,CN1900100000000,19,1,"Adair County, IA",Aug-19,4319,4230,89,2.1
16884,CN1900300000000,19,3,"Adams County, IA",Aug-19,2228,2197,31,1.4
16885,CN1900500000000,19,5,"Allamakee County, IA",Aug-19,7398,7200,198,2.7
16886,CN1900700000000,19,7,"Appanoose County, IA",Aug-19,6063,5814,249,4.1
16887,CN1900900000000,19,9,"Audubon County, IA",Aug-19,3168,3092,76,2.4
16888,CN1901100000000,19,11,"Benton County, IA",Aug-19,13835,13437,398,2.9
16889,CN1901300000000,19,13,"Black Hawk County, IA",Aug-19,70330,67465,2865,4.1
16890,CN1901500000000,19,15,"Boone County, IA",Aug-19,14976,14635,341,2.3
16891,CN1901700000000,19,17,"Bremer County, IA",Aug-19,14008,13660,348,2.5
16892,CN1901900000000,19,19,"Buchanan County, IA",Aug-19,11592,11286,306,2.6
16893,CN1902100000000,19,21,"Buena Vista County, IA",Aug-19,11541,11265,276,2.4
16894,CN1902300000000,19,23,"Butler County, IA",Aug-19,7953,7722,231,2.9
16895,CN1902500000000,19,25,"Calhoun County, IA",Aug-19,4255,4158,97,2.3
16896,CN1902700000000,19,27,"Carroll County, IA",Aug-19,11256,11039,217,1.9
16897,CN1902900000000,19,29,"Cass County, IA",Aug-19,6962,6787,175,2.5
16898,CN1903100000000,19,31,"Cedar County, IA",Aug-19,10916,10662,254,2.3
16899,CN1903300000000,19,33,"Cerro Gordo County, IA",Aug-19,24107,23454,653,2.7
16900,CN1903500000000,19,35,"Cherokee County, IA",Aug-19,6281,6117,164,2.6
16901,CN1903700000000,19,37,"Chickasaw County, IA",Aug-19,6527,6351,176,2.7
16902,CN1903900000000,19,39,"Clarke County, IA",Aug-19,5008,4886,122,2.4
16903,CN1904100000000,19,41,"Clay County, IA",Aug-19,8592,8385,207,2.4
16904,CN1904300000000,19,43,"Clayton County, IA",Aug-19,10351,10103,248,2.4
16905,CN1904500000000,19,45,"Clinton County, IA",Aug-19,23451,22502,949,4.0
16906,CN1904700000000,19,47,"Crawford County, IA",Aug-19,8244,7982,262,3.2
16907,CN1904900000000,19,49,"Dallas County, IA",Aug-19,51218,50213,1005,2.0
16908,CN1905100000000,19,51,"Davis County, IA",Aug-19,4249,4090,159,3.7
16909,CN1905300000000,19,53,"Decatur County, IA",Aug-19,4300,4200,100,2.3
16910,CN1905500000000,19,55,"Delaware County, IA",Aug-19,10734,10491,243,2.3
16911,CN1905700000000,19,57,"Des Moines County, IA",Aug-19,19943,19051,892,4.5
16912,CN1905900000000,19,59,"Dickinson County, IA",Aug-19,11303,11074,229,2.0
16913,CN1906100000000,19,61,"Dubuque County, IA",Aug-19,57018,55528,1490,2.6
16914,CN1906300000000,19,63,"Emmet County, IA",Aug-19,5338,5218,120,2.2
16915,CN1906500000000,19,65,"Fayette County, IA",Aug-19,10160,9814,346,3.4
16916,CN1906700000000,19,67,"Floyd County, IA",Aug-19,9217,8837,380,4.1
16917,CN1906900000000,19,69,"Franklin County, IA",Aug-19,5760,5637,123,2.1
16918,CN1907100000000,19,71,"Fremont County, IA",Aug-19,3763,3652,111,2.9
16919,CN1907300000000,19,73,"Greene County, IA",Aug-19,5428,5297,131,2.4
16920,CN1907500000000,19,75,"Grundy County, IA",Aug-19,6556,6385,171,2.6
16921,CN1907700000000,19,77,"Guthrie County, IA",Aug-19,5752,5604,148,2.6
16922,CN1907900000000,19,79,"Hamilton County, IA",Aug-19,6937,6753,184,2.7
16923,CN1908100000000,19,81,"Hancock County, IA",Aug-19,6067,5916,151,2.5
16924,CN1908300000000,19,83,"Hardin County, IA",Aug-19,8162,7919,243,3.0
16925,CN1908500000000,19,85,"Harrison County, IA",Aug-19,7543,7375,168,2.2
16926,CN1908700000000,19,87,"Henry County, IA",Aug-19,9804,9509,295,3.0
16927,CN1908900000000,19,89,"Howard County, IA",Aug-19,5231,5114,117,2.2
16928,CN1909100000000,19,91,"Humboldt County, IA",Aug-19,5160,5040,120,2.3
16929,CN1909300000000,19,93,"Ida County, IA",Aug-19,4129,4062,67,1.6
16930,CN1909500000000,19,95,"Iowa County, IA",Aug-19,10674,10484,190,1.8
16931,CN1909700000000,19,97,"Jackson County, IA",Aug-19,11197,10871,326,2.9
16932,CN1909900000000,19,99,"Jasper County, IA",Aug-19,20118,19560,558,2.8
16933,CN1910100000000,19,101,"Jefferson County, IA",Aug-19,10037,9755,282,2.8
16934,CN1910300000000,19,103,"Johnson County, IA",Aug-19,89125,87201,1924,2.2
16935,CN1910500000000,19,105,"Jones County, IA",Aug-19,10875,10601,274,2.5
16936,CN1910700000000,19,107,"Keokuk County, IA",Aug-19,5307,5139,168,3.2
16937,CN1910900000000,19,109,"Kossuth County, IA",Aug-19,8496,8307,189,2.2
16938,CN1911100000000,19,111,"Lee County, IA",Aug-19,16373,15553,820,5.0
16939,CN1911300000000,19,113,"Linn County, IA",Aug-19,125510,121702,3808,3.0
16940,CN1911500000000,19,115,"Louisa County, IA",Aug-19,6229,6022,207,3.3
16941,CN1911700000000,19,117,"Lucas County, IA",Aug-19,4693,4590,103,2.2
16942,CN1911900000000,19,119,"Lyon County, IA",Aug-19,7195,7103,92,1.3
16943,CN1912100000000,19,121,"Madison County, IA",Aug-19,8806,8536,270,3.1
16944,CN1912300000000,19,123,"Mahaska County, IA",Aug-19,11961,11640,321,2.7
16945,CN1912500000000,19,125,"Marion County, IA",Aug-19,18630,18254,376,2.0
16946,CN1912700000000,19,127,"Marshall County, IA",Aug-19,18191,17546,645,3.5
16947,CN1912900000000,19,129,"Mills County, IA",Aug-19,7593,7420,173,2.3
16948,CN1913100000000,19,131,"Mitchell County, IA",Aug-19,7483,7372,111,1.5
16949,CN1913300000000,19,133,"Monona County, IA",Aug-19,4486,4352,134,3.0
16950,CN1913500000000,19,135,"Monroe County, IA",Aug-19,4121,3988,133,3.2
16951,CN1913700000000,19,137,"Montgomery County, IA",Aug-19,5044,4911,133,2.6
16952,CN1913900000000,19,139,"Muscatine County, IA",Aug-19,22530,21917,613,2.7
16953,CN1914100000000,19,141,"O'Brien County, IA",Aug-19,8346,8179,167,2.0
16954,CN1914300000000,19,143,"Osceola County, IA",Aug-19,3593,3526,67,1.9
16955,CN1914500000000,19,145,"Page County, IA",Aug-19,6423,6252,171,2.7
16956,CN1914700000000,19,147,"Palo Alto County, IA",Aug-19,4805,4705,100,2.1
16957,CN1914900000000,19,149,"Plymouth County, IA",Aug-19,15151,14783,368,2.4
16958,CN1915100000000,19,151,"Pocahontas County, IA",Aug-19,4722,4632,90,1.9
16959,CN1915300000000,19,153,"Polk County, IA",Aug-19,278272,270548,7724,2.8
16960,CN1915500000000,19,155,"Pottawattamie County, IA",Aug-19,49927,48725,1202,2.4
16961,CN1915700000000,19,157,"Poweshiek County, IA",Aug-19,10107,9875,232,2.3
16962,CN1915900000000,19,159,"Ringgold County, IA",Aug-19,2505,2440,65,2.6
16963,CN1916100000000,19,161,"Sac County, IA",Aug-19,5299,5188,111,2.1
16964,CN1916300000000,19,163,"Scott County, IA",Aug-19,92700,89506,3194,3.4
16965,CN1916500000000,19,165,"Shelby County, IA",Aug-19,6886,6744,142,2.1
16966,CN1916700000000,19,167,"Sioux County, IA",Aug-19,20806,20465,341,1.6
16967,CN1916900000000,19,169,"Story County, IA",Aug-19,55961,54781,1180,2.1
16968,CN1917100000000,19,171,"Tama County, IA",Aug-19,9561,9316,245,2.6
16969,CN1917300000000,19,173,"Taylor County, IA",Aug-19,3221,3159,62,1.9
16970,CN1917500000000,19,175,"Union County, IA",Aug-19,6351,6148,203,3.2
16971,CN1917700000000,19,177,"Van Buren County, IA",Aug-19,3768,3664,104,2.8
16972,CN1917900000000,19,179,"Wapello County, IA",Aug-19,18101,17323,778,4.3
16973,CN1918100000000,19,181,"Warren County, IA",Aug-19,29230,28532,698,2.4
16974,CN1918300000000,19,183,"Washington County, IA",Aug-19,12324,12050,274,2.2
16975,CN1918500000000,19,185,"Wayne County, IA",Aug-19,2799,2726,73,2.6
16976,CN1918700000000,19,187,"Webster County, IA",Aug-19,20062,19364,698,3.5
16977,CN1918900000000,19,189,"Winnebago County, IA",Aug-19,5276,5126,150,2.8
16978,CN1919100000000,19,191,"Winneshiek County, IA",Aug-19,11483,11209,274,2.4
16979,CN1919300000000,19,193,"Woodbury County, IA",Aug-19,56937,55422,1515,2.7
16980,CN1919500000000,19,195,"Worth County, IA",Aug-19,4337,4242,95,2.2
16981,CN1919700000000,19,197,"Wright County, IA",Aug-19,7247,7060,187,2.6
16982,CN2000100000000,20,1,"Allen County, KS",Aug-19,6139,5891,248,4.0
16983,CN2000300000000,20,3,"Anderson County, KS",Aug-19,4217,4075,142,3.4
16984,CN2000500000000,20,5,"Atchison County, KS",Aug-19,7006,6601,405,5.8
16985,CN2000700000000,20,7,"Barber County, KS",Aug-19,2330,2262,68,2.9
16986,CN2000900000000,20,9,"Barton County, KS",Aug-19,13507,13058,449,3.3
16987,CN2001100000000,20,11,"Bourbon County, KS",Aug-19,6523,6238,285,4.4
16988,CN2001300000000,20,13,"Brown County, KS",Aug-19,5358,5181,177,3.3
16989,CN2001500000000,20,15,"Butler County, KS",Aug-19,32530,31391,1139,3.5
16990,CN2001700000000,20,17,"Chase County, KS",Aug-19,1522,1478,44,2.9
16991,CN2001900000000,20,19,"Chautauqua County, KS",Aug-19,1413,1350,63,4.5
16992,CN2002100000000,20,21,"Cherokee County, KS",Aug-19,10082,9722,360,3.6
16993,CN2002300000000,20,23,"Cheyenne County, KS",Aug-19,1310,1275,35,2.7
16994,CN2002500000000,20,25,"Clark County, KS",Aug-19,1090,1062,28,2.6
16995,CN2002700000000,20,27,"Clay County, KS",Aug-19,3755,3627,128,3.4
16996,CN2002900000000,20,29,"Cloud County, KS",Aug-19,3768,3632,136,3.6
16997,CN2003100000000,20,31,"Coffey County, KS",Aug-19,3817,3634,183,4.8
16998,CN2003300000000,20,33,"Comanche County, KS",Aug-19,869,839,30,3.5
16999,CN2003500000000,20,35,"Cowley County, KS",Aug-19,16150,15552,598,3.7
17000,CN2003700000000,20,37,"Crawford County, KS",Aug-19,18476,17707,769,4.2
17001,CN2003900000000,20,39,"Decatur County, KS",Aug-19,1290,1243,47,3.6
17002,CN2004100000000,20,41,"Dickinson County, KS",Aug-19,8736,8423,313,3.6
17003,CN2004300000000,20,43,"Doniphan County, KS",Aug-19,4162,4020,142,3.4
17004,CN2004500000000,20,45,"Douglas County, KS",Aug-19,64895,62822,2073,3.2
17005,CN2004700000000,20,47,"Edwards County, KS",Aug-19,1459,1424,35,2.4
17006,CN2004900000000,20,49,"Elk County, KS",Aug-19,1091,1044,47,4.3
17007,CN2005100000000,20,51,"Ellis County, KS",Aug-19,16554,16140,414,2.5
17008,CN2005300000000,20,53,"Ellsworth County, KS",Aug-19,2737,2641,96,3.5
17009,CN2005500000000,20,55,"Finney County, KS",Aug-19,20273,19763,510,2.5
17010,CN2005700000000,20,57,"Ford County, KS",Aug-19,17549,17096,453,2.6
17011,CN2005900000000,20,59,"Franklin County, KS",Aug-19,13832,13371,461,3.3
17012,CN2006100000000,20,61,"Geary County, KS",Aug-19,11008,10485,523,4.8
17013,CN2006300000000,20,63,"Gove County, KS",Aug-19,1495,1460,35,2.3
17014,CN2006500000000,20,65,"Graham County, KS",Aug-19,1148,1111,37,3.2
17015,CN2006700000000,20,67,"Grant County, KS",Aug-19,3253,3153,100,3.1
17016,CN2006900000000,20,69,"Gray County, KS",Aug-19,3177,3104,73,2.3
17017,CN2007100000000,20,71,"Greeley County, KS",Aug-19,802,778,24,3.0
17018,CN2007300000000,20,73,"Greenwood County, KS",Aug-19,3173,3058,115,3.6
17019,CN2007500000000,20,75,"Hamilton County, KS",Aug-19,1656,1621,35,2.1
17020,CN2007700000000,20,77,"Harper County, KS",Aug-19,2824,2742,82,2.9
17021,CN2007900000000,20,79,"Harvey County, KS",Aug-19,17025,16489,536,3.1
17022,CN2008100000000,20,81,"Haskell County, KS",Aug-19,2248,2196,52,2.3
17023,CN2008300000000,20,83,"Hodgeman County, KS",Aug-19,1031,1007,24,2.3
17024,CN2008500000000,20,85,"Jackson County, KS",Aug-19,7233,7011,222,3.1
17025,CN2008700000000,20,87,"Jefferson County, KS",Aug-19,10172,9868,304,3.0
17026,CN2008900000000,20,89,"Jewell County, KS",Aug-19,1315,1278,37,2.8
17027,CN2009100000000,20,91,"Johnson County, KS",Aug-19,340500,330335,10165,3.0
17028,CN2009300000000,20,93,"Kearny County, KS",Aug-19,2034,1978,56,2.8
17029,CN2009500000000,20,95,"Kingman County, KS",Aug-19,3483,3369,114,3.3
17030,CN2009700000000,20,97,"Kiowa County, KS",Aug-19,1270,1237,33,2.6
17031,CN2009900000000,20,99,"Labette County, KS",Aug-19,9882,9487,395,4.0
17032,CN2010100000000,20,101,"Lane County, KS",Aug-19,782,756,26,3.3
17033,CN2010300000000,20,103,"Leavenworth County, KS",Aug-19,36668,35352,1316,3.6
17034,CN2010500000000,20,105,"Lincoln County, KS",Aug-19,1637,1597,40,2.4
17035,CN2010700000000,20,107,"Linn County, KS",Aug-19,4474,4212,262,5.9
17036,CN2010900000000,20,109,"Logan County, KS",Aug-19,1517,1480,37,2.4
17037,CN2011100000000,20,111,"Lyon County, KS",Aug-19,16470,15890,580,3.5
17038,CN2011300000000,20,113,"McPherson County, KS",Aug-19,17342,16907,435,2.5
17039,CN2011500000000,20,115,"Marion County, KS",Aug-19,5865,5680,185,3.2
17040,CN2011700000000,20,117,"Marshall County, KS",Aug-19,5540,5386,154,2.8
17041,CN2011900000000,20,119,"Meade County, KS",Aug-19,2188,2132,56,2.6
17042,CN2012100000000,20,121,"Miami County, KS",Aug-19,17530,16959,571,3.3
17043,CN2012300000000,20,123,"Mitchell County, KS",Aug-19,3379,3292,87,2.6
17044,CN2012500000000,20,125,"Montgomery County, KS",Aug-19,14613,13980,633,4.3
17045,CN2012700000000,20,127,"Morris County, KS",Aug-19,2942,2856,86,2.9
17046,CN2012900000000,20,129,"Morton County, KS",Aug-19,1117,1079,38,3.4
17047,CN2013100000000,20,131,"Nemaha County, KS",Aug-19,5375,5207,168,3.1
17048,CN2013300000000,20,133,"Neosho County, KS",Aug-19,6167,5856,311,5.0
17049,CN2013500000000,20,135,"Ness County, KS",Aug-19,1378,1340,38,2.8
17050,CN2013700000000,20,137,"Norton County, KS",Aug-19,2715,2645,70,2.6
17051,CN2013900000000,20,139,"Osage County, KS",Aug-19,8041,7753,288,3.6
17052,CN2014100000000,20,141,"Osborne County, KS",Aug-19,2042,1998,44,2.2
17053,CN2014300000000,20,143,"Ottawa County, KS",Aug-19,3015,2926,89,3.0
17054,CN2014500000000,20,145,"Pawnee County, KS",Aug-19,2970,2879,91,3.1
17055,CN2014700000000,20,147,"Phillips County, KS",Aug-19,2549,2476,73,2.9
17056,CN2014900000000,20,149,"Pottawatomie County, KS",Aug-19,12103,11745,358,3.0
17057,CN2015100000000,20,151,"Pratt County, KS",Aug-19,4873,4740,133,2.7
17058,CN2015300000000,20,153,"Rawlins County, KS",Aug-19,1556,1518,38,2.4
17059,CN2015500000000,20,155,"Reno County, KS",Aug-19,29132,28118,1014,3.5
17060,CN2015700000000,20,157,"Republic County, KS",Aug-19,2310,2244,66,2.9
17061,CN2015900000000,20,159,"Rice County, KS",Aug-19,5137,4988,149,2.9
17062,CN2016100000000,20,161,"Riley County, KS",Aug-19,34099,33028,1071,3.1
17063,CN2016300000000,20,163,"Rooks County, KS",Aug-19,2533,2440,93,3.7
17064,CN2016500000000,20,165,"Rush County, KS",Aug-19,1648,1601,47,2.9
17065,CN2016700000000,20,167,"Russell County, KS",Aug-19,3233,3121,112,3.5
17066,CN2016900000000,20,169,"Saline County, KS",Aug-19,30531,29549,982,3.2
17067,CN2017100000000,20,171,"Scott County, KS",Aug-19,2918,2850,68,2.3
17068,CN2017300000000,20,173,"Sedgwick County, KS",Aug-19,250870,241610,9260,3.7
17069,CN2017500000000,20,175,"Seward County, KS",Aug-19,9648,9332,316,3.3
17070,CN2017700000000,20,177,"Shawnee County, KS",Aug-19,90875,87733,3142,3.5
17071,CN2017900000000,20,179,"Sheridan County, KS",Aug-19,1434,1401,33,2.3
17072,CN2018100000000,20,181,"Sherman County, KS",Aug-19,2874,2787,87,3.0
17073,CN2018300000000,20,183,"Smith County, KS",Aug-19,1934,1878,56,2.9
17074,CN2018500000000,20,185,"Stafford County, KS",Aug-19,2012,1953,59,2.9
17075,CN2018700000000,20,187,"Stanton County, KS",Aug-19,997,971,26,2.6
17076,CN2018900000000,20,189,"Stevens County, KS",Aug-19,2572,2497,75,2.9
17077,CN2019100000000,20,191,"Sumner County, KS",Aug-19,10969,10571,398,3.6
17078,CN2019300000000,20,193,"Thomas County, KS",Aug-19,4324,4214,110,2.5
17079,CN2019500000000,20,195,"Trego County, KS",Aug-19,1398,1354,44,3.1
17080,CN2019700000000,20,197,"Wabaunsee County, KS",Aug-19,3712,3590,122,3.3
17081,CN2019900000000,20,199,"Wallace County, KS",Aug-19,823,802,21,2.6
17082,CN2020100000000,20,201,"Washington County, KS",Aug-19,2947,2867,80,2.7
17083,CN2020300000000,20,203,"Wichita County, KS",Aug-19,1229,1199,30,2.4
17084,CN2020500000000,20,205,"Wilson County, KS",Aug-19,3916,3741,175,4.5
17085,CN2020700000000,20,207,"Woodson County, KS",Aug-19,1584,1516,68,4.3
17086,CN2020900000000,20,209,"Wyandotte County, KS",Aug-19,77495,74155,3340,4.3
17087,CN2100100000000,21,1,"Adair County, KY",Aug-19,6985,6636,349,5.0
17088,CN2100300000000,21,3,"Allen County, KY",Aug-19,8992,8620,372,4.1
17089,CN2100500000000,21,5,"Anderson County, KY",Aug-19,12182,11732,450,3.7
17090,CN2100700000000,21,7,"Ballard County, KY",Aug-19,3511,3325,186,5.3
17091,CN2100900000000,21,9,"Barren County, KY",Aug-19,18769,17959,810,4.3
17092,CN2101100000000,21,11,"Bath County, KY",Aug-19,4595,4337,258,5.6
17093,CN2101300000000,21,13,"Bell County, KY",Aug-19,8318,7733,585,7.0
17094,CN2101500000000,21,15,"Boone County, KY",Aug-19,71556,69197,2359,3.3
17095,CN2101700000000,21,17,"Bourbon County, KY",Aug-19,9869,9525,344,3.5
17096,CN2101900000000,21,19,"Boyd County, KY",Aug-19,17738,16793,945,5.3
17097,CN2102100000000,21,21,"Boyle County, KY",Aug-19,12437,11845,592,4.8
17098,CN2102300000000,21,23,"Bracken County, KY",Aug-19,3818,3653,165,4.3
17099,CN2102500000000,21,25,"Breathitt County, KY",Aug-19,3368,3143,225,6.7
17100,CN2102700000000,21,27,"Breckinridge County, KY",Aug-19,7920,7540,380,4.8
17101,CN2102900000000,21,29,"Bullitt County, KY",Aug-19,43171,41402,1769,4.1
17102,CN2103100000000,21,31,"Butler County, KY",Aug-19,5020,4787,233,4.6
17103,CN2103300000000,21,33,"Caldwell County, KY",Aug-19,5460,5180,280,5.1
17104,CN2103500000000,21,35,"Calloway County, KY",Aug-19,18699,17974,725,3.9
17105,CN2103700000000,21,37,"Campbell County, KY",Aug-19,51115,49394,1721,3.4
17106,CN2103900000000,21,39,"Carlisle County, KY",Aug-19,2224,2131,93,4.2
17107,CN2104100000000,21,41,"Carroll County, KY",Aug-19,5303,5091,212,4.0
17108,CN2104300000000,21,43,"Carter County, KY",Aug-19,9676,8822,854,8.8
17109,CN2104500000000,21,45,"Casey County, KY",Aug-19,6630,6356,274,4.1
17110,CN2104700000000,21,47,"Christian County, KY",Aug-19,25260,23829,1431,5.7
17111,CN2104900000000,21,49,"Clark County, KY",Aug-19,17201,16542,659,3.8
17112,CN2105100000000,21,51,"Clay County, KY",Aug-19,5206,4836,370,7.1
17113,CN2105300000000,21,53,"Clinton County, KY",Aug-19,4014,3823,191,4.8
17114,CN2105500000000,21,55,"Crittenden County, KY",Aug-19,3760,3594,166,4.4
17115,CN2105700000000,21,57,"Cumberland County, KY",Aug-19,3225,3119,106,3.3
17116,CN2105900000000,21,59,"Daviess County, KY",Aug-19,47691,45942,1749,3.7
17117,CN2106100000000,21,61,"Edmonson County, KY",Aug-19,4766,4554,212,4.4
17118,CN2106300000000,21,63,"Elliott County, KY",Aug-19,2047,1871,176,8.6
17119,CN2106500000000,21,65,"Estill County, KY",Aug-19,5271,5033,238,4.5
17120,CN2106700000000,21,67,"Fayette County, KY",Aug-19,175812,170050,5762,3.3
17121,CN2106900000000,21,69,"Fleming County, KY",Aug-19,6137,5816,321,5.2
17122,CN2107100000000,21,71,"Floyd County, KY",Aug-19,10881,10221,660,6.1
17123,CN2107300000000,21,73,"Franklin County, KY",Aug-19,25471,24555,916,3.6
17124,CN2107500000000,21,75,"Fulton County, KY",Aug-19,2069,1955,114,5.5
17125,CN2107700000000,21,77,"Gallatin County, KY",Aug-19,4121,3961,160,3.9
17126,CN2107900000000,21,79,"Garrard County, KY",Aug-19,7546,7209,337,4.5
17127,CN2108100000000,21,81,"Grant County, KY",Aug-19,11778,11328,450,3.8
17128,CN2108300000000,21,83,"Graves County, KY",Aug-19,15819,15125,694,4.4
17129,CN2108500000000,21,85,"Grayson County, KY",Aug-19,11071,10535,536,4.8
17130,CN2108700000000,21,87,"Green County, KY",Aug-19,4996,4781,215,4.3
17131,CN2108900000000,21,89,"Greenup County, KY",Aug-19,13393,12519,874,6.5
17132,CN2109100000000,21,91,"Hancock County, KY",Aug-19,4017,3864,153,3.8
17133,CN2109300000000,21,93,"Hardin County, KY",Aug-19,49505,47520,1985,4.0
17134,CN2109500000000,21,95,"Harlan County, KY",Aug-19,6770,5898,872,12.9
17135,CN2109700000000,21,97,"Harrison County, KY",Aug-19,8891,8518,373,4.2
17136,CN2109900000000,21,99,"Hart County, KY",Aug-19,7715,7381,334,4.3
17137,CN2110100000000,21,101,"Henderson County, KY",Aug-19,21967,21159,808,3.7
17138,CN2110300000000,21,103,"Henry County, KY",Aug-19,8287,7989,298,3.6
17139,CN2110500000000,21,105,"Hickman County, KY",Aug-19,1769,1689,80,4.5
17140,CN2110700000000,21,107,"Hopkins County, KY",Aug-19,18520,17739,781,4.2
17141,CN2110900000000,21,109,"Jackson County, KY",Aug-19,4112,3856,256,6.2
17142,CN2111100000000,21,111,"Jefferson County, KY",Aug-19,402904,386743,16161,4.0
17143,CN2111300000000,21,113,"Jessamine County, KY",Aug-19,26570,25607,963,3.6
17144,CN2111500000000,21,115,"Johnson County, KY",Aug-19,6739,6328,411,6.1
17145,CN2111700000000,21,117,"Kenton County, KY",Aug-19,88480,85474,3006,3.4
17146,CN2111900000000,21,119,"Knott County, KY",Aug-19,4502,4187,315,7.0
17147,CN2112100000000,21,121,"Knox County, KY",Aug-19,9938,9348,590,5.9
17148,CN2112300000000,21,123,"Larue County, KY",Aug-19,5966,5713,253,4.2
17149,CN2112500000000,21,125,"Laurel County, KY",Aug-19,24687,23471,1216,4.9
17150,CN2112700000000,21,127,"Lawrence County, KY",Aug-19,5234,4885,349,6.7
17151,CN2112900000000,21,129,"Lee County, KY",Aug-19,2048,1950,98,4.8
17152,CN2113100000000,21,131,"Leslie County, KY",Aug-19,2746,2472,274,10.0
17153,CN2113300000000,21,133,"Letcher County, KY",Aug-19,6362,5845,517,8.1
17154,CN2113500000000,21,135,"Lewis County, KY",Aug-19,4562,4194,368,8.1
17155,CN2113700000000,21,137,"Lincoln County, KY",Aug-19,9224,8779,445,4.8
17156,CN2113900000000,21,139,"Livingston County, KY",Aug-19,3659,3475,184,5.0
17157,CN2114100000000,21,141,"Logan County, KY",Aug-19,12603,12107,496,3.9
17158,CN2114300000000,21,143,"Lyon County, KY",Aug-19,3288,3148,140,4.3
17159,CN2114500000000,21,145,"McCracken County, KY",Aug-19,29227,27827,1400,4.8
17160,CN2114700000000,21,147,"McCreary County, KY",Aug-19,4793,4527,266,5.5
17161,CN2114900000000,21,149,"McLean County, KY",Aug-19,4241,4075,166,3.9
17162,CN2115100000000,21,151,"Madison County, KY",Aug-19,46842,45021,1821,3.9
17163,CN2115300000000,21,153,"Magoffin County, KY",Aug-19,3149,2803,346,11.0
17164,CN2115500000000,21,155,"Marion County, KY",Aug-19,9694,9321,373,3.8
17165,CN2115700000000,21,157,"Marshall County, KY",Aug-19,15268,14624,644,4.2
17166,CN2115900000000,21,159,"Martin County, KY",Aug-19,2754,2565,189,6.9
17167,CN2116100000000,21,161,"Mason County, KY",Aug-19,7115,6704,411,5.8
17168,CN2116300000000,21,163,"Meade County, KY",Aug-19,12424,11850,574,4.6
17169,CN2116500000000,21,165,"Menifee County, KY",Aug-19,2307,2172,135,5.9
17170,CN2116700000000,21,167,"Mercer County, KY",Aug-19,10085,9630,455,4.5
17171,CN2116900000000,21,169,"Metcalfe County, KY",Aug-19,4095,3890,205,5.0
17172,CN2117100000000,21,171,"Monroe County, KY",Aug-19,4664,4496,168,3.6
17173,CN2117300000000,21,173,"Montgomery County, KY",Aug-19,11673,11086,587,5.0
17174,CN2117500000000,21,175,"Morgan County, KY",Aug-19,4537,4332,205,4.5
17175,CN2117700000000,21,177,"Muhlenberg County, KY",Aug-19,10203,9559,644,6.3
17176,CN2117900000000,21,179,"Nelson County, KY",Aug-19,23211,22217,994,4.3
17177,CN2118100000000,21,181,"Nicholas County, KY",Aug-19,3318,3179,139,4.2
17178,CN2118300000000,21,183,"Ohio County, KY",Aug-19,9999,9508,491,4.9
17179,CN2118500000000,21,185,"Oldham County, KY",Aug-19,33499,32433,1066,3.2
17180,CN2118700000000,21,187,"Owen County, KY",Aug-19,5087,4870,217,4.3
17181,CN2118900000000,21,189,"Owsley County, KY",Aug-19,1134,1059,75,6.6
17182,CN2119100000000,21,191,"Pendleton County, KY",Aug-19,6980,6742,238,3.4
17183,CN2119300000000,21,193,"Perry County, KY",Aug-19,8265,7765,500,6.0
17184,CN2119500000000,21,195,"Pike County, KY",Aug-19,19856,18798,1058,5.3
17185,CN2119700000000,21,197,"Powell County, KY",Aug-19,5045,4812,233,4.6
17186,CN2119900000000,21,199,"Pulaski County, KY",Aug-19,26935,25771,1164,4.3
17187,CN2120100000000,21,201,"Robertson County, KY",Aug-19,813,777,36,4.4
17188,CN2120300000000,21,203,"Rockcastle County, KY",Aug-19,6607,6297,310,4.7
17189,CN2120500000000,21,205,"Rowan County, KY",Aug-19,10235,9709,526,5.1
17190,CN2120700000000,21,207,"Russell County, KY",Aug-19,6338,6027,311,4.9
17191,CN2120900000000,21,209,"Scott County, KY",Aug-19,29296,28277,1019,3.5
17192,CN2121100000000,21,211,"Shelby County, KY",Aug-19,25768,24844,924,3.6
17193,CN2121300000000,21,213,"Simpson County, KY",Aug-19,8871,8480,391,4.4
17194,CN2121500000000,21,215,"Spencer County, KY",Aug-19,10283,9903,380,3.7
17195,CN2121700000000,21,217,"Taylor County, KY",Aug-19,12500,11946,554,4.4
17196,CN2121900000000,21,219,"Todd County, KY",Aug-19,5478,5276,202,3.7
17197,CN2122100000000,21,221,"Trigg County, KY",Aug-19,6050,5799,251,4.1
17198,CN2122300000000,21,223,"Trimble County, KY",Aug-19,3904,3741,163,4.2
17199,CN2122500000000,21,225,"Union County, KY",Aug-19,6111,5852,259,4.2
17200,CN2122700000000,21,227,"Warren County, KY",Aug-19,64753,62271,2482,3.8
17201,CN2122900000000,21,229,"Washington County, KY",Aug-19,6245,6010,235,3.8
17202,CN2123100000000,21,231,"Wayne County, KY",Aug-19,7415,7022,393,5.3
17203,CN2123300000000,21,233,"Webster County, KY",Aug-19,5860,5633,227,3.9
17204,CN2123500000000,21,235,"Whitley County, KY",Aug-19,13762,13069,693,5.0
17205,CN2123700000000,21,237,"Wolfe County, KY",Aug-19,1919,1798,121,6.3
17206,CN2123900000000,21,239,"Woodford County, KY",Aug-19,14991,14554,437,2.9
17207,CN2200100000000,22,1,"Acadia Parish, LA",Aug-19,24065,22672,1393,5.8
17208,CN2200300000000,22,3,"Allen Parish, LA",Aug-19,8675,8155,520,6.0
17209,CN2200500000000,22,5,"Ascension Parish, LA",Aug-19,63533,60606,2927,4.6
17210,CN2200700000000,22,7,"Assumption Parish, LA",Aug-19,8944,8348,596,6.7
17211,CN2200900000000,22,9,"Avoyelles Parish, LA",Aug-19,15380,14309,1071,7.0
17212,CN2201100000000,22,11,"Beauregard Parish, LA",Aug-19,14796,13930,866,5.9
17213,CN2201300000000,22,13,"Bienville Parish, LA",Aug-19,5616,5277,339,6.0
17214,CN2201500000000,22,15,"Bossier Parish, LA",Aug-19,57620,54935,2685,4.7
17215,CN2201700000000,22,17,"Caddo Parish, LA",Aug-19,103600,97486,6114,5.9
17216,CN2201900000000,22,19,"Calcasieu Parish, LA",Aug-19,105516,100696,4820,4.6
17217,CN2202100000000,22,21,"Caldwell Parish, LA",Aug-19,3740,3512,228,6.1
17218,CN2202300000000,22,23,"Cameron Parish, LA",Aug-19,3906,3752,154,3.9
17219,CN2202500000000,22,25,"Catahoula Parish, LA",Aug-19,3564,3324,240,6.7
17220,CN2202700000000,22,27,"Claiborne Parish, LA",Aug-19,5909,5555,354,6.0
17221,CN2202900000000,22,29,"Concordia Parish, LA",Aug-19,7243,6743,500,6.9
17222,CN2203100000000,22,31,"De Soto Parish, LA",Aug-19,10909,10181,728,6.7
17223,CN2203300000000,22,33,"East Baton Rouge Parish, LA",Aug-19,229404,217751,11653,5.1
17224,CN2203500000000,22,35,"East Carroll Parish, LA",Aug-19,1930,1720,210,10.9
17225,CN2203700000000,22,37,"East Feliciana Parish, LA",Aug-19,7965,7548,417,5.2
17226,CN2203900000000,22,39,"Evangeline Parish, LA",Aug-19,11810,11007,803,6.8
17227,CN2204100000000,22,41,"Franklin Parish, LA",Aug-19,7574,6941,633,8.4
17228,CN2204300000000,22,43,"Grant Parish, LA",Aug-19,8240,7711,529,6.4
17229,CN2204500000000,22,45,"Iberia Parish, LA",Aug-19,28354,26708,1646,5.8
17230,CN2204700000000,22,47,"Iberville Parish, LA",Aug-19,14040,13091,949,6.8
17231,CN2204900000000,22,49,"Jackson Parish, LA",Aug-19,6776,6428,348,5.1
17232,CN2205100000000,22,51,"Jefferson Parish, LA",Aug-19,213285,203405,9880,4.6
17233,CN2205300000000,22,53,"Jefferson Davis Parish, LA",Aug-19,13491,12784,707,5.2
17234,CN2205500000000,22,55,"Lafayette Parish, LA",Aug-19,113921,108526,5395,4.7
17235,CN2205700000000,22,57,"Lafourche Parish, LA",Aug-19,42544,40501,2043,4.8
17236,CN2205900000000,22,59,"LaSalle Parish, LA",Aug-19,6742,6424,318,4.7
17237,CN2206100000000,22,61,"Lincoln Parish, LA",Aug-19,21064,19742,1322,6.3
17238,CN2206300000000,22,63,"Livingston Parish, LA",Aug-19,68361,65287,3074,4.5
17239,CN2206500000000,22,65,"Madison Parish, LA",Aug-19,3654,3329,325,8.9
17240,CN2206700000000,22,67,"Morehouse Parish, LA",Aug-19,9938,9012,926,9.3
17241,CN2206900000000,22,69,"Natchitoches Parish, LA",Aug-19,16563,15359,1204,7.3
17242,CN2207100000000,22,71,"Orleans Parish, LA",Aug-19,178999,169128,9871,5.5
17243,CN2207300000000,22,73,"Ouachita Parish, LA",Aug-19,69552,65486,4066,5.8
17244,CN2207500000000,22,75,"Plaquemines Parish, LA",Aug-19,10122,9636,486,4.8
17245,CN2207700000000,22,77,"Pointe Coupee Parish, LA",Aug-19,9927,9331,596,6.0
17246,CN2207900000000,22,79,"Rapides Parish, LA",Aug-19,55363,52208,3155,5.7
17247,CN2208100000000,22,81,"Red River Parish, LA",Aug-19,3821,3597,224,5.9
17248,CN2208300000000,22,83,"Richland Parish, LA",Aug-19,8280,7727,553,6.7
17249,CN2208500000000,22,85,"Sabine Parish, LA",Aug-19,9358,8849,509,5.4
17250,CN2208700000000,22,87,"St. Bernard Parish, LA",Aug-19,19909,18848,1061,5.3
17251,CN2208900000000,22,89,"St. Charles Parish, LA",Aug-19,25089,23887,1202,4.8
17252,CN2209100000000,22,91,"St. Helena Parish, LA",Aug-19,4264,3983,281,6.6
17253,CN2209300000000,22,93,"St. James Parish, LA",Aug-19,9241,8615,626,6.8
17254,CN2209500000000,22,95,"St. John the Baptist Parish, LA",Aug-19,19594,18390,1204,6.1
17255,CN2209700000000,22,97,"St. Landry Parish, LA",Aug-19,32182,29990,2192,6.8
17256,CN2209900000000,22,99,"St. Martin Parish, LA",Aug-19,22252,21025,1227,5.5
17257,CN2210100000000,22,101,"St. Mary Parish, LA",Aug-19,19944,18655,1289,6.5
17258,CN2210300000000,22,103,"St. Tammany Parish, LA",Aug-19,119241,113788,5453,4.6
17259,CN2210500000000,22,105,"Tangipahoa Parish, LA",Aug-19,54728,51410,3318,6.1
17260,CN2210700000000,22,107,"Tensas Parish, LA",Aug-19,1501,1365,136,9.1
17261,CN2210900000000,22,109,"Terrebonne Parish, LA",Aug-19,46892,44585,2307,4.9
17262,CN2211100000000,22,111,"Union Parish, LA",Aug-19,9083,8537,546,6.0
17263,CN2211300000000,22,113,"Vermilion Parish, LA",Aug-19,24301,22988,1313,5.4
17264,CN2211500000000,22,115,"Vernon Parish, LA",Aug-19,16196,15012,1184,7.3
17265,CN2211700000000,22,117,"Washington Parish, LA",Aug-19,16573,15512,1061,6.4
17266,CN2211900000000,22,119,"Webster Parish, LA",Aug-19,14565,13563,1002,6.9
17267,CN2212100000000,22,121,"West Baton Rouge Parish, LA",Aug-19,13561,12865,696,5.1
17268,CN2212300000000,22,123,"West Carroll Parish, LA",Aug-19,3641,3282,359,9.9
17269,CN2212500000000,22,125,"West Feliciana Parish, LA",Aug-19,5373,5126,247,4.6
17270,CN2212700000000,22,127,"Winn Parish, LA",Aug-19,4980,4637,343,6.9
17271,CN2300100000000,23,1,"Androscoggin County, ME",Aug-19,54692,53329,1363,2.5
17272,CN2300300000000,23,3,"Aroostook County, ME",Aug-19,30627,29601,1026,3.3
17273,CN2300500000000,23,5,"Cumberland County, ME",Aug-19,167946,164718,3228,1.9
17274,CN2300700000000,23,7,"Franklin County, ME",Aug-19,14210,13752,458,3.2
17275,CN2300900000000,23,9,"Hancock County, ME",Aug-19,32569,31934,635,1.9
17276,CN2301100000000,23,11,"Kennebec County, ME",Aug-19,62466,61020,1446,2.3
17277,CN2301300000000,23,13,"Knox County, ME",Aug-19,21477,21071,406,1.9
17278,CN2301500000000,23,15,"Lincoln County, ME",Aug-19,18118,17740,378,2.1
17279,CN2301700000000,23,17,"Oxford County, ME",Aug-19,26969,26227,742,2.8
17280,CN2301900000000,23,19,"Penobscot County, ME",Aug-19,76679,74762,1917,2.5
17281,CN2302100000000,23,21,"Piscataquis County, ME",Aug-19,7498,7291,207,2.8
17282,CN2302300000000,23,23,"Sagadahoc County, ME",Aug-19,19670,19331,339,1.7
17283,CN2302500000000,23,25,"Somerset County, ME",Aug-19,23329,22562,767,3.3
17284,CN2302700000000,23,27,"Waldo County, ME",Aug-19,21348,20821,527,2.5
17285,CN2302900000000,23,29,"Washington County, ME",Aug-19,14524,14062,462,3.2
17286,CN2303100000000,23,31,"York County, ME",Aug-19,116225,113859,2366,2.0
17287,CN2400100000000,24,1,"Allegany County, MD",Aug-19,32512,30607,1905,5.9
17288,CN2400300000000,24,3,"Anne Arundel County, MD",Aug-19,320234,309808,10426,3.3
17289,CN2400500000000,24,5,"Baltimore County, MD",Aug-19,461261,443323,17938,3.9
17290,CN2400900000000,24,9,"Calvert County, MD",Aug-19,50458,48725,1733,3.4
17291,CN2401100000000,24,11,"Caroline County, MD",Aug-19,18301,17655,646,3.5
17292,CN2401300000000,24,13,"Carroll County, MD",Aug-19,96442,93479,2963,3.1
17293,CN2401500000000,24,15,"Cecil County, MD",Aug-19,53433,51104,2329,4.4
17294,CN2401700000000,24,17,"Charles County, MD",Aug-19,88274,84678,3596,4.1
17295,CN2401900000000,24,19,"Dorchester County, MD",Aug-19,15701,14985,716,4.6
17296,CN2402100000000,24,21,"Frederick County, MD",Aug-19,136079,131709,4370,3.2
17297,CN2402300000000,24,23,"Garrett County, MD",Aug-19,16165,15470,695,4.3
17298,CN2402500000000,24,25,"Harford County, MD",Aug-19,143158,137976,5182,3.6
17299,CN2402700000000,24,27,"Howard County, MD",Aug-19,190556,185105,5451,2.9
17300,CN2402900000000,24,29,"Kent County, MD",Aug-19,10038,9667,371,3.7
17301,CN2403100000000,24,31,"Montgomery County, MD",Aug-19,569244,552801,16443,2.9
17302,CN2403300000000,24,33,"Prince George's County, MD",Aug-19,513176,493140,20036,3.9
17303,CN2403500000000,24,35,"Queen Anne's County, MD",Aug-19,27752,26862,890,3.2
17304,CN2403700000000,24,37,"St. Mary's County, MD",Aug-19,57708,55509,2199,3.8
17305,CN2403900000000,24,39,"Somerset County, MD",Aug-19,9497,8904,593,6.2
17306,CN2404100000000,24,41,"Talbot County, MD",Aug-19,19408,18785,623,3.2
17307,CN2404300000000,24,43,"Washington County, MD",Aug-19,74792,71917,2875,3.8
17308,CN2404500000000,24,45,"Wicomico County, MD",Aug-19,54672,52258,2414,4.4
17309,CN2404700000000,24,47,"Worcester County, MD",Aug-19,26456,25169,1287,4.9
17310,CN2451000000000,24,510,"Baltimore city, MD",Aug-19,294759,277884,16875,5.7
17311,CN2500100000000,25,1,"Barnstable County, MA",Aug-19,128334,125122,3212,2.5
17312,CN2500300000000,25,3,"Berkshire County, MA",Aug-19,67213,65112,2101,3.1
17313,CN2500500000000,25,5,"Bristol County, MA",Aug-19,304588,293687,10901,3.6
17314,CN2500700000000,25,7,"Dukes County, MA",Aug-19,12404,12178,226,1.8
17315,CN2500900000000,25,9,"Essex County, MA",Aug-19,432776,420405,12371,2.9
17316,CN2501100000000,25,11,"Franklin County, MA",Aug-19,41221,40183,1038,2.5
17317,CN2501300000000,25,13,"Hampden County, MA",Aug-19,228173,218415,9758,4.3
17318,CN2501500000000,25,15,"Hampshire County, MA",Aug-19,89994,87548,2446,2.7
17319,CN2501700000000,25,17,"Middlesex County, MA",Aug-19,937299,915727,21572,2.3
17320,CN2501900000000,25,19,"Nantucket County/town, MA",Aug-19,10222,10083,139,1.4
17321,CN2502100000000,25,21,"Norfolk County, MA",Aug-19,398784,388898,9886,2.5
17322,CN2502300000000,25,23,"Plymouth County, MA",Aug-19,289938,281439,8499,2.9
17323,CN2502500000000,25,25,"Suffolk County, MA",Aug-19,465595,453249,12346,2.7
17324,CN2502700000000,25,27,"Worcester County, MA",Aug-19,449269,435363,13906,3.1
17325,CN2600100000000,26,1,"Alcona County, MI",Aug-19,4029,3812,217,5.4
17326,CN2600300000000,26,3,"Alger County, MI",Aug-19,3452,3250,202,5.9
17327,CN2600500000000,26,5,"Allegan County, MI",Aug-19,63174,61291,1883,3.0
17328,CN2600700000000,26,7,"Alpena County, MI",Aug-19,13228,12618,610,4.6
17329,CN2600900000000,26,9,"Antrim County, MI",Aug-19,11079,10621,458,4.1
17330,CN2601100000000,26,11,"Arenac County, MI",Aug-19,6236,5882,354,5.7
17331,CN2601300000000,26,13,"Baraga County, MI",Aug-19,3282,3088,194,5.9
17332,CN2601500000000,26,15,"Barry County, MI",Aug-19,31712,30704,1008,3.2
17333,CN2601700000000,26,17,"Bay County, MI",Aug-19,50094,47892,2202,4.4
17334,CN2601900000000,26,19,"Benzie County, MI",Aug-19,9268,8921,347,3.7
17335,CN2602100000000,26,21,"Berrien County, MI",Aug-19,73984,70932,3052,4.1
17336,CN2602300000000,26,23,"Branch County, MI",Aug-19,19652,18869,783,4.0
17337,CN2602500000000,26,25,"Calhoun County, MI",Aug-19,62248,59562,2686,4.3
17338,CN2602700000000,26,27,"Cass County, MI",Aug-19,24282,23202,1080,4.4
17339,CN2602900000000,26,29,"Charlevoix County, MI",Aug-19,13855,13354,501,3.6
17340,CN2603100000000,26,31,"Cheboygan County, MI",Aug-19,11314,10910,404,3.6
17341,CN2603300000000,26,33,"Chippewa County, MI",Aug-19,15963,15096,867,5.4
17342,CN2603500000000,26,35,"Clare County, MI",Aug-19,11710,11076,634,5.4
17343,CN2603700000000,26,37,"Clinton County, MI",Aug-19,40111,38888,1223,3.0
17344,CN2603900000000,26,39,"Crawford County, MI",Aug-19,5738,5456,282,4.9
17345,CN2604100000000,26,41,"Delta County, MI",Aug-19,17582,16739,843,4.8
17346,CN2604300000000,26,43,"Dickinson County, MI",Aug-19,12500,12026,474,3.8
17347,CN2604500000000,26,45,"Eaton County, MI",Aug-19,55429,53555,1874,3.4
17348,CN2604700000000,26,47,"Emmet County, MI",Aug-19,19051,18331,720,3.8
17349,CN2604900000000,26,49,"Genesee County, MI",Aug-19,183576,174910,8666,4.7
17350,CN2605100000000,26,51,"Gladwin County, MI",Aug-19,10083,9522,561,5.6
17351,CN2605300000000,26,53,"Gogebic County, MI",Aug-19,5976,5663,313,5.2
17352,CN2605500000000,26,55,"Grand Traverse County, MI",Aug-19,52365,50812,1553,3.0
17353,CN2605700000000,26,57,"Gratiot County, MI",Aug-19,17744,17007,737,4.2
17354,CN2605900000000,26,59,"Hillsdale County, MI",Aug-19,20706,19840,866,4.2
17355,CN2606100000000,26,61,"Houghton County, MI",Aug-19,15578,14824,754,4.8
17356,CN2606300000000,26,63,"Huron County, MI",Aug-19,15741,15120,621,3.9
17357,CN2606500000000,26,65,"Ingham County, MI",Aug-19,146693,141341,5352,3.6
17358,CN2606700000000,26,67,"Ionia County, MI",Aug-19,30302,29291,1011,3.3
17359,CN2606900000000,26,69,"Iosco County, MI",Aug-19,10621,10091,530,5.0
17360,CN2607100000000,26,71,"Iron County, MI",Aug-19,5301,5048,253,4.8
17361,CN2607300000000,26,73,"Isabella County, MI",Aug-19,34678,33342,1336,3.9
17362,CN2607500000000,26,75,"Jackson County, MI",Aug-19,73669,70847,2822,3.8
17363,CN2607700000000,26,77,"Kalamazoo County, MI",Aug-19,132661,127985,4676,3.5
17364,CN2607900000000,26,79,"Kalkaska County, MI",Aug-19,8294,7917,377,4.5
17365,CN2608100000000,26,81,"Kent County, MI",Aug-19,360011,349072,10939,3.0
17366,CN2608300000000,26,83,"Keweenaw County, MI",Aug-19,852,799,53,6.2
17367,CN2608500000000,26,85,"Lake County, MI",Aug-19,3748,3518,230,6.1
17368,CN2608700000000,26,87,"Lapeer County, MI",Aug-19,41804,39652,2152,5.1
17369,CN2608900000000,26,89,"Leelanau County, MI",Aug-19,11088,10751,337,3.0
17370,CN2609100000000,26,91,"Lenawee County, MI",Aug-19,46367,44648,1719,3.7
17371,CN2609300000000,26,93,"Livingston County, MI",Aug-19,105225,101478,3747,3.6
17372,CN2609500000000,26,95,"Luce County, MI",Aug-19,2426,2292,134,5.5
17373,CN2609700000000,26,97,"Mackinac County, MI",Aug-19,6288,6100,188,3.0
17374,CN2609900000000,26,99,"Macomb County, MI",Aug-19,455437,434467,20970,4.6
17375,CN2610100000000,26,101,"Manistee County, MI",Aug-19,10877,10369,508,4.7
17376,CN2610300000000,26,103,"Marquette County, MI",Aug-19,32253,30793,1460,4.5
17377,CN2610500000000,26,105,"Mason County, MI",Aug-19,14234,13625,609,4.3
17378,CN2610700000000,26,107,"Mecosta County, MI",Aug-19,17658,16843,815,4.6
17379,CN2610900000000,26,109,"Menominee County, MI",Aug-19,11208,10738,470,4.2
17380,CN2611100000000,26,111,"Midland County, MI",Aug-19,40174,38713,1461,3.6
17381,CN2611300000000,26,113,"Missaukee County, MI",Aug-19,7134,6844,290,4.1
17382,CN2611500000000,26,115,"Monroe County, MI",Aug-19,74662,71816,2846,3.8
17383,CN2611700000000,26,117,"Montcalm County, MI",Aug-19,28519,27420,1099,3.9
17384,CN2611900000000,26,119,"Montmorency County, MI",Aug-19,3062,2864,198,6.5
17385,CN2612100000000,26,121,"Muskegon County, MI",Aug-19,78095,74797,3298,4.2
17386,CN2612300000000,26,123,"Newaygo County, MI",Aug-19,23630,22685,945,4.0
17387,CN2612500000000,26,125,"Oakland County, MI",Aug-19,687450,660784,26666,3.9
17388,CN2612700000000,26,127,"Oceana County, MI",Aug-19,12955,12367,588,4.5
17389,CN2612900000000,26,129,"Ogemaw County, MI",Aug-19,8271,7809,462,5.6
17390,CN2613100000000,26,131,"Ontonagon County, MI",Aug-19,2118,1997,121,5.7
17391,CN2613300000000,26,133,"Osceola County, MI",Aug-19,11317,10887,430,3.8
17392,CN2613500000000,26,135,"Oscoda County, MI",Aug-19,3232,3041,191,5.9
17393,CN2613700000000,26,137,"Otsego County, MI",Aug-19,11917,11397,520,4.4
17394,CN2613900000000,26,139,"Ottawa County, MI",Aug-19,161542,156945,4597,2.8
17395,CN2614100000000,26,141,"Presque Isle County, MI",Aug-19,5139,4848,291,5.7
17396,CN2614300000000,26,143,"Roscommon County, MI",Aug-19,8032,7517,515,6.4
17397,CN2614500000000,26,145,"Saginaw County, MI",Aug-19,86675,82782,3893,4.5
17398,CN2614700000000,26,147,"St. Clair County, MI",Aug-19,76948,73078,3870,5.0
17399,CN2614900000000,26,149,"St. Joseph County, MI",Aug-19,28602,27356,1246,4.4
17400,CN2615100000000,26,151,"Sanilac County, MI",Aug-19,19966,19095,871,4.4
17401,CN2615300000000,26,153,"Schoolcraft County, MI",Aug-19,3400,3205,195,5.7
17402,CN2615500000000,26,155,"Shiawassee County, MI",Aug-19,33123,31746,1377,4.2
17403,CN2615700000000,26,157,"Tuscola County, MI",Aug-19,23966,22830,1136,4.7
17404,CN2615900000000,26,159,"Van Buren County, MI",Aug-19,35196,33637,1559,4.4
17405,CN2616100000000,26,161,"Washtenaw County, MI",Aug-19,195961,189782,6179,3.2
17406,CN2616300000000,26,163,"Wayne County, MI",Aug-19,816837,770486,46351,5.7
17407,CN2616500000000,26,165,"Wexford County, MI",Aug-19,14991,14362,629,4.2
17408,CN2700100000000,27,1,"Aitkin County, MN",Aug-19,7205,6901,304,4.2
17409,CN2700300000000,27,3,"Anoka County, MN",Aug-19,200785,194905,5880,2.9
17410,CN2700500000000,27,5,"Becker County, MN",Aug-19,18870,18329,541,2.9
17411,CN2700700000000,27,7,"Beltrami County, MN",Aug-19,24707,23805,902,3.7
17412,CN2700900000000,27,9,"Benton County, MN",Aug-19,21880,21217,663,3.0
17413,CN2701100000000,27,11,"Big Stone County, MN",Aug-19,2492,2427,65,2.6
17414,CN2701300000000,27,13,"Blue Earth County, MN",Aug-19,39960,38794,1166,2.9
17415,CN2701500000000,27,15,"Brown County, MN",Aug-19,14497,14075,422,2.9
17416,CN2701700000000,27,17,"Carlton County, MN",Aug-19,17660,16961,699,4.0
17417,CN2701900000000,27,19,"Carver County, MN",Aug-19,59597,57946,1651,2.8
17418,CN2702100000000,27,21,"Cass County, MN",Aug-19,15294,14718,576,3.8
17419,CN2702300000000,27,23,"Chippewa County, MN",Aug-19,6799,6575,224,3.3
17420,CN2702500000000,27,25,"Chisago County, MN",Aug-19,30320,29384,936,3.1
17421,CN2702700000000,27,27,"Clay County, MN",Aug-19,35738,34781,957,2.7
17422,CN2702900000000,27,29,"Clearwater County, MN",Aug-19,4351,4114,237,5.4
17423,CN2703100000000,27,31,"Cook County, MN",Aug-19,3434,3343,91,2.6
17424,CN2703300000000,27,33,"Cottonwood County, MN",Aug-19,5837,5615,222,3.8
17425,CN2703500000000,27,35,"Crow Wing County, MN",Aug-19,33168,32114,1054,3.2
17426,CN2703700000000,27,37,"Dakota County, MN",Aug-19,245848,238710,7138,2.9
17427,CN2703900000000,27,39,"Dodge County, MN",Aug-19,12081,11726,355,2.9
17428,CN2704100000000,27,41,"Douglas County, MN",Aug-19,21646,21086,560,2.6
17429,CN2704300000000,27,43,"Faribault County, MN",Aug-19,7161,6924,237,3.3
17430,CN2704500000000,27,45,"Fillmore County, MN",Aug-19,11708,11402,306,2.6
17431,CN2704700000000,27,47,"Freeborn County, MN",Aug-19,15845,15363,482,3.0
17432,CN2704900000000,27,49,"Goodhue County, MN",Aug-19,27514,26762,752,2.7
17433,CN2705100000000,27,51,"Grant County, MN",Aug-19,3271,3163,108,3.3
17434,CN2705300000000,27,53,"Hennepin County, MN",Aug-19,720645,699539,21106,2.9
17435,CN2705500000000,27,55,"Houston County, MN",Aug-19,10280,10008,272,2.6
17436,CN2705700000000,27,57,"Hubbard County, MN",Aug-19,10368,9996,372,3.6
17437,CN2705900000000,27,59,"Isanti County, MN",Aug-19,21485,20801,684,3.2
17438,CN2706100000000,27,61,"Itasca County, MN",Aug-19,22201,21063,1138,5.1
17439,CN2706300000000,27,63,"Jackson County, MN",Aug-19,5780,5613,167,2.9
17440,CN2706500000000,27,65,"Kanabec County, MN",Aug-19,9001,8705,296,3.3
17441,CN2706700000000,27,67,"Kandiyohi County, MN",Aug-19,24364,23648,716,2.9
17442,CN2706900000000,27,69,"Kittson County, MN",Aug-19,2364,2286,78,3.3
17443,CN2707100000000,27,71,"Koochiching County, MN",Aug-19,6070,5703,367,6.0
17444,CN2707300000000,27,73,"Lac qui Parle County, MN",Aug-19,3413,3312,101,3.0
17445,CN2707500000000,27,75,"Lake County, MN",Aug-19,5775,5604,171,3.0
17446,CN2707700000000,27,77,"Lake of the Woods County, MN",Aug-19,2480,2368,112,4.5
17447,CN2707900000000,27,79,"Le Sueur County, MN",Aug-19,16180,15698,482,3.0
17448,CN2708100000000,27,81,"Lincoln County, MN",Aug-19,3233,3132,101,3.1
17449,CN2708300000000,27,83,"Lyon County, MN",Aug-19,14156,13729,427,3.0
17450,CN2708500000000,27,85,"McLeod County, MN",Aug-19,19434,18784,650,3.3
17451,CN2708700000000,27,87,"Mahnomen County, MN",Aug-19,2218,2146,72,3.2
17452,CN2708900000000,27,89,"Marshall County, MN",Aug-19,5232,5050,182,3.5
17453,CN2709100000000,27,91,"Martin County, MN",Aug-19,10236,9866,370,3.6
17454,CN2709300000000,27,93,"Meeker County, MN",Aug-19,13398,12997,401,3.0
17455,CN2709500000000,27,95,"Mille Lacs County, MN",Aug-19,12931,12454,477,3.7
17456,CN2709700000000,27,97,"Morrison County, MN",Aug-19,17385,16792,593,3.4
17457,CN2709900000000,27,99,"Mower County, MN",Aug-19,20331,19750,581,2.9
17458,CN2710100000000,27,101,"Murray County, MN",Aug-19,4747,4580,167,3.5
17459,CN2710300000000,27,103,"Nicollet County, MN",Aug-19,20641,20107,534,2.6
17460,CN2710500000000,27,105,"Nobles County, MN",Aug-19,11164,10822,342,3.1
17461,CN2710700000000,27,107,"Norman County, MN",Aug-19,3199,3076,123,3.8
17462,CN2710900000000,27,109,"Olmsted County, MN",Aug-19,90662,88381,2281,2.5
17463,CN2711100000000,27,111,"Otter Tail County, MN",Aug-19,32244,31226,1018,3.2
17464,CN2711300000000,27,113,"Pennington County, MN",Aug-19,8491,8269,222,2.6
17465,CN2711500000000,27,115,"Pine County, MN",Aug-19,15082,14510,572,3.8
17466,CN2711700000000,27,117,"Pipestone County, MN",Aug-19,4963,4843,120,2.4
17467,CN2711900000000,27,119,"Polk County, MN",Aug-19,16162,15571,591,3.7
17468,CN2712100000000,27,121,"Pope County, MN",Aug-19,6592,6429,163,2.5
17469,CN2712300000000,27,123,"Ramsey County, MN",Aug-19,295177,286001,9176,3.1
17470,CN2712500000000,27,125,"Red Lake County, MN",Aug-19,2180,2095,85,3.9
17471,CN2712700000000,27,127,"Redwood County, MN",Aug-19,7539,7296,243,3.2
17472,CN2712900000000,27,129,"Renville County, MN",Aug-19,8498,8169,329,3.9
17473,CN2713100000000,27,131,"Rice County, MN",Aug-19,37226,36073,1153,3.1
17474,CN2713300000000,27,133,"Rock County, MN",Aug-19,5566,5441,125,2.2
17475,CN2713500000000,27,135,"Roseau County, MN",Aug-19,7770,7462,308,4.0
17476,CN2713700000000,27,137,"St. Louis County, MN",Aug-19,101104,97269,3835,3.8
17477,CN2713900000000,27,139,"Scott County, MN",Aug-19,84916,82656,2260,2.7
17478,CN2714100000000,27,141,"Sherburne County, MN",Aug-19,52979,51458,1521,2.9
17479,CN2714300000000,27,143,"Sibley County, MN",Aug-19,8594,8345,249,2.9
17480,CN2714500000000,27,145,"Stearns County, MN",Aug-19,90451,87877,2574,2.8
17481,CN2714700000000,27,147,"Steele County, MN",Aug-19,21242,20587,655,3.1
17482,CN2714900000000,27,149,"Stevens County, MN",Aug-19,5423,5290,133,2.5
17483,CN2715100000000,27,151,"Swift County, MN",Aug-19,4939,4779,160,3.2
17484,CN2715300000000,27,153,"Todd County, MN",Aug-19,13340,12897,443,3.3
17485,CN2715500000000,27,155,"Traverse County, MN",Aug-19,1726,1671,55,3.2
17486,CN2715700000000,27,157,"Wabasha County, MN",Aug-19,12536,12166,370,3.0
17487,CN2715900000000,27,159,"Wadena County, MN",Aug-19,5757,5491,266,4.6
17488,CN2716100000000,27,161,"Waseca County, MN",Aug-19,9190,8892,298,3.2
17489,CN2716300000000,27,163,"Washington County, MN",Aug-19,145631,141642,3989,2.7
17490,CN2716500000000,27,165,"Watonwan County, MN",Aug-19,6396,6149,247,3.9
17491,CN2716700000000,27,167,"Wilkin County, MN",Aug-19,3500,3378,122,3.5
17492,CN2716900000000,27,169,"Winona County, MN",Aug-19,28613,27754,859,3.0
17493,CN2717100000000,27,171,"Wright County, MN",Aug-19,76587,74539,2048,2.7
17494,CN2717300000000,27,173,"Yellow Medicine County, MN",Aug-19,5273,5093,180,3.4
17495,CN2800100000000,28,1,"Adams County, MS",Aug-19,11301,10444,857,7.6
17496,CN2800300000000,28,3,"Alcorn County, MS",Aug-19,15808,15001,807,5.1
17497,CN2800500000000,28,5,"Amite County, MS",Aug-19,4455,4117,338,7.6
17498,CN2800700000000,28,7,"Attala County, MS",Aug-19,7056,6631,425,6.0
17499,CN2800900000000,28,9,"Benton County, MS",Aug-19,3038,2863,175,5.8
17500,CN2801100000000,28,11,"Bolivar County, MS",Aug-19,12176,11310,866,7.1
17501,CN2801300000000,28,13,"Calhoun County, MS",Aug-19,5740,5426,314,5.5
17502,CN2801500000000,28,15,"Carroll County, MS",Aug-19,3493,3265,228,6.5
17503,CN2801700000000,28,17,"Chickasaw County, MS",Aug-19,6907,6503,404,5.8
17504,CN2801900000000,28,19,"Choctaw County, MS",Aug-19,3764,3566,198,5.3
17505,CN2802100000000,28,21,"Claiborne County, MS",Aug-19,3090,2713,377,12.2
17506,CN2802300000000,28,23,"Clarke County, MS",Aug-19,5904,5531,373,6.3
17507,CN2802500000000,28,25,"Clay County, MS",Aug-19,7779,7213,566,7.3
17508,CN2802700000000,28,27,"Coahoma County, MS",Aug-19,8338,7663,675,8.1
17509,CN2802900000000,28,29,"Copiah County, MS",Aug-19,11168,10431,737,6.6
17510,CN2803100000000,28,31,"Covington County, MS",Aug-19,8158,7729,429,5.3
17511,CN2803300000000,28,33,"DeSoto County, MS",Aug-19,91284,87144,4140,4.5
17512,CN2803500000000,28,35,"Forrest County, MS",Aug-19,32885,31083,1802,5.5
17513,CN2803700000000,28,37,"Franklin County, MS",Aug-19,2778,2575,203,7.3
17514,CN2803900000000,28,39,"George County, MS",Aug-19,8924,8196,728,8.2
17515,CN2804100000000,28,41,"Greene County, MS",Aug-19,4450,4052,398,8.9
17516,CN2804300000000,28,43,"Grenada County, MS",Aug-19,9360,8866,494,5.3
17517,CN2804500000000,28,45,"Hancock County, MS",Aug-19,18785,17713,1072,5.7
17518,CN2804700000000,28,47,"Harrison County, MS",Aug-19,86595,82059,4536,5.2
17519,CN2804900000000,28,49,"Hinds County, MS",Aug-19,106421,100636,5785,5.4
17520,CN2805100000000,28,51,"Holmes County, MS",Aug-19,5639,5062,577,10.2
17521,CN2805300000000,28,53,"Humphreys County, MS",Aug-19,2220,2014,206,9.3
17522,CN2805500000000,28,55,"Issaquena County, MS",Aug-19,402,356,46,11.4
17523,CN2805700000000,28,57,"Itawamba County, MS",Aug-19,10542,10023,519,4.9
17524,CN2805900000000,28,59,"Jackson County, MS",Aug-19,58750,55100,3650,6.2
17525,CN2806100000000,28,61,"Jasper County, MS",Aug-19,6132,5731,401,6.5
17526,CN2806300000000,28,63,"Jefferson County, MS",Aug-19,2090,1713,377,18.0
17527,CN2806500000000,28,65,"Jefferson Davis County, MS",Aug-19,4093,3780,313,7.6
17528,CN2806700000000,28,67,"Jones County, MS",Aug-19,26111,24650,1461,5.6
17529,CN2806900000000,28,69,"Kemper County, MS",Aug-19,3554,3274,280,7.9
17530,CN2807100000000,28,71,"Lafayette County, MS",Aug-19,27956,26588,1368,4.9
17531,CN2807300000000,28,73,"Lamar County, MS",Aug-19,30267,28959,1308,4.3
17532,CN2807500000000,28,75,"Lauderdale County, MS",Aug-19,30436,28691,1745,5.7
17533,CN2807700000000,28,77,"Lawrence County, MS",Aug-19,4614,4260,354,7.7
17534,CN2807900000000,28,79,"Leake County, MS",Aug-19,7983,7521,462,5.8
17535,CN2808100000000,28,81,"Lee County, MS",Aug-19,41200,39277,1923,4.7
17536,CN2808300000000,28,83,"Leflore County, MS",Aug-19,10058,9284,774,7.7
17537,CN2808500000000,28,85,"Lincoln County, MS",Aug-19,14668,13783,885,6.0
17538,CN2808700000000,28,87,"Lowndes County, MS",Aug-19,25020,23650,1370,5.5
17539,CN2808900000000,28,89,"Madison County, MS",Aug-19,52914,50554,2360,4.5
17540,CN2809100000000,28,91,"Marion County, MS",Aug-19,9949,9408,541,5.4
17541,CN2809300000000,28,93,"Marshall County, MS",Aug-19,14447,13642,805,5.6
17542,CN2809500000000,28,95,"Monroe County, MS",Aug-19,15594,14690,904,5.8
17543,CN2809700000000,28,97,"Montgomery County, MS",Aug-19,3959,3722,237,6.0
17544,CN2809900000000,28,99,"Neshoba County, MS",Aug-19,10491,9851,640,6.1
17545,CN2810100000000,28,101,"Newton County, MS",Aug-19,8845,8342,503,5.7
17546,CN2810300000000,28,103,"Noxubee County, MS",Aug-19,3776,3501,275,7.3
17547,CN2810500000000,28,105,"Oktibbeha County, MS",Aug-19,22580,21236,1344,6.0
17548,CN2810700000000,28,107,"Panola County, MS",Aug-19,12600,11759,841,6.7
17549,CN2810900000000,28,109,"Pearl River County, MS",Aug-19,23616,22346,1270,5.4
17550,CN2811100000000,28,111,"Perry County, MS",Aug-19,4268,3950,318,7.5
17551,CN2811300000000,28,113,"Pike County, MS",Aug-19,14534,13537,997,6.9
17552,CN2811500000000,28,115,"Pontotoc County, MS",Aug-19,14777,14093,684,4.6
17553,CN2811700000000,28,117,"Prentiss County, MS",Aug-19,11286,10718,568,5.0
17554,CN2811900000000,28,119,"Quitman County, MS",Aug-19,2409,2212,197,8.2
17555,CN2812100000000,28,121,"Rankin County, MS",Aug-19,75728,72591,3137,4.1
17556,CN2812300000000,28,123,"Scott County, MS",Aug-19,12948,12339,609,4.7
17557,CN2812500000000,28,125,"Sharkey County, MS",Aug-19,1610,1481,129,8.0
17558,CN2812700000000,28,127,"Simpson County, MS",Aug-19,10745,10147,598,5.6
17559,CN2812900000000,28,129,"Smith County, MS",Aug-19,6822,6471,351,5.1
17560,CN2813100000000,28,131,"Stone County, MS",Aug-19,6802,6349,453,6.7
17561,CN2813300000000,28,133,"Sunflower County, MS",Aug-19,7760,7051,709,9.1
17562,CN2813500000000,28,135,"Tallahatchie County, MS",Aug-19,5249,4969,280,5.3
17563,CN2813700000000,28,137,"Tate County, MS",Aug-19,12423,11695,728,5.9
17564,CN2813900000000,28,139,"Tippah County, MS",Aug-19,9405,8922,483,5.1
17565,CN2814100000000,28,141,"Tishomingo County, MS",Aug-19,8494,8022,472,5.6
17566,CN2814300000000,28,143,"Tunica County, MS",Aug-19,4482,4199,283,6.3
17567,CN2814500000000,28,145,"Union County, MS",Aug-19,14223,13614,609,4.3
17568,CN2814700000000,28,147,"Walthall County, MS",Aug-19,4972,4593,379,7.6
17569,CN2814900000000,28,149,"Warren County, MS",Aug-19,20420,19145,1275,6.2
17570,CN2815100000000,28,151,"Washington County, MS",Aug-19,16921,15647,1274,7.5
17571,CN2815300000000,28,153,"Wayne County, MS",Aug-19,7534,7050,484,6.4
17572,CN2815500000000,28,155,"Webster County, MS",Aug-19,3967,3739,228,5.7
17573,CN2815700000000,28,157,"Wilkinson County, MS",Aug-19,2836,2517,319,11.2
17574,CN2815900000000,28,159,"Winston County, MS",Aug-19,7473,7006,467,6.2
17575,CN2816100000000,28,161,"Yalobusha County, MS",Aug-19,4951,4632,319,6.4
17576,CN2816300000000,28,163,"Yazoo County, MS",Aug-19,9435,8801,634,6.7
17577,CN2900100000000,29,1,"Adair County, MO",Aug-19,9932,9486,446,4.5
17578,CN2900300000000,29,3,"Andrew County, MO",Aug-19,9686,9426,260,2.7
17579,CN2900500000000,29,5,"Atchison County, MO",Aug-19,2515,2408,107,4.3
17580,CN2900700000000,29,7,"Audrain County, MO",Aug-19,10344,9987,357,3.5
17581,CN2900900000000,29,9,"Barry County, MO",Aug-19,14912,14361,551,3.7
17582,CN2901100000000,29,11,"Barton County, MO",Aug-19,5004,4810,194,3.9
17583,CN2901300000000,29,13,"Bates County, MO",Aug-19,7868,7529,339,4.3
17584,CN2901500000000,29,15,"Benton County, MO",Aug-19,6960,6643,317,4.6
17585,CN2901700000000,29,17,"Bollinger County, MO",Aug-19,5395,5167,228,4.2
17586,CN2901900000000,29,19,"Boone County, MO",Aug-19,96631,94045,2586,2.7
17587,CN2902100000000,29,21,"Buchanan County, MO",Aug-19,44537,43114,1423,3.2
17588,CN2902300000000,29,23,"Butler County, MO",Aug-19,17771,16935,836,4.7
17589,CN2902500000000,29,25,"Caldwell County, MO",Aug-19,4327,4186,141,3.3
17590,CN2902700000000,29,27,"Callaway County, MO",Aug-19,21541,20827,714,3.3
17591,CN2902900000000,29,29,"Camden County, MO",Aug-19,20003,19238,765,3.8
17592,CN2903100000000,29,31,"Cape Girardeau County, MO",Aug-19,40517,39136,1381,3.4
17593,CN2903300000000,29,33,"Carroll County, MO",Aug-19,4555,4402,153,3.4
17594,CN2903500000000,29,35,"Carter County, MO",Aug-19,2633,2504,129,4.9
17595,CN2903700000000,29,37,"Cass County, MO",Aug-19,55038,53335,1703,3.1
17596,CN2903900000000,29,39,"Cedar County, MO",Aug-19,5576,5350,226,4.1
17597,CN2904100000000,29,41,"Chariton County, MO",Aug-19,3478,3353,125,3.6
17598,CN2904300000000,29,43,"Christian County, MO",Aug-19,44609,43287,1322,3.0
17599,CN2904500000000,29,45,"Clark County, MO",Aug-19,3155,3046,109,3.5
17600,CN2904700000000,29,47,"Clay County, MO",Aug-19,137287,133101,4186,3.0
17601,CN2904900000000,29,49,"Clinton County, MO",Aug-19,10700,10377,323,3.0
17602,CN2905100000000,29,51,"Cole County, MO",Aug-19,39447,38270,1177,3.0
17603,CN2905300000000,29,53,"Cooper County, MO",Aug-19,7197,6937,260,3.6
17604,CN2905500000000,29,55,"Crawford County, MO",Aug-19,10914,10508,406,3.7
17605,CN2905700000000,29,57,"Dade County, MO",Aug-19,3322,3201,121,3.6
17606,CN2905900000000,29,59,"Dallas County, MO",Aug-19,7018,6626,392,5.6
17607,CN2906100000000,29,61,"Daviess County, MO",Aug-19,3842,3707,135,3.5
17608,CN2906300000000,29,63,"DeKalb County, MO",Aug-19,4755,4614,141,3.0
17609,CN2906500000000,29,65,"Dent County, MO",Aug-19,6028,5774,254,4.2
17610,CN2906700000000,29,67,"Douglas County, MO",Aug-19,4986,4621,365,7.3
17611,CN2906900000000,29,69,"Dunklin County, MO",Aug-19,11060,10410,650,5.9
17612,CN2907100000000,29,71,"Franklin County, MO",Aug-19,53463,51659,1804,3.4
17613,CN2907300000000,29,73,"Gasconade County, MO",Aug-19,7557,7339,218,2.9
17614,CN2907500000000,29,75,"Gentry County, MO",Aug-19,3403,3298,105,3.1
17615,CN2907700000000,29,77,"Greene County, MO",Aug-19,150343,145662,4681,3.1
17616,CN2907900000000,29,79,"Grundy County, MO",Aug-19,4049,3892,157,3.9
17617,CN2908100000000,29,81,"Harrison County, MO",Aug-19,3578,3431,147,4.1
17618,CN2908300000000,29,83,"Henry County, MO",Aug-19,9426,9041,385,4.1
17619,CN2908500000000,29,85,"Hickory County, MO",Aug-19,3840,3662,178,4.6
17620,CN2908700000000,29,87,"Holt County, MO",Aug-19,2490,2409,81,3.3
17621,CN2908900000000,29,89,"Howard County, MO",Aug-19,4643,4492,151,3.3
17622,CN2909100000000,29,91,"Howell County, MO",Aug-19,16331,15647,684,4.2
17623,CN2909300000000,29,93,"Iron County, MO",Aug-19,3455,3275,180,5.2
17624,CN2909500000000,29,95,"Jackson County, MO",Aug-19,366256,351433,14823,4.0
17625,CN2909700000000,29,97,"Jasper County, MO",Aug-19,57231,55419,1812,3.2
17626,CN2909900000000,29,99,"Jefferson County, MO",Aug-19,118919,115120,3799,3.2
17627,CN2910100000000,29,101,"Johnson County, MO",Aug-19,22713,21793,920,4.1
17628,CN2910300000000,29,103,"Knox County, MO",Aug-19,1669,1621,48,2.9
17629,CN2910500000000,29,105,"Laclede County, MO",Aug-19,17283,15695,1588,9.2
17630,CN2910700000000,29,107,"Lafayette County, MO",Aug-19,16738,16246,492,2.9
17631,CN2910900000000,29,109,"Lawrence County, MO",Aug-19,17419,16755,664,3.8
17632,CN2911100000000,29,111,"Lewis County, MO",Aug-19,4815,4645,170,3.5
17633,CN2911300000000,29,113,"Lincoln County, MO",Aug-19,28462,27530,932,3.3
17634,CN2911500000000,29,115,"Linn County, MO",Aug-19,4943,4634,309,6.3
17635,CN2911700000000,29,117,"Livingston County, MO",Aug-19,7141,6955,186,2.6
17636,CN2911900000000,29,119,"McDonald County, MO",Aug-19,10637,10258,379,3.6
17637,CN2912100000000,29,121,"Macon County, MO",Aug-19,7198,6946,252,3.5
17638,CN2912300000000,29,123,"Madison County, MO",Aug-19,5428,5242,186,3.4
17639,CN2912500000000,29,125,"Maries County, MO",Aug-19,3755,3614,141,3.8
17640,CN2912700000000,29,127,"Marion County, MO",Aug-19,14291,13825,466,3.3
17641,CN2912900000000,29,129,"Mercer County, MO",Aug-19,1651,1597,54,3.3
17642,CN2913100000000,29,131,"Miller County, MO",Aug-19,12217,11777,440,3.6
17643,CN2913300000000,29,133,"Mississippi County, MO",Aug-19,5651,5397,254,4.5
17644,CN2913500000000,29,135,"Moniteau County, MO",Aug-19,7267,7037,230,3.2
17645,CN2913700000000,29,137,"Monroe County, MO",Aug-19,3710,3538,172,4.6
17646,CN2913900000000,29,139,"Montgomery County, MO",Aug-19,5685,5507,178,3.1
17647,CN2914100000000,29,141,"Morgan County, MO",Aug-19,8214,7891,323,3.9
17648,CN2914300000000,29,143,"New Madrid County, MO",Aug-19,7944,7556,388,4.9
17649,CN2914500000000,29,145,"Newton County, MO",Aug-19,27263,26329,934,3.4
17650,CN2914700000000,29,147,"Nodaway County, MO",Aug-19,10398,10021,377,3.6
17651,CN2914900000000,29,149,"Oregon County, MO",Aug-19,3922,3757,165,4.2
17652,CN2915100000000,29,151,"Osage County, MO",Aug-19,7111,6915,196,2.8
17653,CN2915300000000,29,153,"Ozark County, MO",Aug-19,3303,3091,212,6.4
17654,CN2915500000000,29,155,"Pemiscot County, MO",Aug-19,6338,5989,349,5.5
17655,CN2915700000000,29,157,"Perry County, MO",Aug-19,9911,9645,266,2.7
17656,CN2915900000000,29,159,"Pettis County, MO",Aug-19,21178,20310,868,4.1
17657,CN2916100000000,29,161,"Phelps County, MO",Aug-19,19854,19178,676,3.4
17658,CN2916300000000,29,163,"Pike County, MO",Aug-19,7325,7034,291,4.0
17659,CN2916500000000,29,165,"Platte County, MO",Aug-19,59037,57384,1653,2.8
17660,CN2916700000000,29,167,"Polk County, MO",Aug-19,14425,13866,559,3.9
17661,CN2916900000000,29,169,"Pulaski County, MO",Aug-19,14717,14065,652,4.4
17662,CN2917100000000,29,171,"Putnam County, MO",Aug-19,2215,2108,107,4.8
17663,CN2917300000000,29,173,"Ralls County, MO",Aug-19,5521,5356,165,3.0
17664,CN2917500000000,29,175,"Randolph County, MO",Aug-19,10059,9631,428,4.3
17665,CN2917700000000,29,177,"Ray County, MO",Aug-19,11083,10635,448,4.0
17666,CN2917900000000,29,179,"Reynolds County, MO",Aug-19,2933,2812,121,4.1
17667,CN2918100000000,29,181,"Ripley County, MO",Aug-19,4842,4574,268,5.5
17668,CN2918300000000,29,183,"St. Charles County, MO",Aug-19,228067,222034,6033,2.6
17669,CN2918500000000,29,185,"St. Clair County, MO",Aug-19,3552,3354,198,5.6
17670,CN2918600000000,29,186,"Ste. Genevieve County, MO",Aug-19,9111,8865,246,2.7
17671,CN2918700000000,29,187,"St. Francois County, MO",Aug-19,26557,25528,1029,3.9
17672,CN2918900000000,29,189,"St. Louis County, MO",Aug-19,537065,519166,17899,3.3
17673,CN2919500000000,29,195,"Saline County, MO",Aug-19,10156,9787,369,3.6
17674,CN2919700000000,29,197,"Schuyler County, MO",Aug-19,1849,1758,91,4.9
17675,CN2919900000000,29,199,"Scotland County, MO",Aug-19,2320,2243,77,3.3
17676,CN2920100000000,29,201,"Scott County, MO",Aug-19,19642,18881,761,3.9
17677,CN2920300000000,29,203,"Shannon County, MO",Aug-19,3150,2985,165,5.2
17678,CN2920500000000,29,205,"Shelby County, MO",Aug-19,2913,2838,75,2.6
17679,CN2920700000000,29,207,"Stoddard County, MO",Aug-19,12980,12334,646,5.0
17680,CN2920900000000,29,209,"Stone County, MO",Aug-19,14368,13809,559,3.9
17681,CN2921100000000,29,211,"Sullivan County, MO",Aug-19,2507,2402,105,4.2
17682,CN2921300000000,29,213,"Taney County, MO",Aug-19,28099,27013,1086,3.9
17683,CN2921500000000,29,215,"Texas County, MO",Aug-19,8492,8062,430,5.1
17684,CN2921700000000,29,217,"Vernon County, MO",Aug-19,9001,8650,351,3.9
17685,CN2921900000000,29,219,"Warren County, MO",Aug-19,17977,17476,501,2.8
17686,CN2922100000000,29,221,"Washington County, MO",Aug-19,9982,9542,440,4.4
17687,CN2922300000000,29,223,"Wayne County, MO",Aug-19,5278,5016,262,5.0
17688,CN2922500000000,29,225,"Webster County, MO",Aug-19,17183,16398,785,4.6
17689,CN2922700000000,29,227,"Worth County, MO",Aug-19,1081,1053,28,2.6
17690,CN2922900000000,29,229,"Wright County, MO",Aug-19,7168,6688,480,6.7
17691,CN2951000000000,29,510,"St. Louis city, MO",Aug-19,154409,147791,6618,4.3
17692,CN3000100000000,30,1,"Beaverhead County, MT",Aug-19,5132,5007,125,2.4
17693,CN3000300000000,30,3,"Big Horn County, MT",Aug-19,4823,4476,347,7.2
17694,CN3000500000000,30,5,"Blaine County, MT",Aug-19,2523,2448,75,3.0
17695,CN3000700000000,30,7,"Broadwater County, MT",Aug-19,2645,2552,93,3.5
17696,CN3000900000000,30,9,"Carbon County, MT",Aug-19,5497,5340,157,2.9
17697,CN3001100000000,30,11,"Carter County, MT",Aug-19,680,667,13,1.9
17698,CN3001300000000,30,13,"Cascade County, MT",Aug-19,37579,36330,1249,3.3
17699,CN3001500000000,30,15,"Chouteau County, MT",Aug-19,2508,2455,53,2.1
17700,CN3001700000000,30,17,"Custer County, MT",Aug-19,6052,5911,141,2.3
17701,CN3001900000000,30,19,"Daniels County, MT",Aug-19,916,902,14,1.5
17702,CN3002100000000,30,21,"Dawson County, MT",Aug-19,4619,4521,98,2.1
17703,CN3002300000000,30,23,"Deer Lodge County, MT",Aug-19,5142,4977,165,3.2
17704,CN3002500000000,30,25,"Fallon County, MT",Aug-19,1802,1778,24,1.3
17705,CN3002700000000,30,27,"Fergus County, MT",Aug-19,6228,6079,149,2.4
17706,CN3002900000000,30,29,"Flathead County, MT",Aug-19,49912,48008,1904,3.8
17707,CN3003100000000,30,31,"Gallatin County, MT",Aug-19,71140,69838,1302,1.8
17708,CN3003300000000,30,33,"Garfield County, MT",Aug-19,746,728,18,2.4
17709,CN3003500000000,30,35,"Glacier County, MT",Aug-19,6228,5816,412,6.6
17710,CN3003700000000,30,37,"Golden Valley County, MT",Aug-19,365,357,8,2.2
17711,CN3003900000000,30,39,"Granite County, MT",Aug-19,1722,1648,74,4.3
17712,CN3004100000000,30,41,"Hill County, MT",Aug-19,7706,7387,319,4.1
17713,CN3004300000000,30,43,"Jefferson County, MT",Aug-19,5796,5631,165,2.8
17714,CN3004500000000,30,45,"Judith Basin County, MT",Aug-19,941,920,21,2.2
17715,CN3004700000000,30,47,"Lake County, MT",Aug-19,13313,12775,538,4.0
17716,CN3004900000000,30,49,"Lewis and Clark County, MT",Aug-19,36569,35523,1046,2.9
17717,CN3005100000000,30,51,"Liberty County, MT",Aug-19,949,927,22,2.3
17718,CN3005300000000,30,53,"Lincoln County, MT",Aug-19,8274,7781,493,6.0
17719,CN3005500000000,30,55,"McCone County, MT",Aug-19,951,933,18,1.9
17720,CN3005700000000,30,57,"Madison County, MT",Aug-19,4732,4610,122,2.6
17721,CN3005900000000,30,59,"Meagher County, MT",Aug-19,906,885,21,2.3
17722,CN3006100000000,30,61,"Mineral County, MT",Aug-19,1824,1741,83,4.6
17723,CN3006300000000,30,63,"Missoula County, MT",Aug-19,63580,61812,1768,2.8
17724,CN3006500000000,30,65,"Musselshell County, MT",Aug-19,2253,2175,78,3.5
17725,CN3006700000000,30,67,"Park County, MT",Aug-19,9496,9265,231,2.4
17726,CN3006900000000,30,69,"Petroleum County, MT",Aug-19,279,271,8,2.9
17727,CN3007100000000,30,71,"Phillips County, MT",Aug-19,1875,1824,51,2.7
17728,CN3007300000000,30,73,"Pondera County, MT",Aug-19,2651,2563,88,3.3
17729,CN3007500000000,30,75,"Powder River County, MT",Aug-19,971,952,19,2.0
17730,CN3007700000000,30,77,"Powell County, MT",Aug-19,3066,2968,98,3.2
17731,CN3007900000000,30,79,"Prairie County, MT",Aug-19,484,465,19,3.9
17732,CN3008100000000,30,81,"Ravalli County, MT",Aug-19,20365,19668,697,3.4
17733,CN3008300000000,30,83,"Richland County, MT",Aug-19,6096,5929,167,2.7
17734,CN3008500000000,30,85,"Roosevelt County, MT",Aug-19,4469,4277,192,4.3
17735,CN3008700000000,30,87,"Rosebud County, MT",Aug-19,3986,3767,219,5.5
17736,CN3008900000000,30,89,"Sanders County, MT",Aug-19,4975,4725,250,5.0
17737,CN3009100000000,30,91,"Sheridan County, MT",Aug-19,1740,1705,35,2.0
17738,CN3009300000000,30,93,"Silver Bow County, MT",Aug-19,17621,16987,634,3.6
17739,CN3009500000000,30,95,"Stillwater County, MT",Aug-19,5242,5099,143,2.7
17740,CN3009700000000,30,97,"Sweet Grass County, MT",Aug-19,1807,1762,45,2.5
17741,CN3009900000000,30,99,"Teton County, MT",Aug-19,2762,2688,74,2.7
17742,CN3010100000000,30,101,"Toole County, MT",Aug-19,2155,2104,51,2.4
17743,CN3010300000000,30,103,"Treasure County, MT",Aug-19,338,328,10,3.0
17744,CN3010500000000,30,105,"Valley County, MT",Aug-19,4141,4021,120,2.9
17745,CN3010700000000,30,107,"Wheatland County, MT",Aug-19,801,772,29,3.6
17746,CN3010900000000,30,109,"Wibaux County, MT",Aug-19,472,462,10,2.1
17747,CN3011100000000,30,111,"Yellowstone County, MT",Aug-19,82243,79719,2524,3.1
17748,CN3100100000000,31,1,"Adams County, NE",Aug-19,16976,16480,496,2.9
17749,CN3100300000000,31,3,"Antelope County, NE",Aug-19,3511,3420,91,2.6
17750,CN3100500000000,31,5,"Arthur County, NE",Aug-19,215,200,15,7.0
17751,CN3100700000000,31,7,"Banner County, NE",Aug-19,367,350,17,4.6
17752,CN3100900000000,31,9,"Blaine County, NE",Aug-19,240,229,11,4.6
17753,CN3101100000000,31,11,"Boone County, NE",Aug-19,2881,2807,74,2.6
17754,CN3101300000000,31,13,"Box Butte County, NE",Aug-19,5415,5230,185,3.4
17755,CN3101500000000,31,15,"Boyd County, NE",Aug-19,1025,991,34,3.3
17756,CN3101700000000,31,17,"Brown County, NE",Aug-19,1376,1332,44,3.2
17757,CN3101900000000,31,19,"Buffalo County, NE",Aug-19,27605,26867,738,2.7
17758,CN3102100000000,31,21,"Burt County, NE",Aug-19,3409,3303,106,3.1
17759,CN3102300000000,31,23,"Butler County, NE",Aug-19,4575,4456,119,2.6
17760,CN3102500000000,31,25,"Cass County, NE",Aug-19,13672,13235,437,3.2
17761,CN3102700000000,31,27,"Cedar County, NE",Aug-19,4439,4327,112,2.5
17762,CN3102900000000,31,29,"Chase County, NE",Aug-19,2235,2180,55,2.5
17763,CN3103100000000,31,31,"Cherry County, NE",Aug-19,3361,3278,83,2.5
17764,CN3103300000000,31,33,"Cheyenne County, NE",Aug-19,4429,4251,178,4.0
17765,CN3103500000000,31,35,"Clay County, NE",Aug-19,3274,3178,96,2.9
17766,CN3103700000000,31,37,"Colfax County, NE",Aug-19,5554,5401,153,2.8
17767,CN3103900000000,31,39,"Cuming County, NE",Aug-19,4605,4482,123,2.7
17768,CN3104100000000,31,41,"Custer County, NE",Aug-19,6256,6095,161,2.6
17769,CN3104300000000,31,43,"Dakota County, NE",Aug-19,10804,10431,373,3.5
17770,CN3104500000000,31,45,"Dawes County, NE",Aug-19,4874,4725,149,3.1
17771,CN3104700000000,31,47,"Dawson County, NE",Aug-19,13035,12662,373,2.9
17772,CN3104900000000,31,49,"Deuel County, NE",Aug-19,966,936,30,3.1
17773,CN3105100000000,31,51,"Dixon County, NE",Aug-19,2978,2899,79,2.7
17774,CN3105300000000,31,53,"Dodge County, NE",Aug-19,19584,19011,573,2.9
17775,CN3105500000000,31,55,"Douglas County, NE",Aug-19,303633,293867,9766,3.2
17776,CN3105700000000,31,57,"Dundy County, NE",Aug-19,1121,1089,32,2.9
17777,CN3105900000000,31,59,"Fillmore County, NE",Aug-19,3167,3088,79,2.5
17778,CN3106100000000,31,61,"Franklin County, NE",Aug-19,1371,1322,49,3.6
17779,CN3106300000000,31,63,"Frontier County, NE",Aug-19,1526,1473,53,3.5
17780,CN3106500000000,31,65,"Furnas County, NE",Aug-19,2534,2453,81,3.2
17781,CN3106700000000,31,67,"Gage County, NE",Aug-19,10932,10567,365,3.3
17782,CN3106900000000,31,69,"Garden County, NE",Aug-19,1093,1065,28,2.6
17783,CN3107100000000,31,71,"Garfield County, NE",Aug-19,1177,1145,32,2.7
17784,CN3107300000000,31,73,"Gosper County, NE",Aug-19,1150,1122,28,2.4
17785,CN3107500000000,31,75,"Grant County, NE",Aug-19,390,377,13,3.3
17786,CN3107700000000,31,77,"Greeley County, NE",Aug-19,1162,1130,32,2.8
17787,CN3107900000000,31,79,"Hall County, NE",Aug-19,31854,30876,978,3.1
17788,CN3108100000000,31,81,"Hamilton County, NE",Aug-19,4717,4575,142,3.0
17789,CN3108300000000,31,83,"Harlan County, NE",Aug-19,1830,1769,61,3.3
17790,CN3108500000000,31,85,"Hayes County, NE",Aug-19,588,573,15,2.6
17791,CN3108700000000,31,87,"Hitchcock County, NE",Aug-19,1263,1221,42,3.3
17792,CN3108900000000,31,89,"Holt County, NE",Aug-19,5595,5449,146,2.6
17793,CN3109100000000,31,91,"Hooker County, NE",Aug-19,447,434,13,2.9
17794,CN3109300000000,31,93,"Howard County, NE",Aug-19,3314,3218,96,2.9
17795,CN3109500000000,31,95,"Jefferson County, NE",Aug-19,4138,4017,121,2.9
17796,CN3109700000000,31,97,"Johnson County, NE",Aug-19,2029,1955,74,3.6
17797,CN3109900000000,31,99,"Kearney County, NE",Aug-19,3751,3656,95,2.5
17798,CN3110100000000,31,101,"Keith County, NE",Aug-19,4677,4520,157,3.4
17799,CN3110300000000,31,103,"Keya Paha County, NE",Aug-19,553,536,17,3.1
17800,CN3110500000000,31,105,"Kimball County, NE",Aug-19,2028,1966,62,3.1
17801,CN3110700000000,31,107,"Knox County, NE",Aug-19,4512,4387,125,2.8
17802,CN3110900000000,31,109,"Lancaster County, NE",Aug-19,178242,173242,5000,2.8
17803,CN3111100000000,31,111,"Lincoln County, NE",Aug-19,18522,17884,638,3.4
17804,CN3111300000000,31,113,"Logan County, NE",Aug-19,449,436,13,2.9
17805,CN3111500000000,31,115,"Loup County, NE",Aug-19,384,367,17,4.4
17806,CN3111700000000,31,117,"McPherson County, NE",Aug-19,429,418,11,2.6
17807,CN3111900000000,31,119,"Madison County, NE",Aug-19,19858,19321,537,2.7
17808,CN3112100000000,31,121,"Merrick County, NE",Aug-19,3963,3844,119,3.0
17809,CN3112300000000,31,123,"Morrill County, NE",Aug-19,2591,2521,70,2.7
17810,CN3112500000000,31,125,"Nance County, NE",Aug-19,1917,1866,51,2.7
17811,CN3112700000000,31,127,"Nemaha County, NE",Aug-19,3484,3346,138,4.0
17812,CN3112900000000,31,129,"Nuckolls County, NE",Aug-19,2365,2301,64,2.7
17813,CN3113100000000,31,131,"Otoe County, NE",Aug-19,8441,8176,265,3.1
17814,CN3113300000000,31,133,"Pawnee County, NE",Aug-19,1463,1419,44,3.0
17815,CN3113500000000,31,135,"Perkins County, NE",Aug-19,1774,1734,40,2.3
17816,CN3113700000000,31,137,"Phelps County, NE",Aug-19,4927,4791,136,2.8
17817,CN3113900000000,31,139,"Pierce County, NE",Aug-19,4085,3975,110,2.7
17818,CN3114100000000,31,141,"Platte County, NE",Aug-19,17908,17393,515,2.9
17819,CN3114300000000,31,143,"Polk County, NE",Aug-19,2858,2779,79,2.8
17820,CN3114500000000,31,145,"Red Willow County, NE",Aug-19,5845,5680,165,2.8
17821,CN3114700000000,31,147,"Richardson County, NE",Aug-19,4217,4083,134,3.2
17822,CN3114900000000,31,149,"Rock County, NE",Aug-19,836,810,26,3.1
17823,CN3115100000000,31,151,"Saline County, NE",Aug-19,7200,6981,219,3.0
17824,CN3115300000000,31,153,"Sarpy County, NE",Aug-19,98010,95146,2864,2.9
17825,CN3115500000000,31,155,"Saunders County, NE",Aug-19,11209,10904,305,2.7
17826,CN3115700000000,31,157,"Scotts Bluff County, NE",Aug-19,18281,17653,628,3.4
17827,CN3115900000000,31,159,"Seward County, NE",Aug-19,8871,8610,261,2.9
17828,CN3116100000000,31,161,"Sheridan County, NE",Aug-19,2618,2546,72,2.8
17829,CN3116300000000,31,163,"Sherman County, NE",Aug-19,1673,1620,53,3.2
17830,CN3116500000000,31,165,"Sioux County, NE",Aug-19,732,713,19,2.6
17831,CN3116700000000,31,167,"Stanton County, NE",Aug-19,3492,3407,85,2.4
17832,CN3116900000000,31,169,"Thayer County, NE",Aug-19,2715,2639,76,2.8
17833,CN3117100000000,31,171,"Thomas County, NE",Aug-19,405,390,15,3.7
17834,CN3117300000000,31,173,"Thurston County, NE",Aug-19,3054,2916,138,4.5
17835,CN3117500000000,31,175,"Valley County, NE",Aug-19,2098,2037,61,2.9
17836,CN3117700000000,31,177,"Washington County, NE",Aug-19,11357,11041,316,2.8
17837,CN3117900000000,31,179,"Wayne County, NE",Aug-19,5435,5293,142,2.6
17838,CN3118100000000,31,181,"Webster County, NE",Aug-19,1643,1584,59,3.6
17839,CN3118300000000,31,183,"Wheeler County, NE",Aug-19,535,520,15,2.8
17840,CN3118500000000,31,185,"York County, NE",Aug-19,7313,7118,195,2.7
17841,CN3200100000000,32,1,"Churchill County, NV",Aug-19,10927,10548,379,3.5
17842,CN3200300000000,32,3,"Clark County, NV",Aug-19,1137375,1091232,46143,4.1
17843,CN3200500000000,32,5,"Douglas County, NV",Aug-19,23511,22662,849,3.6
17844,CN3200700000000,32,7,"Elko County, NV",Aug-19,27222,26450,772,2.8
17845,CN3200900000000,32,9,"Esmeralda County, NV",Aug-19,443,426,17,3.8
17846,CN3201100000000,32,11,"Eureka County, NV",Aug-19,1027,999,28,2.7
17847,CN3201300000000,32,13,"Humboldt County, NV",Aug-19,8064,7818,246,3.1
17848,CN3201500000000,32,15,"Lander County, NV",Aug-19,3180,3085,95,3.0
17849,CN3201700000000,32,17,"Lincoln County, NV",Aug-19,2074,1997,77,3.7
17850,CN3201900000000,32,19,"Lyon County, NV",Aug-19,23146,22109,1037,4.5
17851,CN3202100000000,32,21,"Mineral County, NV",Aug-19,2072,1997,75,3.6
17852,CN3202300000000,32,23,"Nye County, NV",Aug-19,17206,16339,867,5.0
17853,CN3202700000000,32,27,"Pershing County, NV",Aug-19,2484,2397,87,3.5
17854,CN3202900000000,32,29,"Storey County, NV",Aug-19,2040,1970,70,3.4
17855,CN3203100000000,32,31,"Washoe County, NV",Aug-19,256252,248379,7873,3.1
17856,CN3203300000000,32,33,"White Pine County, NV",Aug-19,4696,4563,133,2.8
17857,CN3251000000000,32,510,"Carson City, NV",Aug-19,26435,25475,960,3.6
17858,CN3300100000000,33,1,"Belknap County, NH",Aug-19,33389,32629,760,2.3
17859,CN3300300000000,33,3,"Carroll County, NH",Aug-19,26370,25796,574,2.2
17860,CN3300500000000,33,5,"Cheshire County, NH",Aug-19,40610,39565,1045,2.6
17861,CN3300700000000,33,7,"Coos County, NH",Aug-19,15328,14901,427,2.8
17862,CN3300900000000,33,9,"Grafton County, NH",Aug-19,50692,49593,1099,2.2
17863,CN3301100000000,33,11,"Hillsborough County, NH",Aug-19,242743,236342,6401,2.6
17864,CN3301300000000,33,13,"Merrimack County, NH",Aug-19,84187,82306,1881,2.2
17865,CN3301500000000,33,15,"Rockingham County, NH",Aug-19,191884,186765,5119,2.7
17866,CN3301700000000,33,17,"Strafford County, NH",Aug-19,74925,73173,1752,2.3
17867,CN3301900000000,33,19,"Sullivan County, NH",Aug-19,23568,23019,549,2.3
17868,CN3400100000000,34,1,"Atlantic County, NJ",Aug-19,124209,118285,5924,4.8
17869,CN3400300000000,34,3,"Bergen County, NJ",Aug-19,482282,466973,15309,3.2
17870,CN3400500000000,34,5,"Burlington County, NJ",Aug-19,231562,223409,8153,3.5
17871,CN3400700000000,34,7,"Camden County, NJ",Aug-19,253992,243189,10803,4.3
17872,CN3400900000000,34,9,"Cape May County, NJ",Aug-19,55575,53481,2094,3.8
17873,CN3401100000000,34,11,"Cumberland County, NJ",Aug-19,63760,60210,3550,5.6
17874,CN3401300000000,34,13,"Essex County, NJ",Aug-19,371123,353708,17415,4.7
17875,CN3401500000000,34,15,"Gloucester County, NJ",Aug-19,150309,144457,5852,3.9
17876,CN3401700000000,34,17,"Hudson County, NJ",Aug-19,361014,348571,12443,3.4
17877,CN3401900000000,34,19,"Hunterdon County, NJ",Aug-19,64841,62996,1845,2.8
17878,CN3402100000000,34,21,"Mercer County, NJ",Aug-19,204770,197745,7025,3.4
17879,CN3402300000000,34,23,"Middlesex County, NJ",Aug-19,445540,430768,14772,3.3
17880,CN3402500000000,34,25,"Monmouth County, NJ",Aug-19,333079,322284,10795,3.2
17881,CN3402700000000,34,27,"Morris County, NJ",Aug-19,257966,250442,7524,2.9
17882,CN3402900000000,34,29,"Ocean County, NJ",Aug-19,278247,268257,9990,3.6
17883,CN3403100000000,34,31,"Passaic County, NJ",Aug-19,242316,231234,11082,4.6
17884,CN3403300000000,34,33,"Salem County, NJ",Aug-19,29312,27849,1463,5.0
17885,CN3403500000000,34,35,"Somerset County, NJ",Aug-19,172269,166861,5408,3.1
17886,CN3403700000000,34,37,"Sussex County, NJ",Aug-19,74302,71716,2586,3.5
17887,CN3403900000000,34,39,"Union County, NJ",Aug-19,277861,267184,10677,3.8
17888,CN3404100000000,34,41,"Warren County, NJ",Aug-19,56215,54235,1980,3.5
17889,CN3500100000000,35,1,"Bernalillo County, NM",Aug-19,333369,317980,15389,4.6
17890,CN3500300000000,35,3,"Catron County, NM",Aug-19,1221,1156,65,5.3
17891,CN3500500000000,35,5,"Chaves County, NM",Aug-19,27134,25777,1357,5.0
17892,CN3500600000000,35,6,"Cibola County, NM",Aug-19,8987,8408,579,6.4
17893,CN3500700000000,35,7,"Colfax County, NM",Aug-19,6249,5983,266,4.3
17894,CN3500900000000,35,9,"Curry County, NM",Aug-19,21443,20493,950,4.4
17895,CN3501100000000,35,11,"De Baca County, NM",Aug-19,788,756,32,4.1
17896,CN3501300000000,35,13,"Dona Ana County, NM",Aug-19,97287,91983,5304,5.5
17897,CN3501500000000,35,15,"Eddy County, NM",Aug-19,34793,33670,1123,3.2
17898,CN3501700000000,35,17,"Grant County, NM",Aug-19,11993,11395,598,5.0
17899,CN3501900000000,35,19,"Guadalupe County, NM",Aug-19,1579,1498,81,5.1
17900,CN3502100000000,35,21,"Harding County, NM",Aug-19,276,261,15,5.4
17901,CN3502300000000,35,23,"Hidalgo County, NM",Aug-19,2083,1984,99,4.8
17902,CN3502500000000,35,25,"Lea County, NM",Aug-19,31036,29759,1277,4.1
17903,CN3502700000000,35,27,"Lincoln County, NM",Aug-19,9405,9011,394,4.2
17904,CN3502800000000,35,28,"Los Alamos County, NM",Aug-19,9759,9443,316,3.2
17905,CN3502900000000,35,29,"Luna County, NM",Aug-19,10938,10020,918,8.4
17906,CN3503100000000,35,31,"McKinley County, NM",Aug-19,24134,22389,1745,7.2
17907,CN3503300000000,35,33,"Mora County, NM",Aug-19,2270,2143,127,5.6
17908,CN3503500000000,35,35,"Otero County, NM",Aug-19,24629,23384,1245,5.1
17909,CN3503700000000,35,37,"Quay County, NM",Aug-19,3197,3024,173,5.4
17910,CN3503900000000,35,39,"Rio Arriba County, NM",Aug-19,17115,16237,878,5.1
17911,CN3504100000000,35,41,"Roosevelt County, NM",Aug-19,7825,7451,374,4.8
17912,CN3504300000000,35,43,"Sandoval County, NM",Aug-19,66357,63039,3318,5.0
17913,CN3504500000000,35,45,"San Juan County, NM",Aug-19,50950,47941,3009,5.9
17914,CN3504700000000,35,47,"San Miguel County, NM",Aug-19,10513,9863,650,6.2
17915,CN3504900000000,35,49,"Santa Fe County, NM",Aug-19,76039,72961,3078,4.0
17916,CN3505100000000,35,51,"Sierra County, NM",Aug-19,4145,3895,250,6.0
17917,CN3505300000000,35,53,"Socorro County, NM",Aug-19,6441,6041,400,6.2
17918,CN3505500000000,35,55,"Taos County, NM",Aug-19,15218,14328,890,5.8
17919,CN3505700000000,35,57,"Torrance County, NM",Aug-19,5680,5300,380,6.7
17920,CN3505900000000,35,59,"Union County, NM",Aug-19,1944,1879,65,3.3
17921,CN3506100000000,35,61,"Valencia County, NM",Aug-19,30830,29108,1722,5.6
17922,CN3600100000000,36,1,"Albany County, NY",Aug-19,157698,151605,6093,3.9
17923,CN3600300000000,36,3,"Allegany County, NY",Aug-19,19038,18062,976,5.1
17924,CN3600500000000,36,5,"Bronx County, NY",Aug-19,597863,563669,34194,5.7
17925,CN3600700000000,36,7,"Broome County, NY",Aug-19,82887,78926,3961,4.8
17926,CN3600900000000,36,9,"Cattaraugus County, NY",Aug-19,33836,32233,1603,4.7
17927,CN3601100000000,36,11,"Cayuga County, NY",Aug-19,36499,34974,1525,4.2
17928,CN3601300000000,36,13,"Chautauqua County, NY",Aug-19,56079,53618,2461,4.4
17929,CN3601500000000,36,15,"Chemung County, NY",Aug-19,34435,32939,1496,4.3
17930,CN3601700000000,36,17,"Chenango County, NY",Aug-19,22535,21646,889,3.9
17931,CN3601900000000,36,19,"Clinton County, NY",Aug-19,36194,34665,1529,4.2
17932,CN3602100000000,36,21,"Columbia County, NY",Aug-19,31859,30862,997,3.1
17933,CN3602300000000,36,23,"Cortland County, NY",Aug-19,22360,21377,983,4.4
17934,CN3602500000000,36,25,"Delaware County, NY",Aug-19,19598,18725,873,4.5
17935,CN3602700000000,36,27,"Dutchess County, NY",Aug-19,144193,138736,5457,3.8
17936,CN3602900000000,36,29,"Erie County, NY",Aug-19,443615,424184,19431,4.4
17937,CN3603100000000,36,31,"Essex County, NY",Aug-19,18111,17427,684,3.8
17938,CN3603300000000,36,33,"Franklin County, NY",Aug-19,20041,19131,910,4.5
17939,CN3603500000000,36,35,"Fulton County, NY",Aug-19,22805,21728,1077,4.7
17940,CN3603700000000,36,37,"Genesee County, NY",Aug-19,30210,29162,1048,3.5
17941,CN3603900000000,36,39,"Greene County, NY",Aug-19,20577,19642,935,4.5
17942,CN3604100000000,36,41,"Hamilton County, NY",Aug-19,2467,2384,83,3.4
17943,CN3604300000000,36,43,"Herkimer County, NY",Aug-19,28093,26868,1225,4.4
17944,CN3604500000000,36,45,"Jefferson County, NY",Aug-19,44724,42429,2295,5.1
17945,CN3604700000000,36,47,"Kings County, NY",Aug-19,1195650,1144209,51441,4.3
17946,CN3604900000000,36,49,"Lewis County, NY",Aug-19,11632,11120,512,4.4
17947,CN3605100000000,36,51,"Livingston County, NY",Aug-19,30608,29401,1207,3.9
17948,CN3605300000000,36,53,"Madison County, NY",Aug-19,32976,31604,1372,4.2
17949,CN3605500000000,36,55,"Monroe County, NY",Aug-19,360480,344457,16023,4.4
17950,CN3605700000000,36,57,"Montgomery County, NY",Aug-19,22289,21196,1093,4.9
17951,CN3605900000000,36,59,"Nassau County, NY",Aug-19,713893,687174,26719,3.7
17952,CN3606100000000,36,61,"New York County, NY",Aug-19,908438,875416,33022,3.6
17953,CN3606300000000,36,63,"Niagara County, NY",Aug-19,99206,94334,4872,4.9
17954,CN3606500000000,36,65,"Oneida County, NY",Aug-19,102232,97893,4339,4.2
17955,CN3606700000000,36,67,"Onondaga County, NY",Aug-19,222307,213322,8985,4.0
17956,CN3606900000000,36,69,"Ontario County, NY",Aug-19,55013,53021,1992,3.6
17957,CN3607100000000,36,71,"Orange County, NY",Aug-19,186884,179253,7631,4.1
17958,CN3607300000000,36,73,"Orleans County, NY",Aug-19,17688,16791,897,5.1
17959,CN3607500000000,36,75,"Oswego County, NY",Aug-19,53146,50446,2700,5.1
17960,CN3607700000000,36,77,"Otsego County, NY",Aug-19,28541,27440,1101,3.9
17961,CN3607900000000,36,79,"Putnam County, NY",Aug-19,51258,49247,2011,3.9
17962,CN3608100000000,36,81,"Queens County, NY",Aug-19,1136396,1095372,41024,3.6
17963,CN3608300000000,36,83,"Rensselaer County, NY",Aug-19,81140,77968,3172,3.9
17964,CN3608500000000,36,85,"Richmond County, NY",Aug-19,222534,213152,9382,4.2
17965,CN3608700000000,36,87,"Rockland County, NY",Aug-19,156427,150306,6121,3.9
17966,CN3608900000000,36,89,"St. Lawrence County, NY",Aug-19,42603,40250,2353,5.5
17967,CN3609100000000,36,91,"Saratoga County, NY",Aug-19,118705,114772,3933,3.3
17968,CN3609300000000,36,93,"Schenectady County, NY",Aug-19,76049,73049,3000,3.9
17969,CN3609500000000,36,95,"Schoharie County, NY",Aug-19,14639,13992,647,4.4
17970,CN3609700000000,36,97,"Schuyler County, NY",Aug-19,8192,7871,321,3.9
17971,CN3609900000000,36,99,"Seneca County, NY",Aug-19,16229,15662,567,3.5
17972,CN3610100000000,36,101,"Steuben County, NY",Aug-19,42517,40750,1767,4.2
17973,CN3610300000000,36,103,"Suffolk County, NY",Aug-19,785615,753852,31763,4.0
17974,CN3610500000000,36,105,"Sullivan County, NY",Aug-19,39015,37580,1435,3.7
17975,CN3610700000000,36,107,"Tioga County, NY",Aug-19,22520,21637,883,3.9
17976,CN3610900000000,36,109,"Tompkins County, NY",Aug-19,47830,45894,1936,4.0
17977,CN3611100000000,36,111,"Ulster County, NY",Aug-19,87711,84176,3535,4.0
17978,CN3611300000000,36,113,"Warren County, NY",Aug-19,32698,31497,1201,3.7
17979,CN3611500000000,36,115,"Washington County, NY",Aug-19,29254,28210,1044,3.6
17980,CN3611700000000,36,117,"Wayne County, NY",Aug-19,43786,42087,1699,3.9
17981,CN3611900000000,36,119,"Westchester County, NY",Aug-19,487601,467552,20049,4.1
17982,CN3612100000000,36,121,"Wyoming County, NY",Aug-19,18571,17881,690,3.7
17983,CN3612300000000,36,123,"Yates County, NY",Aug-19,11847,11459,388,3.3
17984,CN3700100000000,37,1,"Alamance County, NC",Aug-19,82566,79154,3412,4.1
17985,CN3700300000000,37,3,"Alexander County, NC",Aug-19,17987,17338,649,3.6
17986,CN3700500000000,37,5,"Alleghany County, NC",Aug-19,4417,4200,217,4.9
17987,CN3700700000000,37,7,"Anson County, NC",Aug-19,10701,10228,473,4.4
17988,CN3700900000000,37,9,"Ashe County, NC",Aug-19,12925,12429,496,3.8
17989,CN3701100000000,37,11,"Avery County, NC",Aug-19,7754,7459,295,3.8
17990,CN3701300000000,37,13,"Beaufort County, NC",Aug-19,19076,18114,962,5.0
17991,CN3701500000000,37,15,"Bertie County, NC",Aug-19,7601,7207,394,5.2
17992,CN3701700000000,37,17,"Bladen County, NC",Aug-19,14400,13642,758,5.3
17993,CN3701900000000,37,19,"Brunswick County, NC",Aug-19,56041,53106,2935,5.2
17994,CN3702100000000,37,21,"Buncombe County, NC",Aug-19,141342,136755,4587,3.2
17995,CN3702300000000,37,23,"Burke County, NC",Aug-19,41071,39384,1687,4.1
17996,CN3702500000000,37,25,"Cabarrus County, NC",Aug-19,110360,106172,4188,3.8
17997,CN3702700000000,37,27,"Caldwell County, NC",Aug-19,36624,35041,1583,4.3
17998,CN3702900000000,37,29,"Camden County, NC",Aug-19,4560,4374,186,4.1
17999,CN3703100000000,37,31,"Carteret County, NC",Aug-19,32857,31507,1350,4.1
18000,CN3703300000000,37,33,"Caswell County, NC",Aug-19,9764,9304,460,4.7
18001,CN3703500000000,37,35,"Catawba County, NC",Aug-19,79161,76091,3070,3.9
18002,CN3703700000000,37,37,"Chatham County, NC",Aug-19,35757,34451,1306,3.7
18003,CN3703900000000,37,39,"Cherokee County, NC",Aug-19,11050,10524,526,4.8
18004,CN3704100000000,37,41,"Chowan County, NC",Aug-19,5445,5166,279,5.1
18005,CN3704300000000,37,43,"Clay County, NC",Aug-19,4078,3872,206,5.1
18006,CN3704500000000,37,45,"Cleveland County, NC",Aug-19,48253,46182,2071,4.3
18007,CN3704700000000,37,47,"Columbus County, NC",Aug-19,23175,21964,1211,5.2
18008,CN3704900000000,37,49,"Craven County, NC",Aug-19,42060,40241,1819,4.3
18009,CN3705100000000,37,51,"Cumberland County, NC",Aug-19,127416,120468,6948,5.5
18010,CN3705300000000,37,53,"Currituck County, NC",Aug-19,14152,13638,514,3.6
18011,CN3705500000000,37,55,"Dare County, NC",Aug-19,22613,21813,800,3.5
18012,CN3705700000000,37,57,"Davidson County, NC",Aug-19,81295,78056,3239,4.0
18013,CN3705900000000,37,59,"Davie County, NC",Aug-19,20730,19949,781,3.8
18014,CN3706100000000,37,61,"Duplin County, NC",Aug-19,24826,23722,1104,4.4
18015,CN3706300000000,37,63,"Durham County, NC",Aug-19,172706,166345,6361,3.7
18016,CN3706500000000,37,65,"Edgecombe County, NC",Aug-19,20931,19616,1315,6.3
18017,CN3706700000000,37,67,"Forsyth County, NC",Aug-19,189022,181334,7688,4.1
18018,CN3706900000000,37,69,"Franklin County, NC",Aug-19,31692,30323,1369,4.3
18019,CN3707100000000,37,71,"Gaston County, NC",Aug-19,112516,107904,4612,4.1
18020,CN3707300000000,37,73,"Gates County, NC",Aug-19,5360,5127,233,4.3
18021,CN3707500000000,37,75,"Graham County, NC",Aug-19,3280,3110,170,5.2
18022,CN3707700000000,37,77,"Granville County, NC",Aug-19,29968,28881,1087,3.6
18023,CN3707900000000,37,79,"Greene County, NC",Aug-19,9221,8834,387,4.2
18024,CN3708100000000,37,81,"Guilford County, NC",Aug-19,264275,252474,11801,4.5
18025,CN3708300000000,37,83,"Halifax County, NC",Aug-19,20214,18974,1240,6.1
18026,CN3708500000000,37,85,"Harnett County, NC",Aug-19,53252,50620,2632,4.9
18027,CN3708700000000,37,87,"Haywood County, NC",Aug-19,30139,29036,1103,3.7
18028,CN3708900000000,37,89,"Henderson County, NC",Aug-19,55343,53366,1977,3.6
18029,CN3709100000000,37,91,"Hertford County, NC",Aug-19,9089,8564,525,5.8
18030,CN3709300000000,37,93,"Hoke County, NC",Aug-19,20005,18958,1047,5.2
18031,CN3709500000000,37,95,"Hyde County, NC",Aug-19,2036,1919,117,5.7
18032,CN3709700000000,37,97,"Iredell County, NC",Aug-19,90548,87054,3494,3.9
18033,CN3709900000000,37,99,"Jackson County, NC",Aug-19,20415,19542,873,4.3
18034,CN3710100000000,37,101,"Johnston County, NC",Aug-19,100078,96172,3906,3.9
18035,CN3710300000000,37,103,"Jones County, NC",Aug-19,4350,4161,189,4.3
18036,CN3710500000000,37,105,"Lee County, NC",Aug-19,25875,24626,1249,4.8
18037,CN3710700000000,37,107,"Lenoir County, NC",Aug-19,27689,26545,1144,4.1
18038,CN3710900000000,37,109,"Lincoln County, NC",Aug-19,43914,42281,1633,3.7
18039,CN3711100000000,37,111,"McDowell County, NC",Aug-19,20656,19786,870,4.2
18040,CN3711300000000,37,113,"Macon County, NC",Aug-19,15737,15107,630,4.0
18041,CN3711500000000,37,115,"Madison County, NC",Aug-19,10246,9824,422,4.1
18042,CN3711700000000,37,117,"Martin County, NC",Aug-19,8843,8347,496,5.6
18043,CN3711900000000,37,119,"Mecklenburg County, NC",Aug-19,629721,605589,24132,3.8
18044,CN3712100000000,37,121,"Mitchell County, NC",Aug-19,6090,5794,296,4.9
18045,CN3712300000000,37,123,"Montgomery County, NC",Aug-19,11550,11025,525,4.5
18046,CN3712500000000,37,125,"Moore County, NC",Aug-19,42640,40863,1777,4.2
18047,CN3712700000000,37,127,"Nash County, NC",Aug-19,42698,40442,2256,5.3
18048,CN3712900000000,37,129,"New Hanover County, NC",Aug-19,126142,121442,4700,3.7
18049,CN3713100000000,37,131,"Northampton County, NC",Aug-19,7653,7215,438,5.7
18050,CN3713300000000,37,133,"Onslow County, NC",Aug-19,65310,62097,3213,4.9
18051,CN3713500000000,37,135,"Orange County, NC",Aug-19,79514,76633,2881,3.6
18052,CN3713700000000,37,137,"Pamlico County, NC",Aug-19,5354,5133,221,4.1
18053,CN3713900000000,37,139,"Pasquotank County, NC",Aug-19,16543,15741,802,4.8
18054,CN3714100000000,37,141,"Pender County, NC",Aug-19,29249,28011,1238,4.2
18055,CN3714300000000,37,143,"Perquimans County, NC",Aug-19,4859,4601,258,5.3
18056,CN3714500000000,37,145,"Person County, NC",Aug-19,18548,17713,835,4.5
18057,CN3714700000000,37,147,"Pitt County, NC",Aug-19,88562,84328,4234,4.8
18058,CN3714900000000,37,149,"Polk County, NC",Aug-19,9158,8785,373,4.1
18059,CN3715100000000,37,151,"Randolph County, NC",Aug-19,66492,63746,2746,4.1
18060,CN3715300000000,37,153,"Richmond County, NC",Aug-19,16397,15477,920,5.6
18061,CN3715500000000,37,155,"Robeson County, NC",Aug-19,49855,46954,2901,5.8
18062,CN3715700000000,37,157,"Rockingham County, NC",Aug-19,40277,38388,1889,4.7
18063,CN3715900000000,37,159,"Rowan County, NC",Aug-19,66884,64088,2796,4.2
18064,CN3716100000000,37,161,"Rutherford County, NC",Aug-19,25000,23680,1320,5.3
18065,CN3716300000000,37,163,"Sampson County, NC",Aug-19,28172,26954,1218,4.3
18066,CN3716500000000,37,165,"Scotland County, NC",Aug-19,11310,10502,808,7.1
18067,CN3716700000000,37,167,"Stanly County, NC",Aug-19,30447,29240,1207,4.0
18068,CN3716900000000,37,169,"Stokes County, NC",Aug-19,21791,20940,851,3.9
18069,CN3717100000000,37,171,"Surry County, NC",Aug-19,34035,32702,1333,3.9
18070,CN3717300000000,37,173,"Swain County, NC",Aug-19,7267,6998,269,3.7
18071,CN3717500000000,37,175,"Transylvania County, NC",Aug-19,15034,14437,597,4.0
18072,CN3717700000000,37,177,"Tyrrell County, NC",Aug-19,1610,1533,77,4.8
18073,CN3717900000000,37,179,"Union County, NC",Aug-19,125147,120488,4659,3.7
18074,CN3718100000000,37,181,"Vance County, NC",Aug-19,17584,16491,1093,6.2
18075,CN3718300000000,37,183,"Wake County, NC",Aug-19,603654,581983,21671,3.6
18076,CN3718500000000,37,185,"Warren County, NC",Aug-19,6570,6171,399,6.1
18077,CN3718700000000,37,187,"Washington County, NC",Aug-19,4499,4238,261,5.8
18078,CN3718900000000,37,189,"Watauga County, NC",Aug-19,30360,29190,1170,3.9
18079,CN3719100000000,37,191,"Wayne County, NC",Aug-19,51194,48899,2295,4.5
18080,CN3719300000000,37,193,"Wilkes County, NC",Aug-19,29376,28091,1285,4.4
18081,CN3719500000000,37,195,"Wilson County, NC",Aug-19,34615,32437,2178,6.3
18082,CN3719700000000,37,197,"Yadkin County, NC",Aug-19,17733,17067,666,3.8
18083,CN3719900000000,37,199,"Yancey County, NC",Aug-19,8476,8134,342,4.0
18084,CN3800100000000,38,1,"Adams County, ND",Aug-19,1072,1052,20,1.9
18085,CN3800300000000,38,3,"Barnes County, ND",Aug-19,5062,4849,213,4.2
18086,CN3800500000000,38,5,"Benson County, ND",Aug-19,2269,2176,93,4.1
18087,CN3800700000000,38,7,"Billings County, ND",Aug-19,560,547,13,2.3
18088,CN3800900000000,38,9,"Bottineau County, ND",Aug-19,2973,2893,80,2.7
18089,CN3801100000000,38,11,"Bowman County, ND",Aug-19,1707,1681,26,1.5
18090,CN3801300000000,38,13,"Burke County, ND",Aug-19,1012,989,23,2.3
18091,CN3801500000000,38,15,"Burleigh County, ND",Aug-19,50208,49110,1098,2.2
18092,CN3801700000000,38,17,"Cass County, ND",Aug-19,103825,101930,1895,1.8
18093,CN3801900000000,38,19,"Cavalier County, ND",Aug-19,1880,1834,46,2.4
18094,CN3802100000000,38,21,"Dickey County, ND",Aug-19,2321,2274,47,2.0
18095,CN3802300000000,38,23,"Divide County, ND",Aug-19,1510,1489,21,1.4
18096,CN3802500000000,38,25,"Dunn County, ND",Aug-19,3174,3128,46,1.4
18097,CN3802700000000,38,27,"Eddy County, ND",Aug-19,1155,1108,47,4.1
18098,CN3802900000000,38,29,"Emmons County, ND",Aug-19,1414,1370,44,3.1
18099,CN3803100000000,38,31,"Foster County, ND",Aug-19,1489,1455,34,2.3
18100,CN3803300000000,38,33,"Golden Valley County, ND",Aug-19,811,797,14,1.7
18101,CN3803500000000,38,35,"Grand Forks County, ND",Aug-19,37008,36239,769,2.1
18102,CN3803700000000,38,37,"Grant County, ND",Aug-19,1183,1163,20,1.7
18103,CN3803900000000,38,39,"Griggs County, ND",Aug-19,1029,1006,23,2.2
18104,CN3804100000000,38,41,"Hettinger County, ND",Aug-19,1348,1318,30,2.2
18105,CN3804300000000,38,43,"Kidder County, ND",Aug-19,1247,1208,39,3.1
18106,CN3804500000000,38,45,"LaMoure County, ND",Aug-19,1977,1934,43,2.2
18107,CN3804700000000,38,47,"Logan County, ND",Aug-19,845,828,17,2.0
18108,CN3804900000000,38,49,"McHenry County, ND",Aug-19,2981,2901,80,2.7
18109,CN3805100000000,38,51,"McIntosh County, ND",Aug-19,1107,1078,29,2.6
18110,CN3805300000000,38,53,"McKenzie County, ND",Aug-19,10836,10663,173,1.6
18111,CN3805500000000,38,55,"McLean County, ND",Aug-19,4756,4616,140,2.9
18112,CN3805700000000,38,57,"Mercer County, ND",Aug-19,3627,3478,149,4.1
18113,CN3805900000000,38,59,"Morton County, ND",Aug-19,16460,16038,422,2.6
18114,CN3806100000000,38,61,"Mountrail County, ND",Aug-19,7626,7526,100,1.3
18115,CN3806300000000,38,63,"Nelson County, ND",Aug-19,1400,1361,39,2.8
18116,CN3806500000000,38,65,"Oliver County, ND",Aug-19,874,844,30,3.4
18117,CN3806700000000,38,67,"Pembina County, ND",Aug-19,3402,3289,113,3.3
18118,CN3806900000000,38,69,"Pierce County, ND",Aug-19,1714,1664,50,2.9
18119,CN3807100000000,38,71,"Ramsey County, ND",Aug-19,5670,5531,139,2.5
18120,CN3807300000000,38,73,"Ransom County, ND",Aug-19,2817,2771,46,1.6
18121,CN3807500000000,38,75,"Renville County, ND",Aug-19,1214,1185,29,2.4
18122,CN3807700000000,38,77,"Richland County, ND",Aug-19,8634,8445,189,2.2
18123,CN3807900000000,38,79,"Rolette County, ND",Aug-19,4697,4252,445,9.5
18124,CN3808100000000,38,81,"Sargent County, ND",Aug-19,2726,2682,44,1.6
18125,CN3808300000000,38,83,"Sheridan County, ND",Aug-19,660,640,20,3.0
18126,CN3808500000000,38,85,"Sioux County, ND",Aug-19,1272,1209,63,5.0
18127,CN3808700000000,38,87,"Slope County, ND",Aug-19,399,388,11,2.8
18128,CN3808900000000,38,89,"Stark County, ND",Aug-19,19030,18651,379,2.0
18129,CN3809100000000,38,91,"Steele County, ND",Aug-19,965,944,21,2.2
18130,CN3809300000000,38,93,"Stutsman County, ND",Aug-19,10301,10081,220,2.1
18131,CN3809500000000,38,95,"Towner County, ND",Aug-19,1098,1069,29,2.6
18132,CN3809700000000,38,97,"Traill County, ND",Aug-19,4304,4188,116,2.7
18133,CN3809900000000,38,99,"Walsh County, ND",Aug-19,5102,4933,169,3.3
18134,CN3810100000000,38,101,"Ward County, ND",Aug-19,31925,31211,714,2.2
18135,CN3810300000000,38,103,"Wells County, ND",Aug-19,1915,1869,46,2.4
18136,CN3810500000000,38,105,"Williams County, ND",Aug-19,25659,25245,414,1.6
18137,CN3900100000000,39,1,"Adams County, OH",Aug-19,10715,10012,703,6.6
18138,CN3900300000000,39,3,"Allen County, OH",Aug-19,48427,46413,2014,4.2
18139,CN3900500000000,39,5,"Ashland County, OH",Aug-19,26878,25792,1086,4.0
18140,CN3900700000000,39,7,"Ashtabula County, OH",Aug-19,45285,43198,2087,4.6
18141,CN3900900000000,39,9,"Athens County, OH",Aug-19,25428,23892,1536,6.0
18142,CN3901100000000,39,11,"Auglaize County, OH",Aug-19,25213,24434,779,3.1
18143,CN3901300000000,39,13,"Belmont County, OH",Aug-19,30097,28519,1578,5.2
18144,CN3901500000000,39,15,"Brown County, OH",Aug-19,19747,18774,973,4.9
18145,CN3901700000000,39,17,"Butler County, OH",Aug-19,196844,188960,7884,4.0
18146,CN3901900000000,39,19,"Carroll County, OH",Aug-19,12991,12390,601,4.6
18147,CN3902100000000,39,21,"Champaign County, OH",Aug-19,20060,19318,742,3.7
18148,CN3902300000000,39,23,"Clark County, OH",Aug-19,63507,60771,2736,4.3
18149,CN3902500000000,39,25,"Clermont County, OH",Aug-19,107809,103622,4187,3.9
18150,CN3902700000000,39,27,"Clinton County, OH",Aug-19,17715,16872,843,4.8
18151,CN3902900000000,39,29,"Columbiana County, OH",Aug-19,47886,45548,2338,4.9
18152,CN3903100000000,39,31,"Coshocton County, OH",Aug-19,14477,13629,848,5.9
18153,CN3903300000000,39,33,"Crawford County, OH",Aug-19,18459,17543,916,5.0
18154,CN3903500000000,39,35,"Cuyahoga County, OH",Aug-19,619193,593054,26139,4.2
18155,CN3903700000000,39,37,"Darke County, OH",Aug-19,25901,24935,966,3.7
18156,CN3903900000000,39,39,"Defiance County, OH",Aug-19,18208,17433,775,4.3
18157,CN3904100000000,39,41,"Delaware County, OH",Aug-19,111876,108066,3810,3.4
18158,CN3904300000000,39,43,"Erie County, OH",Aug-19,39124,37438,1686,4.3
18159,CN3904500000000,39,45,"Fairfield County, OH",Aug-19,78853,75842,3011,3.8
18160,CN3904700000000,39,47,"Fayette County, OH",Aug-19,13984,13412,572,4.1
18161,CN3904900000000,39,49,"Franklin County, OH",Aug-19,706950,680148,26802,3.8
18162,CN3905100000000,39,51,"Fulton County, OH",Aug-19,22329,21460,869,3.9
18163,CN3905300000000,39,53,"Gallia County, OH",Aug-19,11974,11311,663,5.5
18164,CN3905500000000,39,55,"Geauga County, OH",Aug-19,49679,48022,1657,3.3
18165,CN3905700000000,39,57,"Greene County, OH",Aug-19,83985,80654,3331,4.0
18166,CN3905900000000,39,59,"Guernsey County, OH",Aug-19,18755,17815,940,5.0
18167,CN3906100000000,39,61,"Hamilton County, OH",Aug-19,420795,403360,17435,4.1
18168,CN3906300000000,39,63,"Hancock County, OH",Aug-19,41820,40425,1395,3.3
18169,CN3906500000000,39,65,"Hardin County, OH",Aug-19,13378,12758,620,4.6
18170,CN3906700000000,39,67,"Harrison County, OH",Aug-19,6839,6495,344,5.0
18171,CN3906900000000,39,69,"Henry County, OH",Aug-19,13255,12706,549,4.1
18172,CN3907100000000,39,71,"Highland County, OH",Aug-19,17045,16149,896,5.3
18173,CN3907300000000,39,73,"Hocking County, OH",Aug-19,13191,12629,562,4.3
18174,CN3907500000000,39,75,"Holmes County, OH",Aug-19,21083,20424,659,3.1
18175,CN3907700000000,39,77,"Huron County, OH",Aug-19,28379,27005,1374,4.8
18176,CN3907900000000,39,79,"Jackson County, OH",Aug-19,12662,11907,755,6.0
18177,CN3908100000000,39,81,"Jefferson County, OH",Aug-19,28126,26461,1665,5.9
18178,CN3908300000000,39,83,"Knox County, OH",Aug-19,31276,29998,1278,4.1
18179,CN3908500000000,39,85,"Lake County, OH",Aug-19,127417,122844,4573,3.6
18180,CN3908700000000,39,87,"Lawrence County, OH",Aug-19,23999,22646,1353,5.6
18181,CN3908900000000,39,89,"Licking County, OH",Aug-19,91693,88081,3612,3.9
18182,CN3909100000000,39,91,"Logan County, OH",Aug-19,22916,22044,872,3.8
18183,CN3909300000000,39,93,"Lorain County, OH",Aug-19,155002,148482,6520,4.2
18184,CN3909500000000,39,95,"Lucas County, OH",Aug-19,209895,200184,9711,4.6
18185,CN3909700000000,39,97,"Madison County, OH",Aug-19,20979,20237,742,3.5
18186,CN3909900000000,39,99,"Mahoning County, OH",Aug-19,103711,97478,6233,6.0
18187,CN3910100000000,39,101,"Marion County, OH",Aug-19,28446,27238,1208,4.2
18188,CN3910300000000,39,103,"Medina County, OH",Aug-19,98528,95135,3393,3.4
18189,CN3910500000000,39,105,"Meigs County, OH",Aug-19,8884,8259,625,7.0
18190,CN3910700000000,39,107,"Mercer County, OH",Aug-19,23659,23011,648,2.7
18191,CN3910900000000,39,109,"Miami County, OH",Aug-19,54519,52416,2103,3.9
18192,CN3911100000000,39,111,"Monroe County, OH",Aug-19,5335,4931,404,7.6
18193,CN3911300000000,39,113,"Montgomery County, OH",Aug-19,254959,243643,11316,4.4
18194,CN3911500000000,39,115,"Morgan County, OH",Aug-19,6684,6291,393,5.9
18195,CN3911700000000,39,117,"Morrow County, OH",Aug-19,16970,16299,671,4.0
18196,CN3911900000000,39,119,"Muskingum County, OH",Aug-19,39599,37743,1856,4.7
18197,CN3912100000000,39,121,"Noble County, OH",Aug-19,4679,4390,289,6.2
18198,CN3912300000000,39,123,"Ottawa County, OH",Aug-19,22390,21461,929,4.1
18199,CN3912500000000,39,125,"Paulding County, OH",Aug-19,8716,8377,339,3.9
18200,CN3912700000000,39,127,"Perry County, OH",Aug-19,15994,15224,770,4.8
18201,CN3912900000000,39,129,"Pickaway County, OH",Aug-19,26707,25638,1069,4.0
18202,CN3913100000000,39,131,"Pike County, OH",Aug-19,10860,10220,640,5.9
18203,CN3913300000000,39,133,"Portage County, OH",Aug-19,87912,84157,3755,4.3
18204,CN3913500000000,39,135,"Preble County, OH",Aug-19,21317,20515,802,3.8
18205,CN3913700000000,39,137,"Putnam County, OH",Aug-19,19025,18458,567,3.0
18206,CN3913900000000,39,139,"Richland County, OH",Aug-19,52294,49938,2356,4.5
18207,CN3914100000000,39,141,"Ross County, OH",Aug-19,35435,33907,1528,4.3
18208,CN3914300000000,39,143,"Sandusky County, OH",Aug-19,30913,29706,1207,3.9
18209,CN3914500000000,39,145,"Scioto County, OH",Aug-19,29061,27221,1840,6.3
18210,CN3914700000000,39,147,"Seneca County, OH",Aug-19,27380,26266,1114,4.1
18211,CN3914900000000,39,149,"Shelby County, OH",Aug-19,24365,23460,905,3.7
18212,CN3915100000000,39,151,"Stark County, OH",Aug-19,186768,178466,8302,4.4
18213,CN3915300000000,39,153,"Summit County, OH",Aug-19,274402,262308,12094,4.4
18214,CN3915500000000,39,155,"Trumbull County, OH",Aug-19,87247,81743,5504,6.3
18215,CN3915700000000,39,157,"Tuscarawas County, OH",Aug-19,45555,43660,1895,4.2
18216,CN3915900000000,39,159,"Union County, OH",Aug-19,29349,28308,1041,3.5
18217,CN3916100000000,39,161,"Van Wert County, OH",Aug-19,15196,14704,492,3.2
18218,CN3916300000000,39,163,"Vinton County, OH",Aug-19,5608,5324,284,5.1
18219,CN3916500000000,39,165,"Warren County, OH",Aug-19,120364,115820,4544,3.8
18220,CN3916700000000,39,167,"Washington County, OH",Aug-19,27741,26273,1468,5.3
18221,CN3916900000000,39,169,"Wayne County, OH",Aug-19,62299,60206,2093,3.4
18222,CN3917100000000,39,171,"Williams County, OH",Aug-19,19157,18498,659,3.4
18223,CN3917300000000,39,173,"Wood County, OH",Aug-19,71146,68437,2709,3.8
18224,CN3917500000000,39,175,"Wyandot County, OH",Aug-19,13047,12649,398,3.1
18225,CN4000100000000,40,1,"Adair County, OK",Aug-19,8146,7825,321,3.9
18226,CN4000300000000,40,3,"Alfalfa County, OK",Aug-19,2790,2731,59,2.1
18227,CN4000500000000,40,5,"Atoka County, OK",Aug-19,4915,4708,207,4.2
18228,CN4000700000000,40,7,"Beaver County, OK",Aug-19,2895,2838,57,2.0
18229,CN4000900000000,40,9,"Beckham County, OK",Aug-19,10339,10001,338,3.3
18230,CN4001100000000,40,11,"Blaine County, OK",Aug-19,4829,4737,92,1.9
18231,CN4001300000000,40,13,"Bryan County, OK",Aug-19,21579,20936,643,3.0
18232,CN4001500000000,40,15,"Caddo County, OK",Aug-19,11877,11441,436,3.7
18233,CN4001700000000,40,17,"Canadian County, OK",Aug-19,74004,71841,2163,2.9
18234,CN4001900000000,40,19,"Carter County, OK",Aug-19,20966,20242,724,3.5
18235,CN4002100000000,40,21,"Cherokee County, OK",Aug-19,18898,18145,753,4.0
18236,CN4002300000000,40,23,"Choctaw County, OK",Aug-19,5482,5204,278,5.1
18237,CN4002500000000,40,25,"Cimarron County, OK",Aug-19,1378,1356,22,1.6
18238,CN4002700000000,40,27,"Cleveland County, OK",Aug-19,142168,138030,4138,2.9
18239,CN4002900000000,40,29,"Coal County, OK",Aug-19,2393,2293,100,4.2
18240,CN4003100000000,40,31,"Comanche County, OK",Aug-19,47820,46002,1818,3.8
18241,CN4003300000000,40,33,"Cotton County, OK",Aug-19,2717,2633,84,3.1
18242,CN4003500000000,40,35,"Craig County, OK",Aug-19,5942,5735,207,3.5
18243,CN4003700000000,40,37,"Creek County, OK",Aug-19,31662,30470,1192,3.8
18244,CN4003900000000,40,39,"Custer County, OK",Aug-19,15426,15039,387,2.5
18245,CN4004100000000,40,41,"Delaware County, OK",Aug-19,18228,17549,679,3.7
18246,CN4004300000000,40,43,"Dewey County, OK",Aug-19,2966,2904,62,2.1
18247,CN4004500000000,40,45,"Ellis County, OK",Aug-19,2172,2115,57,2.6
18248,CN4004700000000,40,47,"Garfield County, OK",Aug-19,27078,26266,812,3.0
18249,CN4004900000000,40,49,"Garvin County, OK",Aug-19,12517,12129,388,3.1
18250,CN4005100000000,40,51,"Grady County, OK",Aug-19,26423,25611,812,3.1
18251,CN4005300000000,40,53,"Grant County, OK",Aug-19,2719,2660,59,2.2
18252,CN4005500000000,40,55,"Greer County, OK",Aug-19,1879,1800,79,4.2
18253,CN4005700000000,40,57,"Harmon County, OK",Aug-19,1197,1159,38,3.2
18254,CN4005900000000,40,59,"Harper County, OK",Aug-19,1809,1756,53,2.9
18255,CN4006100000000,40,61,"Haskell County, OK",Aug-19,4195,3972,223,5.3
18256,CN4006300000000,40,63,"Hughes County, OK",Aug-19,5143,4897,246,4.8
18257,CN4006500000000,40,65,"Jackson County, OK",Aug-19,10655,10344,311,2.9
18258,CN4006700000000,40,67,"Jefferson County, OK",Aug-19,2520,2434,86,3.4
18259,CN4006900000000,40,69,"Johnston County, OK",Aug-19,3765,3608,157,4.2
18260,CN4007100000000,40,71,"Kay County, OK",Aug-19,18134,17373,761,4.2
18261,CN4007300000000,40,73,"Kingfisher County, OK",Aug-19,9123,8933,190,2.1
18262,CN4007500000000,40,75,"Kiowa County, OK",Aug-19,3526,3381,145,4.1
18263,CN4007700000000,40,77,"Latimer County, OK",Aug-19,3061,2875,186,6.1
18264,CN4007900000000,40,79,"Le Flore County, OK",Aug-19,18999,18125,874,4.6
18265,CN4008100000000,40,81,"Lincoln County, OK",Aug-19,15757,15187,570,3.6
18266,CN4008300000000,40,83,"Logan County, OK",Aug-19,22025,21385,640,2.9
18267,CN4008500000000,40,85,"Love County, OK",Aug-19,6135,5990,145,2.4
18268,CN4008700000000,40,87,"McClain County, OK",Aug-19,19610,19075,535,2.7
18269,CN4008900000000,40,89,"McCurtain County, OK",Aug-19,14628,13824,804,5.5
18270,CN4009100000000,40,91,"McIntosh County, OK",Aug-19,7162,6737,425,5.9
18271,CN4009300000000,40,93,"Major County, OK",Aug-19,3834,3747,87,2.3
18272,CN4009500000000,40,95,"Marshall County, OK",Aug-19,6962,6720,242,3.5
18273,CN4009700000000,40,97,"Mayes County, OK",Aug-19,19426,18810,616,3.2
18274,CN4009900000000,40,99,"Murray County, OK",Aug-19,6241,6047,194,3.1
18275,CN4010100000000,40,101,"Muskogee County, OK",Aug-19,30041,28842,1199,4.0
18276,CN4010300000000,40,103,"Noble County, OK",Aug-19,5592,5456,136,2.4
18277,CN4010500000000,40,105,"Nowata County, OK",Aug-19,4592,4443,149,3.2
18278,CN4010700000000,40,107,"Okfuskee County, OK",Aug-19,4541,4332,209,4.6
18279,CN4010900000000,40,109,"Oklahoma County, OK",Aug-19,382886,370704,12182,3.2
18280,CN4011100000000,40,111,"Okmulgee County, OK",Aug-19,15727,14970,757,4.8
18281,CN4011300000000,40,113,"Osage County, OK",Aug-19,20718,19953,765,3.7
18282,CN4011500000000,40,115,"Ottawa County, OK",Aug-19,14093,13631,462,3.3
18283,CN4011700000000,40,117,"Pawnee County, OK",Aug-19,7370,7091,279,3.8
18284,CN4011900000000,40,119,"Payne County, OK",Aug-19,37447,36359,1088,2.9
18285,CN4012100000000,40,121,"Pittsburg County, OK",Aug-19,16690,15930,760,4.6
18286,CN4012300000000,40,123,"Pontotoc County, OK",Aug-19,19042,18488,554,2.9
18287,CN4012500000000,40,125,"Pottawatomie County, OK",Aug-19,32094,30950,1144,3.6
18288,CN4012700000000,40,127,"Pushmataha County, OK",Aug-19,4323,4119,204,4.7
18289,CN4012900000000,40,129,"Roger Mills County, OK",Aug-19,1931,1866,65,3.4
18290,CN4013100000000,40,131,"Rogers County, OK",Aug-19,45112,43756,1356,3.0
18291,CN4013300000000,40,133,"Seminole County, OK",Aug-19,9331,8903,428,4.6
18292,CN4013500000000,40,135,"Sequoyah County, OK",Aug-19,16142,15485,657,4.1
18293,CN4013700000000,40,137,"Stephens County, OK",Aug-19,18306,17475,831,4.5
18294,CN4013900000000,40,139,"Texas County, OK",Aug-19,11263,11040,223,2.0
18295,CN4014100000000,40,141,"Tillman County, OK",Aug-19,2955,2855,100,3.4
18296,CN4014300000000,40,143,"Tulsa County, OK",Aug-19,323330,313219,10111,3.1
18297,CN4014500000000,40,145,"Wagoner County, OK",Aug-19,37979,36801,1178,3.1
18298,CN4014700000000,40,147,"Washington County, OK",Aug-19,22370,21616,754,3.4
18299,CN4014900000000,40,149,"Washita County, OK",Aug-19,5301,5127,174,3.3
18300,CN4015100000000,40,151,"Woods County, OK",Aug-19,4522,4417,105,2.3
18301,CN4015300000000,40,153,"Woodward County, OK",Aug-19,8987,8745,242,2.7
18302,CN4100100000000,41,1,"Baker County, OR",Aug-19,7202,6904,298,4.1
18303,CN4100300000000,41,3,"Benton County, OR",Aug-19,46439,44812,1627,3.5
18304,CN4100500000000,41,5,"Clackamas County, OR",Aug-19,221315,213326,7989,3.6
18305,CN4100700000000,41,7,"Clatsop County, OR",Aug-19,20046,19344,702,3.5
18306,CN4100900000000,41,9,"Columbia County, OR",Aug-19,24551,23396,1155,4.7
18307,CN4101100000000,41,11,"Coos County, OR",Aug-19,26375,25063,1312,5.0
18308,CN4101300000000,41,13,"Crook County, OR",Aug-19,9837,9373,464,4.7
18309,CN4101500000000,41,15,"Curry County, OR",Aug-19,9321,8899,422,4.5
18310,CN4101700000000,41,17,"Deschutes County, OR",Aug-19,97993,94469,3524,3.6
18311,CN4101900000000,41,19,"Douglas County, OR",Aug-19,46870,44504,2366,5.0
18312,CN4102100000000,41,21,"Gilliam County, OR",Aug-19,966,934,32,3.3
18313,CN4102300000000,41,23,"Grant County, OR",Aug-19,3304,3161,143,4.3
18314,CN4102500000000,41,25,"Harney County, OR",Aug-19,3692,3537,155,4.2
18315,CN4102700000000,41,27,"Hood River County, OR",Aug-19,16439,15965,474,2.9
18316,CN4102900000000,41,29,"Jackson County, OR",Aug-19,104367,99699,4668,4.5
18317,CN4103100000000,41,31,"Jefferson County, OR",Aug-19,10272,9808,464,4.5
18318,CN4103300000000,41,33,"Josephine County, OR",Aug-19,36275,34442,1833,5.1
18319,CN4103500000000,41,35,"Klamath County, OR",Aug-19,29574,27943,1631,5.5
18320,CN4103700000000,41,37,"Lake County, OR",Aug-19,3831,3663,168,4.4
18321,CN4103900000000,41,39,"Lane County, OR",Aug-19,179490,171686,7804,4.3
18322,CN4104100000000,41,41,"Lincoln County, OR",Aug-19,21669,20770,899,4.1
18323,CN4104300000000,41,43,"Linn County, OR",Aug-19,58418,55811,2607,4.5
18324,CN4104500000000,41,45,"Malheur County, OR",Aug-19,12630,12126,504,4.0
18325,CN4104700000000,41,47,"Marion County, OR",Aug-19,164387,157604,6783,4.1
18326,CN4104900000000,41,49,"Morrow County, OR",Aug-19,5917,5687,230,3.9
18327,CN4105100000000,41,51,"Multnomah County, OR",Aug-19,458074,442260,15814,3.5
18328,CN4105300000000,41,53,"Polk County, OR",Aug-19,40243,38487,1756,4.4
18329,CN4105500000000,41,55,"Sherman County, OR",Aug-19,1000,965,35,3.5
18330,CN4105700000000,41,57,"Tillamook County, OR",Aug-19,12318,11857,461,3.7
18331,CN4105900000000,41,59,"Umatilla County, OR",Aug-19,37882,36263,1619,4.3
18332,CN4106100000000,41,61,"Union County, OR",Aug-19,11978,11445,533,4.4
18333,CN4106300000000,41,63,"Wallowa County, OR",Aug-19,3665,3511,154,4.2
18334,CN4106500000000,41,65,"Wasco County, OR",Aug-19,13726,13194,532,3.9
18335,CN4106700000000,41,67,"Washington County, OR",Aug-19,327126,316254,10872,3.3
18336,CN4106900000000,41,69,"Wheeler County, OR",Aug-19,710,680,30,4.2
18337,CN4107100000000,41,71,"Yamhill County, OR",Aug-19,55586,53507,2079,3.7
18338,CN4200100000000,42,1,"Adams County, PA",Aug-19,55861,53846,2015,3.6
18339,CN4200300000000,42,3,"Allegheny County, PA",Aug-19,653454,623562,29892,4.6
18340,CN4200500000000,42,5,"Armstrong County, PA",Aug-19,32552,30829,1723,5.3
18341,CN4200700000000,42,7,"Beaver County, PA",Aug-19,84737,80501,4236,5.0
18342,CN4200900000000,42,9,"Bedford County, PA",Aug-19,24051,22972,1079,4.5
18343,CN4201100000000,42,11,"Berks County, PA",Aug-19,217962,207542,10420,4.8
18344,CN4201300000000,42,13,"Blair County, PA",Aug-19,60599,57582,3017,5.0
18345,CN4201500000000,42,15,"Bradford County, PA",Aug-19,29390,28093,1297,4.4
18346,CN4201700000000,42,17,"Bucks County, PA",Aug-19,348594,333755,14839,4.3
18347,CN4201900000000,42,19,"Butler County, PA",Aug-19,100600,96395,4205,4.2
18348,CN4202100000000,42,21,"Cambria County, PA",Aug-19,57977,54471,3506,6.0
18349,CN4202300000000,42,23,"Cameron County, PA",Aug-19,2161,2043,118,5.5
18350,CN4202500000000,42,25,"Carbon County, PA",Aug-19,32320,30451,1869,5.8
18351,CN4202700000000,42,27,"Centre County, PA",Aug-19,79777,77114,2663,3.3
18352,CN4202900000000,42,29,"Chester County, PA",Aug-19,291742,281079,10663,3.7
18353,CN4203100000000,42,31,"Clarion County, PA",Aug-19,16969,16126,843,5.0
18354,CN4203300000000,42,33,"Clearfield County, PA",Aug-19,36298,34401,1897,5.2
18355,CN4203500000000,42,35,"Clinton County, PA",Aug-19,18358,17403,955,5.2
18356,CN4203700000000,42,37,"Columbia County, PA",Aug-19,33577,31965,1612,4.8
18357,CN4203900000000,42,39,"Crawford County, PA",Aug-19,39083,37118,1965,5.0
18358,CN4204100000000,42,41,"Cumberland County, PA",Aug-19,134874,129826,5048,3.7
18359,CN4204300000000,42,43,"Dauphin County, PA",Aug-19,147227,140494,6733,4.6
18360,CN4204500000000,42,45,"Delaware County, PA",Aug-19,299505,285842,13663,4.6
18361,CN4204700000000,42,47,"Elk County, PA",Aug-19,15923,15072,851,5.3
18362,CN4204900000000,42,49,"Erie County, PA",Aug-19,129231,123209,6022,4.7
18363,CN4205100000000,42,51,"Fayette County, PA",Aug-19,57573,54041,3532,6.1
18364,CN4205300000000,42,53,"Forest County, PA",Aug-19,1863,1737,126,6.8
18365,CN4205500000000,42,55,"Franklin County, PA",Aug-19,78733,75450,3283,4.2
18366,CN4205700000000,42,57,"Fulton County, PA",Aug-19,8060,7712,348,4.3
18367,CN4205900000000,42,59,"Greene County, PA",Aug-19,16557,15633,924,5.6
18368,CN4206100000000,42,61,"Huntingdon County, PA",Aug-19,20277,19119,1158,5.7
18369,CN4206300000000,42,63,"Indiana County, PA",Aug-19,38940,36772,2168,5.6
18370,CN4206500000000,42,65,"Jefferson County, PA",Aug-19,20852,19823,1029,4.9
18371,CN4206700000000,42,67,"Juniata County, PA",Aug-19,12963,12399,564,4.4
18372,CN4206900000000,42,69,"Lackawanna County, PA",Aug-19,105865,100012,5853,5.5
18373,CN4207100000000,42,71,"Lancaster County, PA",Aug-19,290354,279104,11250,3.9
18374,CN4207300000000,42,73,"Lawrence County, PA",Aug-19,40914,38862,2052,5.0
18375,CN4207500000000,42,75,"Lebanon County, PA",Aug-19,73701,70544,3157,4.3
18376,CN4207700000000,42,77,"Lehigh County, PA",Aug-19,193721,184059,9662,5.0
18377,CN4207900000000,42,79,"Luzerne County, PA",Aug-19,158634,148683,9951,6.3
18378,CN4208100000000,42,81,"Lycoming County, PA",Aug-19,57284,54463,2821,4.9
18379,CN4208300000000,42,83,"McKean County, PA",Aug-19,17485,16549,936,5.4
18380,CN4208500000000,42,85,"Mercer County, PA",Aug-19,49812,47188,2624,5.3
18381,CN4208700000000,42,87,"Mifflin County, PA",Aug-19,21526,20386,1140,5.3
18382,CN4208900000000,42,89,"Monroe County, PA",Aug-19,84044,79300,4744,5.6
18383,CN4209100000000,42,91,"Montgomery County, PA",Aug-19,460562,442274,18288,4.0
18384,CN4209300000000,42,93,"Montour County, PA",Aug-19,9138,8798,340,3.7
18385,CN4209500000000,42,95,"Northampton County, PA",Aug-19,162086,154137,7949,4.9
18386,CN4209700000000,42,97,"Northumberland County, PA",Aug-19,44007,41533,2474,5.6
18387,CN4209900000000,42,99,"Perry County, PA",Aug-19,25178,24151,1027,4.1
18388,CN4210100000000,42,101,"Philadelphia County/city, PA",Aug-19,723251,676889,46362,6.4
18389,CN4210300000000,42,103,"Pike County, PA",Aug-19,25578,24048,1530,6.0
18390,CN4210500000000,42,105,"Potter County, PA",Aug-19,7357,6954,403,5.5
18391,CN4210700000000,42,107,"Schuylkill County, PA",Aug-19,67252,63302,3950,5.9
18392,CN4210900000000,42,109,"Snyder County, PA",Aug-19,20049,18714,1335,6.7
18393,CN4211100000000,42,111,"Somerset County, PA",Aug-19,33673,31889,1784,5.3
18394,CN4211300000000,42,113,"Sullivan County, PA",Aug-19,2763,2616,147,5.3
18395,CN4211500000000,42,115,"Susquehanna County, PA",Aug-19,21135,20282,853,4.0
18396,CN4211700000000,42,117,"Tioga County, PA",Aug-19,19382,18395,987,5.1
18397,CN4211900000000,42,119,"Union County, PA",Aug-19,20189,19360,829,4.1
18398,CN4212100000000,42,121,"Venango County, PA",Aug-19,22720,21558,1162,5.1
18399,CN4212300000000,42,123,"Warren County, PA",Aug-19,19097,18218,879,4.6
18400,CN4212500000000,42,125,"Washington County, PA",Aug-19,107775,102723,5052,4.7
18401,CN4212700000000,42,127,"Wayne County, PA",Aug-19,24531,23547,984,4.0
18402,CN4212900000000,42,129,"Westmoreland County, PA",Aug-19,182605,173741,8864,4.9
18403,CN4213100000000,42,131,"Wyoming County, PA",Aug-19,13685,13040,645,4.7
18404,CN4213300000000,42,133,"York County, PA",Aug-19,238284,228005,10279,4.3
18405,CN4400100000000,44,1,"Bristol County, RI",Aug-19,26172,25369,803,3.1
18406,CN4400300000000,44,3,"Kent County, RI",Aug-19,91422,88315,3107,3.4
18407,CN4400500000000,44,5,"Newport County, RI",Aug-19,44472,43149,1323,3.0
18408,CN4400700000000,44,7,"Providence County, RI",Aug-19,328209,314709,13500,4.1
18409,CN4400900000000,44,9,"Washington County, RI",Aug-19,70193,67988,2205,3.1
18410,CN4500100000000,45,1,"Abbeville County, SC",Aug-19,9934,9596,338,3.4
18411,CN4500300000000,45,3,"Aiken County, SC",Aug-19,75153,72937,2216,2.9
18412,CN4500500000000,45,5,"Allendale County, SC",Aug-19,2677,2526,151,5.6
18413,CN4500700000000,45,7,"Anderson County, SC",Aug-19,91398,88920,2478,2.7
18414,CN4500900000000,45,9,"Bamberg County, SC",Aug-19,4987,4678,309,6.2
18415,CN4501100000000,45,11,"Barnwell County, SC",Aug-19,8260,7885,375,4.5
18416,CN4501300000000,45,13,"Beaufort County, SC",Aug-19,79372,77262,2110,2.7
18417,CN4501500000000,45,15,"Berkeley County, SC",Aug-19,105149,102471,2678,2.5
18418,CN4501700000000,45,17,"Calhoun County, SC",Aug-19,6651,6396,255,3.8
18419,CN4501900000000,45,19,"Charleston County, SC",Aug-19,213629,208642,4987,2.3
18420,CN4502100000000,45,21,"Cherokee County, SC",Aug-19,25296,24505,791,3.1
18421,CN4502300000000,45,23,"Chester County, SC",Aug-19,13542,12965,577,4.3
18422,CN4502500000000,45,25,"Chesterfield County, SC",Aug-19,22081,21420,661,3.0
18423,CN4502700000000,45,27,"Clarendon County, SC",Aug-19,12913,12424,489,3.8
18424,CN4502900000000,45,29,"Colleton County, SC",Aug-19,16935,16384,551,3.3
18425,CN4503100000000,45,31,"Darlington County, SC",Aug-19,30715,29629,1086,3.5
18426,CN4503300000000,45,33,"Dillon County, SC",Aug-19,13133,12621,512,3.9
18427,CN4503500000000,45,35,"Dorchester County, SC",Aug-19,78966,77006,1960,2.5
18428,CN4503700000000,45,37,"Edgefield County, SC",Aug-19,10785,10478,307,2.8
18429,CN4503900000000,45,39,"Fairfield County, SC",Aug-19,9648,9228,420,4.4
18430,CN4504100000000,45,41,"Florence County, SC",Aug-19,67258,65286,1972,2.9
18431,CN4504300000000,45,43,"Georgetown County, SC",Aug-19,26216,25313,903,3.4
18432,CN4504500000000,45,45,"Greenville County, SC",Aug-19,255228,249089,6139,2.4
18433,CN4504700000000,45,47,"Greenwood County, SC",Aug-19,31100,30099,1001,3.2
18434,CN4504900000000,45,49,"Hampton County, SC",Aug-19,8539,8312,227,2.7
18435,CN4505100000000,45,51,"Horry County, SC",Aug-19,152853,148069,4784,3.1
18436,CN4505300000000,45,53,"Jasper County, SC",Aug-19,12881,12558,323,2.5
18437,CN4505500000000,45,55,"Kershaw County, SC",Aug-19,29444,28527,917,3.1
18438,CN4505700000000,45,57,"Lancaster County, SC",Aug-19,41523,40145,1378,3.3
18439,CN4505900000000,45,59,"Laurens County, SC",Aug-19,30284,29362,922,3.0
18440,CN4506100000000,45,61,"Lee County, SC",Aug-19,6690,6408,282,4.2
18441,CN4506300000000,45,63,"Lexington County, SC",Aug-19,150508,147016,3492,2.3
18442,CN4506500000000,45,65,"McCormick County, SC",Aug-19,3382,3276,106,3.1
18443,CN4506700000000,45,67,"Marion County, SC",Aug-19,13138,12582,556,4.2
18444,CN4506900000000,45,69,"Marlboro County, SC",Aug-19,9278,8866,412,4.4
18445,CN4507100000000,45,71,"Newberry County, SC",Aug-19,19287,18733,554,2.9
18446,CN4507300000000,45,73,"Oconee County, SC",Aug-19,35191,34198,993,2.8
18447,CN4507500000000,45,75,"Orangeburg County, SC",Aug-19,34494,32631,1863,5.4
18448,CN4507700000000,45,77,"Pickens County, SC",Aug-19,57550,55906,1644,2.9
18449,CN4507900000000,45,79,"Richland County, SC",Aug-19,199311,193712,5599,2.8
18450,CN4508100000000,45,81,"Saluda County, SC",Aug-19,9034,8803,231,2.6
18451,CN4508300000000,45,83,"Spartanburg County, SC",Aug-19,153135,149159,3976,2.6
18452,CN4508500000000,45,85,"Sumter County, SC",Aug-19,43309,41818,1491,3.4
18453,CN4508700000000,45,87,"Union County, SC",Aug-19,11658,11241,417,3.6
18454,CN4508900000000,45,89,"Williamsburg County, SC",Aug-19,12127,11553,574,4.7
18455,CN4509100000000,45,91,"York County, SC",Aug-19,141040,137097,3943,2.8
18456,CN4600300000000,46,3,"Aurora County, SD",Aug-19,1552,1512,40,2.6
18457,CN4600500000000,46,5,"Beadle County, SD",Aug-19,9719,9425,294,3.0
18458,CN4600700000000,46,7,"Bennett County, SD",Aug-19,1134,1072,62,5.5
18459,CN4600900000000,46,9,"Bon Homme County, SD",Aug-19,2915,2826,89,3.1
18460,CN4601100000000,46,11,"Brookings County, SD",Aug-19,18769,18138,631,3.4
18461,CN4601300000000,46,13,"Brown County, SD",Aug-19,20717,20066,651,3.1
18462,CN4601500000000,46,15,"Brule County, SD",Aug-19,2487,2410,77,3.1
18463,CN4601700000000,46,17,"Buffalo County, SD",Aug-19,702,643,59,8.4
18464,CN4601900000000,46,19,"Butte County, SD",Aug-19,5116,4944,172,3.4
18465,CN4602100000000,46,21,"Campbell County, SD",Aug-19,790,761,29,3.7
18466,CN4602300000000,46,23,"Charles Mix County, SD",Aug-19,3815,3674,141,3.7
18467,CN4602500000000,46,25,"Clark County, SD",Aug-19,1898,1827,71,3.7
18468,CN4602700000000,46,27,"Clay County, SD",Aug-19,6894,6640,254,3.7
18469,CN4602900000000,46,29,"Codington County, SD",Aug-19,15542,15066,476,3.1
18470,CN4603100000000,46,31,"Corson County, SD",Aug-19,1337,1241,96,7.2
18471,CN4603300000000,46,33,"Custer County, SD",Aug-19,4115,3957,158,3.8
18472,CN4603500000000,46,35,"Davison County, SD",Aug-19,11222,10906,316,2.8
18473,CN4603700000000,46,37,"Day County, SD",Aug-19,2791,2682,109,3.9
18474,CN4603900000000,46,39,"Deuel County, SD",Aug-19,2206,2125,81,3.7
18475,CN4604100000000,46,41,"Dewey County, SD",Aug-19,2262,1993,269,11.9
18476,CN4604300000000,46,43,"Douglas County, SD",Aug-19,1593,1551,42,2.6
18477,CN4604500000000,46,45,"Edmunds County, SD",Aug-19,2029,1967,62,3.1
18478,CN4604700000000,46,47,"Fall River County, SD",Aug-19,3040,2919,121,4.0
18479,CN4604900000000,46,49,"Faulk County, SD",Aug-19,1048,1011,37,3.5
18480,CN4605100000000,46,51,"Grant County, SD",Aug-19,4433,4310,123,2.8
18481,CN4605300000000,46,53,"Gregory County, SD",Aug-19,2004,1940,64,3.2
18482,CN4605500000000,46,55,"Haakon County, SD",Aug-19,1048,1018,30,2.9
18483,CN4605700000000,46,57,"Hamlin County, SD",Aug-19,3355,3261,94,2.8
18484,CN4605900000000,46,59,"Hand County, SD",Aug-19,1757,1708,49,2.8
18485,CN4606100000000,46,61,"Hanson County, SD",Aug-19,1746,1677,69,4.0
18486,CN4606300000000,46,63,"Harding County, SD",Aug-19,730,708,22,3.0
18487,CN4606500000000,46,65,"Hughes County, SD",Aug-19,10086,9819,267,2.6
18488,CN4606700000000,46,67,"Hutchinson County, SD",Aug-19,3609,3500,109,3.0
18489,CN4606900000000,46,69,"Hyde County, SD",Aug-19,688,664,24,3.5
18490,CN4607100000000,46,71,"Jackson County, SD",Aug-19,1355,1291,64,4.7
18491,CN4607300000000,46,73,"Jerauld County, SD",Aug-19,1127,1097,30,2.7
18492,CN4607500000000,46,75,"Jones County, SD",Aug-19,593,576,17,2.9
18493,CN4607700000000,46,77,"Kingsbury County, SD",Aug-19,2644,2568,76,2.9
18494,CN4607900000000,46,79,"Lake County, SD",Aug-19,6559,6310,249,3.8
18495,CN4608100000000,46,81,"Lawrence County, SD",Aug-19,13639,13198,441,3.2
18496,CN4608300000000,46,83,"Lincoln County, SD",Aug-19,34792,33892,900,2.6
18497,CN4608500000000,46,85,"Lyman County, SD",Aug-19,1788,1692,96,5.4
18498,CN4608700000000,46,87,"McCook County, SD",Aug-19,3078,2996,82,2.7
18499,CN4608900000000,46,89,"McPherson County, SD",Aug-19,984,940,44,4.5
18500,CN4609100000000,46,91,"Marshall County, SD",Aug-19,2437,2350,87,3.6
18501,CN4609300000000,46,93,"Meade County, SD",Aug-19,14708,14210,498,3.4
18502,CN4609500000000,46,95,"Mellette County, SD",Aug-19,758,708,50,6.6
18503,CN4609700000000,46,97,"Miner County, SD",Aug-19,1174,1139,35,3.0
18504,CN4609900000000,46,99,"Minnehaha County, SD",Aug-19,113650,110479,3171,2.8
18505,CN4610100000000,46,101,"Moody County, SD",Aug-19,4145,3930,215,5.2
18506,CN4610200000000,46,102,"Oglala Lakota County, SD",Aug-19,3790,3447,343,9.1
18507,CN4610300000000,46,103,"Pennington County, SD",Aug-19,59227,57287,1940,3.3
18508,CN4610500000000,46,105,"Perkins County, SD",Aug-19,1429,1382,47,3.3
18509,CN4610700000000,46,107,"Potter County, SD",Aug-19,1078,1043,35,3.2
18510,CN4610900000000,46,109,"Roberts County, SD",Aug-19,4838,4640,198,4.1
18511,CN4611100000000,46,111,"Sanborn County, SD",Aug-19,1171,1132,39,3.3
18512,CN4611500000000,46,115,"Spink County, SD",Aug-19,3196,3095,101,3.2
18513,CN4611700000000,46,117,"Stanley County, SD",Aug-19,1849,1799,50,2.7
18514,CN4611900000000,46,119,"Sully County, SD",Aug-19,799,775,24,3.0
18515,CN4612100000000,46,121,"Todd County, SD",Aug-19,3190,2949,241,7.6
18516,CN4612300000000,46,123,"Tripp County, SD",Aug-19,3099,2998,101,3.3
18517,CN4612500000000,46,125,"Turner County, SD",Aug-19,4707,4564,143,3.0
18518,CN4612700000000,46,127,"Union County, SD",Aug-19,8431,8121,310,3.7
18519,CN4612900000000,46,129,"Walworth County, SD",Aug-19,2192,2078,114,5.2
18520,CN4613500000000,46,135,"Yankton County, SD",Aug-19,11984,11639,345,2.9
18521,CN4613700000000,46,137,"Ziebach County, SD",Aug-19,921,857,64,6.9
18522,CN4700100000000,47,1,"Anderson County, TN",Aug-19,34748,33531,1217,3.5
18523,CN4700300000000,47,3,"Bedford County, TN",Aug-19,21181,20373,808,3.8
18524,CN4700500000000,47,5,"Benton County, TN",Aug-19,6930,6612,318,4.6
18525,CN4700700000000,47,7,"Bledsoe County, TN",Aug-19,4338,4123,215,5.0
18526,CN4700900000000,47,9,"Blount County, TN",Aug-19,63779,61780,1999,3.1
18527,CN4701100000000,47,11,"Bradley County, TN",Aug-19,53142,51261,1881,3.5
18528,CN4701300000000,47,13,"Campbell County, TN",Aug-19,14872,14226,646,4.3
18529,CN4701500000000,47,15,"Cannon County, TN",Aug-19,6692,6472,220,3.3
18530,CN4701700000000,47,17,"Carroll County, TN",Aug-19,12011,11449,562,4.7
18531,CN4701900000000,47,19,"Carter County, TN",Aug-19,23932,22955,977,4.1
18532,CN4702100000000,47,21,"Cheatham County, TN",Aug-19,22137,21565,572,2.6
18533,CN4702300000000,47,23,"Chester County, TN",Aug-19,8616,8301,315,3.7
18534,CN4702500000000,47,25,"Claiborne County, TN",Aug-19,13039,12491,548,4.2
18535,CN4702700000000,47,27,"Clay County, TN",Aug-19,2852,2686,166,5.8
18536,CN4702900000000,47,29,"Cocke County, TN",Aug-19,15353,14717,636,4.1
18537,CN4703100000000,47,31,"Coffee County, TN",Aug-19,25778,24899,879,3.4
18538,CN4703300000000,47,33,"Crockett County, TN",Aug-19,7055,6811,244,3.5
18539,CN4703500000000,47,35,"Cumberland County, TN",Aug-19,23880,22901,979,4.1
18540,CN4703700000000,47,37,"Davidson County, TN",Aug-19,408879,398419,10460,2.6
18541,CN4703900000000,47,39,"Decatur County, TN",Aug-19,4608,4380,228,4.9
18542,CN4704100000000,47,41,"DeKalb County, TN",Aug-19,7918,7595,323,4.1
18543,CN4704300000000,47,43,"Dickson County, TN",Aug-19,27391,26533,858,3.1
18544,CN4704500000000,47,45,"Dyer County, TN",Aug-19,16584,15764,820,4.9
18545,CN4704700000000,47,47,"Fayette County, TN",Aug-19,19331,18655,676,3.5
18546,CN4704900000000,47,49,"Fentress County, TN",Aug-19,7552,7209,343,4.5
18547,CN4705100000000,47,51,"Franklin County, TN",Aug-19,20214,19543,671,3.3
18548,CN4705300000000,47,53,"Gibson County, TN",Aug-19,22367,21427,940,4.2
18549,CN4705500000000,47,55,"Giles County, TN",Aug-19,14836,14282,554,3.7
18550,CN4705700000000,47,57,"Grainger County, TN",Aug-19,9558,9192,366,3.8
18551,CN4705900000000,47,59,"Greene County, TN",Aug-19,29959,28544,1415,4.7
18552,CN4706100000000,47,61,"Grundy County, TN",Aug-19,5050,4857,193,3.8
18553,CN4706300000000,47,63,"Hamblen County, TN",Aug-19,28108,27008,1100,3.9
18554,CN4706500000000,47,65,"Hamilton County, TN",Aug-19,184811,178621,6190,3.3
18555,CN4706700000000,47,67,"Hancock County, TN",Aug-19,2162,2034,128,5.9
18556,CN4706900000000,47,69,"Hardeman County, TN",Aug-19,9577,9136,441,4.6
18557,CN4707100000000,47,71,"Hardin County, TN",Aug-19,10566,10133,433,4.1
18558,CN4707300000000,47,73,"Hawkins County, TN",Aug-19,23904,22899,1005,4.2
18559,CN4707500000000,47,75,"Haywood County, TN",Aug-19,7825,7451,374,4.8
18560,CN4707700000000,47,77,"Henderson County, TN",Aug-19,12373,11878,495,4.0
18561,CN4707900000000,47,79,"Henry County, TN",Aug-19,14408,13844,564,3.9
18562,CN4708100000000,47,81,"Hickman County, TN",Aug-19,11588,11227,361,3.1
18563,CN4708300000000,47,83,"Houston County, TN",Aug-19,3311,3167,144,4.3
18564,CN4708500000000,47,85,"Humphreys County, TN",Aug-19,9019,8681,338,3.7
18565,CN4708700000000,47,87,"Jackson County, TN",Aug-19,4690,4488,202,4.3
18566,CN4708900000000,47,89,"Jefferson County, TN",Aug-19,24526,23634,892,3.6
18567,CN4709100000000,47,91,"Johnson County, TN",Aug-19,7754,7501,253,3.3
18568,CN4709300000000,47,93,"Knox County, TN",Aug-19,245160,237848,7312,3.0
18569,CN4709500000000,47,95,"Lake County, TN",Aug-19,1763,1676,87,4.9
18570,CN4709700000000,47,97,"Lauderdale County, TN",Aug-19,9873,9343,530,5.4
18571,CN4709900000000,47,99,"Lawrence County, TN",Aug-19,19399,18622,777,4.0
18572,CN4710100000000,47,101,"Lewis County, TN",Aug-19,5252,5067,185,3.5
18573,CN4710300000000,47,103,"Lincoln County, TN",Aug-19,17011,16478,533,3.1
18574,CN4710500000000,47,105,"Loudon County, TN",Aug-19,23624,22819,805,3.4
18575,CN4710700000000,47,107,"McMinn County, TN",Aug-19,24120,23213,907,3.8
18576,CN4710900000000,47,109,"McNairy County, TN",Aug-19,8720,8267,453,5.2
18577,CN4711100000000,47,111,"Macon County, TN",Aug-19,11456,11097,359,3.1
18578,CN4711300000000,47,113,"Madison County, TN",Aug-19,49205,47413,1792,3.6
18579,CN4711500000000,47,115,"Marion County, TN",Aug-19,12558,12007,551,4.4
18580,CN4711700000000,47,117,"Marshall County, TN",Aug-19,15785,15259,526,3.3
18581,CN4711900000000,47,119,"Maury County, TN",Aug-19,49848,48467,1381,2.8
18582,CN4712100000000,47,121,"Meigs County, TN",Aug-19,5248,5017,231,4.4
18583,CN4712300000000,47,123,"Monroe County, TN",Aug-19,20347,19617,730,3.6
18584,CN4712500000000,47,125,"Montgomery County, TN",Aug-19,86490,83119,3371,3.9
18585,CN4712700000000,47,127,"Moore County, TN",Aug-19,3619,3499,120,3.3
18586,CN4712900000000,47,129,"Morgan County, TN",Aug-19,7917,7601,316,4.0
18587,CN4713100000000,47,131,"Obion County, TN",Aug-19,12536,11983,553,4.4
18588,CN4713300000000,47,133,"Overton County, TN",Aug-19,10116,9759,357,3.5
18589,CN4713500000000,47,135,"Perry County, TN",Aug-19,3081,2953,128,4.2
18590,CN4713700000000,47,137,"Pickett County, TN",Aug-19,2447,2350,97,4.0
18591,CN4713900000000,47,139,"Polk County, TN",Aug-19,7683,7363,320,4.2
18592,CN4714100000000,47,141,"Putnam County, TN",Aug-19,35173,33924,1249,3.6
18593,CN4714300000000,47,143,"Rhea County, TN",Aug-19,13246,12521,725,5.5
18594,CN4714500000000,47,145,"Roane County, TN",Aug-19,23514,22553,961,4.1
18595,CN4714700000000,47,147,"Robertson County, TN",Aug-19,38510,37397,1113,2.9
18596,CN4714900000000,47,149,"Rutherford County, TN",Aug-19,186351,181415,4936,2.6
18597,CN4715100000000,47,151,"Scott County, TN",Aug-19,8380,8001,379,4.5
18598,CN4715300000000,47,153,"Sequatchie County, TN",Aug-19,6237,5966,271,4.3
18599,CN4715500000000,47,155,"Sevier County, TN",Aug-19,56852,55404,1448,2.5
18600,CN4715700000000,47,157,"Shelby County, TN",Aug-19,449052,430585,18467,4.1
18601,CN4715900000000,47,159,"Smith County, TN",Aug-19,9569,9290,279,2.9
18602,CN4716100000000,47,161,"Stewart County, TN",Aug-19,5580,5339,241,4.3
18603,CN4716300000000,47,163,"Sullivan County, TN",Aug-19,70646,68034,2612,3.7
18604,CN4716500000000,47,165,"Sumner County, TN",Aug-19,103635,100783,2852,2.8
18605,CN4716700000000,47,167,"Tipton County, TN",Aug-19,28396,27299,1097,3.9
18606,CN4716900000000,47,169,"Trousdale County, TN",Aug-19,5489,5327,162,3.0
18607,CN4717100000000,47,171,"Unicoi County, TN",Aug-19,7082,6746,336,4.7
18608,CN4717300000000,47,173,"Union County, TN",Aug-19,7654,7354,300,3.9
18609,CN4717500000000,47,175,"Van Buren County, TN",Aug-19,2074,1985,89,4.3
18610,CN4717700000000,47,177,"Warren County, TN",Aug-19,16919,16248,671,4.0
18611,CN4717900000000,47,179,"Washington County, TN",Aug-19,60206,58058,2148,3.6
18612,CN4718100000000,47,181,"Wayne County, TN",Aug-19,6268,6004,264,4.2
18613,CN4718300000000,47,183,"Weakley County, TN",Aug-19,16053,15384,669,4.2
18614,CN4718500000000,47,185,"White County, TN",Aug-19,12324,11857,467,3.8
18615,CN4718700000000,47,187,"Williamson County, TN",Aug-19,130063,126772,3291,2.5
18616,CN4718900000000,47,189,"Wilson County, TN",Aug-19,77566,75474,2092,2.7
18617,CN4800100000000,48,1,"Anderson County, TX",Aug-19,24055,23332,723,3.0
18618,CN4800300000000,48,3,"Andrews County, TX",Aug-19,9899,9663,236,2.4
18619,CN4800500000000,48,5,"Angelina County, TX",Aug-19,35730,34236,1494,4.2
18620,CN4800700000000,48,7,"Aransas County, TX",Aug-19,9425,9015,410,4.4
18621,CN4800900000000,48,9,"Archer County, TX",Aug-19,4156,4035,121,2.9
18622,CN4801100000000,48,11,"Armstrong County, TX",Aug-19,940,914,26,2.8
18623,CN4801300000000,48,13,"Atascosa County, TX",Aug-19,21784,20960,824,3.8
18624,CN4801500000000,48,15,"Austin County, TX",Aug-19,14112,13599,513,3.6
18625,CN4801700000000,48,17,"Bailey County, TX",Aug-19,2573,2485,88,3.4
18626,CN4801900000000,48,19,"Bandera County, TX",Aug-19,10120,9756,364,3.6
18627,CN4802100000000,48,21,"Bastrop County, TX",Aug-19,42911,41567,1344,3.1
18628,CN4802300000000,48,23,"Baylor County, TX",Aug-19,1802,1757,45,2.5
18629,CN4802500000000,48,25,"Bee County, TX",Aug-19,9805,9337,468,4.8
18630,CN4802700000000,48,27,"Bell County, TX",Aug-19,143168,137486,5682,4.0
18631,CN4802900000000,48,29,"Bexar County, TX",Aug-19,948570,916844,31726,3.3
18632,CN4803100000000,48,31,"Blanco County, TX",Aug-19,6496,6331,165,2.5
18633,CN4803300000000,48,33,"Borden County, TX",Aug-19,414,402,12,2.9
18634,CN4803500000000,48,35,"Bosque County, TX",Aug-19,8450,8141,309,3.7
18635,CN4803700000000,48,37,"Bowie County, TX",Aug-19,39449,37584,1865,4.7
18636,CN4803900000000,48,39,"Brazoria County, TX",Aug-19,179398,170969,8429,4.7
18637,CN4804100000000,48,41,"Brazos County, TX",Aug-19,114786,111348,3438,3.0
18638,CN4804300000000,48,43,"Brewster County, TX",Aug-19,4213,4084,129,3.1
18639,CN4804500000000,48,45,"Briscoe County, TX",Aug-19,593,574,19,3.2
18640,CN4804700000000,48,47,"Brooks County, TX",Aug-19,2578,2445,133,5.2
18641,CN4804900000000,48,49,"Brown County, TX",Aug-19,15792,15142,650,4.1
18642,CN4805100000000,48,51,"Burleson County, TX",Aug-19,8106,7840,266,3.3
18643,CN4805300000000,48,53,"Burnet County, TX",Aug-19,23599,22909,690,2.9
18644,CN4805500000000,48,55,"Caldwell County, TX",Aug-19,19670,18984,686,3.5
18645,CN4805700000000,48,57,"Calhoun County, TX",Aug-19,12155,11737,418,3.4
18646,CN4805900000000,48,59,"Callahan County, TX",Aug-19,6124,5916,208,3.4
18647,CN4806100000000,48,61,"Cameron County, TX",Aug-19,167322,157828,9494,5.7
18648,CN4806300000000,48,63,"Camp County, TX",Aug-19,5015,4791,224,4.5
18649,CN4806500000000,48,65,"Carson County, TX",Aug-19,3035,2962,73,2.4
18650,CN4806700000000,48,67,"Cass County, TX",Aug-19,12472,11910,562,4.5
18651,CN4806900000000,48,69,"Castro County, TX",Aug-19,3501,3402,99,2.8
18652,CN4807100000000,48,71,"Chambers County, TX",Aug-19,19440,18483,957,4.9
18653,CN4807300000000,48,73,"Cherokee County, TX",Aug-19,20961,20115,846,4.0
18654,CN4807500000000,48,75,"Childress County, TX",Aug-19,3034,2952,82,2.7
18655,CN4807700000000,48,77,"Clay County, TX",Aug-19,4962,4804,158,3.2
18656,CN4807900000000,48,79,"Cochran County, TX",Aug-19,1167,1126,41,3.5
18657,CN4808100000000,48,81,"Coke County, TX",Aug-19,1508,1457,51,3.4
18658,CN4808300000000,48,83,"Coleman County, TX",Aug-19,2922,2792,130,4.4
18659,CN4808500000000,48,85,"Collin County, TX",Aug-19,565015,546555,18460,3.3
18660,CN4808700000000,48,87,"Collingsworth County, TX",Aug-19,1182,1143,39,3.3
18661,CN4808900000000,48,89,"Colorado County, TX",Aug-19,10038,9718,320,3.2
18662,CN4809100000000,48,91,"Comal County, TX",Aug-19,73358,70965,2393,3.3
18663,CN4809300000000,48,93,"Comanche County, TX",Aug-19,5697,5504,193,3.4
18664,CN4809500000000,48,95,"Concho County, TX",Aug-19,1406,1359,47,3.3
18665,CN4809700000000,48,97,"Cooke County, TX",Aug-19,19668,19097,571,2.9
18666,CN4809900000000,48,99,"Coryell County, TX",Aug-19,24036,23037,999,4.2
18667,CN4810100000000,48,101,"Cottle County, TX",Aug-19,551,531,20,3.6
18668,CN4810300000000,48,103,"Crane County, TX",Aug-19,1589,1522,67,4.2
18669,CN4810500000000,48,105,"Crockett County, TX",Aug-19,1662,1609,53,3.2
18670,CN4810700000000,48,107,"Crosby County, TX",Aug-19,2579,2469,110,4.3
18671,CN4810900000000,48,109,"Culberson County, TX",Aug-19,1079,1031,48,4.4
18672,CN4811100000000,48,111,"Dallam County, TX",Aug-19,4017,3941,76,1.9
18673,CN4811300000000,48,113,"Dallas County, TX",Aug-19,1367878,1317877,50001,3.7
18674,CN4811500000000,48,115,"Dawson County, TX",Aug-19,4643,4454,189,4.1
18675,CN4811700000000,48,117,"Deaf Smith County, TX",Aug-19,8666,8419,247,2.9
18676,CN4811900000000,48,119,"Delta County, TX",Aug-19,2450,2358,92,3.8
18677,CN4812100000000,48,121,"Denton County, TX",Aug-19,495743,480216,15527,3.1
18678,CN4812300000000,48,123,"DeWitt County, TX",Aug-19,9926,9658,268,2.7
18679,CN4812500000000,48,125,"Dickens County, TX",Aug-19,706,674,32,4.5
18680,CN4812700000000,48,127,"Dimmit County, TX",Aug-19,7241,7042,199,2.7
18681,CN4812900000000,48,129,"Donley County, TX",Aug-19,1412,1353,59,4.2
18682,CN4813100000000,48,131,"Duval County, TX",Aug-19,4942,4704,238,4.8
18683,CN4813300000000,48,133,"Eastland County, TX",Aug-19,8185,7885,300,3.7
18684,CN4813500000000,48,135,"Ector County, TX",Aug-19,87710,85163,2547,2.9
18685,CN4813700000000,48,137,"Edwards County, TX",Aug-19,1136,1114,22,1.9
18686,CN4813900000000,48,139,"Ellis County, TX",Aug-19,92939,89920,3019,3.2
18687,CN4814100000000,48,141,"El Paso County, TX",Aug-19,360767,346238,14529,4.0
18688,CN4814300000000,48,143,"Erath County, TX",Aug-19,20719,20004,715,3.5
18689,CN4814500000000,48,145,"Falls County, TX",Aug-19,6632,6415,217,3.3
18690,CN4814700000000,48,147,"Fannin County, TX",Aug-19,17468,16974,494,2.8
18691,CN4814900000000,48,149,"Fayette County, TX",Aug-19,12232,11881,351,2.9
18692,CN4815100000000,48,151,"Fisher County, TX",Aug-19,1679,1620,59,3.5
18693,CN4815300000000,48,153,"Floyd County, TX",Aug-19,2662,2544,118,4.4
18694,CN4815500000000,48,155,"Foard County, TX",Aug-19,606,587,19,3.1
18695,CN4815700000000,48,157,"Fort Bend County, TX",Aug-19,390701,376254,14447,3.7
18696,CN4815900000000,48,159,"Franklin County, TX",Aug-19,4697,4514,183,3.9
18697,CN4816100000000,48,161,"Freestone County, TX",Aug-19,6511,6199,312,4.8
18698,CN4816300000000,48,163,"Frio County, TX",Aug-19,10534,10259,275,2.6
18699,CN4816500000000,48,165,"Gaines County, TX",Aug-19,10002,9743,259,2.6
18700,CN4816700000000,48,167,"Galveston County, TX",Aug-19,165085,157895,7190,4.4
18701,CN4816900000000,48,169,"Garza County, TX",Aug-19,2202,2142,60,2.7
18702,CN4817100000000,48,171,"Gillespie County, TX",Aug-19,13580,13241,339,2.5
18703,CN4817300000000,48,173,"Glasscock County, TX",Aug-19,827,808,19,2.3
18704,CN4817500000000,48,175,"Goliad County, TX",Aug-19,3268,3155,113,3.5
18705,CN4817700000000,48,177,"Gonzales County, TX",Aug-19,9677,9398,279,2.9
18706,CN4817900000000,48,179,"Gray County, TX",Aug-19,8174,7874,300,3.7
18707,CN4818100000000,48,181,"Grayson County, TX",Aug-19,64139,62027,2112,3.3
18708,CN4818300000000,48,183,"Gregg County, TX",Aug-19,58311,56013,2298,3.9
18709,CN4818500000000,48,185,"Grimes County, TX",Aug-19,11207,10723,484,4.3
18710,CN4818700000000,48,187,"Guadalupe County, TX",Aug-19,81484,78890,2594,3.2
18711,CN4818900000000,48,189,"Hale County, TX",Aug-19,12200,11648,552,4.5
18712,CN4819100000000,48,191,"Hall County, TX",Aug-19,1091,1047,44,4.0
18713,CN4819300000000,48,193,"Hamilton County, TX",Aug-19,3718,3594,124,3.3
18714,CN4819500000000,48,195,"Hansford County, TX",Aug-19,2809,2742,67,2.4
18715,CN4819700000000,48,197,"Hardeman County, TX",Aug-19,1747,1691,56,3.2
18716,CN4819900000000,48,199,"Hardin County, TX",Aug-19,25104,23862,1242,4.9
18717,CN4820100000000,48,201,"Harris County, TX",Aug-19,2308787,2214712,94075,4.1
18718,CN4820300000000,48,203,"Harrison County, TX",Aug-19,29320,28081,1239,4.2
18719,CN4820500000000,48,205,"Hartley County, TX",Aug-19,2866,2816,50,1.7
18720,CN4820700000000,48,207,"Haskell County, TX",Aug-19,2328,2249,79,3.4
18721,CN4820900000000,48,209,"Hays County, TX",Aug-19,119765,116237,3528,2.9
18722,CN4821100000000,48,211,"Hemphill County, TX",Aug-19,1941,1884,57,2.9
18723,CN4821300000000,48,213,"Henderson County, TX",Aug-19,36485,35136,1349,3.7
18724,CN4821500000000,48,215,"Hidalgo County, TX",Aug-19,351616,328460,23156,6.6
18725,CN4821700000000,48,217,"Hill County, TX",Aug-19,16564,15983,581,3.5
18726,CN4821900000000,48,219,"Hockley County, TX",Aug-19,11294,10940,354,3.1
18727,CN4822100000000,48,221,"Hood County, TX",Aug-19,27635,26627,1008,3.6
18728,CN4822300000000,48,223,"Hopkins County, TX",Aug-19,17607,17044,563,3.2
18729,CN4822500000000,48,225,"Houston County, TX",Aug-19,10590,10226,364,3.4
18730,CN4822700000000,48,227,"Howard County, TX",Aug-19,14115,13648,467,3.3
18731,CN4822900000000,48,229,"Hudspeth County, TX",Aug-19,1865,1777,88,4.7
18732,CN4823100000000,48,231,"Hunt County, TX",Aug-19,43580,41944,1636,3.8
18733,CN4823300000000,48,233,"Hutchinson County, TX",Aug-19,8710,8265,445,5.1
18734,CN4823500000000,48,235,"Irion County, TX",Aug-19,771,752,19,2.5
18735,CN4823700000000,48,237,"Jack County, TX",Aug-19,3530,3416,114,3.2
18736,CN4823900000000,48,239,"Jackson County, TX",Aug-19,7733,7502,231,3.0
18737,CN4824100000000,48,241,"Jasper County, TX",Aug-19,12842,12007,835,6.5
18738,CN4824300000000,48,243,"Jeff Davis County, TX",Aug-19,1071,1037,34,3.2
18739,CN4824500000000,48,245,"Jefferson County, TX",Aug-19,106426,99534,6892,6.5
18740,CN4824700000000,48,247,"Jim Hogg County, TX",Aug-19,1854,1763,91,4.9
18741,CN4824900000000,48,249,"Jim Wells County, TX",Aug-19,16715,15888,827,4.9
18742,CN4825100000000,48,251,"Johnson County, TX",Aug-19,82196,79383,2813,3.4
18743,CN4825300000000,48,253,"Jones County, TX",Aug-19,5793,5525,268,4.6
18744,CN4825500000000,48,255,"Karnes County, TX",Aug-19,7181,6995,186,2.6
18745,CN4825700000000,48,257,"Kaufman County, TX",Aug-19,64765,62530,2235,3.5
18746,CN4825900000000,48,259,"Kendall County, TX",Aug-19,22222,21583,639,2.9
18747,CN4826100000000,48,261,"Kenedy County, TX",Aug-19,215,206,9,4.2
18748,CN4826300000000,48,263,"Kent County, TX",Aug-19,502,492,10,2.0
18749,CN4826500000000,48,265,"Kerr County, TX",Aug-19,22206,21497,709,3.2
18750,CN4826700000000,48,267,"Kimble County, TX",Aug-19,1945,1884,61,3.1
18751,CN4826900000000,48,269,"King County, TX",Aug-19,250,244,6,2.4
18752,CN4827100000000,48,271,"Kinney County, TX",Aug-19,1423,1378,45,3.2
18753,CN4827300000000,48,273,"Kleberg County, TX",Aug-19,13455,12817,638,4.7
18754,CN4827500000000,48,275,"Knox County, TX",Aug-19,1490,1439,51,3.4
18755,CN4827700000000,48,277,"Lamar County, TX",Aug-19,24235,23403,832,3.4
18756,CN4827900000000,48,279,"Lamb County, TX",Aug-19,5432,5224,208,3.8
18757,CN4828100000000,48,281,"Lampasas County, TX",Aug-19,9202,8885,317,3.4
18758,CN4828300000000,48,283,"La Salle County, TX",Aug-19,4423,4305,118,2.7
18759,CN4828500000000,48,285,"Lavaca County, TX",Aug-19,8671,8396,275,3.2
18760,CN4828700000000,48,287,"Lee County, TX",Aug-19,10144,9866,278,2.7
18761,CN4828900000000,48,289,"Leon County, TX",Aug-19,6415,6114,301,4.7
18762,CN4829100000000,48,291,"Liberty County, TX",Aug-19,33067,31301,1766,5.3
18763,CN4829300000000,48,293,"Limestone County, TX",Aug-19,8638,8290,348,4.0
18764,CN4829500000000,48,295,"Lipscomb County, TX",Aug-19,1623,1576,47,2.9
18765,CN4829700000000,48,297,"Live Oak County, TX",Aug-19,5687,5509,178,3.1
18766,CN4829900000000,48,299,"Llano County, TX",Aug-19,8951,8623,328,3.7
18767,CN4830100000000,48,301,"Loving County, TX",Aug-19,599,595,4,0.7
18768,CN4830300000000,48,303,"Lubbock County, TX",Aug-19,158118,153394,4724,3.0
18769,CN4830500000000,48,305,"Lynn County, TX",Aug-19,2841,2755,86,3.0
18770,CN4830700000000,48,307,"McCulloch County, TX",Aug-19,3433,3221,212,6.2
18771,CN4830900000000,48,309,"McLennan County, TX",Aug-19,120020,115699,4321,3.6
18772,CN4831100000000,48,311,"McMullen County, TX",Aug-19,894,878,16,1.8
18773,CN4831300000000,48,313,"Madison County, TX",Aug-19,4585,4357,228,5.0
18774,CN4831500000000,48,315,"Marion County, TX",Aug-19,4239,4053,186,4.4
18775,CN4831700000000,48,317,"Martin County, TX",Aug-19,2938,2856,82,2.8
18776,CN4831900000000,48,319,"Mason County, TX",Aug-19,1809,1752,57,3.2
18777,CN4832100000000,48,321,"Matagorda County, TX",Aug-19,16722,15669,1053,6.3
18778,CN4832300000000,48,323,"Maverick County, TX",Aug-19,23059,21464,1595,6.9
18779,CN4832500000000,48,325,"Medina County, TX",Aug-19,21896,21187,709,3.2
18780,CN4832700000000,48,327,"Menard County, TX",Aug-19,887,855,32,3.6
18781,CN4832900000000,48,329,"Midland County, TX",Aug-19,107772,105352,2420,2.2
18782,CN4833100000000,48,331,"Milam County, TX",Aug-19,9816,9345,471,4.8
18783,CN4833300000000,48,333,"Mills County, TX",Aug-19,1963,1903,60,3.1
18784,CN4833500000000,48,335,"Mitchell County, TX",Aug-19,2339,2253,86,3.7
18785,CN4833700000000,48,337,"Montague County, TX",Aug-19,9323,9042,281,3.0
18786,CN4833900000000,48,339,"Montgomery County, TX",Aug-19,283152,272818,10334,3.6
18787,CN4834100000000,48,341,"Moore County, TX",Aug-19,11063,10782,281,2.5
18788,CN4834300000000,48,343,"Morris County, TX",Aug-19,4871,4596,275,5.6
18789,CN4834500000000,48,345,"Motley County, TX",Aug-19,502,484,18,3.6
18790,CN4834700000000,48,347,"Nacogdoches County, TX",Aug-19,27962,26790,1172,4.2
18791,CN4834900000000,48,349,"Navarro County, TX",Aug-19,24276,23473,803,3.3
18792,CN4835100000000,48,351,"Newton County, TX",Aug-19,5167,4812,355,6.9
18793,CN4835300000000,48,353,"Nolan County, TX",Aug-19,7217,6992,225,3.1
18794,CN4835500000000,48,355,"Nueces County, TX",Aug-19,167056,159883,7173,4.3
18795,CN4835700000000,48,357,"Ochiltree County, TX",Aug-19,4296,4179,117,2.7
18796,CN4835900000000,48,359,"Oldham County, TX",Aug-19,932,903,29,3.1
18797,CN4836100000000,48,361,"Orange County, TX",Aug-19,36124,34082,2042,5.7
18798,CN4836300000000,48,363,"Palo Pinto County, TX",Aug-19,13575,13126,449,3.3
18799,CN4836500000000,48,365,"Panola County, TX",Aug-19,10047,9620,427,4.3
18800,CN4836700000000,48,367,"Parker County, TX",Aug-19,67381,65317,2064,3.1
18801,CN4836900000000,48,369,"Parmer County, TX",Aug-19,5042,4926,116,2.3
18802,CN4837100000000,48,371,"Pecos County, TX",Aug-19,6434,6220,214,3.3
18803,CN4837300000000,48,373,"Polk County, TX",Aug-19,17968,17087,881,4.9
18804,CN4837500000000,48,375,"Potter County, TX",Aug-19,55038,53432,1606,2.9
18805,CN4837700000000,48,377,"Presidio County, TX",Aug-19,3146,2941,205,6.5
18806,CN4837900000000,48,379,"Rains County, TX",Aug-19,5961,5766,195,3.3
18807,CN4838100000000,48,381,"Randall County, TX",Aug-19,71989,70096,1893,2.6
18808,CN4838300000000,48,383,"Reagan County, TX",Aug-19,1930,1879,51,2.6
18809,CN4838500000000,48,385,"Real County, TX",Aug-19,1136,1094,42,3.7
18810,CN4838700000000,48,387,"Red River County, TX",Aug-19,5184,4918,266,5.1
18811,CN4838900000000,48,389,"Reeves County, TX",Aug-19,11358,11150,208,1.8
18812,CN4839100000000,48,391,"Refugio County, TX",Aug-19,3169,3048,121,3.8
18813,CN4839300000000,48,393,"Roberts County, TX",Aug-19,434,421,13,3.0
18814,CN4839500000000,48,395,"Robertson County, TX",Aug-19,7453,7168,285,3.8
18815,CN4839700000000,48,397,"Rockwall County, TX",Aug-19,52223,50508,1715,3.3
18816,CN4839900000000,48,399,"Runnels County, TX",Aug-19,4646,4511,135,2.9
18817,CN4840100000000,48,401,"Rusk County, TX",Aug-19,23106,22239,867,3.8
18818,CN4840300000000,48,403,"Sabine County, TX",Aug-19,3783,3534,249,6.6
18819,CN4840500000000,48,405,"San Augustine County, TX",Aug-19,3451,3289,162,4.7
18820,CN4840700000000,48,407,"San Jacinto County, TX",Aug-19,11663,11088,575,4.9
18821,CN4840900000000,48,409,"San Patricio County, TX",Aug-19,29958,28222,1736,5.8
18822,CN4841100000000,48,411,"San Saba County, TX",Aug-19,2520,2444,76,3.0
18823,CN4841300000000,48,413,"Schleicher County, TX",Aug-19,1304,1262,42,3.2
18824,CN4841500000000,48,415,"Scurry County, TX",Aug-19,6750,6528,222,3.3
18825,CN4841700000000,48,417,"Shackelford County, TX",Aug-19,2000,1953,47,2.4
18826,CN4841900000000,48,419,"Shelby County, TX",Aug-19,11308,10840,468,4.1
18827,CN4842100000000,48,421,"Sherman County, TX",Aug-19,1404,1369,35,2.5
18828,CN4842300000000,48,423,"Smith County, TX",Aug-19,107003,103185,3818,3.6
18829,CN4842500000000,48,425,"Somervell County, TX",Aug-19,4363,4202,161,3.7
18830,CN4842700000000,48,427,"Starr County, TX",Aug-19,24796,22322,2474,10.0
18831,CN4842900000000,48,429,"Stephens County, TX",Aug-19,4045,3907,138,3.4
18832,CN4843100000000,48,431,"Sterling County, TX",Aug-19,619,600,19,3.1
18833,CN4843300000000,48,433,"Stonewall County, TX",Aug-19,623,604,19,3.0
18834,CN4843500000000,48,435,"Sutton County, TX",Aug-19,1346,1287,59,4.4
18835,CN4843700000000,48,437,"Swisher County, TX",Aug-19,2673,2569,104,3.9
18836,CN4843900000000,48,439,"Tarrant County, TX",Aug-19,1081348,1043832,37516,3.5
18837,CN4844100000000,48,441,"Taylor County, TX",Aug-19,66795,64751,2044,3.1
18838,CN4844300000000,48,443,"Terrell County, TX",Aug-19,376,361,15,4.0
18839,CN4844500000000,48,445,"Terry County, TX",Aug-19,5070,4883,187,3.7
18840,CN4844700000000,48,447,"Throckmorton County, TX",Aug-19,682,651,31,4.5
18841,CN4844900000000,48,449,"Titus County, TX",Aug-19,12989,12427,562,4.3
18842,CN4845100000000,48,451,"Tom Green County, TX",Aug-19,54383,52639,1744,3.2
18843,CN4845300000000,48,453,"Travis County, TX",Aug-19,739901,719674,20227,2.7
18844,CN4845500000000,48,455,"Trinity County, TX",Aug-19,5385,5125,260,4.8
18845,CN4845700000000,48,457,"Tyler County, TX",Aug-19,7265,6825,440,6.1
18846,CN4845900000000,48,459,"Upshur County, TX",Aug-19,17947,17243,704,3.9
18847,CN4846100000000,48,461,"Upton County, TX",Aug-19,1729,1676,53,3.1
18848,CN4846300000000,48,463,"Uvalde County, TX",Aug-19,11671,11215,456,3.9
18849,CN4846500000000,48,465,"Val Verde County, TX",Aug-19,22836,22081,755,3.3
18850,CN4846700000000,48,467,"Van Zandt County, TX",Aug-19,26285,25374,911,3.5
18851,CN4846900000000,48,469,"Victoria County, TX",Aug-19,42647,41121,1526,3.6
18852,CN4847100000000,48,471,"Walker County, TX",Aug-19,24100,23054,1046,4.3
18853,CN4847300000000,48,473,"Waller County, TX",Aug-19,23479,22544,935,4.0
18854,CN4847500000000,48,475,"Ward County, TX",Aug-19,7450,7263,187,2.5
18855,CN4847700000000,48,477,"Washington County, TX",Aug-19,15220,14692,528,3.5
18856,CN4847900000000,48,479,"Webb County, TX",Aug-19,118413,113959,4454,3.8
18857,CN4848100000000,48,481,"Wharton County, TX",Aug-19,21803,21016,787,3.6
18858,CN4848300000000,48,483,"Wheeler County, TX",Aug-19,2343,2271,72,3.1
18859,CN4848500000000,48,485,"Wichita County, TX",Aug-19,56131,54251,1880,3.3
18860,CN4848700000000,48,487,"Wilbarger County, TX",Aug-19,4936,4749,187,3.8
18861,CN4848900000000,48,489,"Willacy County, TX",Aug-19,6551,6004,547,8.3
18862,CN4849100000000,48,491,"Williamson County, TX",Aug-19,313384,304103,9281,3.0
18863,CN4849300000000,48,493,"Wilson County, TX",Aug-19,24887,24154,733,2.9
18864,CN4849500000000,48,495,"Winkler County, TX",Aug-19,3992,3872,120,3.0
18865,CN4849700000000,48,497,"Wise County, TX",Aug-19,31964,30880,1084,3.4
18866,CN4849900000000,48,499,"Wood County, TX",Aug-19,17807,17090,717,4.0
18867,CN4850100000000,48,501,"Yoakum County, TX",Aug-19,3766,3652,114,3.0
18868,CN4850300000000,48,503,"Young County, TX",Aug-19,8061,7805,256,3.2
18869,CN4850500000000,48,505,"Zapata County, TX",Aug-19,4812,4569,243,5.0
18870,CN4850700000000,48,507,"Zavala County, TX",Aug-19,3347,3041,306,9.1
18871,CN4900100000000,49,1,"Beaver County, UT",Aug-19,2787,2698,89,3.2
18872,CN4900300000000,49,3,"Box Elder County, UT",Aug-19,26006,25327,679,2.6
18873,CN4900500000000,49,5,"Cache County, UT",Aug-19,61194,59742,1452,2.4
18874,CN4900700000000,49,7,"Carbon County, UT",Aug-19,8588,8289,299,3.5
18875,CN4900900000000,49,9,"Daggett County, UT",Aug-19,434,421,13,3.0
18876,CN4901100000000,49,11,"Davis County, UT",Aug-19,175542,171161,4381,2.5
18877,CN4901300000000,49,13,"Duchesne County, UT",Aug-19,7701,7401,300,3.9
18878,CN4901500000000,49,15,"Emery County, UT",Aug-19,4236,4076,160,3.8
18879,CN4901700000000,49,17,"Garfield County, UT",Aug-19,3112,3010,102,3.3
18880,CN4901900000000,49,19,"Grand County, UT",Aug-19,6778,6633,145,2.1
18881,CN4902100000000,49,21,"Iron County, UT",Aug-19,23466,22751,715,3.0
18882,CN4902300000000,49,23,"Juab County, UT",Aug-19,5678,5543,135,2.4
18883,CN4902500000000,49,25,"Kane County, UT",Aug-19,4176,4077,99,2.4
18884,CN4902700000000,49,27,"Millard County, UT",Aug-19,5997,5836,161,2.7
18885,CN4902900000000,49,29,"Morgan County, UT",Aug-19,5613,5472,141,2.5
18886,CN4903100000000,49,31,"Piute County, UT",Aug-19,463,441,22,4.8
18887,CN4903300000000,49,33,"Rich County, UT",Aug-19,1529,1499,30,2.0
18888,CN4903500000000,49,35,"Salt Lake County, UT",Aug-19,641093,624581,16512,2.6
18889,CN4903700000000,49,37,"San Juan County, UT",Aug-19,5900,5648,252,4.3
18890,CN4903900000000,49,39,"Sanpete County, UT",Aug-19,12149,11758,391,3.2
18891,CN4904100000000,49,41,"Sevier County, UT",Aug-19,9744,9473,271,2.8
18892,CN4904300000000,49,43,"Summit County, UT",Aug-19,24793,24206,587,2.4
18893,CN4904500000000,49,45,"Tooele County, UT",Aug-19,34298,33284,1014,3.0
18894,CN4904700000000,49,47,"Uintah County, UT",Aug-19,13828,13268,560,4.0
18895,CN4904900000000,49,49,"Utah County, UT",Aug-19,306532,298885,7647,2.5
18896,CN4905100000000,49,51,"Wasatch County, UT",Aug-19,16509,16071,438,2.7
18897,CN4905300000000,49,53,"Washington County, UT",Aug-19,77311,74913,2398,3.1
18898,CN4905500000000,49,55,"Wayne County, UT",Aug-19,1510,1460,50,3.3
18899,CN4905700000000,49,57,"Weber County, UT",Aug-19,128434,124755,3679,2.9
18900,CN5000100000000,50,1,"Addison County, VT",Aug-19,20899,20439,460,2.2
18901,CN5000300000000,50,3,"Bennington County, VT",Aug-19,18002,17494,508,2.8
18902,CN5000500000000,50,5,"Caledonia County, VT",Aug-19,14580,14176,404,2.8
18903,CN5000700000000,50,7,"Chittenden County, VT",Aug-19,97787,95943,1844,1.9
18904,CN5000900000000,50,9,"Essex County, VT",Aug-19,2716,2633,83,3.1
18905,CN5001100000000,50,11,"Franklin County, VT",Aug-19,27444,26769,675,2.5
18906,CN5001300000000,50,13,"Grand Isle County, VT",Aug-19,4077,3975,102,2.5
18907,CN5001500000000,50,15,"Lamoille County, VT",Aug-19,13917,13574,343,2.5
18908,CN5001700000000,50,17,"Orange County, VT",Aug-19,16056,15736,320,2.0
18909,CN5001900000000,50,19,"Orleans County, VT",Aug-19,12943,12441,502,3.9
18910,CN5002100000000,50,21,"Rutland County, VT",Aug-19,30734,29899,835,2.7
18911,CN5002300000000,50,23,"Washington County, VT",Aug-19,34517,33848,669,1.9
18912,CN5002500000000,50,25,"Windham County, VT",Aug-19,21821,21278,543,2.5
18913,CN5002700000000,50,27,"Windsor County, VT",Aug-19,28873,28250,623,2.2
18914,CN5100100000000,51,1,"Accomack County, VA",Aug-19,17105,16545,560,3.3
18915,CN5100300000000,51,3,"Albemarle County, VA",Aug-19,56785,55231,1554,2.7
18916,CN5100500000000,51,5,"Alleghany County, VA",Aug-19,6833,6591,242,3.5
18917,CN5100700000000,51,7,"Amelia County, VA",Aug-19,6354,6152,202,3.2
18918,CN5100900000000,51,9,"Amherst County, VA",Aug-19,15151,14629,522,3.4
18919,CN5101100000000,51,11,"Appomattox County, VA",Aug-19,7222,6959,263,3.6
18920,CN5101300000000,51,13,"Arlington County, VA",Aug-19,156045,152907,3138,2.0
18921,CN5101500000000,51,15,"Augusta County, VA",Aug-19,37609,36646,963,2.6
18922,CN5101700000000,51,17,"Bath County, VA",Aug-19,2571,2505,66,2.6
18923,CN5101900000000,51,19,"Bedford County, VA",Aug-19,38719,37541,1178,3.0
18924,CN5102100000000,51,21,"Bland County, VA",Aug-19,2803,2728,75,2.7
18925,CN5102300000000,51,23,"Botetourt County, VA",Aug-19,17605,17123,482,2.7
18926,CN5102500000000,51,25,"Brunswick County, VA",Aug-19,6004,5713,291,4.8
18927,CN5102700000000,51,27,"Buchanan County, VA",Aug-19,6650,6226,424,6.4
18928,CN5102900000000,51,29,"Buckingham County, VA",Aug-19,6367,6107,260,4.1
18929,CN5103100000000,51,31,"Campbell County, VA",Aug-19,26159,25292,867,3.3
18930,CN5103300000000,51,33,"Caroline County, VA",Aug-19,15415,14888,527,3.4
18931,CN5103500000000,51,35,"Carroll County, VA",Aug-19,13184,12717,467,3.5
18932,CN5103600000000,51,36,"Charles City County, VA",Aug-19,3704,3580,124,3.3
18933,CN5103700000000,51,37,"Charlotte County, VA",Aug-19,5283,5089,194,3.7
18934,CN5104100000000,51,41,"Chesterfield County, VA",Aug-19,189326,183737,5589,3.0
18935,CN5104300000000,51,43,"Clarke County, VA",Aug-19,7716,7522,194,2.5
18936,CN5104500000000,51,45,"Craig County, VA",Aug-19,2327,2250,77,3.3
18937,CN5104700000000,51,47,"Culpeper County, VA",Aug-19,24938,24267,671,2.7
18938,CN5104900000000,51,49,"Cumberland County, VA",Aug-19,4676,4524,152,3.3
18939,CN5105100000000,51,51,"Dickenson County, VA",Aug-19,4684,4456,228,4.9
18940,CN5105300000000,51,53,"Dinwiddie County, VA",Aug-19,13819,13349,470,3.4
18941,CN5105700000000,51,57,"Essex County, VA",Aug-19,5520,5321,199,3.6
18942,CN5105900000000,51,59,"Fairfax County, VA",Aug-19,642476,626970,15506,2.4
18943,CN5106100000000,51,61,"Fauquier County, VA",Aug-19,37789,36837,952,2.5
18944,CN5106300000000,51,63,"Floyd County, VA",Aug-19,8254,8047,207,2.5
18945,CN5106500000000,51,65,"Fluvanna County, VA",Aug-19,13783,13427,356,2.6
18946,CN5106700000000,51,67,"Franklin County, VA",Aug-19,26675,25890,785,2.9
18947,CN5106900000000,51,69,"Frederick County, VA",Aug-19,48785,47562,1223,2.5
18948,CN5107100000000,51,71,"Giles County, VA",Aug-19,7891,7650,241,3.1
18949,CN5107300000000,51,73,"Gloucester County, VA",Aug-19,19881,19354,527,2.7
18950,CN5107500000000,51,75,"Goochland County, VA",Aug-19,11336,11009,327,2.9
18951,CN5107700000000,51,77,"Grayson County, VA",Aug-19,7808,7570,238,3.0
18952,CN5107900000000,51,79,"Greene County, VA",Aug-19,10415,10145,270,2.6
18953,CN5108100000000,51,81,"Greensville County, VA",Aug-19,4305,4151,154,3.6
18954,CN5108300000000,51,83,"Halifax County, VA",Aug-19,15690,15017,673,4.3
18955,CN5108500000000,51,85,"Hanover County, VA",Aug-19,59839,58285,1554,2.6
18956,CN5108700000000,51,87,"Henrico County, VA",Aug-19,183788,178236,5552,3.0
18957,CN5108900000000,51,89,"Henry County, VA",Aug-19,24065,23243,822,3.4
18958,CN5109100000000,51,91,"Highland County, VA",Aug-19,1292,1258,34,2.6
18959,CN5109300000000,51,93,"Isle of Wight County, VA",Aug-19,19763,19179,584,3.0
18960,CN5109500000000,51,95,"James City County, VA",Aug-19,37150,36100,1050,2.8
18961,CN5109700000000,51,97,"King and Queen County, VA",Aug-19,3851,3737,114,3.0
18962,CN5109900000000,51,99,"King George County, VA",Aug-19,13608,13245,363,2.7
18963,CN5110100000000,51,101,"King William County, VA",Aug-19,9254,8992,262,2.8
18964,CN5110300000000,51,103,"Lancaster County, VA",Aug-19,5522,5336,186,3.4
18965,CN5110500000000,51,105,"Lee County, VA",Aug-19,8307,7888,419,5.0
18966,CN5110700000000,51,107,"Loudoun County, VA",Aug-19,225159,219666,5493,2.4
18967,CN5110900000000,51,109,"Louisa County, VA",Aug-19,20077,19517,560,2.8
18968,CN5111100000000,51,111,"Lunenburg County, VA",Aug-19,5306,5115,191,3.6
18969,CN5111300000000,51,113,"Madison County, VA",Aug-19,7438,7261,177,2.4
18970,CN5111500000000,51,115,"Mathews County, VA",Aug-19,4203,4078,125,3.0
18971,CN5111700000000,51,117,"Mecklenburg County, VA",Aug-19,12387,11856,531,4.3
18972,CN5111900000000,51,119,"Middlesex County, VA",Aug-19,5450,5307,143,2.6
18973,CN5112100000000,51,121,"Montgomery County, VA",Aug-19,50206,48695,1511,3.0
18974,CN5112500000000,51,125,"Nelson County, VA",Aug-19,7429,7209,220,3.0
18975,CN5112700000000,51,127,"New Kent County, VA",Aug-19,12604,12286,318,2.5
18976,CN5113100000000,51,131,"Northampton County, VA",Aug-19,5779,5543,236,4.1
18977,CN5113300000000,51,133,"Northumberland County, VA",Aug-19,5745,5544,201,3.5
18978,CN5113500000000,51,135,"Nottoway County, VA",Aug-19,7242,7038,204,2.8
18979,CN5113700000000,51,137,"Orange County, VA",Aug-19,17592,17029,563,3.2
18980,CN5113900000000,51,139,"Page County, VA",Aug-19,12066,11682,384,3.2
18981,CN5114100000000,51,141,"Patrick County, VA",Aug-19,7239,6981,258,3.6
18982,CN5114300000000,51,143,"Pittsylvania County, VA",Aug-19,30025,28958,1067,3.6
18983,CN5114500000000,51,145,"Powhatan County, VA",Aug-19,14289,13896,393,2.8
18984,CN5114700000000,51,147,"Prince Edward County, VA",Aug-19,10465,10049,416,4.0
18985,CN5114900000000,51,149,"Prince George County, VA",Aug-19,15248,14694,554,3.6
18986,CN5115300000000,51,153,"Prince William County, VA",Aug-19,248340,241733,6607,2.7
18987,CN5115500000000,51,155,"Pulaski County, VA",Aug-19,16064,15520,544,3.4
18988,CN5115700000000,51,157,"Rappahannock County, VA",Aug-19,3761,3661,100,2.7
18989,CN5115900000000,51,159,"Richmond County, VA",Aug-19,4124,4002,122,3.0
18990,CN5116100000000,51,161,"Roanoke County, VA",Aug-19,49824,48488,1336,2.7
18991,CN5116300000000,51,163,"Rockbridge County, VA",Aug-19,11006,10698,308,2.8
18992,CN5116500000000,51,165,"Rockingham County, VA",Aug-19,41216,40158,1058,2.6
18993,CN5116700000000,51,167,"Russell County, VA",Aug-19,11083,10592,491,4.4
18994,CN5116900000000,51,169,"Scott County, VA",Aug-19,9192,8895,297,3.2
18995,CN5117100000000,51,171,"Shenandoah County, VA",Aug-19,22621,22035,586,2.6
18996,CN5117300000000,51,173,"Smyth County, VA",Aug-19,13961,13425,536,3.8
18997,CN5117500000000,51,175,"Southampton County, VA",Aug-19,9260,8977,283,3.1
18998,CN5117700000000,51,177,"Spotsylvania County, VA",Aug-19,67867,65785,2082,3.1
18999,CN5117900000000,51,179,"Stafford County, VA",Aug-19,72837,70753,2084,2.9
19000,CN5118100000000,51,181,"Surry County, VA",Aug-19,3733,3584,149,4.0
19001,CN5118300000000,51,183,"Sussex County, VA",Aug-19,3883,3708,175,4.5
19002,CN5118500000000,51,185,"Tazewell County, VA",Aug-19,15365,14668,697,4.5
19003,CN5118700000000,51,187,"Warren County, VA",Aug-19,20684,20074,610,2.9
19004,CN5119100000000,51,191,"Washington County, VA",Aug-19,26894,25989,905,3.4
19005,CN5119300000000,51,193,"Westmoreland County, VA",Aug-19,9657,9328,329,3.4
19006,CN5119500000000,51,195,"Wise County, VA",Aug-19,13331,12654,677,5.1
19007,CN5119700000000,51,197,"Wythe County, VA",Aug-19,13840,13379,461,3.3
19008,CN5119900000000,51,199,"York County, VA",Aug-19,33210,32306,904,2.7
19009,CN5151000000000,51,510,"Alexandria city, VA",Aug-19,102455,100169,2286,2.2
19010,CN5152000000000,51,520,"Bristol city, VA",Aug-19,7240,6957,283,3.9
19011,CN5153000000000,51,530,"Buena Vista city, VA",Aug-19,3437,3341,96,2.8
19012,CN5154000000000,51,540,"Charlottesville city, VA",Aug-19,26169,25469,700,2.7
19013,CN5155000000000,51,550,"Chesapeake city, VA",Aug-19,124559,120700,3859,3.1
19014,CN5157000000000,51,570,"Colonial Heights city, VA",Aug-19,8883,8588,295,3.3
19015,CN5158000000000,51,580,"Covington city, VA",Aug-19,2374,2262,112,4.7
19016,CN5159000000000,51,590,"Danville city, VA",Aug-19,19164,18148,1016,5.3
19017,CN5159500000000,51,595,"Emporia city, VA",Aug-19,2312,2190,122,5.3
19018,CN5160000000000,51,600,"Fairfax city, VA",Aug-19,13587,13296,291,2.1
19019,CN5161000000000,51,610,"Falls Church city, VA",Aug-19,8699,8506,193,2.2
19020,CN5162000000000,51,620,"Franklin city, VA",Aug-19,3644,3492,152,4.2
19021,CN5163000000000,51,630,"Fredericksburg city, VA",Aug-19,14313,13807,506,3.5
19022,CN5164000000000,51,640,"Galax city, VA",Aug-19,2919,2818,101,3.5
19023,CN5165000000000,51,650,"Hampton city, VA",Aug-19,65303,62728,2575,3.9
19024,CN5166000000000,51,660,"Harrisonburg city, VA",Aug-19,24486,23614,872,3.6
19025,CN5167000000000,51,670,"Hopewell city, VA",Aug-19,9773,9333,440,4.5
19026,CN5167800000000,51,678,"Lexington city, VA",Aug-19,2074,1971,103,5.0
19027,CN5168000000000,51,680,"Lynchburg city, VA",Aug-19,36582,35129,1453,4.0
19028,CN5168300000000,51,683,"Manassas city, VA",Aug-19,22290,21711,579,2.6
19029,CN5168500000000,51,685,"Manassas Park city, VA",Aug-19,9469,9239,230,2.4
19030,CN5169000000000,51,690,"Martinsville city, VA",Aug-19,5559,5301,258,4.6
19031,CN5170000000000,51,700,"Newport News city, VA",Aug-19,90065,86811,3254,3.6
19032,CN5171000000000,51,710,"Norfolk city, VA",Aug-19,113288,109114,4174,3.7
19033,CN5172000000000,51,720,"Norton city, VA",Aug-19,1681,1617,64,3.8
19034,CN5173000000000,51,730,"Petersburg city, VA",Aug-19,13154,12388,766,5.8
19035,CN5173500000000,51,735,"Poquoson city, VA",Aug-19,6490,6326,164,2.5
19036,CN5174000000000,51,740,"Portsmouth city, VA",Aug-19,44907,43082,1825,4.1
19037,CN5175000000000,51,750,"Radford city, VA",Aug-19,8675,8327,348,4.0
19038,CN5176000000000,51,760,"Richmond city, VA",Aug-19,119539,115300,4239,3.5
19039,CN5177000000000,51,770,"Roanoke city, VA",Aug-19,49683,48031,1652,3.3
19040,CN5177500000000,51,775,"Salem city, VA",Aug-19,13099,12707,392,3.0
19041,CN5179000000000,51,790,"Staunton city, VA",Aug-19,12245,11892,353,2.9
19042,CN5180000000000,51,800,"Suffolk city, VA",Aug-19,45305,43839,1466,3.2
19043,CN5181000000000,51,810,"Virginia Beach city, VA",Aug-19,236402,229663,6739,2.9
19044,CN5182000000000,51,820,"Waynesboro city, VA",Aug-19,10695,10361,334,3.1
19045,CN5183000000000,51,830,"Williamsburg city, VA",Aug-19,6801,6512,289,4.2
19046,CN5184000000000,51,840,"Winchester city, VA",Aug-19,15004,14585,419,2.8
19047,CN5300100000000,53,1,"Adams County, WA",Aug-19,11034,10588,446,4.0
19048,CN5300300000000,53,3,"Asotin County, WA",Aug-19,10279,9881,398,3.9
19049,CN5300500000000,53,5,"Benton County, WA",Aug-19,104121,99190,4931,4.7
19050,CN5300700000000,53,7,"Chelan County, WA",Aug-19,47696,45644,2052,4.3
19051,CN5300900000000,53,9,"Clallam County, WA",Aug-19,28959,27197,1762,6.1
19052,CN5301100000000,53,11,"Clark County, WA",Aug-19,240864,229108,11756,4.9
19053,CN5301300000000,53,13,"Columbia County, WA",Aug-19,1852,1765,87,4.7
19054,CN5301500000000,53,15,"Cowlitz County, WA",Aug-19,47709,44864,2845,6.0
19055,CN5301700000000,53,17,"Douglas County, WA",Aug-19,22419,21220,1199,5.3
19056,CN5301900000000,53,19,"Ferry County, WA",Aug-19,2495,2254,241,9.7
19057,CN5302100000000,53,21,"Franklin County, WA",Aug-19,45219,42870,2349,5.2
19058,CN5302300000000,53,23,"Garfield County, WA",Aug-19,965,923,42,4.4
19059,CN5302500000000,53,25,"Grant County, WA",Aug-19,49109,46309,2800,5.7
19060,CN5302700000000,53,27,"Grays Harbor County, WA",Aug-19,28896,27014,1882,6.5
19061,CN5302900000000,53,29,"Island County, WA",Aug-19,36015,34185,1830,5.1
19062,CN5303100000000,53,31,"Jefferson County, WA",Aug-19,13091,12390,701,5.4
19063,CN5303300000000,53,33,"King County, WA",Aug-19,1297538,1261969,35569,2.7
19064,CN5303500000000,53,35,"Kitsap County, WA",Aug-19,128041,122293,5748,4.5
19065,CN5303700000000,53,37,"Kittitas County, WA",Aug-19,21585,20438,1147,5.3
19066,CN5303900000000,53,39,"Klickitat County, WA",Aug-19,10832,10288,544,5.0
19067,CN5304100000000,53,41,"Lewis County, WA",Aug-19,35169,33107,2062,5.9
19068,CN5304300000000,53,43,"Lincoln County, WA",Aug-19,5218,4996,222,4.3
19069,CN5304500000000,53,45,"Mason County, WA",Aug-19,24984,23505,1479,5.9
19070,CN5304700000000,53,47,"Okanogan County, WA",Aug-19,21803,20630,1173,5.4
19071,CN5304900000000,53,49,"Pacific County, WA",Aug-19,8950,8406,544,6.1
19072,CN5305100000000,53,51,"Pend Oreille County, WA",Aug-19,5059,4633,426,8.4
19073,CN5305300000000,53,53,"Pierce County, WA",Aug-19,440461,418147,22314,5.1
19074,CN5305500000000,53,55,"San Juan County, WA",Aug-19,9714,9427,287,3.0
19075,CN5305700000000,53,57,"Skagit County, WA",Aug-19,63724,60373,3351,5.3
19076,CN5305900000000,53,59,"Skamania County, WA",Aug-19,5545,5239,306,5.5
19077,CN5306100000000,53,61,"Snohomish County, WA",Aug-19,442018,428834,13184,3.0
19078,CN5306300000000,53,63,"Spokane County, WA",Aug-19,251787,239196,12591,5.0
19079,CN5306500000000,53,65,"Stevens County, WA",Aug-19,18751,17613,1138,6.1
19080,CN5306700000000,53,67,"Thurston County, WA",Aug-19,141325,134594,6731,4.8
19081,CN5306900000000,53,69,"Wahkiakum County, WA",Aug-19,1366,1286,80,5.9
19082,CN5307100000000,53,71,"Walla Walla County, WA",Aug-19,30254,28837,1417,4.7
19083,CN5307300000000,53,73,"Whatcom County, WA",Aug-19,114378,108647,5731,5.0
19084,CN5307500000000,53,75,"Whitman County, WA",Aug-19,24190,23110,1080,4.5
19085,CN5307700000000,53,77,"Yakima County, WA",Aug-19,137152,128750,8402,6.1
19086,CN5400100000000,54,1,"Barbour County, WV",Aug-19,6931,6535,396,5.7
19087,CN5400300000000,54,3,"Berkeley County, WV",Aug-19,58730,56551,2179,3.7
19088,CN5400500000000,54,5,"Boone County, WV",Aug-19,7533,7126,407,5.4
19089,CN5400700000000,54,7,"Braxton County, WV",Aug-19,5254,4927,327,6.2
19090,CN5400900000000,54,9,"Brooke County, WV",Aug-19,10138,9639,499,4.9
19091,CN5401100000000,54,11,"Cabell County, WV",Aug-19,41907,40106,1801,4.3
19092,CN5401300000000,54,13,"Calhoun County, WV",Aug-19,2425,2168,257,10.6
19093,CN5401500000000,54,15,"Clay County, WV",Aug-19,3154,2926,228,7.2
19094,CN5401700000000,54,17,"Doddridge County, WV",Aug-19,4072,3903,169,4.2
19095,CN5401900000000,54,19,"Fayette County, WV",Aug-19,16452,15567,885,5.4
19096,CN5402100000000,54,21,"Gilmer County, WV",Aug-19,2320,2185,135,5.8
19097,CN5402300000000,54,23,"Grant County, WV",Aug-19,6089,5772,317,5.2
19098,CN5402500000000,54,25,"Greenbrier County, WV",Aug-19,16837,16152,685,4.1
19099,CN5402700000000,54,27,"Hampshire County, WV",Aug-19,11041,10618,423,3.8
19100,CN5402900000000,54,29,"Hancock County, WV",Aug-19,13255,12589,666,5.0
19101,CN5403100000000,54,31,"Hardy County, WV",Aug-19,5785,5515,270,4.7
19102,CN5403300000000,54,33,"Harrison County, WV",Aug-19,34848,33352,1496,4.3
19103,CN5403500000000,54,35,"Jackson County, WV",Aug-19,13908,13275,633,4.6
19104,CN5403700000000,54,37,"Jefferson County, WV",Aug-19,30612,29579,1033,3.4
19105,CN5403900000000,54,39,"Kanawha County, WV",Aug-19,83468,79641,3827,4.6
19106,CN5404100000000,54,41,"Lewis County, WV",Aug-19,6936,6536,400,5.8
19107,CN5404300000000,54,43,"Lincoln County, WV",Aug-19,7220,6793,427,5.9
19108,CN5404500000000,54,45,"Logan County, WV",Aug-19,11151,10486,665,6.0
19109,CN5404700000000,54,47,"McDowell County, WV",Aug-19,4449,4065,384,8.6
19110,CN5404900000000,54,49,"Marion County, WV",Aug-19,25481,24208,1273,5.0
19111,CN5405100000000,54,51,"Marshall County, WV",Aug-19,14213,13417,796,5.6
19112,CN5405300000000,54,53,"Mason County, WV",Aug-19,10039,9374,665,6.6
19113,CN5405500000000,54,55,"Mercer County, WV",Aug-19,20585,19358,1227,6.0
19114,CN5405700000000,54,57,"Mineral County, WV",Aug-19,12828,11963,865,6.7
19115,CN5405900000000,54,59,"Mingo County, WV",Aug-19,6878,6388,490,7.1
19116,CN5406100000000,54,61,"Monongalia County, WV",Aug-19,54997,52939,2058,3.7
19117,CN5406300000000,54,63,"Monroe County, WV",Aug-19,6057,5808,249,4.1
19118,CN5406500000000,54,65,"Morgan County, WV",Aug-19,8389,8069,320,3.8
19119,CN5406700000000,54,67,"Nicholas County, WV",Aug-19,9595,9050,545,5.7
19120,CN5406900000000,54,69,"Ohio County, WV",Aug-19,21377,20478,899,4.2
19121,CN5407100000000,54,71,"Pendleton County, WV",Aug-19,3729,3599,130,3.5
19122,CN5407300000000,54,73,"Pleasants County, WV",Aug-19,2840,2665,175,6.2
19123,CN5407500000000,54,75,"Pocahontas County, WV",Aug-19,3859,3690,169,4.4
19124,CN5407700000000,54,77,"Preston County, WV",Aug-19,15755,15081,674,4.3
19125,CN5407900000000,54,79,"Putnam County, WV",Aug-19,26914,25786,1128,4.2
19126,CN5408100000000,54,81,"Raleigh County, WV",Aug-19,30862,29449,1413,4.6
19127,CN5408300000000,54,83,"Randolph County, WV",Aug-19,12417,11757,660,5.3
19128,CN5408500000000,54,85,"Ritchie County, WV",Aug-19,4399,4198,201,4.6
19129,CN5408700000000,54,87,"Roane County, WV",Aug-19,5090,4714,376,7.4
19130,CN5408900000000,54,89,"Summers County, WV",Aug-19,4447,4219,228,5.1
19131,CN5409100000000,54,91,"Taylor County, WV",Aug-19,7946,7563,383,4.8
19132,CN5409300000000,54,93,"Tucker County, WV",Aug-19,3393,3243,150,4.4
19133,CN5409500000000,54,95,"Tyler County, WV",Aug-19,3125,2895,230,7.4
19134,CN5409700000000,54,97,"Upshur County, WV",Aug-19,9620,9053,567,5.9
19135,CN5409900000000,54,99,"Wayne County, WV",Aug-19,15888,15061,827,5.2
19136,CN5410100000000,54,101,"Webster County, WV",Aug-19,3392,3202,190,5.6
19137,CN5410300000000,54,103,"Wetzel County, WV",Aug-19,6615,6173,442,6.7
19138,CN5410500000000,54,105,"Wirt County, WV",Aug-19,2305,2148,157,6.8
19139,CN5410700000000,54,107,"Wood County, WV",Aug-19,36998,35175,1823,4.9
19140,CN5410900000000,54,109,"Wyoming County, WV",Aug-19,6633,6198,435,6.6
19141,CN5500100000000,55,1,"Adams County, WI",Aug-19,8278,7900,378,4.6
19142,CN5500300000000,55,3,"Ashland County, WI",Aug-19,8290,7888,402,4.8
19143,CN5500500000000,55,5,"Barron County, WI",Aug-19,24252,23457,795,3.3
19144,CN5500700000000,55,7,"Bayfield County, WI",Aug-19,7891,7501,390,4.9
19145,CN5500900000000,55,9,"Brown County, WI",Aug-19,142281,137667,4614,3.2
19146,CN5501100000000,55,11,"Buffalo County, WI",Aug-19,6363,6117,246,3.9
19147,CN5501300000000,55,13,"Burnett County, WI",Aug-19,7183,6843,340,4.7
19148,CN5501500000000,55,15,"Calumet County, WI",Aug-19,27731,26900,831,3.0
19149,CN5501700000000,55,17,"Chippewa County, WI",Aug-19,32826,31769,1057,3.2
19150,CN5501900000000,55,19,"Clark County, WI",Aug-19,17418,16886,532,3.1
19151,CN5502100000000,55,21,"Columbia County, WI",Aug-19,31632,30676,956,3.0
19152,CN5502300000000,55,23,"Crawford County, WI",Aug-19,7544,7262,282,3.7
19153,CN5502500000000,55,25,"Dane County, WI",Aug-19,323442,315396,8046,2.5
19154,CN5502700000000,55,27,"Dodge County, WI",Aug-19,47892,46464,1428,3.0
19155,CN5502900000000,55,29,"Door County, WI",Aug-19,16988,16540,448,2.6
19156,CN5503100000000,55,31,"Douglas County, WI",Aug-19,22810,21861,949,4.2
19157,CN5503300000000,55,33,"Dunn County, WI",Aug-19,22795,22010,785,3.4
19158,CN5503500000000,55,35,"Eau Claire County, WI",Aug-19,58834,56910,1924,3.3
19159,CN5503700000000,55,37,"Florence County, WI",Aug-19,2222,2128,94,4.2
19160,CN5503900000000,55,39,"Fond du Lac County, WI",Aug-19,57481,55591,1890,3.3
19161,CN5504100000000,55,41,"Forest County, WI",Aug-19,3982,3794,188,4.7
19162,CN5504300000000,55,43,"Grant County, WI",Aug-19,26529,25674,855,3.2
19163,CN5504500000000,55,45,"Green County, WI",Aug-19,21015,20451,564,2.7
19164,CN5504700000000,55,47,"Green Lake County, WI",Aug-19,9610,9263,347,3.6
19165,CN5504900000000,55,49,"Iowa County, WI",Aug-19,13659,13319,340,2.5
19166,CN5505100000000,55,51,"Iron County, WI",Aug-19,2563,2411,152,5.9
19167,CN5505300000000,55,53,"Jackson County, WI",Aug-19,10318,9981,337,3.3
19168,CN5505500000000,55,55,"Jefferson County, WI",Aug-19,46117,44708,1409,3.1
19169,CN5505700000000,55,57,"Juneau County, WI",Aug-19,13452,13040,412,3.1
19170,CN5505900000000,55,59,"Kenosha County, WI",Aug-19,90588,86692,3896,4.3
19171,CN5506100000000,55,61,"Kewaunee County, WI",Aug-19,10979,10635,344,3.1
19172,CN5506300000000,55,63,"La Crosse County, WI",Aug-19,65628,63733,1895,2.9
19173,CN5506500000000,55,65,"Lafayette County, WI",Aug-19,9855,9585,270,2.7
19174,CN5506700000000,55,67,"Langlade County, WI",Aug-19,9241,8897,344,3.7
19175,CN5506900000000,55,69,"Lincoln County, WI",Aug-19,15274,14662,612,4.0
19176,CN5507100000000,55,71,"Manitowoc County, WI",Aug-19,40964,39642,1322,3.2
19177,CN5507300000000,55,73,"Marathon County, WI",Aug-19,73651,71496,2155,2.9
19178,CN5507500000000,55,75,"Marinette County, WI",Aug-19,19533,18587,946,4.8
19179,CN5507700000000,55,77,"Marquette County, WI",Aug-19,7728,7473,255,3.3
19180,CN5507800000000,55,78,"Menominee County, WI",Aug-19,1719,1483,236,13.7
19181,CN5507900000000,55,79,"Milwaukee County, WI",Aug-19,471633,450677,20956,4.4
19182,CN5508100000000,55,81,"Monroe County, WI",Aug-19,23431,22778,653,2.8
19183,CN5508300000000,55,83,"Oconto County, WI",Aug-19,20522,19833,689,3.4
19184,CN5508500000000,55,85,"Oneida County, WI",Aug-19,18664,17958,706,3.8
19185,CN5508700000000,55,87,"Outagamie County, WI",Aug-19,103788,100698,3090,3.0
19186,CN5508900000000,55,89,"Ozaukee County, WI",Aug-19,49457,47935,1522,3.1
19187,CN5509100000000,55,91,"Pepin County, WI",Aug-19,4145,4017,128,3.1
19188,CN5509300000000,55,93,"Pierce County, WI",Aug-19,25400,24653,747,2.9
19189,CN5509500000000,55,95,"Polk County, WI",Aug-19,24315,23559,756,3.1
19190,CN5509700000000,55,97,"Portage County, WI",Aug-19,37707,36537,1170,3.1
19191,CN5509900000000,55,99,"Price County, WI",Aug-19,6512,6259,253,3.9
19192,CN5510100000000,55,101,"Racine County, WI",Aug-19,99792,95424,4368,4.4
19193,CN5510300000000,55,103,"Richland County, WI",Aug-19,9169,8882,287,3.1
19194,CN5510500000000,55,105,"Rock County, WI",Aug-19,86236,82804,3432,4.0
19195,CN5510700000000,55,107,"Rusk County, WI",Aug-19,6616,6332,284,4.3
19196,CN5510900000000,55,109,"St. Croix County, WI",Aug-19,50656,49151,1505,3.0
19197,CN5511100000000,55,111,"Sauk County, WI",Aug-19,36538,35587,951,2.6
19198,CN5511300000000,55,113,"Sawyer County, WI",Aug-19,8378,8022,356,4.2
19199,CN5511500000000,55,115,"Shawano County, WI",Aug-19,20867,20234,633,3.0
19200,CN5511700000000,55,117,"Sheboygan County, WI",Aug-19,63409,61651,1758,2.8
19201,CN5511900000000,55,119,"Taylor County, WI",Aug-19,10875,10572,303,2.8
19202,CN5512100000000,55,121,"Trempealeau County, WI",Aug-19,15712,15230,482,3.1
19203,CN5512300000000,55,123,"Vernon County, WI",Aug-19,14901,14492,409,2.7
19204,CN5512500000000,55,125,"Vilas County, WI",Aug-19,11244,10880,364,3.2
19205,CN5512700000000,55,127,"Walworth County, WI",Aug-19,57374,55462,1912,3.3
19206,CN5512900000000,55,129,"Washburn County, WI",Aug-19,8093,7794,299,3.7
19207,CN5513100000000,55,131,"Washington County, WI",Aug-19,77591,75286,2305,3.0
19208,CN5513300000000,55,133,"Waukesha County, WI",Aug-19,226414,219457,6957,3.1
19209,CN5513500000000,55,135,"Waupaca County, WI",Aug-19,26030,25233,797,3.1
19210,CN5513700000000,55,137,"Waushara County, WI",Aug-19,11284,10855,429,3.8
19211,CN5513900000000,55,139,"Winnebago County, WI",Aug-19,91648,88609,3039,3.3
19212,CN5514100000000,55,141,"Wood County, WI",Aug-19,35118,33781,1337,3.8
19213,CN5600100000000,56,1,"Albany County, WY",Aug-19,19023,18440,583,3.1
19214,CN5600300000000,56,3,"Big Horn County, WY",Aug-19,5451,5250,201,3.7
19215,CN5600500000000,56,5,"Campbell County, WY",Aug-19,23407,22405,1002,4.3
19216,CN5600700000000,56,7,"Carbon County, WY",Aug-19,8495,8282,213,2.5
19217,CN5600900000000,56,9,"Converse County, WY",Aug-19,9045,8824,221,2.4
19218,CN5601100000000,56,11,"Crook County, WY",Aug-19,3802,3690,112,2.9
19219,CN5601300000000,56,13,"Fremont County, WY",Aug-19,18580,17845,735,4.0
19220,CN5601500000000,56,15,"Goshen County, WY",Aug-19,6610,6370,240,3.6
19221,CN5601700000000,56,17,"Hot Springs County, WY",Aug-19,2196,2122,74,3.4
19222,CN5601900000000,56,19,"Johnson County, WY",Aug-19,4275,4150,125,2.9
19223,CN5602100000000,56,21,"Laramie County, WY",Aug-19,48570,46925,1645,3.4
19224,CN5602300000000,56,23,"Lincoln County, WY",Aug-19,9037,8783,254,2.8
19225,CN5602500000000,56,25,"Natrona County, WY",Aug-19,39398,37952,1446,3.7
19226,CN5602700000000,56,27,"Niobrara County, WY",Aug-19,1223,1194,29,2.4
19227,CN5602900000000,56,29,"Park County, WY",Aug-19,16759,16230,529,3.2
19228,CN5603100000000,56,31,"Platte County, WY",Aug-19,4503,4335,168,3.7
19229,CN5603300000000,56,33,"Sheridan County, WY",Aug-19,15747,15278,469,3.0
19230,CN5603500000000,56,35,"Sublette County, WY",Aug-19,4249,4086,163,3.8
19231,CN5603700000000,56,37,"Sweetwater County, WY",Aug-19,21289,20562,727,3.4
19232,CN5603900000000,56,39,"Teton County, WY",Aug-19,17714,17385,329,1.9
19233,CN5604100000000,56,41,"Uinta County, WY",Aug-19,9127,8802,325,3.6
19234,CN5604300000000,56,43,"Washakie County, WY",Aug-19,3891,3758,133,3.4
19235,CN5604500000000,56,45,"Weston County, WY",Aug-19,3749,3649,100,2.7
19236,CN7200100000000,72,1,"Adjuntas Municipio, PR",Aug-19,4044,3565,479,11.8
19237,CN7200300000000,72,3,"Aguada Municipio, PR",Aug-19,11598,10695,903,7.8
19238,CN7200500000000,72,5,"Aguadilla Municipio, PR",Aug-19,14286,13066,1220,8.5
19239,CN7200700000000,72,7,"Aguas Buenas Municipio, PR",Aug-19,6471,5955,516,8.0
19240,CN7200900000000,72,9,"Aibonito Municipio, PR",Aug-19,6430,5864,566,8.8
19241,CN7201100000000,72,11,"Anasco Municipio, PR",Aug-19,8718,8090,628,7.2
19242,CN7201300000000,72,13,"Arecibo Municipio, PR",Aug-19,23664,21763,1901,8.0
19243,CN7201500000000,72,15,"Arroyo Municipio, PR",Aug-19,4509,4002,507,11.2
19244,CN7201700000000,72,17,"Barceloneta Municipio, PR",Aug-19,5833,5266,567,9.7
19245,CN7201900000000,72,19,"Barranquitas Municipio, PR",Aug-19,7322,6753,569,7.8
19246,CN7202100000000,72,21,"Bayamon Municipio, PR",Aug-19,64733,61194,3539,5.5
19247,CN7202300000000,72,23,"Cabo Rojo Municipio, PR",Aug-19,13357,12351,1006,7.5
19248,CN7202500000000,72,25,"Caguas Municipio, PR",Aug-19,47233,44565,2668,5.6
19249,CN7202700000000,72,27,"Camuy Municipio, PR",Aug-19,9443,8735,708,7.5
19250,CN7202900000000,72,29,"Canovanas Municipio, PR",Aug-19,15923,15002,921,5.8
19251,CN7203100000000,72,31,"Carolina Municipio, PR",Aug-19,60963,57901,3062,5.0
19252,CN7203300000000,72,33,"Catano Municipio, PR",Aug-19,7753,7267,486,6.3
19253,CN7203500000000,72,35,"Cayey Municipio, PR",Aug-19,15959,14988,971,6.1
19254,CN7203700000000,72,37,"Ceiba Municipio, PR",Aug-19,3657,3335,322,8.8
19255,CN7203900000000,72,39,"Ciales Municipio, PR",Aug-19,3692,3311,381,10.3
19256,CN7204100000000,72,41,"Cidra Municipio, PR",Aug-19,15330,14460,870,5.7
19257,CN7204300000000,72,43,"Coamo Municipio, PR",Aug-19,9777,8718,1059,10.8
19258,CN7204500000000,72,45,"Comerio Municipio, PR",Aug-19,4845,4477,368,7.6
19259,CN7204700000000,72,47,"Corozal Municipio, PR",Aug-19,8870,8155,715,8.1
19260,CN7204900000000,72,49,"Culebra Municipio, PR",Aug-19,913,889,24,2.6
19261,CN7205100000000,72,51,"Dorado Municipio, PR",Aug-19,13077,12443,634,4.8
19262,CN7205300000000,72,53,"Fajardo Municipio, PR",Aug-19,10793,9818,975,9.0
19263,CN7205400000000,72,54,"Florida Municipio, PR",Aug-19,3257,2973,284,8.7
19264,CN7205500000000,72,55,"Guanica Municipio, PR",Aug-19,3917,3386,531,13.6
19265,CN7205700000000,72,57,"Guayama Municipio, PR",Aug-19,10777,9670,1107,10.3
19266,CN7205900000000,72,59,"Guayanilla Municipio, PR",Aug-19,5148,4523,625,12.1
19267,CN7206100000000,72,61,"Guaynabo Municipio, PR",Aug-19,37380,36024,1356,3.6
19268,CN7206300000000,72,63,"Gurabo Municipio, PR",Aug-19,17939,17053,886,4.9
19269,CN7206500000000,72,65,"Hatillo Municipio, PR",Aug-19,13080,11978,1102,8.4
19270,CN7206700000000,72,67,"Hormigueros Municipio, PR",Aug-19,5293,4901,392,7.4
19271,CN7206900000000,72,69,"Humacao Municipio, PR",Aug-19,16889,15492,1397,8.3
19272,CN7207100000000,72,71,"Isabela Municipio, PR",Aug-19,12183,11264,919,7.5
19273,CN7207300000000,72,73,"Jayuya Municipio, PR",Aug-19,4172,3667,505,12.1
19274,CN7207500000000,72,75,"Juana Diaz Municipio, PR",Aug-19,14779,13484,1295,8.8
19275,CN7207700000000,72,77,"Juncos Municipio, PR",Aug-19,12170,11271,899,7.4
19276,CN7207900000000,72,79,"Lajas Municipio, PR",Aug-19,5115,4531,584,11.4
19277,CN7208100000000,72,81,"Lares Municipio, PR",Aug-19,6850,6082,768,11.2
19278,CN7208300000000,72,83,"Las Marias Municipio, PR",Aug-19,2615,2387,228,8.7
19279,CN7208500000000,72,85,"Las Piedras Municipio, PR",Aug-19,11165,10303,862,7.7
19280,CN7208700000000,72,87,"Loiza Municipio, PR",Aug-19,8330,7790,540,6.5
19281,CN7208900000000,72,89,"Luquillo Municipio, PR",Aug-19,6111,5608,503,8.2
19282,CN7209100000000,72,91,"Manati Municipio, PR",Aug-19,11360,10559,801,7.1
19283,CN7209300000000,72,93,"Maricao Municipio, PR",Aug-19,1856,1670,186,10.0
19284,CN7209500000000,72,95,"Maunabo Municipio, PR",Aug-19,2839,2509,330,11.6
19285,CN7209700000000,72,97,"Mayaguez Municipio, PR",Aug-19,21462,19487,1975,9.2
19286,CN7209900000000,72,99,"Moca Municipio, PR",Aug-19,10276,9412,864,8.4
19287,CN7210100000000,72,101,"Morovis Municipio, PR",Aug-19,7892,7267,625,7.9
19288,CN7210300000000,72,103,"Naguabo Municipio, PR",Aug-19,8028,7431,597,7.4
19289,CN7210500000000,72,105,"Naranjito Municipio, PR",Aug-19,7034,6483,551,7.8
19290,CN7210700000000,72,107,"Orocovis Municipio, PR",Aug-19,4900,4458,442,9.0
19291,CN7210900000000,72,109,"Patillas Municipio, PR",Aug-19,4120,3621,499,12.1
19292,CN7211100000000,72,111,"Penuelas Municipio, PR",Aug-19,5768,5051,717,12.4
19293,CN7211300000000,72,113,"Ponce Municipio, PR",Aug-19,44773,40985,3788,8.5
19294,CN7211500000000,72,115,"Quebradillas Municipio, PR",Aug-19,5904,5364,540,9.1
19295,CN7211700000000,72,117,"Rincon Municipio, PR",Aug-19,4509,4107,402,8.9
19296,CN7211900000000,72,119,"Rio Grande Municipio, PR",Aug-19,16741,15707,1034,6.2
19297,CN7212100000000,72,121,"Sabana Grande Municipio, PR",Aug-19,6047,5345,702,11.6
19298,CN7212300000000,72,123,"Salinas Municipio, PR",Aug-19,6994,6089,905,12.9
19299,CN7212500000000,72,125,"San German Municipio, PR",Aug-19,9511,8601,910,9.6
19300,CN7212700000000,72,127,"San Juan Municipio, PR",Aug-19,132913,126543,6370,4.8
19301,CN7212900000000,72,129,"San Lorenzo Municipio, PR",Aug-19,11551,10687,864,7.5
19302,CN7213100000000,72,131,"San Sebastian Municipio, PR",Aug-19,10011,8988,1023,10.2
19303,CN7213300000000,72,133,"Santa Isabel Municipio, PR",Aug-19,7750,6882,868,11.2
19304,CN7213500000000,72,135,"Toa Alta Municipio, PR",Aug-19,26871,25567,1304,4.9
19305,CN7213700000000,72,137,"Toa Baja Municipio, PR",Aug-19,28950,27522,1428,4.9
19306,CN7213900000000,72,139,"Trujillo Alto Municipio, PR",Aug-19,26862,25742,1120,4.2
19307,CN7214100000000,72,141,"Utuado Municipio, PR",Aug-19,6596,5951,645,9.8
19308,CN7214300000000,72,143,"Vega Alta Municipio, PR",Aug-19,9632,8948,684,7.1
19309,CN7214500000000,72,145,"Vega Baja Municipio, PR",Aug-19,13088,12014,1074,8.2
19310,CN7214700000000,72,147,"Vieques Municipio, PR",Aug-19,2562,2427,135,5.3
19311,CN7214900000000,72,149,"Villalba Municipio, PR",Aug-19,7200,6297,903,12.5
19312,CN7215100000000,72,151,"Yabucoa Municipio, PR",Aug-19,8645,7691,954,11.0
19313,CN7215300000000,72,153,"Yauco Municipio, PR",Aug-19,9598,8430,1168,12.2
19314,CN0100100000000,01,1,"Autauga County, AL",Sep-19,26010,25391,619,2.4
19315,CN0100300000000,01,3,"Baldwin County, AL",Sep-19,96754,94510,2244,2.3
19316,CN0100500000000,01,5,"Barbour County, AL",Sep-19,8656,8376,280,3.2
19317,CN0100700000000,01,7,"Bibb County, AL",Sep-19,8655,8430,225,2.6
19318,CN0100900000000,01,9,"Blount County, AL",Sep-19,25351,24763,588,2.3
19319,CN0101100000000,01,11,"Bullock County, AL",Sep-19,4951,4783,168,3.4
19320,CN0101300000000,01,13,"Butler County, AL",Sep-19,9297,8999,298,3.2
19321,CN0101500000000,01,15,"Calhoun County, AL",Sep-19,45820,44455,1365,3.0
19322,CN0101700000000,01,17,"Chambers County, AL",Sep-19,15763,15369,394,2.5
19323,CN0101900000000,01,19,"Cherokee County, AL",Sep-19,11472,11194,278,2.4
19324,CN0102100000000,01,21,"Chilton County, AL",Sep-19,19885,19418,467,2.3
19325,CN0102300000000,01,23,"Choctaw County, AL",Sep-19,4547,4349,198,4.4
19326,CN0102500000000,01,25,"Clarke County, AL",Sep-19,7456,7063,393,5.3
19327,CN0102700000000,01,27,"Clay County, AL",Sep-19,6154,6008,146,2.4
19328,CN0102900000000,01,29,"Cleburne County, AL",Sep-19,5811,5667,144,2.5
19329,CN0103100000000,01,31,"Coffee County, AL",Sep-19,21386,20849,537,2.5
19330,CN0103300000000,01,33,"Colbert County, AL",Sep-19,23668,22913,755,3.2
19331,CN0103500000000,01,35,"Conecuh County, AL",Sep-19,4548,4389,159,3.5
19332,CN0103700000000,01,37,"Coosa County, AL",Sep-19,4562,4449,113,2.5
19333,CN0103900000000,01,39,"Covington County, AL",Sep-19,15799,15353,446,2.8
19334,CN0104100000000,01,41,"Crenshaw County, AL",Sep-19,6597,6449,148,2.2
19335,CN0104300000000,01,43,"Cullman County, AL",Sep-19,38902,38037,865,2.2
19336,CN0104500000000,01,45,"Dale County, AL",Sep-19,20774,20240,534,2.6
19337,CN0104700000000,01,47,"Dallas County, AL",Sep-19,14742,13981,761,5.2
19338,CN0104900000000,01,49,"DeKalb County, AL",Sep-19,31301,30577,724,2.3
19339,CN0105100000000,01,51,"Elmore County, AL",Sep-19,37250,36408,842,2.3
19340,CN0105300000000,01,53,"Escambia County, AL",Sep-19,14819,14365,454,3.1
19341,CN0105500000000,01,55,"Etowah County, AL",Sep-19,42423,41196,1227,2.9
19342,CN0105700000000,01,57,"Fayette County, AL",Sep-19,6619,6435,184,2.8
19343,CN0105900000000,01,59,"Franklin County, AL",Sep-19,14759,14413,346,2.3
19344,CN0106100000000,01,61,"Geneva County, AL",Sep-19,11203,10939,264,2.4
19345,CN0106300000000,01,63,"Greene County, AL",Sep-19,2886,2744,142,4.9
19346,CN0106500000000,01,65,"Hale County, AL",Sep-19,6312,6097,215,3.4
19347,CN0106700000000,01,67,"Henry County, AL",Sep-19,6957,6753,204,2.9
19348,CN0106900000000,01,69,"Houston County, AL",Sep-19,46108,44951,1157,2.5
19349,CN0107100000000,01,71,"Jackson County, AL",Sep-19,23340,22692,648,2.8
19350,CN0107300000000,01,73,"Jefferson County, AL",Sep-19,316826,308951,7875,2.5
19351,CN0107500000000,01,75,"Lamar County, AL",Sep-19,5887,5736,151,2.6
19352,CN0107700000000,01,77,"Lauderdale County, AL",Sep-19,42590,41381,1209,2.8
19353,CN0107900000000,01,79,"Lawrence County, AL",Sep-19,14333,13967,366,2.6
19354,CN0108100000000,01,81,"Lee County, AL",Sep-19,76841,75093,1748,2.3
19355,CN0108300000000,01,83,"Limestone County, AL",Sep-19,43818,42867,951,2.2
19356,CN0108500000000,01,85,"Lowndes County, AL",Sep-19,3586,3404,182,5.1
19357,CN0108700000000,01,87,"Macon County, AL",Sep-19,7882,7597,285,3.6
19358,CN0108900000000,01,89,"Madison County, AL",Sep-19,184550,180634,3916,2.1
19359,CN0109100000000,01,91,"Marengo County, AL",Sep-19,7710,7470,240,3.1
19360,CN0109300000000,01,93,"Marion County, AL",Sep-19,12936,12547,389,3.0
19361,CN0109500000000,01,95,"Marshall County, AL",Sep-19,44210,43292,918,2.1
19362,CN0109700000000,01,97,"Mobile County, AL",Sep-19,188658,182592,6066,3.2
19363,CN0109900000000,01,99,"Monroe County, AL",Sep-19,7394,7083,311,4.2
19364,CN0110100000000,01,101,"Montgomery County, AL",Sep-19,104877,102046,2831,2.7
19365,CN0110300000000,01,103,"Morgan County, AL",Sep-19,58212,56959,1253,2.2
19366,CN0110500000000,01,105,"Perry County, AL",Sep-19,3500,3335,165,4.7
19367,CN0110700000000,01,107,"Pickens County, AL",Sep-19,8047,7815,232,2.9
19368,CN0110900000000,01,109,"Pike County, AL",Sep-19,15557,15113,444,2.9
19369,CN0111100000000,01,111,"Randolph County, AL",Sep-19,9786,9528,258,2.6
19370,CN0111300000000,01,113,"Russell County, AL",Sep-19,23626,23035,591,2.5
19371,CN0111500000000,01,115,"St. Clair County, AL",Sep-19,40335,39401,934,2.3
19372,CN0111700000000,01,117,"Shelby County, AL",Sep-19,115332,113154,2178,1.9
19373,CN0111900000000,01,119,"Sumter County, AL",Sep-19,4933,4748,185,3.8
19374,CN0112100000000,01,121,"Talladega County, AL",Sep-19,35615,34540,1075,3.0
19375,CN0112300000000,01,123,"Tallapoosa County, AL",Sep-19,18751,18290,461,2.5
19376,CN0112500000000,01,125,"Tuscaloosa County, AL",Sep-19,105496,103116,2380,2.3
19377,CN0112700000000,01,127,"Walker County, AL",Sep-19,25184,24488,696,2.8
19378,CN0112900000000,01,129,"Washington County, AL",Sep-19,6835,6569,266,3.9
19379,CN0113100000000,01,131,"Wilcox County, AL",Sep-19,2726,2558,168,6.2
19380,CN0113300000000,01,133,"Winston County, AL",Sep-19,10187,9910,277,2.7
19381,CN0201300000000,02,13,"Aleutians East Borough, AK",Sep-19,3020,2959,61,2.0
19382,CN0201600000000,02,16,"Aleutians West Census Area, AK",Sep-19,3675,3570,105,2.9
19383,CN0202000000000,02,20,"Anchorage Borough/municipality, AK",Sep-19,145481,138354,7127,4.9
19384,CN0205000000000,02,50,"Bethel Census Area, AK",Sep-19,6856,5972,884,12.9
19385,CN0206000000000,02,60,"Bristol Bay Borough, AK",Sep-19,455,432,23,5.1
19386,CN0206800000000,02,68,"Denali Borough, AK",Sep-19,1449,1390,59,4.1
19387,CN0207000000000,02,70,"Dillingham Census Area, AK",Sep-19,1840,1697,143,7.8
19388,CN0209000000000,02,90,"Fairbanks North Star Borough, AK",Sep-19,44804,42641,2163,4.8
19389,CN0210000000000,02,100,"Haines Borough, AK",Sep-19,1249,1186,63,5.0
19390,CN0210500000000,02,105,"Hoonah-Angoon Census Area, AK",Sep-19,1306,1222,84,6.4
19391,CN0211000000000,02,110,"Juneau Borough/city, AK",Sep-19,17393,16716,677,3.9
19392,CN0212200000000,02,122,"Kenai Peninsula Borough, AK",Sep-19,26293,24750,1543,5.9
19393,CN0213000000000,02,130,"Ketchikan Gateway Borough, AK",Sep-19,7466,7098,368,4.9
19394,CN0215000000000,02,150,"Kodiak Island Borough, AK",Sep-19,5961,5698,263,4.4
19395,CN0215800000000,02,158,"Kusilvak Census Area, AK",Sep-19,2787,2346,441,15.8
19396,CN0216400000000,02,164,"Lake and Peninsula Borough, AK",Sep-19,746,687,59,7.9
19397,CN0217000000000,02,170,"Matanuska-Susitna Borough, AK",Sep-19,46102,43269,2833,6.1
19398,CN0218000000000,02,180,"Nome Census Area, AK",Sep-19,3939,3538,401,10.2
19399,CN0218500000000,02,185,"North Slope Borough, AK",Sep-19,3382,3137,245,7.2
19400,CN0218800000000,02,188,"Northwest Arctic Borough, AK",Sep-19,2896,2502,394,13.6
19401,CN0219500000000,02,195,"Petersburg Borough, AK",Sep-19,1563,1462,101,6.5
19402,CN0219800000000,02,198,"Prince of Wales-Hyder Census Area, AK",Sep-19,2916,2681,235,8.1
19403,CN0222000000000,02,220,"Sitka Borough/city, AK",Sep-19,4604,4439,165,3.6
19404,CN0223000000000,02,230,"Skagway Municipality, AK",Sep-19,1004,974,30,3.0
19405,CN0224000000000,02,240,"Southeast Fairbanks Census Area, AK",Sep-19,2775,2574,201,7.2
19406,CN0226100000000,02,261,"Valdez-Cordova Census Area, AK",Sep-19,5224,4942,282,5.4
19407,CN0227500000000,02,275,"Wrangell Borough/city, AK",Sep-19,1010,949,61,6.0
19408,CN0228200000000,02,282,"Yakutat Borough/city, AK",Sep-19,273,256,17,6.2
19409,CN0229000000000,02,290,"Yukon-Koyukuk Census Area, AK",Sep-19,2355,2077,278,11.8
19410,CN0400100000000,04,1,"Apache County, AZ",Sep-19,20752,18825,1927,9.3
19411,CN0400300000000,04,3,"Cochise County, AZ",Sep-19,51109,48301,2808,5.5
19412,CN0400500000000,04,5,"Coconino County, AZ",Sep-19,79489,75514,3975,5.0
19413,CN0400700000000,04,7,"Gila County, AZ",Sep-19,21934,20786,1148,5.2
19414,CN0400900000000,04,9,"Graham County, AZ",Sep-19,15694,15004,690,4.4
19415,CN0401100000000,04,11,"Greenlee County, AZ",Sep-19,4590,4426,164,3.6
19416,CN0401200000000,04,12,"La Paz County, AZ",Sep-19,9465,8948,517,5.5
19417,CN0401300000000,04,13,"Maricopa County, AZ",Sep-19,2335044,2245452,89592,3.8
19418,CN0401500000000,04,15,"Mohave County, AZ",Sep-19,88269,83388,4881,5.5
19419,CN0401700000000,04,17,"Navajo County, AZ",Sep-19,41906,39095,2811,6.7
19420,CN0401900000000,04,19,"Pima County, AZ",Sep-19,503048,481627,21421,4.3
19421,CN0402100000000,04,21,"Pinal County, AZ",Sep-19,189693,180755,8938,4.7
19422,CN0402300000000,04,23,"Santa Cruz County, AZ",Sep-19,19483,17297,2186,11.2
19423,CN0402500000000,04,25,"Yavapai County, AZ",Sep-19,108122,103538,4584,4.2
19424,CN0402700000000,04,27,"Yuma County, AZ",Sep-19,102870,83080,19790,19.2
19425,CN0500100000000,05,1,"Arkansas County, AR",Sep-19,9418,9173,245,2.6
19426,CN0500300000000,05,3,"Ashley County, AR",Sep-19,7591,7238,353,4.7
19427,CN0500500000000,05,5,"Baxter County, AR",Sep-19,16339,15745,594,3.6
19428,CN0500700000000,05,7,"Benton County, AR",Sep-19,138373,134921,3452,2.5
19429,CN0500900000000,05,9,"Boone County, AR",Sep-19,16078,15588,490,3.0
19430,CN0501100000000,05,11,"Bradley County, AR",Sep-19,4527,4368,159,3.5
19431,CN0501300000000,05,13,"Calhoun County, AR",Sep-19,2442,2357,85,3.5
19432,CN0501500000000,05,15,"Carroll County, AR",Sep-19,13110,12761,349,2.7
19433,CN0501700000000,05,17,"Chicot County, AR",Sep-19,3289,3091,198,6.0
19434,CN0501900000000,05,19,"Clark County, AR",Sep-19,9813,9467,346,3.5
19435,CN0502100000000,05,21,"Clay County, AR",Sep-19,5672,5430,242,4.3
19436,CN0502300000000,05,23,"Cleburne County, AR",Sep-19,9280,8885,395,4.3
19437,CN0502500000000,05,25,"Cleveland County, AR",Sep-19,3216,3107,109,3.4
19438,CN0502700000000,05,27,"Columbia County, AR",Sep-19,9239,8858,381,4.1
19439,CN0502900000000,05,29,"Conway County, AR",Sep-19,8372,8025,347,4.1
19440,CN0503100000000,05,31,"Craighead County, AR",Sep-19,56047,54599,1448,2.6
19441,CN0503300000000,05,33,"Crawford County, AR",Sep-19,26879,26036,843,3.1
19442,CN0503500000000,05,35,"Crittenden County, AR",Sep-19,21402,20541,861,4.0
19443,CN0503700000000,05,37,"Cross County, AR",Sep-19,7470,7186,284,3.8
19444,CN0503900000000,05,39,"Dallas County, AR",Sep-19,2820,2697,123,4.4
19445,CN0504100000000,05,41,"Desha County, AR",Sep-19,5359,5138,221,4.1
19446,CN0504300000000,05,43,"Drew County, AR",Sep-19,7923,7570,353,4.5
19447,CN0504500000000,05,45,"Faulkner County, AR",Sep-19,62060,60266,1794,2.9
19448,CN0504700000000,05,47,"Franklin County, AR",Sep-19,7565,7320,245,3.2
19449,CN0504900000000,05,49,"Fulton County, AR",Sep-19,5036,4857,179,3.6
19450,CN0505100000000,05,51,"Garland County, AR",Sep-19,41040,39588,1452,3.5
19451,CN0505300000000,05,53,"Grant County, AR",Sep-19,8360,8105,255,3.1
19452,CN0505500000000,05,55,"Greene County, AR",Sep-19,20142,19475,667,3.3
19453,CN0505700000000,05,57,"Hempstead County, AR",Sep-19,9964,9615,349,3.5
19454,CN0505900000000,05,59,"Hot Spring County, AR",Sep-19,14025,13543,482,3.4
19455,CN0506100000000,05,61,"Howard County, AR",Sep-19,5728,5568,160,2.8
19456,CN0506300000000,05,63,"Independence County, AR",Sep-19,16639,16000,639,3.8
19457,CN0506500000000,05,65,"Izard County, AR",Sep-19,4948,4700,248,5.0
19458,CN0506700000000,05,67,"Jackson County, AR",Sep-19,5812,5462,350,6.0
19459,CN0506900000000,05,69,"Jefferson County, AR",Sep-19,27741,26306,1435,5.2
19460,CN0507100000000,05,71,"Johnson County, AR",Sep-19,10236,9822,414,4.0
19461,CN0507300000000,05,73,"Lafayette County, AR",Sep-19,2443,2329,114,4.7
19462,CN0507500000000,05,75,"Lawrence County, AR",Sep-19,6901,6634,267,3.9
19463,CN0507700000000,05,77,"Lee County, AR",Sep-19,2827,2706,121,4.3
19464,CN0507900000000,05,79,"Lincoln County, AR",Sep-19,3954,3796,158,4.0
19465,CN0508100000000,05,81,"Little River County, AR",Sep-19,5507,5286,221,4.0
19466,CN0508300000000,05,83,"Logan County, AR",Sep-19,8599,8219,380,4.4
19467,CN0508500000000,05,85,"Lonoke County, AR",Sep-19,34427,33229,1198,3.5
19468,CN0508700000000,05,87,"Madison County, AR",Sep-19,7503,7320,183,2.4
19469,CN0508900000000,05,89,"Marion County, AR",Sep-19,6739,6477,262,3.9
19470,CN0509100000000,05,91,"Miller County, AR",Sep-19,19693,18963,730,3.7
19471,CN0509300000000,05,93,"Mississippi County, AR",Sep-19,17407,16634,773,4.4
19472,CN0509500000000,05,95,"Monroe County, AR",Sep-19,2776,2662,114,4.1
19473,CN0509700000000,05,97,"Montgomery County, AR",Sep-19,2997,2868,129,4.3
19474,CN0509900000000,05,99,"Nevada County, AR",Sep-19,3670,3530,140,3.8
19475,CN0510100000000,05,101,"Newton County, AR",Sep-19,3342,3234,108,3.2
19476,CN0510300000000,05,103,"Ouachita County, AR",Sep-19,9813,9366,447,4.6
19477,CN0510500000000,05,105,"Perry County, AR",Sep-19,4232,4085,147,3.5
19478,CN0510700000000,05,107,"Phillips County, AR",Sep-19,6317,5955,362,5.7
19479,CN0510900000000,05,109,"Pike County, AR",Sep-19,4290,4142,148,3.4
19480,CN0511100000000,05,111,"Poinsett County, AR",Sep-19,10359,10033,326,3.1
19481,CN0511300000000,05,113,"Polk County, AR",Sep-19,8200,7847,353,4.3
19482,CN0511500000000,05,115,"Pope County, AR",Sep-19,29000,27885,1115,3.8
19483,CN0511700000000,05,117,"Prairie County, AR",Sep-19,3639,3475,164,4.5
19484,CN0511900000000,05,119,"Pulaski County, AR",Sep-19,189092,182855,6237,3.3
19485,CN0512100000000,05,121,"Randolph County, AR",Sep-19,7375,7132,243,3.3
19486,CN0512300000000,05,123,"St. Francis County, AR",Sep-19,8193,7812,381,4.7
19487,CN0512500000000,05,125,"Saline County, AR",Sep-19,58765,57163,1602,2.7
19488,CN0512700000000,05,127,"Scott County, AR",Sep-19,4376,4233,143,3.3
19489,CN0512900000000,05,129,"Searcy County, AR",Sep-19,2964,2834,130,4.4
19490,CN0513100000000,05,131,"Sebastian County, AR",Sep-19,56617,54828,1789,3.2
19491,CN0513300000000,05,133,"Sevier County, AR",Sep-19,5569,5313,256,4.6
19492,CN0513500000000,05,135,"Sharp County, AR",Sep-19,5782,5514,268,4.6
19493,CN0513700000000,05,137,"Stone County, AR",Sep-19,4690,4510,180,3.8
19494,CN0513900000000,05,139,"Union County, AR",Sep-19,15826,15056,770,4.9
19495,CN0514100000000,05,141,"Van Buren County, AR",Sep-19,5762,5502,260,4.5
19496,CN0514300000000,05,143,"Washington County, AR",Sep-19,126003,123101,2902,2.3
19497,CN0514500000000,05,145,"White County, AR",Sep-19,33834,32475,1359,4.0
19498,CN0514700000000,05,147,"Woodruff County, AR",Sep-19,2798,2660,138,4.9
19499,CN0514900000000,05,149,"Yell County, AR",Sep-19,8466,8170,296,3.5
19500,CN0600100000000,06,1,"Alameda County, CA",Sep-19,846894,824463,22431,2.6
19501,CN0600300000000,06,3,"Alpine County, CA",Sep-19,463,440,23,5.0
19502,CN0600500000000,06,5,"Amador County, CA",Sep-19,15087,14618,469,3.1
19503,CN0600700000000,06,7,"Butte County, CA",Sep-19,99693,95695,3998,4.0
19504,CN0600900000000,06,9,"Calaveras County, CA",Sep-19,21733,21059,674,3.1
19505,CN0601100000000,06,11,"Colusa County, CA",Sep-19,11119,10359,760,6.8
19506,CN0601300000000,06,13,"Contra Costa County, CA",Sep-19,563330,547866,15464,2.7
19507,CN0601500000000,06,15,"Del Norte County, CA",Sep-19,9835,9357,478,4.9
19508,CN0601700000000,06,17,"El Dorado County, CA",Sep-19,92231,89502,2729,3.0
19509,CN0601900000000,06,19,"Fresno County, CA",Sep-19,452958,427545,25413,5.6
19510,CN0602100000000,06,21,"Glenn County, CA",Sep-19,13214,12605,609,4.6
19511,CN0602300000000,06,23,"Humboldt County, CA",Sep-19,62790,60944,1846,2.9
19512,CN0602500000000,06,25,"Imperial County, CA",Sep-19,71373,57534,13839,19.4
19513,CN0602700000000,06,27,"Inyo County, CA",Sep-19,8824,8578,246,2.8
19514,CN0602900000000,06,29,"Kern County, CA",Sep-19,397235,372625,24610,6.2
19515,CN0603100000000,06,31,"Kings County, CA",Sep-19,57497,54053,3444,6.0
19516,CN0603300000000,06,33,"Lake County, CA",Sep-19,29277,28110,1167,4.0
19517,CN0603500000000,06,35,"Lassen County, CA",Sep-19,9831,9497,334,3.4
19518,CN0603700000000,06,37,"Los Angeles County, CA",Sep-19,5152447,4929776,222671,4.3
19519,CN0603900000000,06,39,"Madera County, CA",Sep-19,62493,59192,3301,5.3
19520,CN0604100000000,06,41,"Marin County, CA",Sep-19,141022,138149,2873,2.0
19521,CN0604300000000,06,43,"Mariposa County, CA",Sep-19,8056,7804,252,3.1
19522,CN0604500000000,06,45,"Mendocino County, CA",Sep-19,39175,37961,1214,3.1
19523,CN0604700000000,06,47,"Merced County, CA",Sep-19,117807,111001,6806,5.8
19524,CN0604900000000,06,49,"Modoc County, CA",Sep-19,3184,3039,145,4.6
19525,CN0605100000000,06,51,"Mono County, CA",Sep-19,8327,8048,279,3.4
19526,CN0605300000000,06,53,"Monterey County, CA",Sep-19,228665,220561,8104,3.5
19527,CN0605500000000,06,55,"Napa County, CA",Sep-19,75913,74198,1715,2.3
19528,CN0605700000000,06,57,"Nevada County, CA",Sep-19,48495,47139,1356,2.8
19529,CN0605900000000,06,59,"Orange County, CA",Sep-19,1629470,1588476,40994,2.5
19530,CN0606100000000,06,61,"Placer County, CA",Sep-19,188662,183483,5179,2.7
19531,CN0606300000000,06,63,"Plumas County, CA",Sep-19,8194,7810,384,4.7
19532,CN0606500000000,06,65,"Riverside County, CA",Sep-19,1105907,1061700,44207,4.0
19533,CN0606700000000,06,67,"Sacramento County, CA",Sep-19,714699,691537,23162,3.2
19534,CN0606900000000,06,69,"San Benito County, CA",Sep-19,31349,30144,1205,3.8
19535,CN0607100000000,06,71,"San Bernardino County, CA",Sep-19,968925,935067,33858,3.5
19536,CN0607300000000,06,73,"San Diego County, CA",Sep-19,1593792,1548011,45781,2.9
19537,CN0607500000000,06,75,"San Francisco County/city, CA",Sep-19,588121,576853,11268,1.9
19538,CN0607700000000,06,77,"San Joaquin County, CA",Sep-19,328532,312511,16021,4.9
19539,CN0607900000000,06,79,"San Luis Obispo County, CA",Sep-19,139872,136334,3538,2.5
19540,CN0608100000000,06,81,"San Mateo County, CA",Sep-19,464123,455698,8425,1.8
19541,CN0608300000000,06,83,"Santa Barbara County, CA",Sep-19,218504,212046,6458,3.0
19542,CN0608500000000,06,85,"Santa Clara County, CA",Sep-19,1056884,1032954,23930,2.3
19543,CN0608700000000,06,87,"Santa Cruz County, CA",Sep-19,142734,138027,4707,3.3
19544,CN0608900000000,06,89,"Shasta County, CA",Sep-19,74740,71980,2760,3.7
19545,CN0609100000000,06,91,"Sierra County, CA",Sep-19,1385,1333,52,3.8
19546,CN0609300000000,06,93,"Siskiyou County, CA",Sep-19,17506,16717,789,4.5
19547,CN0609500000000,06,95,"Solano County, CA",Sep-19,209933,203225,6708,3.2
19548,CN0609700000000,06,97,"Sonoma County, CA",Sep-19,264030,258016,6014,2.3
19549,CN0609900000000,06,99,"Stanislaus County, CA",Sep-19,246178,234305,11873,4.8
19550,CN0610100000000,06,101,"Sutter County, CA",Sep-19,46098,43777,2321,5.0
19551,CN0610300000000,06,103,"Tehama County, CA",Sep-19,26114,24968,1146,4.4
19552,CN0610500000000,06,105,"Trinity County, CA",Sep-19,4755,4570,185,3.9
19553,CN0610700000000,06,107,"Tulare County, CA",Sep-19,204349,188111,16238,7.9
19554,CN0610900000000,06,109,"Tuolumne County, CA",Sep-19,21389,20618,771,3.6
19555,CN0611100000000,06,111,"Ventura County, CA",Sep-19,421441,407362,14079,3.3
19556,CN0611300000000,06,113,"Yolo County, CA",Sep-19,108824,105313,3511,3.2
19557,CN0611500000000,06,115,"Yuba County, CA",Sep-19,30366,28889,1477,4.9
19558,CN0800100000000,08,1,"Adams County, CO",Sep-19,277989,270969,7020,2.5
19559,CN0800300000000,08,3,"Alamosa County, CO",Sep-19,8824,8539,285,3.2
19560,CN0800500000000,08,5,"Arapahoe County, CO",Sep-19,372327,363438,8889,2.4
19561,CN0800700000000,08,7,"Archuleta County, CO",Sep-19,7166,6990,176,2.5
19562,CN0800900000000,08,9,"Baca County, CO",Sep-19,2209,2176,33,1.5
19563,CN0801100000000,08,11,"Bent County, CO",Sep-19,1964,1917,47,2.4
19564,CN0801300000000,08,13,"Boulder County, CO",Sep-19,199949,195744,4205,2.1
19565,CN0801400000000,08,14,"Broomfield County/city, CO",Sep-19,40908,40016,892,2.2
19566,CN0801500000000,08,15,"Chaffee County, CO",Sep-19,9840,9646,194,2.0
19567,CN0801700000000,08,17,"Cheyenne County, CO",Sep-19,1197,1181,16,1.3
19568,CN0801900000000,08,19,"Clear Creek County, CO",Sep-19,6191,6049,142,2.3
19569,CN0802100000000,08,21,"Conejos County, CO",Sep-19,4228,4103,125,3.0
19570,CN0802300000000,08,23,"Costilla County, CO",Sep-19,1949,1893,56,2.9
19571,CN0802500000000,08,25,"Crowley County, CO",Sep-19,1539,1479,60,3.9
19572,CN0802700000000,08,27,"Custer County, CO",Sep-19,2164,2108,56,2.6
19573,CN0802900000000,08,29,"Delta County, CO",Sep-19,14893,14515,378,2.5
19574,CN0803100000000,08,31,"Denver County/city, CO",Sep-19,425492,415503,9989,2.3
19575,CN0803300000000,08,33,"Dolores County, CO",Sep-19,1221,1195,26,2.1
19576,CN0803500000000,08,35,"Douglas County, CO",Sep-19,198361,194128,4233,2.1
19577,CN0803700000000,08,37,"Eagle County, CO",Sep-19,36332,35689,643,1.8
19578,CN0803900000000,08,39,"Elbert County, CO",Sep-19,15593,15308,285,1.8
19579,CN0804100000000,08,41,"El Paso County, CO",Sep-19,345755,335904,9851,2.8
19580,CN0804300000000,08,43,"Fremont County, CO",Sep-19,15275,14683,592,3.9
19581,CN0804500000000,08,45,"Garfield County, CO",Sep-19,32424,31704,720,2.2
19582,CN0804700000000,08,47,"Gilpin County, CO",Sep-19,3866,3789,77,2.0
19583,CN0804900000000,08,49,"Grand County, CO",Sep-19,9581,9409,172,1.8
19584,CN0805100000000,08,51,"Gunnison County, CO",Sep-19,11872,11681,191,1.6
19585,CN0805300000000,08,53,"Hinsdale County, CO",Sep-19,501,480,21,4.2
19586,CN0805500000000,08,55,"Huerfano County, CO",Sep-19,2588,2481,107,4.1
19587,CN0805700000000,08,57,"Jackson County, CO",Sep-19,1074,1058,16,1.5
19588,CN0805900000000,08,59,"Jefferson County, CO",Sep-19,342313,334777,7536,2.2
19589,CN0806100000000,08,61,"Kiowa County, CO",Sep-19,1005,993,12,1.2
19590,CN0806300000000,08,63,"Kit Carson County, CO",Sep-19,4455,4386,69,1.5
19591,CN0806500000000,08,65,"Lake County, CO",Sep-19,4870,4766,104,2.1
19592,CN0806700000000,08,67,"La Plata County, CO",Sep-19,32716,32077,639,2.0
19593,CN0806900000000,08,69,"Larimer County, CO",Sep-19,209577,205334,4243,2.0
19594,CN0807100000000,08,71,"Las Animas County, CO",Sep-19,6677,6464,213,3.2
19595,CN0807300000000,08,73,"Lincoln County, CO",Sep-19,2417,2366,51,2.1
19596,CN0807500000000,08,75,"Logan County, CO",Sep-19,11243,11019,224,2.0
19597,CN0807700000000,08,77,"Mesa County, CO",Sep-19,77499,75359,2140,2.8
19598,CN0807900000000,08,79,"Mineral County, CO",Sep-19,465,454,11,2.4
19599,CN0808100000000,08,81,"Moffat County, CO",Sep-19,7396,7215,181,2.4
19600,CN0808300000000,08,83,"Montezuma County, CO",Sep-19,13286,12878,408,3.1
19601,CN0808500000000,08,85,"Montrose County, CO",Sep-19,22335,21795,540,2.4
19602,CN0808700000000,08,87,"Morgan County, CO",Sep-19,16713,16327,386,2.3
19603,CN0808900000000,08,89,"Otero County, CO",Sep-19,8598,8315,283,3.3
19604,CN0809100000000,08,91,"Ouray County, CO",Sep-19,2578,2526,52,2.0
19605,CN0809300000000,08,93,"Park County, CO",Sep-19,11459,11228,231,2.0
19606,CN0809500000000,08,95,"Phillips County, CO",Sep-19,2710,2676,34,1.3
19607,CN0809700000000,08,97,"Pitkin County, CO",Sep-19,11218,10951,267,2.4
19608,CN0809900000000,08,99,"Prowers County, CO",Sep-19,6555,6408,147,2.2
19609,CN0810100000000,08,101,"Pueblo County, CO",Sep-19,76923,74192,2731,3.6
19610,CN0810300000000,08,103,"Rio Blanco County, CO",Sep-19,3093,3004,89,2.9
19611,CN0810500000000,08,105,"Rio Grande County, CO",Sep-19,5638,5447,191,3.4
19612,CN0810700000000,08,107,"Routt County, CO",Sep-19,16135,15849,286,1.8
19613,CN0810900000000,08,109,"Saguache County, CO",Sep-19,3696,3557,139,3.8
19614,CN0811100000000,08,111,"San Juan County, CO",Sep-19,686,674,12,1.7
19615,CN0811300000000,08,113,"San Miguel County, CO",Sep-19,5900,5807,93,1.6
19616,CN0811500000000,08,115,"Sedgwick County, CO",Sep-19,1282,1260,22,1.7
19617,CN0811700000000,08,117,"Summit County, CO",Sep-19,21317,20939,378,1.8
19618,CN0811900000000,08,119,"Teller County, CO",Sep-19,12963,12626,337,2.6
19619,CN0812100000000,08,121,"Washington County, CO",Sep-19,3023,2971,52,1.7
19620,CN0812300000000,08,123,"Weld County, CO",Sep-19,172833,169054,3779,2.2
19621,CN0812500000000,08,125,"Yuma County, CO",Sep-19,6074,5987,87,1.4
19622,CN0900100000000,09,1,"Fairfield County, CT",Sep-19,479513,463213,16300,3.4
19623,CN0900300000000,09,3,"Hartford County, CT",Sep-19,483751,465909,17842,3.7
19624,CN0900500000000,09,5,"Litchfield County, CT",Sep-19,105188,102000,3188,3.0
19625,CN0900700000000,09,7,"Middlesex County, CT",Sep-19,93980,91171,2809,3.0
19626,CN0900900000000,09,9,"New Haven County, CT",Sep-19,462538,445476,17062,3.7
19627,CN0901100000000,09,11,"New London County, CT",Sep-19,137212,132588,4624,3.4
19628,CN0901300000000,09,13,"Tolland County, CT",Sep-19,86971,84459,2512,2.9
19629,CN0901500000000,09,15,"Windham County, CT",Sep-19,63954,61727,2227,3.5
19630,CN1000100000000,10,1,"Kent County, DE",Sep-19,78818,75393,3425,4.3
19631,CN1000300000000,10,3,"New Castle County, DE",Sep-19,297006,285272,11734,4.0
19632,CN1000500000000,10,5,"Sussex County, DE",Sep-19,108531,104781,3750,3.5
19633,CN1100100000000,11,1,District of Columbia,Sep-19,407988,386102,21886,5.4
19634,CN1200100000000,12,1,"Alachua County, FL",Sep-19,142833,138948,3885,2.7
19635,CN1200300000000,12,3,"Baker County, FL",Sep-19,12024,11694,330,2.7
19636,CN1200500000000,12,5,"Bay County, FL",Sep-19,85601,82964,2637,3.1
19637,CN1200700000000,12,7,"Bradford County, FL",Sep-19,11367,11034,333,2.9
19638,CN1200900000000,12,9,"Brevard County, FL",Sep-19,288086,279637,8449,2.9
19639,CN1201100000000,12,11,"Broward County, FL",Sep-19,1054173,1024315,29858,2.8
19640,CN1201300000000,12,13,"Calhoun County, FL",Sep-19,4896,4718,178,3.6
19641,CN1201500000000,12,15,"Charlotte County, FL",Sep-19,71697,69183,2514,3.5
19642,CN1201700000000,12,17,"Citrus County, FL",Sep-19,47643,45542,2101,4.4
19643,CN1201900000000,12,19,"Clay County, FL",Sep-19,109436,106394,3042,2.8
19644,CN1202100000000,12,21,"Collier County, FL",Sep-19,177330,171611,5719,3.2
19645,CN1202300000000,12,23,"Columbia County, FL",Sep-19,30393,29485,908,3.0
19646,CN1202700000000,12,27,"DeSoto County, FL",Sep-19,13864,13403,461,3.3
19647,CN1202900000000,12,29,"Dixie County, FL",Sep-19,6088,5882,206,3.4
19648,CN1203100000000,12,31,"Duval County, FL",Sep-19,499809,484615,15194,3.0
19649,CN1203300000000,12,33,"Escambia County, FL",Sep-19,147795,143453,4342,2.9
19650,CN1203500000000,12,35,"Flagler County, FL",Sep-19,47459,45791,1668,3.5
19651,CN1203700000000,12,37,"Franklin County, FL",Sep-19,4717,4581,136,2.9
19652,CN1203900000000,12,39,"Gadsden County, FL",Sep-19,19216,18466,750,3.9
19653,CN1204100000000,12,41,"Gilchrist County, FL",Sep-19,7342,7118,224,3.1
19654,CN1204300000000,12,43,"Glades County, FL",Sep-19,5183,4976,207,4.0
19655,CN1204500000000,12,45,"Gulf County, FL",Sep-19,5852,5625,227,3.9
19656,CN1204700000000,12,47,"Hamilton County, FL",Sep-19,4379,4209,170,3.9
19657,CN1204900000000,12,49,"Hardee County, FL",Sep-19,8505,8066,439,5.2
19658,CN1205100000000,12,51,"Hendry County, FL",Sep-19,15621,14507,1114,7.1
19659,CN1205300000000,12,53,"Hernando County, FL",Sep-19,72983,70152,2831,3.9
19660,CN1205500000000,12,55,"Highlands County, FL",Sep-19,35809,34267,1542,4.3
19661,CN1205700000000,12,57,"Hillsborough County, FL",Sep-19,760926,738870,22056,2.9
19662,CN1205900000000,12,59,"Holmes County, FL",Sep-19,7139,6907,232,3.2
19663,CN1206100000000,12,61,"Indian River County, FL",Sep-19,64959,62494,2465,3.8
19664,CN1206300000000,12,63,"Jackson County, FL",Sep-19,17568,17031,537,3.1
19665,CN1206500000000,12,65,"Jefferson County, FL",Sep-19,5724,5552,172,3.0
19666,CN1206700000000,12,67,"Lafayette County, FL",Sep-19,2895,2810,85,2.9
19667,CN1206900000000,12,69,"Lake County, FL",Sep-19,161049,156335,4714,2.9
19668,CN1207100000000,12,71,"Lee County, FL",Sep-19,348608,338282,10326,3.0
19669,CN1207300000000,12,73,"Leon County, FL",Sep-19,158252,153685,4567,2.9
19670,CN1207500000000,12,75,"Levy County, FL",Sep-19,16945,16377,568,3.4
19671,CN1207700000000,12,77,"Liberty County, FL",Sep-19,2673,2596,77,2.9
19672,CN1207900000000,12,79,"Madison County, FL",Sep-19,7620,7339,281,3.7
19673,CN1208100000000,12,81,"Manatee County, FL",Sep-19,180409,175035,5374,3.0
19674,CN1208300000000,12,83,"Marion County, FL",Sep-19,139064,134160,4904,3.5
19675,CN1208500000000,12,85,"Martin County, FL",Sep-19,74620,72413,2207,3.0
19676,CN1208600000000,12,86,"Miami-Dade County, FL",Sep-19,1384761,1353065,31696,2.3
19677,CN1208700000000,12,87,"Monroe County, FL",Sep-19,45951,45072,879,1.9
19678,CN1208900000000,12,89,"Nassau County, FL",Sep-19,41832,40711,1121,2.7
19679,CN1209100000000,12,91,"Okaloosa County, FL",Sep-19,98076,95724,2352,2.4
19680,CN1209300000000,12,93,"Okeechobee County, FL",Sep-19,17981,17364,617,3.4
19681,CN1209500000000,12,95,"Orange County, FL",Sep-19,774223,752975,21248,2.7
19682,CN1209700000000,12,97,"Osceola County, FL",Sep-19,187142,181281,5861,3.1
19683,CN1209900000000,12,99,"Palm Beach County, FL",Sep-19,737841,714200,23641,3.2
19684,CN1210100000000,12,101,"Pasco County, FL",Sep-19,241597,233774,7823,3.2
19685,CN1210300000000,12,103,"Pinellas County, FL",Sep-19,501846,488211,13635,2.7
19686,CN1210500000000,12,105,"Polk County, FL",Sep-19,310844,299922,10922,3.5
19687,CN1210700000000,12,107,"Putnam County, FL",Sep-19,26770,25720,1050,3.9
19688,CN1210900000000,12,109,"St. Johns County, FL",Sep-19,134391,131160,3231,2.4
19689,CN1211100000000,12,111,"St. Lucie County, FL",Sep-19,146187,140698,5489,3.8
19690,CN1211300000000,12,113,"Santa Rosa County, FL",Sep-19,83984,81754,2230,2.7
19691,CN1211500000000,12,115,"Sarasota County, FL",Sep-19,189659,184249,5410,2.9
19692,CN1211700000000,12,117,"Seminole County, FL",Sep-19,259142,252145,6997,2.7
19693,CN1211900000000,12,119,"Sumter County, FL",Sep-19,32911,31571,1340,4.1
19694,CN1212100000000,12,121,"Suwannee County, FL",Sep-19,18299,17709,590,3.2
19695,CN1212300000000,12,123,"Taylor County, FL",Sep-19,8373,8094,279,3.3
19696,CN1212500000000,12,125,"Union County, FL",Sep-19,4766,4639,127,2.7
19697,CN1212700000000,12,127,"Volusia County, FL",Sep-19,256846,248670,8176,3.2
19698,CN1212900000000,12,129,"Wakulla County, FL",Sep-19,15188,14789,399,2.6
19699,CN1213100000000,12,131,"Walton County, FL",Sep-19,31888,31086,802,2.5
19700,CN1213300000000,12,133,"Washington County, FL",Sep-19,9844,9552,292,3.0
19701,CN1300100000000,13,1,"Appling County, GA",Sep-19,9455,9119,336,3.6
19702,CN1300300000000,13,3,"Atkinson County, GA",Sep-19,4629,4523,106,2.3
19703,CN1300500000000,13,5,"Bacon County, GA",Sep-19,4892,4748,144,2.9
19704,CN1300700000000,13,7,"Baker County, GA",Sep-19,1156,1109,47,4.1
19705,CN1300900000000,13,9,"Baldwin County, GA",Sep-19,17489,16840,649,3.7
19706,CN1301100000000,13,11,"Banks County, GA",Sep-19,9607,9380,227,2.4
19707,CN1301300000000,13,13,"Barrow County, GA",Sep-19,40500,39509,991,2.4
19708,CN1301500000000,13,15,"Bartow County, GA",Sep-19,50665,49214,1451,2.9
19709,CN1301700000000,13,17,"Ben Hill County, GA",Sep-19,5379,5122,257,4.8
19710,CN1301900000000,13,19,"Berrien County, GA",Sep-19,7408,7150,258,3.5
19711,CN1302100000000,13,21,"Bibb County, GA",Sep-19,67664,65292,2372,3.5
19712,CN1302300000000,13,23,"Bleckley County, GA",Sep-19,4457,4250,207,4.6
19713,CN1302500000000,13,25,"Brantley County, GA",Sep-19,7326,7046,280,3.8
19714,CN1302700000000,13,27,"Brooks County, GA",Sep-19,6898,6695,203,2.9
19715,CN1302900000000,13,29,"Bryan County, GA",Sep-19,18163,17661,502,2.8
19716,CN1303100000000,13,31,"Bulloch County, GA",Sep-19,36477,35257,1220,3.3
19717,CN1303300000000,13,33,"Burke County, GA",Sep-19,9099,8668,431,4.7
19718,CN1303500000000,13,35,"Butts County, GA",Sep-19,10746,10442,304,2.8
19719,CN1303700000000,13,37,"Calhoun County, GA",Sep-19,2263,2184,79,3.5
19720,CN1303900000000,13,39,"Camden County, GA",Sep-19,20750,20063,687,3.3
19721,CN1304300000000,13,43,"Candler County, GA",Sep-19,5635,5489,146,2.6
19722,CN1304500000000,13,45,"Carroll County, GA",Sep-19,55450,53777,1673,3.0
19723,CN1304700000000,13,47,"Catoosa County, GA",Sep-19,33756,32904,852,2.5
19724,CN1304900000000,13,49,"Charlton County, GA",Sep-19,4783,4616,167,3.5
19725,CN1305100000000,13,51,"Chatham County, GA",Sep-19,138515,134342,4173,3.0
19726,CN1305300000000,13,53,"Chattahoochee County, GA",Sep-19,1966,1893,73,3.7
19727,CN1305500000000,13,55,"Chattooga County, GA",Sep-19,10097,9750,347,3.4
19728,CN1305700000000,13,57,"Cherokee County, GA",Sep-19,136552,133276,3276,2.4
19729,CN1305900000000,13,59,"Clarke County, GA",Sep-19,59053,57175,1878,3.2
19730,CN1306100000000,13,61,"Clay County, GA",Sep-19,893,836,57,6.4
19731,CN1306300000000,13,63,"Clayton County, GA",Sep-19,138102,132810,5292,3.8
19732,CN1306500000000,13,65,"Clinch County, GA",Sep-19,2489,2399,90,3.6
19733,CN1306700000000,13,67,"Cobb County, GA",Sep-19,427185,416004,11181,2.6
19734,CN1306900000000,13,69,"Coffee County, GA",Sep-19,18868,18279,589,3.1
19735,CN1307100000000,13,71,"Colquitt County, GA",Sep-19,21042,20448,594,2.8
19736,CN1307300000000,13,73,"Columbia County, GA",Sep-19,75007,72987,2020,2.7
19737,CN1307500000000,13,75,"Cook County, GA",Sep-19,8005,7773,232,2.9
19738,CN1307700000000,13,77,"Coweta County, GA",Sep-19,74816,72918,1898,2.5
19739,CN1307900000000,13,79,"Crawford County, GA",Sep-19,5583,5403,180,3.2
19740,CN1308100000000,13,81,"Crisp County, GA",Sep-19,9400,9088,312,3.3
19741,CN1308300000000,13,83,"Dade County, GA",Sep-19,8339,8107,232,2.8
19742,CN1308500000000,13,85,"Dawson County, GA",Sep-19,12401,12105,296,2.4
19743,CN1308700000000,13,87,"Decatur County, GA",Sep-19,11461,11056,405,3.5
19744,CN1308900000000,13,89,"DeKalb County, GA",Sep-19,400810,388609,12201,3.0
19745,CN1309100000000,13,91,"Dodge County, GA",Sep-19,7117,6763,354,5.0
19746,CN1309300000000,13,93,"Dooly County, GA",Sep-19,5070,4907,163,3.2
19747,CN1309500000000,13,95,"Dougherty County, GA",Sep-19,38579,36895,1684,4.4
19748,CN1309700000000,13,97,"Douglas County, GA",Sep-19,73529,71191,2338,3.2
19749,CN1309900000000,13,99,"Early County, GA",Sep-19,4420,4278,142,3.2
19750,CN1310100000000,13,101,"Echols County, GA",Sep-19,1892,1848,44,2.3
19751,CN1310300000000,13,103,"Effingham County, GA",Sep-19,30606,29801,805,2.6
19752,CN1310500000000,13,105,"Elbert County, GA",Sep-19,7674,7413,261,3.4
19753,CN1310700000000,13,107,"Emanuel County, GA",Sep-19,8305,7889,416,5.0
19754,CN1310900000000,13,109,"Evans County, GA",Sep-19,4901,4750,151,3.1
19755,CN1311100000000,13,111,"Fannin County, GA",Sep-19,11499,11161,338,2.9
19756,CN1311300000000,13,113,"Fayette County, GA",Sep-19,58178,56644,1534,2.6
19757,CN1311500000000,13,115,"Floyd County, GA",Sep-19,44060,42609,1451,3.3
19758,CN1311700000000,13,117,"Forsyth County, GA",Sep-19,122624,119655,2969,2.4
19759,CN1311900000000,13,119,"Franklin County, GA",Sep-19,9854,9549,305,3.1
19760,CN1312100000000,13,121,"Fulton County, GA",Sep-19,559050,541672,17378,3.1
19761,CN1312300000000,13,123,"Gilmer County, GA",Sep-19,12011,11652,359,3.0
19762,CN1312500000000,13,125,"Glascock County, GA",Sep-19,1271,1227,44,3.5
19763,CN1312700000000,13,127,"Glynn County, GA",Sep-19,39568,38235,1333,3.4
19764,CN1312900000000,13,129,"Gordon County, GA",Sep-19,27976,27191,785,2.8
19765,CN1313100000000,13,131,"Grady County, GA",Sep-19,10366,10044,322,3.1
19766,CN1313300000000,13,133,"Greene County, GA",Sep-19,6965,6732,233,3.3
19767,CN1313500000000,13,135,"Gwinnett County, GA",Sep-19,492265,479079,13186,2.7
19768,CN1313700000000,13,137,"Habersham County, GA",Sep-19,19054,18508,546,2.9
19769,CN1313900000000,13,139,"Hall County, GA",Sep-19,102502,100012,2490,2.4
19770,CN1314100000000,13,141,"Hancock County, GA",Sep-19,2448,2321,127,5.2
19771,CN1314300000000,13,143,"Haralson County, GA",Sep-19,12631,12257,374,3.0
19772,CN1314500000000,13,145,"Harris County, GA",Sep-19,16561,16102,459,2.8
19773,CN1314700000000,13,147,"Hart County, GA",Sep-19,10980,10647,333,3.0
19774,CN1314900000000,13,149,"Heard County, GA",Sep-19,5257,5112,145,2.8
19775,CN1315100000000,13,151,"Henry County, GA",Sep-19,115633,111980,3653,3.2
19776,CN1315300000000,13,153,"Houston County, GA",Sep-19,70304,68269,2035,2.9
19777,CN1315500000000,13,155,"Irwin County, GA",Sep-19,3348,3210,138,4.1
19778,CN1315700000000,13,157,"Jackson County, GA",Sep-19,36568,35733,835,2.3
19779,CN1315900000000,13,159,"Jasper County, GA",Sep-19,6966,6782,184,2.6
19780,CN1316100000000,13,161,"Jeff Davis County, GA",Sep-19,5984,5730,254,4.2
19781,CN1316300000000,13,163,"Jefferson County, GA",Sep-19,6562,6286,276,4.2
19782,CN1316500000000,13,165,"Jenkins County, GA",Sep-19,3166,3010,156,4.9
19783,CN1316700000000,13,167,"Johnson County, GA",Sep-19,3956,3837,119,3.0
19784,CN1316900000000,13,169,"Jones County, GA",Sep-19,13657,13277,380,2.8
19785,CN1317100000000,13,171,"Lamar County, GA",Sep-19,8299,7995,304,3.7
19786,CN1317300000000,13,173,"Lanier County, GA",Sep-19,3738,3618,120,3.2
19787,CN1317500000000,13,175,"Laurens County, GA",Sep-19,18859,18040,819,4.3
19788,CN1317700000000,13,177,"Lee County, GA",Sep-19,14832,14422,410,2.8
19789,CN1317900000000,13,179,"Liberty County, GA",Sep-19,26107,25183,924,3.5
19790,CN1318100000000,13,181,"Lincoln County, GA",Sep-19,3536,3416,120,3.4
19791,CN1318300000000,13,183,"Long County, GA",Sep-19,8147,7869,278,3.4
19792,CN1318500000000,13,185,"Lowndes County, GA",Sep-19,51061,49462,1599,3.1
19793,CN1318700000000,13,187,"Lumpkin County, GA",Sep-19,16934,16482,452,2.7
19794,CN1318900000000,13,189,"McDuffie County, GA",Sep-19,8825,8397,428,4.8
19795,CN1319100000000,13,191,"McIntosh County, GA",Sep-19,6190,5965,225,3.6
19796,CN1319300000000,13,193,"Macon County, GA",Sep-19,4657,4458,199,4.3
19797,CN1319500000000,13,195,"Madison County, GA",Sep-19,13327,12959,368,2.8
19798,CN1319700000000,13,197,"Marion County, GA",Sep-19,3290,3164,126,3.8
19799,CN1319900000000,13,199,"Meriwether County, GA",Sep-19,8942,8588,354,4.0
19800,CN1320100000000,13,201,"Miller County, GA",Sep-19,2742,2660,82,3.0
19801,CN1320500000000,13,205,"Mitchell County, GA",Sep-19,8489,8135,354,4.2
19802,CN1320700000000,13,207,"Monroe County, GA",Sep-19,12983,12613,370,2.8
19803,CN1320900000000,13,209,"Montgomery County, GA",Sep-19,3823,3627,196,5.1
19804,CN1321100000000,13,211,"Morgan County, GA",Sep-19,9311,9050,261,2.8
19805,CN1321300000000,13,213,"Murray County, GA",Sep-19,15480,14786,694,4.5
19806,CN1321500000000,13,215,"Muscogee County, GA",Sep-19,76938,73764,3174,4.1
19807,CN1321700000000,13,217,"Newton County, GA",Sep-19,52337,50534,1803,3.4
19808,CN1321900000000,13,219,"Oconee County, GA",Sep-19,19558,19132,426,2.2
19809,CN1322100000000,13,221,"Oglethorpe County, GA",Sep-19,6917,6722,195,2.8
19810,CN1322300000000,13,223,"Paulding County, GA",Sep-19,86163,83937,2226,2.6
19811,CN1322500000000,13,225,"Peach County, GA",Sep-19,11835,11405,430,3.6
19812,CN1322700000000,13,227,"Pickens County, GA",Sep-19,15324,14927,397,2.6
19813,CN1322900000000,13,229,"Pierce County, GA",Sep-19,8667,8411,256,3.0
19814,CN1323100000000,13,231,"Pike County, GA",Sep-19,8950,8712,238,2.7
19815,CN1323300000000,13,233,"Polk County, GA",Sep-19,18492,17924,568,3.1
19816,CN1323500000000,13,235,"Pulaski County, GA",Sep-19,4047,3919,128,3.2
19817,CN1323700000000,13,237,"Putnam County, GA",Sep-19,8193,7889,304,3.7
19818,CN1323900000000,13,239,"Quitman County, GA",Sep-19,801,766,35,4.4
19819,CN1324100000000,13,241,"Rabun County, GA",Sep-19,7318,7116,202,2.8
19820,CN1324300000000,13,243,"Randolph County, GA",Sep-19,2490,2379,111,4.5
19821,CN1324500000000,13,245,"Richmond County, GA",Sep-19,84577,81153,3424,4.0
19822,CN1324700000000,13,247,"Rockdale County, GA",Sep-19,44881,43393,1488,3.3
19823,CN1324900000000,13,249,"Schley County, GA",Sep-19,2229,2156,73,3.3
19824,CN1325100000000,13,251,"Screven County, GA",Sep-19,5262,4835,427,8.1
19825,CN1325300000000,13,253,"Seminole County, GA",Sep-19,3048,2932,116,3.8
19826,CN1325500000000,13,255,"Spalding County, GA",Sep-19,28746,27733,1013,3.5
19827,CN1325700000000,13,257,"Stephens County, GA",Sep-19,10674,10320,354,3.3
19828,CN1325900000000,13,259,"Stewart County, GA",Sep-19,2404,2314,90,3.7
19829,CN1326100000000,13,261,"Sumter County, GA",Sep-19,12843,12283,560,4.4
19830,CN1326300000000,13,263,"Talbot County, GA",Sep-19,2791,2692,99,3.5
19831,CN1326500000000,13,265,"Taliaferro County, GA",Sep-19,567,537,30,5.3
19832,CN1326700000000,13,267,"Tattnall County, GA",Sep-19,9609,9287,322,3.4
19833,CN1326900000000,13,269,"Taylor County, GA",Sep-19,3138,3033,105,3.3
19834,CN1327100000000,13,271,"Telfair County, GA",Sep-19,3892,3489,403,10.4
19835,CN1327300000000,13,273,"Terrell County, GA",Sep-19,3510,3368,142,4.0
19836,CN1327500000000,13,275,"Thomas County, GA",Sep-19,16422,15828,594,3.6
19837,CN1327700000000,13,277,"Tift County, GA",Sep-19,19770,19188,582,2.9
19838,CN1327900000000,13,279,"Toombs County, GA",Sep-19,11752,11166,586,5.0
19839,CN1328100000000,13,281,"Towns County, GA",Sep-19,3967,3801,166,4.2
19840,CN1328300000000,13,283,"Treutlen County, GA",Sep-19,2584,2444,140,5.4
19841,CN1328500000000,13,285,"Troup County, GA",Sep-19,37271,36196,1075,2.9
19842,CN1328700000000,13,287,"Turner County, GA",Sep-19,3104,3005,99,3.2
19843,CN1328900000000,13,289,"Twiggs County, GA",Sep-19,2844,2709,135,4.7
19844,CN1329100000000,13,291,"Union County, GA",Sep-19,10285,10020,265,2.6
19845,CN1329300000000,13,293,"Upson County, GA",Sep-19,11387,11015,372,3.3
19846,CN1329500000000,13,295,"Walker County, GA",Sep-19,31467,30587,880,2.8
19847,CN1329700000000,13,297,"Walton County, GA",Sep-19,46153,44900,1253,2.7
19848,CN1329900000000,13,299,"Ware County, GA",Sep-19,15487,14974,513,3.3
19849,CN1330100000000,13,301,"Warren County, GA",Sep-19,2840,2724,116,4.1
19850,CN1330300000000,13,303,"Washington County, GA",Sep-19,7015,6782,233,3.3
19851,CN1330500000000,13,305,"Wayne County, GA",Sep-19,11292,10858,434,3.8
19852,CN1330700000000,13,307,"Webster County, GA",Sep-19,1011,965,46,4.5
19853,CN1330900000000,13,309,"Wheeler County, GA",Sep-19,1589,1474,115,7.2
19854,CN1331100000000,13,311,"White County, GA",Sep-19,16503,16147,356,2.2
19855,CN1331300000000,13,313,"Whitfield County, GA",Sep-19,43373,41816,1557,3.6
19856,CN1331500000000,13,315,"Wilcox County, GA",Sep-19,2675,2569,106,4.0
19857,CN1331700000000,13,317,"Wilkes County, GA",Sep-19,3802,3640,162,4.3
19858,CN1331900000000,13,319,"Wilkinson County, GA",Sep-19,3937,3809,128,3.3
19859,CN1332100000000,13,321,"Worth County, GA",Sep-19,8982,8627,355,4.0
19860,CN1500100000000,15,1,"Hawaii County, HI",Sep-19,91579,88379,3200,3.5
19861,CN1500300000000,15,3,"Honolulu County/city, HI",Sep-19,447922,435639,12283,2.7
19862,CN1500700000000,15,7,"Kauai County, HI",Sep-19,36588,35589,999,2.7
19863,CN1500900000000,15,9,"Maui County, HI",Sep-19,86453,84094,2359,2.7
19864,CN1600100000000,16,1,"Ada County, ID",Sep-19,254732,249208,5524,2.2
19865,CN1600300000000,16,3,"Adams County, ID",Sep-19,1744,1672,72,4.1
19866,CN1600500000000,16,5,"Bannock County, ID",Sep-19,42462,41461,1001,2.4
19867,CN1600700000000,16,7,"Bear Lake County, ID",Sep-19,3004,2943,61,2.0
19868,CN1600900000000,16,9,"Benewah County, ID",Sep-19,4121,3994,127,3.1
19869,CN1601100000000,16,11,"Bingham County, ID",Sep-19,24918,24396,522,2.1
19870,CN1601300000000,16,13,"Blaine County, ID",Sep-19,12240,12000,240,2.0
19871,CN1601500000000,16,15,"Boise County, ID",Sep-19,3503,3387,116,3.3
19872,CN1601700000000,16,17,"Bonner County, ID",Sep-19,20018,19407,611,3.1
19873,CN1601900000000,16,19,"Bonneville County, ID",Sep-19,57102,55911,1191,2.1
19874,CN1602100000000,16,21,"Boundary County, ID",Sep-19,5386,5219,167,3.1
19875,CN1602300000000,16,23,"Butte County, ID",Sep-19,1408,1376,32,2.3
19876,CN1602500000000,16,25,"Camas County, ID",Sep-19,723,706,17,2.4
19877,CN1602700000000,16,27,"Canyon County, ID",Sep-19,105626,102862,2764,2.6
19878,CN1602900000000,16,29,"Caribou County, ID",Sep-19,4168,4068,100,2.4
19879,CN1603100000000,16,31,"Cassia County, ID",Sep-19,12596,12343,253,2.0
19880,CN1603300000000,16,33,"Clark County, ID",Sep-19,388,375,13,3.4
19881,CN1603500000000,16,35,"Clearwater County, ID",Sep-19,2886,2763,123,4.3
19882,CN1603700000000,16,37,"Custer County, ID",Sep-19,2409,2334,75,3.1
19883,CN1603900000000,16,39,"Elmore County, ID",Sep-19,11798,11501,297,2.5
19884,CN1604100000000,16,41,"Franklin County, ID",Sep-19,7098,6975,123,1.7
19885,CN1604300000000,16,43,"Fremont County, ID",Sep-19,7421,7290,131,1.8
19886,CN1604500000000,16,45,"Gem County, ID",Sep-19,8379,8160,219,2.6
19887,CN1604700000000,16,47,"Gooding County, ID",Sep-19,8273,8105,168,2.0
19888,CN1604900000000,16,49,"Idaho County, ID",Sep-19,6659,6453,206,3.1
19889,CN1605100000000,16,51,"Jefferson County, ID",Sep-19,14103,13830,273,1.9
19890,CN1605300000000,16,53,"Jerome County, ID",Sep-19,12263,12023,240,2.0
19891,CN1605500000000,16,55,"Kootenai County, ID",Sep-19,80050,77926,2124,2.7
19892,CN1605700000000,16,57,"Latah County, ID",Sep-19,21028,20580,448,2.1
19893,CN1605900000000,16,59,"Lemhi County, ID",Sep-19,3646,3536,110,3.0
19894,CN1606100000000,16,61,"Lewis County, ID",Sep-19,1681,1617,64,3.8
19895,CN1606300000000,16,63,"Lincoln County, ID",Sep-19,2759,2691,68,2.5
19896,CN1606500000000,16,65,"Madison County, ID",Sep-19,20619,20244,375,1.8
19897,CN1606700000000,16,67,"Minidoka County, ID",Sep-19,11901,11680,221,1.9
19898,CN1606900000000,16,69,"Nez Perce County, ID",Sep-19,20903,20446,457,2.2
19899,CN1607100000000,16,71,"Oneida County, ID",Sep-19,2328,2293,35,1.5
19900,CN1607300000000,16,73,"Owyhee County, ID",Sep-19,5532,5397,135,2.4
19901,CN1607500000000,16,75,"Payette County, ID",Sep-19,11882,11541,341,2.9
19902,CN1607700000000,16,77,"Power County, ID",Sep-19,4489,4396,93,2.1
19903,CN1607900000000,16,79,"Shoshone County, ID",Sep-19,5041,4829,212,4.2
19904,CN1608100000000,16,81,"Teton County, ID",Sep-19,6972,6863,109,1.6
19905,CN1608300000000,16,83,"Twin Falls County, ID",Sep-19,41613,40669,944,2.3
19906,CN1608500000000,16,85,"Valley County, ID",Sep-19,5641,5506,135,2.4
19907,CN1608700000000,16,87,"Washington County, ID",Sep-19,4692,4543,149,3.2
19908,CN1700100000000,17,1,"Adams County, IL",Sep-19,32168,31142,1026,3.2
19909,CN1700300000000,17,3,"Alexander County, IL",Sep-19,2046,1929,117,5.7
19910,CN1700500000000,17,5,"Bond County, IL",Sep-19,7850,7593,257,3.3
19911,CN1700700000000,17,7,"Boone County, IL",Sep-19,26077,24886,1191,4.6
19912,CN1700900000000,17,9,"Brown County, IL",Sep-19,3035,2965,70,2.3
19913,CN1701100000000,17,11,"Bureau County, IL",Sep-19,17370,16713,657,3.8
19914,CN1701300000000,17,13,"Calhoun County, IL",Sep-19,2333,2239,94,4.0
19915,CN1701500000000,17,15,"Carroll County, IL",Sep-19,7387,7137,250,3.4
19916,CN1701700000000,17,17,"Cass County, IL",Sep-19,6095,5888,207,3.4
19917,CN1701900000000,17,19,"Champaign County, IL",Sep-19,110714,107047,3667,3.3
19918,CN1702100000000,17,21,"Christian County, IL",Sep-19,14341,13733,608,4.2
19919,CN1702300000000,17,23,"Clark County, IL",Sep-19,7632,7330,302,4.0
19920,CN1702500000000,17,25,"Clay County, IL",Sep-19,6476,6221,255,3.9
19921,CN1702700000000,17,27,"Clinton County, IL",Sep-19,20617,20066,551,2.7
19922,CN1702900000000,17,29,"Coles County, IL",Sep-19,24253,23384,869,3.6
19923,CN1703100000000,17,31,"Cook County, IL",Sep-19,2579265,2493164,86101,3.3
19924,CN1703300000000,17,33,"Crawford County, IL",Sep-19,8730,8383,347,4.0
19925,CN1703500000000,17,35,"Cumberland County, IL",Sep-19,6140,5966,174,2.8
19926,CN1703700000000,17,37,"DeKalb County, IL",Sep-19,55436,53466,1970,3.6
19927,CN1703900000000,17,39,"De Witt County, IL",Sep-19,7488,7211,277,3.7
19928,CN1704100000000,17,41,"Douglas County, IL",Sep-19,10278,9944,334,3.2
19929,CN1704300000000,17,43,"DuPage County, IL",Sep-19,505330,492409,12921,2.6
19930,CN1704500000000,17,45,"Edgar County, IL",Sep-19,8826,8486,340,3.9
19931,CN1704700000000,17,47,"Edwards County, IL",Sep-19,2659,2561,98,3.7
19932,CN1704900000000,17,49,"Effingham County, IL",Sep-19,19330,18779,551,2.9
19933,CN1705100000000,17,51,"Fayette County, IL",Sep-19,9885,9518,367,3.7
19934,CN1705300000000,17,53,"Ford County, IL",Sep-19,6538,6301,237,3.6
19935,CN1705500000000,17,55,"Franklin County, IL",Sep-19,16483,15693,790,4.8
19936,CN1705700000000,17,57,"Fulton County, IL",Sep-19,15335,14559,776,5.1
19937,CN1705900000000,17,59,"Gallatin County, IL",Sep-19,2333,2226,107,4.6
19938,CN1706100000000,17,61,"Greene County, IL",Sep-19,6040,5812,228,3.8
19939,CN1706300000000,17,63,"Grundy County, IL",Sep-19,25145,24281,864,3.4
19940,CN1706500000000,17,65,"Hamilton County, IL",Sep-19,4436,4289,147,3.3
19941,CN1706700000000,17,67,"Hancock County, IL",Sep-19,8477,8091,386,4.6
19942,CN1706900000000,17,69,"Hardin County, IL",Sep-19,1321,1246,75,5.7
19943,CN1707100000000,17,71,"Henderson County, IL",Sep-19,3620,3467,153,4.2
19944,CN1707300000000,17,73,"Henry County, IL",Sep-19,25224,24137,1087,4.3
19945,CN1707500000000,17,75,"Iroquois County, IL",Sep-19,14376,13854,522,3.6
19946,CN1707700000000,17,77,"Jackson County, IL",Sep-19,28244,27282,962,3.4
19947,CN1707900000000,17,79,"Jasper County, IL",Sep-19,4651,4468,183,3.9
19948,CN1708100000000,17,81,"Jefferson County, IL",Sep-19,17438,16714,724,4.2
19949,CN1708300000000,17,83,"Jersey County, IL",Sep-19,11041,10631,410,3.7
19950,CN1708500000000,17,85,"Jo Daviess County, IL",Sep-19,10923,10573,350,3.2
19951,CN1708700000000,17,87,"Johnson County, IL",Sep-19,4179,3967,212,5.1
19952,CN1708900000000,17,89,"Kane County, IL",Sep-19,274086,264058,10028,3.7
19953,CN1709100000000,17,91,"Kankakee County, IL",Sep-19,56319,54005,2314,4.1
19954,CN1709300000000,17,93,"Kendall County, IL",Sep-19,68257,66396,1861,2.7
19955,CN1709500000000,17,95,"Knox County, IL",Sep-19,21993,21010,983,4.5
19956,CN1709700000000,17,97,"Lake County, IL",Sep-19,378397,365501,12896,3.4
19957,CN1709900000000,17,99,"LaSalle County, IL",Sep-19,54814,52458,2356,4.3
19958,CN1710100000000,17,101,"Lawrence County, IL",Sep-19,5885,5610,275,4.7
19959,CN1710300000000,17,103,"Lee County, IL",Sep-19,17752,17155,597,3.4
19960,CN1710500000000,17,105,"Livingston County, IL",Sep-19,16789,16202,587,3.5
19961,CN1710700000000,17,107,"Logan County, IL",Sep-19,12781,12269,512,4.0
19962,CN1710900000000,17,109,"McDonough County, IL",Sep-19,14016,13294,722,5.2
19963,CN1711100000000,17,111,"McHenry County, IL",Sep-19,164263,159863,4400,2.7
19964,CN1711300000000,17,113,"McLean County, IL",Sep-19,88942,85880,3062,3.4
19965,CN1711500000000,17,115,"Macon County, IL",Sep-19,48723,46335,2388,4.9
19966,CN1711700000000,17,117,"Macoupin County, IL",Sep-19,23157,22298,859,3.7
19967,CN1711900000000,17,119,"Madison County, IL",Sep-19,135668,130860,4808,3.5
19968,CN1712100000000,17,121,"Marion County, IL",Sep-19,17512,16766,746,4.3
19969,CN1712300000000,17,123,"Marshall County, IL",Sep-19,5333,5116,217,4.1
19970,CN1712500000000,17,125,"Mason County, IL",Sep-19,6387,6095,292,4.6
19971,CN1712700000000,17,127,"Massac County, IL",Sep-19,5675,5382,293,5.2
19972,CN1712900000000,17,129,"Menard County, IL",Sep-19,6494,6296,198,3.0
19973,CN1713100000000,17,131,"Mercer County, IL",Sep-19,8133,7794,339,4.2
19974,CN1713300000000,17,133,"Monroe County, IL",Sep-19,19026,18479,547,2.9
19975,CN1713500000000,17,135,"Montgomery County, IL",Sep-19,11766,11261,505,4.3
19976,CN1713700000000,17,137,"Morgan County, IL",Sep-19,16610,16037,573,3.4
19977,CN1713900000000,17,139,"Moultrie County, IL",Sep-19,7626,7393,233,3.1
19978,CN1714100000000,17,141,"Ogle County, IL",Sep-19,24922,23882,1040,4.2
19979,CN1714300000000,17,143,"Peoria County, IL",Sep-19,85452,81523,3929,4.6
19980,CN1714500000000,17,145,"Perry County, IL",Sep-19,8302,7930,372,4.5
19981,CN1714700000000,17,147,"Piatt County, IL",Sep-19,8732,8462,270,3.1
19982,CN1714900000000,17,149,"Pike County, IL",Sep-19,7027,6779,248,3.5
19983,CN1715100000000,17,151,"Pope County, IL",Sep-19,1683,1596,87,5.2
19984,CN1715300000000,17,153,"Pulaski County, IL",Sep-19,2042,1935,107,5.2
19985,CN1715500000000,17,155,"Putnam County, IL",Sep-19,3048,2931,117,3.8
19986,CN1715700000000,17,157,"Randolph County, IL",Sep-19,14318,13875,443,3.1
19987,CN1715900000000,17,159,"Richland County, IL",Sep-19,7253,6985,268,3.7
19988,CN1716100000000,17,161,"Rock Island County, IL",Sep-19,72182,68772,3410,4.7
19989,CN1716300000000,17,163,"St. Clair County, IL",Sep-19,128007,122746,5261,4.1
19990,CN1716500000000,17,165,"Saline County, IL",Sep-19,9621,9156,465,4.8
19991,CN1716700000000,17,167,"Sangamon County, IL",Sep-19,101252,97631,3621,3.6
19992,CN1716900000000,17,169,"Schuyler County, IL",Sep-19,3294,3170,124,3.8
19993,CN1717100000000,17,171,"Scott County, IL",Sep-19,2533,2440,93,3.7
19994,CN1717300000000,17,173,"Shelby County, IL",Sep-19,10606,10251,355,3.3
19995,CN1717500000000,17,175,"Stark County, IL",Sep-19,2533,2414,119,4.7
19996,CN1717700000000,17,177,"Stephenson County, IL",Sep-19,21847,20950,897,4.1
19997,CN1717900000000,17,179,"Tazewell County, IL",Sep-19,64187,61671,2516,3.9
19998,CN1718100000000,17,181,"Union County, IL",Sep-19,7547,7208,339,4.5
19999,CN1718300000000,17,183,"Vermilion County, IL",Sep-19,33300,31719,1581,4.7
20000,CN1718500000000,17,185,"Wabash County, IL",Sep-19,5985,5774,211,3.5
20001,CN1718700000000,17,187,"Warren County, IL",Sep-19,8460,8153,307,3.6
20002,CN1718900000000,17,189,"Washington County, IL",Sep-19,10313,10082,231,2.2
20003,CN1719100000000,17,191,"Wayne County, IL",Sep-19,7079,6774,305,4.3
20004,CN1719300000000,17,193,"White County, IL",Sep-19,6642,6411,231,3.5
20005,CN1719500000000,17,195,"Whiteside County, IL",Sep-19,28757,27617,1140,4.0
20006,CN1719700000000,17,197,"Will County, IL",Sep-19,354884,343699,11185,3.2
20007,CN1719900000000,17,199,"Williamson County, IL",Sep-19,32336,31088,1248,3.9
20008,CN1720100000000,17,201,"Winnebago County, IL",Sep-19,139626,132266,7360,5.3
20009,CN1720300000000,17,203,"Woodford County, IL",Sep-19,18893,18248,645,3.4
20010,CN1800100000000,18,1,"Adams County, IN",Sep-19,17024,16635,389,2.3
20011,CN1800300000000,18,3,"Allen County, IN",Sep-19,185894,180899,4995,2.7
20012,CN1800500000000,18,5,"Bartholomew County, IN",Sep-19,44791,43880,911,2.0
20013,CN1800700000000,18,7,"Benton County, IN",Sep-19,4484,4372,112,2.5
20014,CN1800900000000,18,9,"Blackford County, IN",Sep-19,4894,4735,159,3.2
20015,CN1801100000000,18,11,"Boone County, IN",Sep-19,36325,35590,735,2.0
20016,CN1801300000000,18,13,"Brown County, IN",Sep-19,7719,7534,185,2.4
20017,CN1801500000000,18,15,"Carroll County, IN",Sep-19,10141,9895,246,2.4
20018,CN1801700000000,18,17,"Cass County, IN",Sep-19,17683,17206,477,2.7
20019,CN1801900000000,18,19,"Clark County, IN",Sep-19,61760,59976,1784,2.9
20020,CN1802100000000,18,21,"Clay County, IN",Sep-19,12043,11685,358,3.0
20021,CN1802300000000,18,23,"Clinton County, IN",Sep-19,17047,16664,383,2.2
20022,CN1802500000000,18,25,"Crawford County, IN",Sep-19,4841,4692,149,3.1
20023,CN1802700000000,18,27,"Daviess County, IN",Sep-19,16593,16243,350,2.1
20024,CN1802900000000,18,29,"Dearborn County, IN",Sep-19,25829,25039,790,3.1
20025,CN1803100000000,18,31,"Decatur County, IN",Sep-19,14499,14157,342,2.4
20026,CN1803300000000,18,33,"DeKalb County, IN",Sep-19,22540,22004,536,2.4
20027,CN1803500000000,18,35,"Delaware County, IN",Sep-19,53971,52268,1703,3.2
20028,CN1803700000000,18,37,"Dubois County, IN",Sep-19,22753,22317,436,1.9
20029,CN1803900000000,18,39,"Elkhart County, IN",Sep-19,111450,108358,3092,2.8
20030,CN1804100000000,18,41,"Fayette County, IN",Sep-19,8620,8229,391,4.5
20031,CN1804300000000,18,43,"Floyd County, IN",Sep-19,41691,40554,1137,2.7
20032,CN1804500000000,18,45,"Fountain County, IN",Sep-19,7940,7720,220,2.8
20033,CN1804700000000,18,47,"Franklin County, IN",Sep-19,11358,11044,314,2.8
20034,CN1804900000000,18,49,"Fulton County, IN",Sep-19,9762,9514,248,2.5
20035,CN1805100000000,18,51,"Gibson County, IN",Sep-19,19494,19085,409,2.1
20036,CN1805300000000,18,53,"Grant County, IN",Sep-19,31186,30182,1004,3.2
20037,CN1805500000000,18,55,"Greene County, IN",Sep-19,13670,13226,444,3.2
20038,CN1805700000000,18,57,"Hamilton County, IN",Sep-19,184544,180609,3935,2.1
20039,CN1805900000000,18,59,"Hancock County, IN",Sep-19,40387,39395,992,2.5
20040,CN1806100000000,18,61,"Harrison County, IN",Sep-19,20275,19752,523,2.6
20041,CN1806300000000,18,63,"Hendricks County, IN",Sep-19,90373,88279,2094,2.3
20042,CN1806500000000,18,65,"Henry County, IN",Sep-19,22102,21501,601,2.7
20043,CN1806700000000,18,67,"Howard County, IN",Sep-19,36857,35671,1186,3.2
20044,CN1806900000000,18,69,"Huntington County, IN",Sep-19,18253,17801,452,2.5
20045,CN1807100000000,18,71,"Jackson County, IN",Sep-19,22821,22310,511,2.2
20046,CN1807300000000,18,73,"Jasper County, IN",Sep-19,16239,15754,485,3.0
20047,CN1807500000000,18,75,"Jay County, IN",Sep-19,9382,9158,224,2.4
20048,CN1807700000000,18,77,"Jefferson County, IN",Sep-19,15009,14565,444,3.0
20049,CN1807900000000,18,79,"Jennings County, IN",Sep-19,13583,13251,332,2.4
20050,CN1808100000000,18,81,"Johnson County, IN",Sep-19,83232,81338,1894,2.3
20051,CN1808300000000,18,83,"Knox County, IN",Sep-19,18404,17919,485,2.6
20052,CN1808500000000,18,85,"Kosciusko County, IN",Sep-19,42011,41025,986,2.3
20053,CN1808700000000,18,87,"LaGrange County, IN",Sep-19,19826,19378,448,2.3
20054,CN1808900000000,18,89,"Lake County, IN",Sep-19,231582,221784,9798,4.2
20055,CN1809100000000,18,91,"LaPorte County, IN",Sep-19,47777,46082,1695,3.5
20056,CN1809300000000,18,93,"Lawrence County, IN",Sep-19,21311,20665,646,3.0
20057,CN1809500000000,18,95,"Madison County, IN",Sep-19,59168,57373,1795,3.0
20058,CN1809700000000,18,97,"Marion County, IN",Sep-19,493075,478775,14300,2.9
20059,CN1809900000000,18,99,"Marshall County, IN",Sep-19,22955,22350,605,2.6
20060,CN1810100000000,18,101,"Martin County, IN",Sep-19,5328,5212,116,2.2
20061,CN1810300000000,18,103,"Miami County, IN",Sep-19,15267,14768,499,3.3
20062,CN1810500000000,18,105,"Monroe County, IN",Sep-19,71317,69480,1837,2.6
20063,CN1810700000000,18,107,"Montgomery County, IN",Sep-19,18801,18302,499,2.7
20064,CN1810900000000,18,109,"Morgan County, IN",Sep-19,36397,35480,917,2.5
20065,CN1811100000000,18,111,"Newton County, IN",Sep-19,6931,6703,228,3.3
20066,CN1811300000000,18,113,"Noble County, IN",Sep-19,23534,22923,611,2.6
20067,CN1811500000000,18,115,"Ohio County, IN",Sep-19,3194,3098,96,3.0
20068,CN1811700000000,18,117,"Orange County, IN",Sep-19,8569,8325,244,2.8
20069,CN1811900000000,18,119,"Owen County, IN",Sep-19,9489,9192,297,3.1
20070,CN1812100000000,18,121,"Parke County, IN",Sep-19,7078,6862,216,3.1
20071,CN1812300000000,18,123,"Perry County, IN",Sep-19,9283,9022,261,2.8
20072,CN1812500000000,18,125,"Pike County, IN",Sep-19,6119,5952,167,2.7
20073,CN1812700000000,18,127,"Porter County, IN",Sep-19,87387,84541,2846,3.3
20074,CN1812900000000,18,129,"Posey County, IN",Sep-19,13579,13253,326,2.4
20075,CN1813100000000,18,131,"Pulaski County, IN",Sep-19,6402,6239,163,2.5
20076,CN1813300000000,18,133,"Putnam County, IN",Sep-19,16742,16290,452,2.7
20077,CN1813500000000,18,135,"Randolph County, IN",Sep-19,11204,10848,356,3.2
20078,CN1813700000000,18,137,"Ripley County, IN",Sep-19,14198,13813,385,2.7
20079,CN1813900000000,18,139,"Rush County, IN",Sep-19,8824,8628,196,2.2
20080,CN1814100000000,18,141,"St. Joseph County, IN",Sep-19,136904,132518,4386,3.2
20081,CN1814300000000,18,143,"Scott County, IN",Sep-19,10551,10237,314,3.0
20082,CN1814500000000,18,145,"Shelby County, IN",Sep-19,23208,22632,576,2.5
20083,CN1814700000000,18,147,"Spencer County, IN",Sep-19,10877,10588,289,2.7
20084,CN1814900000000,18,149,"Starke County, IN",Sep-19,9863,9509,354,3.6
20085,CN1815100000000,18,151,"Steuben County, IN",Sep-19,21065,20605,460,2.2
20086,CN1815300000000,18,153,"Sullivan County, IN",Sep-19,8340,8049,291,3.5
20087,CN1815500000000,18,155,"Switzerland County, IN",Sep-19,4975,4830,145,2.9
20088,CN1815700000000,18,157,"Tippecanoe County, IN",Sep-19,98964,96583,2381,2.4
20089,CN1815900000000,18,159,"Tipton County, IN",Sep-19,9180,8991,189,2.1
20090,CN1816100000000,18,161,"Union County, IN",Sep-19,3543,3445,98,2.8
20091,CN1816300000000,18,163,"Vanderburgh County, IN",Sep-19,94661,92117,2544,2.7
20092,CN1816500000000,18,165,"Vermillion County, IN",Sep-19,6941,6650,291,4.2
20093,CN1816700000000,18,167,"Vigo County, IN",Sep-19,48246,46511,1735,3.6
20094,CN1816900000000,18,169,"Wabash County, IN",Sep-19,15020,14645,375,2.5
20095,CN1817100000000,18,171,"Warren County, IN",Sep-19,4152,4042,110,2.6
20096,CN1817300000000,18,173,"Warrick County, IN",Sep-19,33056,32258,798,2.4
20097,CN1817500000000,18,175,"Washington County, IN",Sep-19,13609,13226,383,2.8
20098,CN1817700000000,18,177,"Wayne County, IN",Sep-19,30522,29589,933,3.1
20099,CN1817900000000,18,179,"Wells County, IN",Sep-19,14344,14040,304,2.1
20100,CN1818100000000,18,181,"White County, IN",Sep-19,13464,13161,303,2.3
20101,CN1818300000000,18,183,"Whitley County, IN",Sep-19,17737,17309,428,2.4
20102,CN1900100000000,19,1,"Adair County, IA",Sep-19,4268,4186,82,1.9
20103,CN1900300000000,19,3,"Adams County, IA",Sep-19,2202,2169,33,1.5
20104,CN1900500000000,19,5,"Allamakee County, IA",Sep-19,7492,7323,169,2.3
20105,CN1900700000000,19,7,"Appanoose County, IA",Sep-19,5778,5567,211,3.7
20106,CN1900900000000,19,9,"Audubon County, IA",Sep-19,3103,3038,65,2.1
20107,CN1901100000000,19,11,"Benton County, IA",Sep-19,13740,13404,336,2.4
20108,CN1901300000000,19,13,"Black Hawk County, IA",Sep-19,70839,68808,2031,2.9
20109,CN1901500000000,19,15,"Boone County, IA",Sep-19,15319,15035,284,1.9
20110,CN1901700000000,19,17,"Bremer County, IA",Sep-19,14188,13904,284,2.0
20111,CN1901900000000,19,19,"Buchanan County, IA",Sep-19,11570,11327,243,2.1
20112,CN1902100000000,19,21,"Buena Vista County, IA",Sep-19,11939,11717,222,1.9
20113,CN1902300000000,19,23,"Butler County, IA",Sep-19,8076,7880,196,2.4
20114,CN1902500000000,19,25,"Calhoun County, IA",Sep-19,4300,4215,85,2.0
20115,CN1902700000000,19,27,"Carroll County, IA",Sep-19,11128,10926,202,1.8
20116,CN1902900000000,19,29,"Cass County, IA",Sep-19,6967,6811,156,2.2
20117,CN1903100000000,19,31,"Cedar County, IA",Sep-19,11014,10801,213,1.9
20118,CN1903300000000,19,33,"Cerro Gordo County, IA",Sep-19,23981,23407,574,2.4
20119,CN1903500000000,19,35,"Cherokee County, IA",Sep-19,6277,6127,150,2.4
20120,CN1903700000000,19,37,"Chickasaw County, IA",Sep-19,6594,6441,153,2.3
20121,CN1903900000000,19,39,"Clarke County, IA",Sep-19,4903,4794,109,2.2
20122,CN1904100000000,19,41,"Clay County, IA",Sep-19,8605,8415,190,2.2
20123,CN1904300000000,19,43,"Clayton County, IA",Sep-19,10292,10064,228,2.2
20124,CN1904500000000,19,45,"Clinton County, IA",Sep-19,23238,22384,854,3.7
20125,CN1904700000000,19,47,"Crawford County, IA",Sep-19,8246,8033,213,2.6
20126,CN1904900000000,19,49,"Dallas County, IA",Sep-19,50680,49801,879,1.7
20127,CN1905100000000,19,51,"Davis County, IA",Sep-19,4293,4144,149,3.5
20128,CN1905300000000,19,53,"Decatur County, IA",Sep-19,4530,4448,82,1.8
20129,CN1905500000000,19,55,"Delaware County, IA",Sep-19,10736,10536,200,1.9
20130,CN1905700000000,19,57,"Des Moines County, IA",Sep-19,19476,18755,721,3.7
20131,CN1905900000000,19,59,"Dickinson County, IA",Sep-19,10540,10323,217,2.1
20132,CN1906100000000,19,61,"Dubuque County, IA",Sep-19,57141,55915,1226,2.1
20133,CN1906300000000,19,63,"Emmet County, IA",Sep-19,5349,5250,99,1.9
20134,CN1906500000000,19,65,"Fayette County, IA",Sep-19,10826,10541,285,2.6
20135,CN1906700000000,19,67,"Floyd County, IA",Sep-19,8760,8418,342,3.9
20136,CN1906900000000,19,69,"Franklin County, IA",Sep-19,5736,5634,102,1.8
20137,CN1907100000000,19,71,"Fremont County, IA",Sep-19,3744,3662,82,2.2
20138,CN1907300000000,19,73,"Greene County, IA",Sep-19,5515,5412,103,1.9
20139,CN1907500000000,19,75,"Grundy County, IA",Sep-19,6646,6485,161,2.4
20140,CN1907700000000,19,77,"Guthrie County, IA",Sep-19,5690,5562,128,2.2
20141,CN1907900000000,19,79,"Hamilton County, IA",Sep-19,7013,6852,161,2.3
20142,CN1908100000000,19,81,"Hancock County, IA",Sep-19,5972,5842,130,2.2
20143,CN1908300000000,19,83,"Hardin County, IA",Sep-19,8166,7959,207,2.5
20144,CN1908500000000,19,85,"Harrison County, IA",Sep-19,7469,7325,144,1.9
20145,CN1908700000000,19,87,"Henry County, IA",Sep-19,10003,9760,243,2.4
20146,CN1908900000000,19,89,"Howard County, IA",Sep-19,5203,5102,101,1.9
20147,CN1909100000000,19,91,"Humboldt County, IA",Sep-19,5223,5103,120,2.3
20148,CN1909300000000,19,93,"Ida County, IA",Sep-19,4164,4104,60,1.4
20149,CN1909500000000,19,95,"Iowa County, IA",Sep-19,10677,10504,173,1.6
20150,CN1909700000000,19,97,"Jackson County, IA",Sep-19,11093,10822,271,2.4
20151,CN1909900000000,19,99,"Jasper County, IA",Sep-19,20221,19739,482,2.4
20152,CN1910100000000,19,101,"Jefferson County, IA",Sep-19,10358,10112,246,2.4
20153,CN1910300000000,19,103,"Johnson County, IA",Sep-19,88492,86799,1693,1.9
20154,CN1910500000000,19,105,"Jones County, IA",Sep-19,10828,10578,250,2.3
20155,CN1910700000000,19,107,"Keokuk County, IA",Sep-19,5268,5112,156,3.0
20156,CN1910900000000,19,109,"Kossuth County, IA",Sep-19,8496,8322,174,2.0
20157,CN1911100000000,19,111,"Lee County, IA",Sep-19,16443,15855,588,3.6
20158,CN1911300000000,19,113,"Linn County, IA",Sep-19,124906,121569,3337,2.7
20159,CN1911500000000,19,115,"Louisa County, IA",Sep-19,6160,5995,165,2.7
20160,CN1911700000000,19,117,"Lucas County, IA",Sep-19,4629,4535,94,2.0
20161,CN1911900000000,19,119,"Lyon County, IA",Sep-19,7142,7054,88,1.2
20162,CN1912100000000,19,121,"Madison County, IA",Sep-19,8701,8469,232,2.7
20163,CN1912300000000,19,123,"Mahaska County, IA",Sep-19,12186,11892,294,2.4
20164,CN1912500000000,19,125,"Marion County, IA",Sep-19,18886,18541,345,1.8
20165,CN1912700000000,19,127,"Marshall County, IA",Sep-19,17962,17414,548,3.1
20166,CN1912900000000,19,129,"Mills County, IA",Sep-19,7520,7367,153,2.0
20167,CN1913100000000,19,131,"Mitchell County, IA",Sep-19,7116,7014,102,1.4
20168,CN1913300000000,19,133,"Monona County, IA",Sep-19,4497,4384,113,2.5
20169,CN1913500000000,19,135,"Monroe County, IA",Sep-19,4145,4015,130,3.1
20170,CN1913700000000,19,137,"Montgomery County, IA",Sep-19,5017,4908,109,2.2
20171,CN1913900000000,19,139,"Muscatine County, IA",Sep-19,22325,21786,539,2.4
20172,CN1914100000000,19,141,"O'Brien County, IA",Sep-19,8387,8235,152,1.8
20173,CN1914300000000,19,143,"Osceola County, IA",Sep-19,3530,3470,60,1.7
20174,CN1914500000000,19,145,"Page County, IA",Sep-19,6428,6270,158,2.5
20175,CN1914700000000,19,147,"Palo Alto County, IA",Sep-19,4866,4781,85,1.7
20176,CN1914900000000,19,149,"Plymouth County, IA",Sep-19,15146,14815,331,2.2
20177,CN1915100000000,19,151,"Pocahontas County, IA",Sep-19,4924,4852,72,1.5
20178,CN1915300000000,19,153,"Polk County, IA",Sep-19,275103,268338,6765,2.5
20179,CN1915500000000,19,155,"Pottawattamie County, IA",Sep-19,49443,48403,1040,2.1
20180,CN1915700000000,19,157,"Poweshiek County, IA",Sep-19,10815,10600,215,2.0
20181,CN1915900000000,19,159,"Ringgold County, IA",Sep-19,2514,2455,59,2.3
20182,CN1916100000000,19,161,"Sac County, IA",Sep-19,5358,5257,101,1.9
20183,CN1916300000000,19,163,"Scott County, IA",Sep-19,91467,88607,2860,3.1
20184,CN1916500000000,19,165,"Shelby County, IA",Sep-19,6770,6651,119,1.8
20185,CN1916700000000,19,167,"Sioux County, IA",Sep-19,21556,21262,294,1.4
20186,CN1916900000000,19,169,"Story County, IA",Sep-19,61172,60174,998,1.6
20187,CN1917100000000,19,171,"Tama County, IA",Sep-19,9510,9288,222,2.3
20188,CN1917300000000,19,173,"Taylor County, IA",Sep-19,3231,3173,58,1.8
20189,CN1917500000000,19,175,"Union County, IA",Sep-19,6395,6226,169,2.6
20190,CN1917700000000,19,177,"Van Buren County, IA",Sep-19,3381,3283,98,2.9
20191,CN1917900000000,19,179,"Wapello County, IA",Sep-19,18277,17484,793,4.3
20192,CN1918100000000,19,181,"Warren County, IA",Sep-19,28926,28318,608,2.1
20193,CN1918300000000,19,183,"Washington County, IA",Sep-19,12243,12001,242,2.0
20194,CN1918500000000,19,185,"Wayne County, IA",Sep-19,2841,2769,72,2.5
20195,CN1918700000000,19,187,"Webster County, IA",Sep-19,19889,19405,484,2.4
20196,CN1918900000000,19,189,"Winnebago County, IA",Sep-19,5247,5123,124,2.4
20197,CN1919100000000,19,191,"Winneshiek County, IA",Sep-19,12585,12349,236,1.9
20198,CN1919300000000,19,193,"Woodbury County, IA",Sep-19,56833,55551,1282,2.3
20199,CN1919500000000,19,195,"Worth County, IA",Sep-19,4293,4200,93,2.2
20200,CN1919700000000,19,197,"Wright County, IA",Sep-19,7147,6981,166,2.3
20201,CN2000100000000,20,1,"Allen County, KS",Sep-19,6404,6217,187,2.9
20202,CN2000300000000,20,3,"Anderson County, KS",Sep-19,4231,4116,115,2.7
20203,CN2000500000000,20,5,"Atchison County, KS",Sep-19,7081,6733,348,4.9
20204,CN2000700000000,20,7,"Barber County, KS",Sep-19,2392,2337,55,2.3
20205,CN2000900000000,20,9,"Barton County, KS",Sep-19,13434,13058,376,2.8
20206,CN2001100000000,20,11,"Bourbon County, KS",Sep-19,6492,6263,229,3.5
20207,CN2001300000000,20,13,"Brown County, KS",Sep-19,5396,5261,135,2.5
20208,CN2001500000000,20,15,"Butler County, KS",Sep-19,32385,31469,916,2.8
20209,CN2001700000000,20,17,"Chase County, KS",Sep-19,1531,1501,30,2.0
20210,CN2001900000000,20,19,"Chautauqua County, KS",Sep-19,1450,1407,43,3.0
20211,CN2002100000000,20,21,"Cherokee County, KS",Sep-19,10137,9838,299,2.9
20212,CN2002300000000,20,23,"Cheyenne County, KS",Sep-19,1375,1350,25,1.8
20213,CN2002500000000,20,25,"Clark County, KS",Sep-19,1118,1096,22,2.0
20214,CN2002700000000,20,27,"Clay County, KS",Sep-19,3927,3832,95,2.4
20215,CN2002900000000,20,29,"Cloud County, KS",Sep-19,3832,3725,107,2.8
20216,CN2003100000000,20,31,"Coffey County, KS",Sep-19,4181,4046,135,3.2
20217,CN2003300000000,20,33,"Comanche County, KS",Sep-19,881,859,22,2.5
20218,CN2003500000000,20,35,"Cowley County, KS",Sep-19,16317,15844,473,2.9
20219,CN2003700000000,20,37,"Crawford County, KS",Sep-19,18482,17849,633,3.4
20220,CN2003900000000,20,39,"Decatur County, KS",Sep-19,1277,1242,35,2.7
20221,CN2004100000000,20,41,"Dickinson County, KS",Sep-19,8859,8597,262,3.0
20222,CN2004300000000,20,43,"Doniphan County, KS",Sep-19,4153,4046,107,2.6
20223,CN2004500000000,20,45,"Douglas County, KS",Sep-19,65602,63967,1635,2.5
20224,CN2004700000000,20,47,"Edwards County, KS",Sep-19,1513,1480,33,2.2
20225,CN2004900000000,20,49,"Elk County, KS",Sep-19,1198,1158,40,3.3
20226,CN2005100000000,20,51,"Ellis County, KS",Sep-19,17184,16866,318,1.9
20227,CN2005300000000,20,53,"Ellsworth County, KS",Sep-19,2780,2715,65,2.3
20228,CN2005500000000,20,55,"Finney County, KS",Sep-19,20725,20300,425,2.1
20229,CN2005700000000,20,57,"Ford County, KS",Sep-19,17284,16905,379,2.2
20230,CN2005900000000,20,59,"Franklin County, KS",Sep-19,14032,13653,379,2.7
20231,CN2006100000000,20,61,"Geary County, KS",Sep-19,11280,10840,440,3.9
20232,CN2006300000000,20,63,"Gove County, KS",Sep-19,1537,1510,27,1.8
20233,CN2006500000000,20,65,"Graham County, KS",Sep-19,1157,1127,30,2.6
20234,CN2006700000000,20,67,"Grant County, KS",Sep-19,3375,3301,74,2.2
20235,CN2006900000000,20,69,"Gray County, KS",Sep-19,3446,3388,58,1.7
20236,CN2007100000000,20,71,"Greeley County, KS",Sep-19,849,829,20,2.4
20237,CN2007300000000,20,73,"Greenwood County, KS",Sep-19,3285,3200,85,2.6
20238,CN2007500000000,20,75,"Hamilton County, KS",Sep-19,1763,1738,25,1.4
20239,CN2007700000000,20,77,"Harper County, KS",Sep-19,2844,2780,64,2.3
20240,CN2007900000000,20,79,"Harvey County, KS",Sep-19,16984,16546,438,2.6
20241,CN2008100000000,20,81,"Haskell County, KS",Sep-19,2299,2259,40,1.7
20242,CN2008300000000,20,83,"Hodgeman County, KS",Sep-19,1042,1020,22,2.1
20243,CN2008500000000,20,85,"Jackson County, KS",Sep-19,7111,6942,169,2.4
20244,CN2008700000000,20,87,"Jefferson County, KS",Sep-19,10019,9780,239,2.4
20245,CN2008900000000,20,89,"Jewell County, KS",Sep-19,1330,1300,30,2.3
20246,CN2009100000000,20,91,"Johnson County, KS",Sep-19,336257,328245,8012,2.4
20247,CN2009300000000,20,93,"Kearny County, KS",Sep-19,2131,2093,38,1.8
20248,CN2009500000000,20,95,"Kingman County, KS",Sep-19,3507,3417,90,2.6
20249,CN2009700000000,20,97,"Kiowa County, KS",Sep-19,1362,1337,25,1.8
20250,CN2009900000000,20,99,"Labette County, KS",Sep-19,9888,9570,318,3.2
20251,CN2010100000000,20,101,"Lane County, KS",Sep-19,828,806,22,2.7
20252,CN2010300000000,20,103,"Leavenworth County, KS",Sep-19,36207,35146,1061,2.9
20253,CN2010500000000,20,105,"Lincoln County, KS",Sep-19,1734,1701,33,1.9
20254,CN2010700000000,20,107,"Linn County, KS",Sep-19,4420,4211,209,4.7
20255,CN2010900000000,20,109,"Logan County, KS",Sep-19,1715,1683,32,1.9
20256,CN2011100000000,20,111,"Lyon County, KS",Sep-19,16624,16154,470,2.8
20257,CN2011300000000,20,113,"McPherson County, KS",Sep-19,17210,16876,334,1.9
20258,CN2011500000000,20,115,"Marion County, KS",Sep-19,6093,5944,149,2.4
20259,CN2011700000000,20,117,"Marshall County, KS",Sep-19,5610,5485,125,2.2
20260,CN2011900000000,20,119,"Meade County, KS",Sep-19,2265,2223,42,1.9
20261,CN2012100000000,20,121,"Miami County, KS",Sep-19,17331,16863,468,2.7
20262,CN2012300000000,20,123,"Mitchell County, KS",Sep-19,3340,3275,65,1.9
20263,CN2012500000000,20,125,"Montgomery County, KS",Sep-19,14573,14067,506,3.5
20264,CN2012700000000,20,127,"Morris County, KS",Sep-19,3077,3012,65,2.1
20265,CN2012900000000,20,129,"Morton County, KS",Sep-19,1182,1149,33,2.8
20266,CN2013100000000,20,131,"Nemaha County, KS",Sep-19,5507,5372,135,2.5
20267,CN2013300000000,20,133,"Neosho County, KS",Sep-19,6212,5953,259,4.2
20268,CN2013500000000,20,135,"Ness County, KS",Sep-19,1409,1379,30,2.1
20269,CN2013700000000,20,137,"Norton County, KS",Sep-19,2764,2714,50,1.8
20270,CN2013900000000,20,139,"Osage County, KS",Sep-19,7921,7690,231,2.9
20271,CN2014100000000,20,141,"Osborne County, KS",Sep-19,2104,2071,33,1.6
20272,CN2014300000000,20,143,"Ottawa County, KS",Sep-19,3040,2971,69,2.3
20273,CN2014500000000,20,145,"Pawnee County, KS",Sep-19,3004,2935,69,2.3
20274,CN2014700000000,20,147,"Phillips County, KS",Sep-19,2720,2665,55,2.0
20275,CN2014900000000,20,149,"Pottawatomie County, KS",Sep-19,12622,12341,281,2.2
20276,CN2015100000000,20,151,"Pratt County, KS",Sep-19,4979,4884,95,1.9
20277,CN2015300000000,20,153,"Rawlins County, KS",Sep-19,1594,1566,28,1.8
20278,CN2015500000000,20,155,"Reno County, KS",Sep-19,30012,29215,797,2.7
20279,CN2015700000000,20,157,"Republic County, KS",Sep-19,2356,2308,48,2.0
20280,CN2015900000000,20,159,"Rice County, KS",Sep-19,5279,5157,122,2.3
20281,CN2016100000000,20,161,"Riley County, KS",Sep-19,35535,34686,849,2.4
20282,CN2016300000000,20,163,"Rooks County, KS",Sep-19,2590,2516,74,2.9
20283,CN2016500000000,20,165,"Rush County, KS",Sep-19,1651,1614,37,2.2
20284,CN2016700000000,20,167,"Russell County, KS",Sep-19,3260,3173,87,2.7
20285,CN2016900000000,20,169,"Saline County, KS",Sep-19,29890,29118,772,2.6
20286,CN2017100000000,20,171,"Scott County, KS",Sep-19,2965,2918,47,1.6
20287,CN2017300000000,20,173,"Sedgwick County, KS",Sep-19,249392,241829,7563,3.0
20288,CN2017500000000,20,175,"Seward County, KS",Sep-19,9558,9287,271,2.8
20289,CN2017700000000,20,177,"Shawnee County, KS",Sep-19,89127,86573,2554,2.9
20290,CN2017900000000,20,179,"Sheridan County, KS",Sep-19,1493,1466,27,1.8
20291,CN2018100000000,20,181,"Sherman County, KS",Sep-19,2889,2820,69,2.4
20292,CN2018300000000,20,183,"Smith County, KS",Sep-19,2033,1991,42,2.1
20293,CN2018500000000,20,185,"Stafford County, KS",Sep-19,2106,2059,47,2.2
20294,CN2018700000000,20,187,"Stanton County, KS",Sep-19,1041,1018,23,2.2
20295,CN2018900000000,20,189,"Stevens County, KS",Sep-19,2714,2650,64,2.4
20296,CN2019100000000,20,191,"Sumner County, KS",Sep-19,10962,10638,324,3.0
20297,CN2019300000000,20,193,"Thomas County, KS",Sep-19,4391,4309,82,1.9
20298,CN2019500000000,20,195,"Trego County, KS",Sep-19,1461,1429,32,2.2
20299,CN2019700000000,20,197,"Wabaunsee County, KS",Sep-19,3680,3586,94,2.6
20300,CN2019900000000,20,199,"Wallace County, KS",Sep-19,873,858,15,1.7
20301,CN2020100000000,20,201,"Washington County, KS",Sep-19,3044,2986,58,1.9
20302,CN2020300000000,20,203,"Wichita County, KS",Sep-19,1317,1295,22,1.7
20303,CN2020500000000,20,205,"Wilson County, KS",Sep-19,3981,3851,130,3.3
20304,CN2020700000000,20,207,"Woodson County, KS",Sep-19,1575,1520,55,3.5
20305,CN2020900000000,20,209,"Wyandotte County, KS",Sep-19,76393,73694,2699,3.5
20306,CN2100100000000,21,1,"Adair County, KY",Sep-19,7131,6814,317,4.4
20307,CN2100300000000,21,3,"Allen County, KY",Sep-19,9055,8718,337,3.7
20308,CN2100500000000,21,5,"Anderson County, KY",Sep-19,12142,11763,379,3.1
20309,CN2100700000000,21,7,"Ballard County, KY",Sep-19,3493,3331,162,4.6
20310,CN2100900000000,21,9,"Barren County, KY",Sep-19,18819,18087,732,3.9
20311,CN2101100000000,21,11,"Bath County, KY",Sep-19,4580,4346,234,5.1
20312,CN2101300000000,21,13,"Bell County, KY",Sep-19,8357,7821,536,6.4
20313,CN2101500000000,21,15,"Boone County, KY",Sep-19,71669,69482,2187,3.1
20314,CN2101700000000,21,17,"Bourbon County, KY",Sep-19,9735,9399,336,3.5
20315,CN2101900000000,21,19,"Boyd County, KY",Sep-19,17888,17003,885,4.9
20316,CN2102100000000,21,21,"Boyle County, KY",Sep-19,12427,11904,523,4.2
20317,CN2102300000000,21,23,"Bracken County, KY",Sep-19,3810,3665,145,3.8
20318,CN2102500000000,21,25,"Breathitt County, KY",Sep-19,3378,3156,222,6.6
20319,CN2102700000000,21,27,"Breckinridge County, KY",Sep-19,7809,7455,354,4.5
20320,CN2102900000000,21,29,"Bullitt County, KY",Sep-19,43172,41565,1607,3.7
20321,CN2103100000000,21,31,"Butler County, KY",Sep-19,5108,4908,200,3.9
20322,CN2103300000000,21,33,"Caldwell County, KY",Sep-19,5428,5181,247,4.6
20323,CN2103500000000,21,35,"Calloway County, KY",Sep-19,18778,18116,662,3.5
20324,CN2103700000000,21,37,"Campbell County, KY",Sep-19,51241,49662,1579,3.1
20325,CN2103900000000,21,39,"Carlisle County, KY",Sep-19,2281,2199,82,3.6
20326,CN2104100000000,21,41,"Carroll County, KY",Sep-19,5271,5076,195,3.7
20327,CN2104300000000,21,43,"Carter County, KY",Sep-19,9820,9115,705,7.2
20328,CN2104500000000,21,45,"Casey County, KY",Sep-19,6658,6396,262,3.9
20329,CN2104700000000,21,47,"Christian County, KY",Sep-19,25239,23886,1353,5.4
20330,CN2104900000000,21,49,"Clark County, KY",Sep-19,17283,16666,617,3.6
20331,CN2105100000000,21,51,"Clay County, KY",Sep-19,5199,4863,336,6.5
20332,CN2105300000000,21,53,"Clinton County, KY",Sep-19,3973,3798,175,4.4
20333,CN2105500000000,21,55,"Crittenden County, KY",Sep-19,3760,3601,159,4.2
20334,CN2105700000000,21,57,"Cumberland County, KY",Sep-19,3206,3109,97,3.0
20335,CN2105900000000,21,59,"Daviess County, KY",Sep-19,47641,46005,1636,3.4
20336,CN2106100000000,21,61,"Edmonson County, KY",Sep-19,4837,4648,189,3.9
20337,CN2106300000000,21,63,"Elliott County, KY",Sep-19,2037,1883,154,7.6
20338,CN2106500000000,21,65,"Estill County, KY",Sep-19,5403,5169,234,4.3
20339,CN2106700000000,21,67,"Fayette County, KY",Sep-19,176388,171207,5181,2.9
20340,CN2106900000000,21,69,"Fleming County, KY",Sep-19,6087,5805,282,4.6
20341,CN2107100000000,21,71,"Floyd County, KY",Sep-19,10968,10343,625,5.7
20342,CN2107300000000,21,73,"Franklin County, KY",Sep-19,25474,24635,839,3.3
20343,CN2107500000000,21,75,"Fulton County, KY",Sep-19,2052,1952,100,4.9
20344,CN2107700000000,21,77,"Gallatin County, KY",Sep-19,4104,3962,142,3.5
20345,CN2107900000000,21,79,"Garrard County, KY",Sep-19,7698,7377,321,4.2
20346,CN2108100000000,21,81,"Grant County, KY",Sep-19,11784,11371,413,3.5
20347,CN2108300000000,21,83,"Graves County, KY",Sep-19,15754,15107,647,4.1
20348,CN2108500000000,21,85,"Grayson County, KY",Sep-19,11002,10511,491,4.5
20349,CN2108700000000,21,87,"Green County, KY",Sep-19,5103,4899,204,4.0
20350,CN2108900000000,21,89,"Greenup County, KY",Sep-19,13458,12651,807,6.0
20351,CN2109100000000,21,91,"Hancock County, KY",Sep-19,4001,3864,137,3.4
20352,CN2109300000000,21,93,"Hardin County, KY",Sep-19,49131,47303,1828,3.7
20353,CN2109500000000,21,95,"Harlan County, KY",Sep-19,6786,5959,827,12.2
20354,CN2109700000000,21,97,"Harrison County, KY",Sep-19,8898,8550,348,3.9
20355,CN2109900000000,21,99,"Hart County, KY",Sep-19,7786,7475,311,4.0
20356,CN2110100000000,21,101,"Henderson County, KY",Sep-19,22079,21337,742,3.4
20357,CN2110300000000,21,103,"Henry County, KY",Sep-19,8238,7979,259,3.1
20358,CN2110500000000,21,105,"Hickman County, KY",Sep-19,1707,1637,70,4.1
20359,CN2110700000000,21,107,"Hopkins County, KY",Sep-19,18511,17786,725,3.9
20360,CN2110900000000,21,109,"Jackson County, KY",Sep-19,4157,3920,237,5.7
20361,CN2111100000000,21,111,"Jefferson County, KY",Sep-19,403436,388763,14673,3.6
20362,CN2111300000000,21,113,"Jessamine County, KY",Sep-19,26712,25845,867,3.2
20363,CN2111500000000,21,115,"Johnson County, KY",Sep-19,6723,6329,394,5.9
20364,CN2111700000000,21,117,"Kenton County, KY",Sep-19,88699,85857,2842,3.2
20365,CN2111900000000,21,119,"Knott County, KY",Sep-19,4470,4196,274,6.1
20366,CN2112100000000,21,121,"Knox County, KY",Sep-19,9882,9352,530,5.4
20367,CN2112300000000,21,123,"Larue County, KY",Sep-19,5945,5704,241,4.1
20368,CN2112500000000,21,125,"Laurel County, KY",Sep-19,24618,23489,1129,4.6
20369,CN2112700000000,21,127,"Lawrence County, KY",Sep-19,5258,4915,343,6.5
20370,CN2112900000000,21,129,"Lee County, KY",Sep-19,2034,1937,97,4.8
20371,CN2113100000000,21,131,"Leslie County, KY",Sep-19,2738,2482,256,9.3
20372,CN2113300000000,21,133,"Letcher County, KY",Sep-19,6420,5912,508,7.9
20373,CN2113500000000,21,135,"Lewis County, KY",Sep-19,4563,4220,343,7.5
20374,CN2113700000000,21,137,"Lincoln County, KY",Sep-19,9203,8807,396,4.3
20375,CN2113900000000,21,139,"Livingston County, KY",Sep-19,3640,3481,159,4.4
20376,CN2114100000000,21,141,"Logan County, KY",Sep-19,12564,12084,480,3.8
20377,CN2114300000000,21,143,"Lyon County, KY",Sep-19,3102,2983,119,3.8
20378,CN2114500000000,21,145,"McCracken County, KY",Sep-19,29297,27985,1312,4.5
20379,CN2114700000000,21,147,"McCreary County, KY",Sep-19,4661,4409,252,5.4
20380,CN2114900000000,21,149,"McLean County, KY",Sep-19,4213,4053,160,3.8
20381,CN2115100000000,21,151,"Madison County, KY",Sep-19,47497,45895,1602,3.4
20382,CN2115300000000,21,153,"Magoffin County, KY",Sep-19,3175,2859,316,10.0
20383,CN2115500000000,21,155,"Marion County, KY",Sep-19,9714,9375,339,3.5
20384,CN2115700000000,21,157,"Marshall County, KY",Sep-19,15293,14727,566,3.7
20385,CN2115900000000,21,159,"Martin County, KY",Sep-19,2762,2590,172,6.2
20386,CN2116100000000,21,161,"Mason County, KY",Sep-19,7054,6673,381,5.4
20387,CN2116300000000,21,163,"Meade County, KY",Sep-19,12293,11773,520,4.2
20388,CN2116500000000,21,165,"Menifee County, KY",Sep-19,2314,2185,129,5.6
20389,CN2116700000000,21,167,"Mercer County, KY",Sep-19,10048,9639,409,4.1
20390,CN2116900000000,21,169,"Metcalfe County, KY",Sep-19,4091,3901,190,4.6
20391,CN2117100000000,21,171,"Monroe County, KY",Sep-19,4708,4553,155,3.3
20392,CN2117300000000,21,173,"Montgomery County, KY",Sep-19,11702,11171,531,4.5
20393,CN2117500000000,21,175,"Morgan County, KY",Sep-19,4557,4362,195,4.3
20394,CN2117700000000,21,177,"Muhlenberg County, KY",Sep-19,10397,9812,585,5.6
20395,CN2117900000000,21,179,"Nelson County, KY",Sep-19,23204,22285,919,4.0
20396,CN2118100000000,21,181,"Nicholas County, KY",Sep-19,3321,3186,135,4.1
20397,CN2118300000000,21,183,"Ohio County, KY",Sep-19,9836,9398,438,4.5
20398,CN2118500000000,21,185,"Oldham County, KY",Sep-19,33523,32564,959,2.9
20399,CN2118700000000,21,187,"Owen County, KY",Sep-19,5202,5005,197,3.8
20400,CN2118900000000,21,189,"Owsley County, KY",Sep-19,1115,1045,70,6.3
20401,CN2119100000000,21,191,"Pendleton County, KY",Sep-19,6999,6780,219,3.1
20402,CN2119300000000,21,193,"Perry County, KY",Sep-19,8296,7808,488,5.9
20403,CN2119500000000,21,195,"Pike County, KY",Sep-19,19914,18940,974,4.9
20404,CN2119700000000,21,197,"Powell County, KY",Sep-19,5035,4814,221,4.4
20405,CN2119900000000,21,199,"Pulaski County, KY",Sep-19,26824,25693,1131,4.2
20406,CN2120100000000,21,201,"Robertson County, KY",Sep-19,824,789,35,4.2
20407,CN2120300000000,21,203,"Rockcastle County, KY",Sep-19,6709,6417,292,4.4
20408,CN2120500000000,21,205,"Rowan County, KY",Sep-19,10468,10000,468,4.5
20409,CN2120700000000,21,207,"Russell County, KY",Sep-19,6237,5933,304,4.9
20410,CN2120900000000,21,209,"Scott County, KY",Sep-19,29382,28446,936,3.2
20411,CN2121100000000,21,211,"Shelby County, KY",Sep-19,25676,24857,819,3.2
20412,CN2121300000000,21,213,"Simpson County, KY",Sep-19,8957,8529,428,4.8
20413,CN2121500000000,21,215,"Spencer County, KY",Sep-19,10287,9951,336,3.3
20414,CN2121700000000,21,217,"Taylor County, KY",Sep-19,12692,12191,501,3.9
20415,CN2121900000000,21,219,"Todd County, KY",Sep-19,5456,5274,182,3.3
20416,CN2122100000000,21,221,"Trigg County, KY",Sep-19,6012,5776,236,3.9
20417,CN2122300000000,21,223,"Trimble County, KY",Sep-19,3892,3742,150,3.9
20418,CN2122500000000,21,225,"Union County, KY",Sep-19,6103,5869,234,3.8
20419,CN2122700000000,21,227,"Warren County, KY",Sep-19,65784,63620,2164,3.3
20420,CN2122900000000,21,229,"Washington County, KY",Sep-19,6223,6004,219,3.5
20421,CN2123100000000,21,231,"Wayne County, KY",Sep-19,7386,7015,371,5.0
20422,CN2123300000000,21,233,"Webster County, KY",Sep-19,5730,5528,202,3.5
20423,CN2123500000000,21,235,"Whitley County, KY",Sep-19,13699,13054,645,4.7
20424,CN2123700000000,21,237,"Wolfe County, KY",Sep-19,1982,1867,115,5.8
20425,CN2123900000000,21,239,"Woodford County, KY",Sep-19,14850,14427,423,2.8
20426,CN2200100000000,22,1,"Acadia Parish, LA",Sep-19,24053,22718,1335,5.6
20427,CN2200300000000,22,3,"Allen Parish, LA",Sep-19,8928,8427,501,5.6
20428,CN2200500000000,22,5,"Ascension Parish, LA",Sep-19,63677,60924,2753,4.3
20429,CN2200700000000,22,7,"Assumption Parish, LA",Sep-19,8933,8392,541,6.1
20430,CN2200900000000,22,9,"Avoyelles Parish, LA",Sep-19,15254,14365,889,5.8
20431,CN2201100000000,22,11,"Beauregard Parish, LA",Sep-19,14699,13938,761,5.2
20432,CN2201300000000,22,13,"Bienville Parish, LA",Sep-19,5535,5209,326,5.9
20433,CN2201500000000,22,15,"Bossier Parish, LA",Sep-19,57416,54860,2556,4.5
20434,CN2201700000000,22,17,"Caddo Parish, LA",Sep-19,102984,97334,5650,5.5
20435,CN2201900000000,22,19,"Calcasieu Parish, LA",Sep-19,105274,100733,4541,4.3
20436,CN2202100000000,22,21,"Caldwell Parish, LA",Sep-19,3808,3578,230,6.0
20437,CN2202300000000,22,23,"Cameron Parish, LA",Sep-19,3905,3755,150,3.8
20438,CN2202500000000,22,25,"Catahoula Parish, LA",Sep-19,3546,3327,219,6.2
20439,CN2202700000000,22,27,"Claiborne Parish, LA",Sep-19,5840,5503,337,5.8
20440,CN2202900000000,22,29,"Concordia Parish, LA",Sep-19,7254,6803,451,6.2
20441,CN2203100000000,22,31,"De Soto Parish, LA",Sep-19,10863,10171,692,6.4
20442,CN2203300000000,22,33,"East Baton Rouge Parish, LA",Sep-19,229560,218879,10681,4.7
20443,CN2203500000000,22,35,"East Carroll Parish, LA",Sep-19,1917,1734,183,9.5
20444,CN2203700000000,22,37,"East Feliciana Parish, LA",Sep-19,7964,7584,380,4.8
20445,CN2203900000000,22,39,"Evangeline Parish, LA",Sep-19,11965,11246,719,6.0
20446,CN2204100000000,22,41,"Franklin Parish, LA",Sep-19,7532,6987,545,7.2
20447,CN2204300000000,22,43,"Grant Parish, LA",Sep-19,8198,7728,470,5.7
20448,CN2204500000000,22,45,"Iberia Parish, LA",Sep-19,28297,26732,1565,5.5
20449,CN2204700000000,22,47,"Iberville Parish, LA",Sep-19,14037,13173,864,6.2
20450,CN2204900000000,22,49,"Jackson Parish, LA",Sep-19,6887,6556,331,4.8
20451,CN2205100000000,22,51,"Jefferson Parish, LA",Sep-19,213041,203835,9206,4.3
20452,CN2205300000000,22,53,"Jefferson Davis Parish, LA",Sep-19,13317,12674,643,4.8
20453,CN2205500000000,22,55,"Lafayette Parish, LA",Sep-19,113688,108580,5108,4.5
20454,CN2205700000000,22,57,"Lafourche Parish, LA",Sep-19,42490,40540,1950,4.6
20455,CN2205900000000,22,59,"LaSalle Parish, LA",Sep-19,6792,6496,296,4.4
20456,CN2206100000000,22,61,"Lincoln Parish, LA",Sep-19,22125,20836,1289,5.8
20457,CN2206300000000,22,63,"Livingston Parish, LA",Sep-19,68552,65613,2939,4.3
20458,CN2206500000000,22,65,"Madison Parish, LA",Sep-19,3597,3313,284,7.9
20459,CN2206700000000,22,67,"Morehouse Parish, LA",Sep-19,10019,9220,799,8.0
20460,CN2206900000000,22,69,"Natchitoches Parish, LA",Sep-19,16861,15808,1053,6.2
20461,CN2207100000000,22,71,"Orleans Parish, LA",Sep-19,178350,169432,8918,5.0
20462,CN2207300000000,22,73,"Ouachita Parish, LA",Sep-19,69869,66063,3806,5.4
20463,CN2207500000000,22,75,"Plaquemines Parish, LA",Sep-19,10125,9668,457,4.5
20464,CN2207700000000,22,77,"Pointe Coupee Parish, LA",Sep-19,9933,9383,550,5.5
20465,CN2207900000000,22,79,"Rapides Parish, LA",Sep-19,55265,52356,2909,5.3
20466,CN2208100000000,22,81,"Red River Parish, LA",Sep-19,3788,3591,197,5.2
20467,CN2208300000000,22,83,"Richland Parish, LA",Sep-19,8286,7766,520,6.3
20468,CN2208500000000,22,85,"Sabine Parish, LA",Sep-19,9367,8869,498,5.3
20469,CN2208700000000,22,87,"St. Bernard Parish, LA",Sep-19,19894,18881,1013,5.1
20470,CN2208900000000,22,89,"St. Charles Parish, LA",Sep-19,25081,23940,1141,4.5
20471,CN2209100000000,22,91,"St. Helena Parish, LA",Sep-19,4252,4005,247,5.8
20472,CN2209300000000,22,93,"St. James Parish, LA",Sep-19,9203,8643,560,6.1
20473,CN2209500000000,22,95,"St. John the Baptist Parish, LA",Sep-19,19544,18436,1108,5.7
20474,CN2209700000000,22,97,"St. Landry Parish, LA",Sep-19,32079,30013,2066,6.4
20475,CN2209900000000,22,99,"St. Martin Parish, LA",Sep-19,22201,21068,1133,5.1
20476,CN2210100000000,22,101,"St. Mary Parish, LA",Sep-19,19948,18766,1182,5.9
20477,CN2210300000000,22,103,"St. Tammany Parish, LA",Sep-19,119187,113973,5214,4.4
20478,CN2210500000000,22,105,"Tangipahoa Parish, LA",Sep-19,55006,51904,3102,5.6
20479,CN2210700000000,22,107,"Tensas Parish, LA",Sep-19,1485,1372,113,7.6
20480,CN2210900000000,22,109,"Terrebonne Parish, LA",Sep-19,46873,44660,2213,4.7
20481,CN2211100000000,22,111,"Union Parish, LA",Sep-19,9144,8621,523,5.7
20482,CN2211300000000,22,113,"Vermilion Parish, LA",Sep-19,24232,22992,1240,5.1
20483,CN2211500000000,22,115,"Vernon Parish, LA",Sep-19,16162,15185,977,6.0
20484,CN2211700000000,22,117,"Washington Parish, LA",Sep-19,16618,15603,1015,6.1
20485,CN2211900000000,22,119,"Webster Parish, LA",Sep-19,14447,13545,902,6.2
20486,CN2212100000000,22,121,"West Baton Rouge Parish, LA",Sep-19,13563,12933,630,4.6
20487,CN2212300000000,22,123,"West Carroll Parish, LA",Sep-19,3681,3352,329,8.9
20488,CN2212500000000,22,125,"West Feliciana Parish, LA",Sep-19,5384,5154,230,4.3
20489,CN2212700000000,22,127,"Winn Parish, LA",Sep-19,4948,4639,309,6.2
20490,CN2300100000000,23,1,"Androscoggin County, ME",Sep-19,55002,53705,1297,2.4
20491,CN2300300000000,23,3,"Aroostook County, ME",Sep-19,29453,28468,985,3.3
20492,CN2300500000000,23,5,"Cumberland County, ME",Sep-19,165786,162492,3294,2.0
20493,CN2300700000000,23,7,"Franklin County, ME",Sep-19,13885,13449,436,3.1
20494,CN2300900000000,23,9,"Hancock County, ME",Sep-19,30168,29549,619,2.1
20495,CN2301100000000,23,11,"Kennebec County, ME",Sep-19,61705,60269,1436,2.3
20496,CN2301300000000,23,13,"Knox County, ME",Sep-19,20078,19655,423,2.1
20497,CN2301500000000,23,15,"Lincoln County, ME",Sep-19,17085,16720,365,2.1
20498,CN2301700000000,23,17,"Oxford County, ME",Sep-19,25851,25140,711,2.8
20499,CN2301900000000,23,19,"Penobscot County, ME",Sep-19,76909,75018,1891,2.5
20500,CN2302100000000,23,21,"Piscataquis County, ME",Sep-19,7219,7025,194,2.7
20501,CN2302300000000,23,23,"Sagadahoc County, ME",Sep-19,19462,19091,371,1.9
20502,CN2302500000000,23,25,"Somerset County, ME",Sep-19,22145,21395,750,3.4
20503,CN2302700000000,23,27,"Waldo County, ME",Sep-19,20539,20072,467,2.3
20504,CN2302900000000,23,29,"Washington County, ME",Sep-19,13113,12672,441,3.4
20505,CN2303100000000,23,31,"York County, ME",Sep-19,114203,111858,2345,2.1
20506,CN2400100000000,24,1,"Allegany County, MD",Sep-19,32578,30988,1590,4.9
20507,CN2400300000000,24,3,"Anne Arundel County, MD",Sep-19,318034,309103,8931,2.8
20508,CN2400500000000,24,5,"Baltimore County, MD",Sep-19,457967,442271,15696,3.4
20509,CN2400900000000,24,9,"Calvert County, MD",Sep-19,50675,49233,1442,2.8
20510,CN2401100000000,24,11,"Caroline County, MD",Sep-19,18048,17505,543,3.0
20511,CN2401300000000,24,13,"Carroll County, MD",Sep-19,95837,93338,2499,2.6
20512,CN2401500000000,24,15,"Cecil County, MD",Sep-19,53095,51198,1897,3.6
20513,CN2401700000000,24,17,"Charles County, MD",Sep-19,88418,85471,2947,3.3
20514,CN2401900000000,24,19,"Dorchester County, MD",Sep-19,15657,15037,620,4.0
20515,CN2402100000000,24,21,"Frederick County, MD",Sep-19,135504,131535,3969,2.9
20516,CN2402300000000,24,23,"Garrett County, MD",Sep-19,15872,15290,582,3.7
20517,CN2402500000000,24,25,"Harford County, MD",Sep-19,141916,137554,4362,3.1
20518,CN2402700000000,24,27,"Howard County, MD",Sep-19,189509,184705,4804,2.5
20519,CN2402900000000,24,29,"Kent County, MD",Sep-19,9813,9478,335,3.4
20520,CN2403100000000,24,31,"Montgomery County, MD",Sep-19,568637,553284,15353,2.7
20521,CN2403300000000,24,33,"Prince George's County, MD",Sep-19,516247,498088,18159,3.5
20522,CN2403500000000,24,35,"Queen Anne's County, MD",Sep-19,27639,26868,771,2.8
20523,CN2403700000000,24,37,"St. Mary's County, MD",Sep-19,57334,55654,1680,2.9
20524,CN2403900000000,24,39,"Somerset County, MD",Sep-19,9092,8608,484,5.3
20525,CN2404100000000,24,41,"Talbot County, MD",Sep-19,19093,18555,538,2.8
20526,CN2404300000000,24,43,"Washington County, MD",Sep-19,74728,72161,2567,3.4
20527,CN2404500000000,24,45,"Wicomico County, MD",Sep-19,52541,50457,2084,4.0
20528,CN2404700000000,24,47,"Worcester County, MD",Sep-19,25534,24360,1174,4.6
20529,CN2451000000000,24,510,"Baltimore city, MD",Sep-19,290883,277012,13871,4.8
20530,CN2500100000000,25,1,"Barnstable County, MA",Sep-19,117049,113991,3058,2.6
20531,CN2500300000000,25,3,"Berkshire County, MA",Sep-19,64397,62472,1925,3.0
20532,CN2500500000000,25,5,"Bristol County, MA",Sep-19,302483,292607,9876,3.3
20533,CN2500700000000,25,7,"Dukes County, MA",Sep-19,10322,10094,228,2.2
20534,CN2500900000000,25,9,"Essex County, MA",Sep-19,427239,415427,11812,2.8
20535,CN2501100000000,25,11,"Franklin County, MA",Sep-19,40967,40022,945,2.3
20536,CN2501300000000,25,13,"Hampden County, MA",Sep-19,228994,220407,8587,3.7
20537,CN2501500000000,25,15,"Hampshire County, MA",Sep-19,90699,88335,2364,2.6
20538,CN2501700000000,25,17,"Middlesex County, MA",Sep-19,923831,903375,20456,2.2
20539,CN2501900000000,25,19,"Nantucket County/town, MA",Sep-19,8561,8417,144,1.7
20540,CN2502100000000,25,21,"Norfolk County, MA",Sep-19,393391,383756,9635,2.4
20541,CN2502300000000,25,23,"Plymouth County, MA",Sep-19,285174,277281,7893,2.8
20542,CN2502500000000,25,25,"Suffolk County, MA",Sep-19,458696,447011,11685,2.5
20543,CN2502700000000,25,27,"Worcester County, MA",Sep-19,446865,433951,12914,2.9
20544,CN2600100000000,26,1,"Alcona County, MI",Sep-19,3926,3751,175,4.5
20545,CN2600300000000,26,3,"Alger County, MI",Sep-19,3289,3127,162,4.9
20546,CN2600500000000,26,5,"Allegan County, MI",Sep-19,62057,60483,1574,2.5
20547,CN2600700000000,26,7,"Alpena County, MI",Sep-19,13253,12791,462,3.5
20548,CN2600900000000,26,9,"Antrim County, MI",Sep-19,10369,9998,371,3.6
20549,CN2601100000000,26,11,"Arenac County, MI",Sep-19,6065,5787,278,4.6
20550,CN2601300000000,26,13,"Baraga County, MI",Sep-19,3173,3035,138,4.3
20551,CN2601500000000,26,15,"Barry County, MI",Sep-19,31306,30478,828,2.6
20552,CN2601700000000,26,17,"Bay County, MI",Sep-19,49502,47725,1777,3.6
20553,CN2601900000000,26,19,"Benzie County, MI",Sep-19,8851,8547,304,3.4
20554,CN2602100000000,26,21,"Berrien County, MI",Sep-19,72828,70455,2373,3.3
20555,CN2602300000000,26,23,"Branch County, MI",Sep-19,19329,18684,645,3.3
20556,CN2602500000000,26,25,"Calhoun County, MI",Sep-19,61399,59207,2192,3.6
20557,CN2602700000000,26,27,"Cass County, MI",Sep-19,24368,23508,860,3.5
20558,CN2602900000000,26,29,"Charlevoix County, MI",Sep-19,12848,12432,416,3.2
20559,CN2603100000000,26,31,"Cheboygan County, MI",Sep-19,10713,10387,326,3.0
20560,CN2603300000000,26,33,"Chippewa County, MI",Sep-19,16045,15409,636,4.0
20561,CN2603500000000,26,35,"Clare County, MI",Sep-19,11661,11155,506,4.3
20562,CN2603700000000,26,37,"Clinton County, MI",Sep-19,40875,39841,1034,2.5
20563,CN2603900000000,26,39,"Crawford County, MI",Sep-19,5581,5350,231,4.1
20564,CN2604100000000,26,41,"Delta County, MI",Sep-19,17192,16584,608,3.5
20565,CN2604300000000,26,43,"Dickinson County, MI",Sep-19,12112,11725,387,3.2
20566,CN2604500000000,26,45,"Eaton County, MI",Sep-19,56555,54989,1566,2.8
20567,CN2604700000000,26,47,"Emmet County, MI",Sep-19,17872,17288,584,3.3
20568,CN2604900000000,26,49,"Genesee County, MI",Sep-19,180056,173035,7021,3.9
20569,CN2605100000000,26,51,"Gladwin County, MI",Sep-19,9909,9456,453,4.6
20570,CN2605300000000,26,53,"Gogebic County, MI",Sep-19,5916,5671,245,4.1
20571,CN2605500000000,26,55,"Grand Traverse County, MI",Sep-19,49992,48683,1309,2.6
20572,CN2605700000000,26,57,"Gratiot County, MI",Sep-19,17761,17155,606,3.4
20573,CN2605900000000,26,59,"Hillsdale County, MI",Sep-19,20372,19668,704,3.5
20574,CN2606100000000,26,61,"Houghton County, MI",Sep-19,16493,15867,626,3.8
20575,CN2606300000000,26,63,"Huron County, MI",Sep-19,15509,15037,472,3.0
20576,CN2606500000000,26,65,"Ingham County, MI",Sep-19,149632,145115,4517,3.0
20577,CN2606700000000,26,67,"Ionia County, MI",Sep-19,30166,29355,811,2.7
20578,CN2606900000000,26,69,"Iosco County, MI",Sep-19,10354,9941,413,4.0
20579,CN2607100000000,26,71,"Iron County, MI",Sep-19,5101,4903,198,3.9
20580,CN2607300000000,26,73,"Isabella County, MI",Sep-19,34691,33540,1151,3.3
20581,CN2607500000000,26,75,"Jackson County, MI",Sep-19,72954,70668,2286,3.1
20582,CN2607700000000,26,77,"Kalamazoo County, MI",Sep-19,132591,128632,3959,3.0
20583,CN2607900000000,26,79,"Kalkaska County, MI",Sep-19,7884,7579,305,3.9
20584,CN2608100000000,26,81,"Kent County, MI",Sep-19,355687,346580,9107,2.6
20585,CN2608300000000,26,83,"Keweenaw County, MI",Sep-19,890,851,39,4.4
20586,CN2608500000000,26,85,"Lake County, MI",Sep-19,3669,3482,187,5.1
20587,CN2608700000000,26,87,"Lapeer County, MI",Sep-19,41561,39784,1777,4.3
20588,CN2608900000000,26,89,"Leelanau County, MI",Sep-19,10589,10311,278,2.6
20589,CN2609100000000,26,91,"Lenawee County, MI",Sep-19,46094,44677,1417,3.1
20590,CN2609300000000,26,93,"Livingston County, MI",Sep-19,105180,101907,3273,3.1
20591,CN2609500000000,26,95,"Luce County, MI",Sep-19,2301,2204,97,4.2
20592,CN2609700000000,26,97,"Mackinac County, MI",Sep-19,5765,5619,146,2.5
20593,CN2609900000000,26,99,"Macomb County, MI",Sep-19,453633,436149,17484,3.9
20594,CN2610100000000,26,101,"Manistee County, MI",Sep-19,10585,10160,425,4.0
20595,CN2610300000000,26,103,"Marquette County, MI",Sep-19,32698,31558,1140,3.5
20596,CN2610500000000,26,105,"Mason County, MI",Sep-19,13672,13163,509,3.7
20597,CN2610700000000,26,107,"Mecosta County, MI",Sep-19,18301,17605,696,3.8
20598,CN2610900000000,26,109,"Menominee County, MI",Sep-19,10955,10609,346,3.2
20599,CN2611100000000,26,111,"Midland County, MI",Sep-19,39783,38558,1225,3.1
20600,CN2611300000000,26,113,"Missaukee County, MI",Sep-19,6970,6725,245,3.5
20601,CN2611500000000,26,115,"Monroe County, MI",Sep-19,74172,71902,2270,3.1
20602,CN2611700000000,26,117,"Montcalm County, MI",Sep-19,27914,27049,865,3.1
20603,CN2611900000000,26,119,"Montmorency County, MI",Sep-19,2966,2805,161,5.4
20604,CN2612100000000,26,121,"Muskegon County, MI",Sep-19,76013,73228,2785,3.7
20605,CN2612300000000,26,123,"Newaygo County, MI",Sep-19,23350,22603,747,3.2
20606,CN2612500000000,26,125,"Oakland County, MI",Sep-19,686212,663726,22486,3.3
20607,CN2612700000000,26,127,"Oceana County, MI",Sep-19,12405,11929,476,3.8
20608,CN2612900000000,26,129,"Ogemaw County, MI",Sep-19,8073,7709,364,4.5
20609,CN2613100000000,26,131,"Ontonagon County, MI",Sep-19,2094,1997,97,4.6
20610,CN2613300000000,26,133,"Osceola County, MI",Sep-19,11183,10849,334,3.0
20611,CN2613500000000,26,135,"Oscoda County, MI",Sep-19,3127,2982,145,4.6
20612,CN2613700000000,26,137,"Otsego County, MI",Sep-19,11529,11100,429,3.7
20613,CN2613900000000,26,139,"Ottawa County, MI",Sep-19,159659,155671,3988,2.5
20614,CN2614100000000,26,141,"Presque Isle County, MI",Sep-19,4975,4748,227,4.6
20615,CN2614300000000,26,143,"Roscommon County, MI",Sep-19,7805,7402,403,5.2
20616,CN2614500000000,26,145,"Saginaw County, MI",Sep-19,85602,82415,3187,3.7
20617,CN2614700000000,26,147,"St. Clair County, MI",Sep-19,76567,73377,3190,4.2
20618,CN2614900000000,26,149,"St. Joseph County, MI",Sep-19,27566,26633,933,3.4
20619,CN2615100000000,26,151,"Sanilac County, MI",Sep-19,19517,18829,688,3.5
20620,CN2615300000000,26,153,"Schoolcraft County, MI",Sep-19,3284,3130,154,4.7
20621,CN2615500000000,26,155,"Shiawassee County, MI",Sep-19,33094,31999,1095,3.3
20622,CN2615700000000,26,157,"Tuscola County, MI",Sep-19,23619,22757,862,3.6
20623,CN2615900000000,26,159,"Van Buren County, MI",Sep-19,34919,33680,1239,3.5
20624,CN2616100000000,26,161,"Washtenaw County, MI",Sep-19,197583,192220,5363,2.7
20625,CN2616300000000,26,163,"Wayne County, MI",Sep-19,813948,775810,38138,4.7
20626,CN2616500000000,26,165,"Wexford County, MI",Sep-19,14699,14192,507,3.4
20627,CN2700100000000,27,1,"Aitkin County, MN",Sep-19,7124,6883,241,3.4
20628,CN2700300000000,27,3,"Anoka County, MN",Sep-19,199444,194323,5121,2.6
20629,CN2700500000000,27,5,"Becker County, MN",Sep-19,18653,18179,474,2.5
20630,CN2700700000000,27,7,"Beltrami County, MN",Sep-19,24647,23906,741,3.0
20631,CN2700900000000,27,9,"Benton County, MN",Sep-19,22089,21477,612,2.8
20632,CN2701100000000,27,11,"Big Stone County, MN",Sep-19,2512,2455,57,2.3
20633,CN2701300000000,27,13,"Blue Earth County, MN",Sep-19,41181,40199,982,2.4
20634,CN2701500000000,27,15,"Brown County, MN",Sep-19,14443,14084,359,2.5
20635,CN2701700000000,27,17,"Carlton County, MN",Sep-19,17778,17209,569,3.2
20636,CN2701900000000,27,19,"Carver County, MN",Sep-19,59237,57782,1455,2.5
20637,CN2702100000000,27,21,"Cass County, MN",Sep-19,14761,14299,462,3.1
20638,CN2702300000000,27,23,"Chippewa County, MN",Sep-19,6942,6756,186,2.7
20639,CN2702500000000,27,25,"Chisago County, MN",Sep-19,30062,29273,789,2.6
20640,CN2702700000000,27,27,"Clay County, MN",Sep-19,36460,35585,875,2.4
20641,CN2702900000000,27,29,"Clearwater County, MN",Sep-19,4433,4252,181,4.1
20642,CN2703100000000,27,31,"Cook County, MN",Sep-19,3349,3272,77,2.3
20643,CN2703300000000,27,33,"Cottonwood County, MN",Sep-19,5924,5734,190,3.2
20644,CN2703500000000,27,35,"Crow Wing County, MN",Sep-19,32600,31658,942,2.9
20645,CN2703700000000,27,37,"Dakota County, MN",Sep-19,244138,238024,6114,2.5
20646,CN2703900000000,27,39,"Dodge County, MN",Sep-19,11911,11629,282,2.4
20647,CN2704100000000,27,41,"Douglas County, MN",Sep-19,21057,20577,480,2.3
20648,CN2704300000000,27,43,"Faribault County, MN",Sep-19,7171,6967,204,2.8
20649,CN2704500000000,27,45,"Fillmore County, MN",Sep-19,11587,11329,258,2.2
20650,CN2704700000000,27,47,"Freeborn County, MN",Sep-19,16174,15772,402,2.5
20651,CN2704900000000,27,49,"Goodhue County, MN",Sep-19,27241,26636,605,2.2
20652,CN2705100000000,27,51,"Grant County, MN",Sep-19,3275,3175,100,3.1
20653,CN2705300000000,27,53,"Hennepin County, MN",Sep-19,714824,696773,18051,2.5
20654,CN2705500000000,27,55,"Houston County, MN",Sep-19,10380,10113,267,2.6
20655,CN2705700000000,27,57,"Hubbard County, MN",Sep-19,10147,9817,330,3.3
20656,CN2705900000000,27,59,"Isanti County, MN",Sep-19,21346,20741,605,2.8
20657,CN2706100000000,27,61,"Itasca County, MN",Sep-19,21753,20866,887,4.1
20658,CN2706300000000,27,63,"Jackson County, MN",Sep-19,5724,5590,134,2.3
20659,CN2706500000000,27,65,"Kanabec County, MN",Sep-19,8914,8667,247,2.8
20660,CN2706700000000,27,67,"Kandiyohi County, MN",Sep-19,24429,23827,602,2.5
20661,CN2706900000000,27,69,"Kittson County, MN",Sep-19,2372,2309,63,2.7
20662,CN2707100000000,27,71,"Koochiching County, MN",Sep-19,5972,5673,299,5.0
20663,CN2707300000000,27,73,"Lac qui Parle County, MN",Sep-19,3538,3455,83,2.3
20664,CN2707500000000,27,75,"Lake County, MN",Sep-19,5593,5452,141,2.5
20665,CN2707700000000,27,77,"Lake of the Woods County, MN",Sep-19,2417,2353,64,2.6
20666,CN2707900000000,27,79,"Le Sueur County, MN",Sep-19,16063,15661,402,2.5
20667,CN2708100000000,27,81,"Lincoln County, MN",Sep-19,3283,3203,80,2.4
20668,CN2708300000000,27,83,"Lyon County, MN",Sep-19,14593,14245,348,2.4
20669,CN2708500000000,27,85,"McLeod County, MN",Sep-19,19287,18751,536,2.8
20670,CN2708700000000,27,87,"Mahnomen County, MN",Sep-19,2285,2207,78,3.4
20671,CN2708900000000,27,89,"Marshall County, MN",Sep-19,5360,5205,155,2.9
20672,CN2709100000000,27,91,"Martin County, MN",Sep-19,9960,9668,292,2.9
20673,CN2709300000000,27,93,"Meeker County, MN",Sep-19,13328,12995,333,2.5
20674,CN2709500000000,27,95,"Mille Lacs County, MN",Sep-19,12830,12416,414,3.2
20675,CN2709700000000,27,97,"Morrison County, MN",Sep-19,17328,16817,511,2.9
20676,CN2709900000000,27,99,"Mower County, MN",Sep-19,20416,19906,510,2.5
20677,CN2710100000000,27,101,"Murray County, MN",Sep-19,4847,4707,140,2.9
20678,CN2710300000000,27,103,"Nicollet County, MN",Sep-19,21267,20802,465,2.2
20679,CN2710500000000,27,105,"Nobles County, MN",Sep-19,11349,11054,295,2.6
20680,CN2710700000000,27,107,"Norman County, MN",Sep-19,3191,3104,87,2.7
20681,CN2710900000000,27,109,"Olmsted County, MN",Sep-19,89276,87376,1900,2.1
20682,CN2711100000000,27,111,"Otter Tail County, MN",Sep-19,31582,30776,806,2.6
20683,CN2711300000000,27,113,"Pennington County, MN",Sep-19,8596,8396,200,2.3
20684,CN2711500000000,27,115,"Pine County, MN",Sep-19,14979,14486,493,3.3
20685,CN2711700000000,27,117,"Pipestone County, MN",Sep-19,4980,4871,109,2.2
20686,CN2711900000000,27,119,"Polk County, MN",Sep-19,16601,16162,439,2.6
20687,CN2712100000000,27,121,"Pope County, MN",Sep-19,6559,6407,152,2.3
20688,CN2712300000000,27,123,"Ramsey County, MN",Sep-19,292994,284985,8009,2.7
20689,CN2712500000000,27,125,"Red Lake County, MN",Sep-19,2193,2119,74,3.4
20690,CN2712700000000,27,127,"Redwood County, MN",Sep-19,7635,7439,196,2.6
20691,CN2712900000000,27,129,"Renville County, MN",Sep-19,8644,8391,253,2.9
20692,CN2713100000000,27,131,"Rice County, MN",Sep-19,37381,36460,921,2.5
20693,CN2713300000000,27,133,"Rock County, MN",Sep-19,5678,5572,106,1.9
20694,CN2713500000000,27,135,"Roseau County, MN",Sep-19,7793,7586,207,2.7
20695,CN2713700000000,27,137,"St. Louis County, MN",Sep-19,101910,98753,3157,3.1
20696,CN2713900000000,27,139,"Scott County, MN",Sep-19,84421,82403,2018,2.4
20697,CN2714100000000,27,141,"Sherburne County, MN",Sep-19,52652,51327,1325,2.5
20698,CN2714300000000,27,143,"Sibley County, MN",Sep-19,8594,8368,226,2.6
20699,CN2714500000000,27,145,"Stearns County, MN",Sep-19,91328,89033,2295,2.5
20700,CN2714700000000,27,147,"Steele County, MN",Sep-19,21389,20843,546,2.6
20701,CN2714900000000,27,149,"Stevens County, MN",Sep-19,5445,5330,115,2.1
20702,CN2715100000000,27,151,"Swift County, MN",Sep-19,4905,4742,163,3.3
20703,CN2715300000000,27,153,"Todd County, MN",Sep-19,13494,13146,348,2.6
20704,CN2715500000000,27,155,"Traverse County, MN",Sep-19,1745,1702,43,2.5
20705,CN2715700000000,27,157,"Wabasha County, MN",Sep-19,12372,12074,298,2.4
20706,CN2715900000000,27,159,"Wadena County, MN",Sep-19,5860,5656,204,3.5
20707,CN2716100000000,27,161,"Waseca County, MN",Sep-19,9161,8908,253,2.8
20708,CN2716300000000,27,163,"Washington County, MN",Sep-19,144850,141277,3573,2.5
20709,CN2716500000000,27,165,"Watonwan County, MN",Sep-19,6319,6142,177,2.8
20710,CN2716700000000,27,167,"Wilkin County, MN",Sep-19,3477,3397,80,2.3
20711,CN2716900000000,27,169,"Winona County, MN",Sep-19,28912,28195,717,2.5
20712,CN2717100000000,27,171,"Wright County, MN",Sep-19,76126,74292,1834,2.4
20713,CN2717300000000,27,173,"Yellow Medicine County, MN",Sep-19,5359,5218,141,2.6
20714,CN2800100000000,28,1,"Adams County, MS",Sep-19,11296,10531,765,6.8
20715,CN2800300000000,28,3,"Alcorn County, MS",Sep-19,15778,15024,754,4.8
20716,CN2800500000000,28,5,"Amite County, MS",Sep-19,4410,4101,309,7.0
20717,CN2800700000000,28,7,"Attala County, MS",Sep-19,7028,6618,410,5.8
20718,CN2800900000000,28,9,"Benton County, MS",Sep-19,3068,2871,197,6.4
20719,CN2801100000000,28,11,"Bolivar County, MS",Sep-19,12197,11377,820,6.7
20720,CN2801300000000,28,13,"Calhoun County, MS",Sep-19,5641,5335,306,5.4
20721,CN2801500000000,28,15,"Carroll County, MS",Sep-19,3486,3260,226,6.5
20722,CN2801700000000,28,17,"Chickasaw County, MS",Sep-19,6913,6526,387,5.6
20723,CN2801900000000,28,19,"Choctaw County, MS",Sep-19,3743,3549,194,5.2
20724,CN2802100000000,28,21,"Claiborne County, MS",Sep-19,3031,2711,320,10.6
20725,CN2802300000000,28,23,"Clarke County, MS",Sep-19,5889,5524,365,6.2
20726,CN2802500000000,28,25,"Clay County, MS",Sep-19,7812,7253,559,7.2
20727,CN2802700000000,28,27,"Coahoma County, MS",Sep-19,8321,7727,594,7.1
20728,CN2802900000000,28,29,"Copiah County, MS",Sep-19,11185,10466,719,6.4
20729,CN2803100000000,28,31,"Covington County, MS",Sep-19,8190,7791,399,4.9
20730,CN2803300000000,28,33,"DeSoto County, MS",Sep-19,91572,87516,4056,4.4
20731,CN2803500000000,28,35,"Forrest County, MS",Sep-19,33292,31617,1675,5.0
20732,CN2803700000000,28,37,"Franklin County, MS",Sep-19,2788,2589,199,7.1
20733,CN2803900000000,28,39,"George County, MS",Sep-19,8827,8172,655,7.4
20734,CN2804100000000,28,41,"Greene County, MS",Sep-19,4338,4010,328,7.6
20735,CN2804300000000,28,43,"Grenada County, MS",Sep-19,9358,8865,493,5.3
20736,CN2804500000000,28,45,"Hancock County, MS",Sep-19,18742,17724,1018,5.4
20737,CN2804700000000,28,47,"Harrison County, MS",Sep-19,86343,81864,4479,5.2
20738,CN2804900000000,28,49,"Hinds County, MS",Sep-19,106949,101404,5545,5.2
20739,CN2805100000000,28,51,"Holmes County, MS",Sep-19,5674,5126,548,9.7
20740,CN2805300000000,28,53,"Humphreys County, MS",Sep-19,2208,2000,208,9.4
20741,CN2805500000000,28,55,"Issaquena County, MS",Sep-19,383,348,35,9.1
20742,CN2805700000000,28,57,"Itawamba County, MS",Sep-19,10562,10067,495,4.7
20743,CN2805900000000,28,59,"Jackson County, MS",Sep-19,58361,54907,3454,5.9
20744,CN2806100000000,28,61,"Jasper County, MS",Sep-19,6149,5747,402,6.5
20745,CN2806300000000,28,63,"Jefferson County, MS",Sep-19,2022,1718,304,15.0
20746,CN2806500000000,28,65,"Jefferson Davis County, MS",Sep-19,4105,3838,267,6.5
20747,CN2806700000000,28,67,"Jones County, MS",Sep-19,26211,24805,1406,5.4
20748,CN2806900000000,28,69,"Kemper County, MS",Sep-19,3533,3242,291,8.2
20749,CN2807100000000,28,71,"Lafayette County, MS",Sep-19,29418,28134,1284,4.4
20750,CN2807300000000,28,73,"Lamar County, MS",Sep-19,30742,29477,1265,4.1
20751,CN2807500000000,28,75,"Lauderdale County, MS",Sep-19,30335,28679,1656,5.5
20752,CN2807700000000,28,77,"Lawrence County, MS",Sep-19,4615,4309,306,6.6
20753,CN2807900000000,28,79,"Leake County, MS",Sep-19,7918,7481,437,5.5
20754,CN2808100000000,28,81,"Lee County, MS",Sep-19,41420,39571,1849,4.5
20755,CN2808300000000,28,83,"Leflore County, MS",Sep-19,9992,9276,716,7.2
20756,CN2808500000000,28,85,"Lincoln County, MS",Sep-19,14603,13822,781,5.3
20757,CN2808700000000,28,87,"Lowndes County, MS",Sep-19,25704,24410,1294,5.0
20758,CN2808900000000,28,89,"Madison County, MS",Sep-19,53268,50961,2307,4.3
20759,CN2809100000000,28,91,"Marion County, MS",Sep-19,9930,9402,528,5.3
20760,CN2809300000000,28,93,"Marshall County, MS",Sep-19,14553,13700,853,5.9
20761,CN2809500000000,28,95,"Monroe County, MS",Sep-19,15628,14784,844,5.4
20762,CN2809700000000,28,97,"Montgomery County, MS",Sep-19,3905,3673,232,5.9
20763,CN2809900000000,28,99,"Neshoba County, MS",Sep-19,10291,9678,613,6.0
20764,CN2810100000000,28,101,"Newton County, MS",Sep-19,8858,8386,472,5.3
20765,CN2810300000000,28,103,"Noxubee County, MS",Sep-19,3785,3503,282,7.5
20766,CN2810500000000,28,105,"Oktibbeha County, MS",Sep-19,23094,21816,1278,5.5
20767,CN2810700000000,28,107,"Panola County, MS",Sep-19,12556,11767,789,6.3
20768,CN2810900000000,28,109,"Pearl River County, MS",Sep-19,23748,22531,1217,5.1
20769,CN2811100000000,28,111,"Perry County, MS",Sep-19,4293,4008,285,6.6
20770,CN2811300000000,28,113,"Pike County, MS",Sep-19,14508,13576,932,6.4
20771,CN2811500000000,28,115,"Pontotoc County, MS",Sep-19,14859,14201,658,4.4
20772,CN2811700000000,28,117,"Prentiss County, MS",Sep-19,11340,10796,544,4.8
20773,CN2811900000000,28,119,"Quitman County, MS",Sep-19,2360,2177,183,7.8
20774,CN2812100000000,28,121,"Rankin County, MS",Sep-19,76162,73133,3029,4.0
20775,CN2812300000000,28,123,"Scott County, MS",Sep-19,12617,12058,559,4.4
20776,CN2812500000000,28,125,"Sharkey County, MS",Sep-19,1595,1478,117,7.3
20777,CN2812700000000,28,127,"Simpson County, MS",Sep-19,10728,10190,538,5.0
20778,CN2812900000000,28,129,"Smith County, MS",Sep-19,6789,6451,338,5.0
20779,CN2813100000000,28,131,"Stone County, MS",Sep-19,6863,6418,445,6.5
20780,CN2813300000000,28,133,"Sunflower County, MS",Sep-19,7692,7039,653,8.5
20781,CN2813500000000,28,135,"Tallahatchie County, MS",Sep-19,5185,4911,274,5.3
20782,CN2813700000000,28,137,"Tate County, MS",Sep-19,12417,11706,711,5.7
20783,CN2813900000000,28,139,"Tippah County, MS",Sep-19,9407,8930,477,5.1
20784,CN2814100000000,28,141,"Tishomingo County, MS",Sep-19,8504,8065,439,5.2
20785,CN2814300000000,28,143,"Tunica County, MS",Sep-19,4432,4174,258,5.8
20786,CN2814500000000,28,145,"Union County, MS",Sep-19,14312,13708,604,4.2
20787,CN2814700000000,28,147,"Walthall County, MS",Sep-19,4890,4535,355,7.3
20788,CN2814900000000,28,149,"Warren County, MS",Sep-19,20317,19143,1174,5.8
20789,CN2815100000000,28,151,"Washington County, MS",Sep-19,16887,15680,1207,7.1
20790,CN2815300000000,28,153,"Wayne County, MS",Sep-19,7451,6991,460,6.2
20791,CN2815500000000,28,155,"Webster County, MS",Sep-19,4007,3789,218,5.4
20792,CN2815700000000,28,157,"Wilkinson County, MS",Sep-19,2827,2536,291,10.3
20793,CN2815900000000,28,159,"Winston County, MS",Sep-19,7421,7014,407,5.5
20794,CN2816100000000,28,161,"Yalobusha County, MS",Sep-19,5019,4747,272,5.4
20795,CN2816300000000,28,163,"Yazoo County, MS",Sep-19,9388,8805,583,6.2
20796,CN2900100000000,29,1,"Adair County, MO",Sep-19,10238,9938,300,2.9
20797,CN2900300000000,29,3,"Andrew County, MO",Sep-19,9679,9484,195,2.0
20798,CN2900500000000,29,5,"Atchison County, MO",Sep-19,2603,2539,64,2.5
20799,CN2900700000000,29,7,"Audrain County, MO",Sep-19,10529,10253,276,2.6
20800,CN2900900000000,29,9,"Barry County, MO",Sep-19,15405,14958,447,2.9
20801,CN2901100000000,29,11,"Barton County, MO",Sep-19,5127,4995,132,2.6
20802,CN2901300000000,29,13,"Bates County, MO",Sep-19,7813,7562,251,3.2
20803,CN2901500000000,29,15,"Benton County, MO",Sep-19,7226,6867,359,5.0
20804,CN2901700000000,29,17,"Bollinger County, MO",Sep-19,5409,5247,162,3.0
20805,CN2901900000000,29,19,"Boone County, MO",Sep-19,99063,97222,1841,1.9
20806,CN2902100000000,29,21,"Buchanan County, MO",Sep-19,44469,43410,1059,2.4
20807,CN2902300000000,29,23,"Butler County, MO",Sep-19,17983,17383,600,3.3
20808,CN2902500000000,29,25,"Caldwell County, MO",Sep-19,4304,4206,98,2.3
20809,CN2902700000000,29,27,"Callaway County, MO",Sep-19,21251,20786,465,2.2
20810,CN2902900000000,29,29,"Camden County, MO",Sep-19,19198,18539,659,3.4
20811,CN2903100000000,29,31,"Cape Girardeau County, MO",Sep-19,40816,39793,1023,2.5
20812,CN2903300000000,29,33,"Carroll County, MO",Sep-19,4624,4512,112,2.4
20813,CN2903500000000,29,35,"Carter County, MO",Sep-19,2575,2483,92,3.6
20814,CN2903700000000,29,37,"Cass County, MO",Sep-19,54836,53566,1270,2.3
20815,CN2903900000000,29,39,"Cedar County, MO",Sep-19,5760,5593,167,2.9
20816,CN2904100000000,29,41,"Chariton County, MO",Sep-19,3665,3585,80,2.2
20817,CN2904300000000,29,43,"Christian County, MO",Sep-19,45135,44164,971,2.2
20818,CN2904500000000,29,45,"Clark County, MO",Sep-19,3137,3063,74,2.4
20819,CN2904700000000,29,47,"Clay County, MO",Sep-19,136805,133724,3081,2.3
20820,CN2904900000000,29,49,"Clinton County, MO",Sep-19,10673,10432,241,2.3
20821,CN2905100000000,29,51,"Cole County, MO",Sep-19,38934,38175,759,1.9
20822,CN2905300000000,29,53,"Cooper County, MO",Sep-19,7507,7318,189,2.5
20823,CN2905500000000,29,55,"Crawford County, MO",Sep-19,10988,10668,320,2.9
20824,CN2905700000000,29,57,"Dade County, MO",Sep-19,3514,3417,97,2.8
20825,CN2905900000000,29,59,"Dallas County, MO",Sep-19,7090,6761,329,4.6
20826,CN2906100000000,29,61,"Daviess County, MO",Sep-19,4028,3936,92,2.3
20827,CN2906300000000,29,63,"DeKalb County, MO",Sep-19,4755,4649,106,2.2
20828,CN2906500000000,29,65,"Dent County, MO",Sep-19,6302,6126,176,2.8
20829,CN2906700000000,29,67,"Douglas County, MO",Sep-19,5320,4743,577,10.8
20830,CN2906900000000,29,69,"Dunklin County, MO",Sep-19,11277,10809,468,4.2
20831,CN2907100000000,29,71,"Franklin County, MO",Sep-19,53179,51896,1283,2.4
20832,CN2907300000000,29,73,"Gasconade County, MO",Sep-19,7694,7517,177,2.3
20833,CN2907500000000,29,75,"Gentry County, MO",Sep-19,3389,3316,73,2.2
20834,CN2907700000000,29,77,"Greene County, MO",Sep-19,152156,148785,3371,2.2
20835,CN2907900000000,29,79,"Grundy County, MO",Sep-19,4300,4189,111,2.6
20836,CN2908100000000,29,81,"Harrison County, MO",Sep-19,3672,3569,103,2.8
20837,CN2908300000000,29,83,"Henry County, MO",Sep-19,9638,9374,264,2.7
20838,CN2908500000000,29,85,"Hickory County, MO",Sep-19,3949,3801,148,3.7
20839,CN2908700000000,29,87,"Holt County, MO",Sep-19,2501,2449,52,2.1
20840,CN2908900000000,29,89,"Howard County, MO",Sep-19,4856,4739,117,2.4
20841,CN2909100000000,29,91,"Howell County, MO",Sep-19,16678,15983,695,4.2
20842,CN2909300000000,29,93,"Iron County, MO",Sep-19,3471,3348,123,3.5
20843,CN2909500000000,29,95,"Jackson County, MO",Sep-19,363860,352946,10914,3.0
20844,CN2909700000000,29,97,"Jasper County, MO",Sep-19,57220,55802,1418,2.5
20845,CN2909900000000,29,99,"Jefferson County, MO",Sep-19,118438,115599,2839,2.4
20846,CN2910100000000,29,101,"Johnson County, MO",Sep-19,23254,22593,661,2.8
20847,CN2910300000000,29,103,"Knox County, MO",Sep-19,1740,1705,35,2.0
20848,CN2910500000000,29,105,"Laclede County, MO",Sep-19,18102,16095,2007,11.1
20849,CN2910700000000,29,107,"Lafayette County, MO",Sep-19,16726,16335,391,2.3
20850,CN2910900000000,29,109,"Lawrence County, MO",Sep-19,17910,17433,477,2.7
20851,CN2911100000000,29,111,"Lewis County, MO",Sep-19,4943,4813,130,2.6
20852,CN2911300000000,29,113,"Lincoln County, MO",Sep-19,28366,27665,701,2.5
20853,CN2911500000000,29,115,"Linn County, MO",Sep-19,5037,4849,188,3.7
20854,CN2911700000000,29,117,"Livingston County, MO",Sep-19,7202,7063,139,1.9
20855,CN2911900000000,29,119,"McDonald County, MO",Sep-19,10695,10413,282,2.6
20856,CN2912100000000,29,121,"Macon County, MO",Sep-19,7419,7230,189,2.5
20857,CN2912300000000,29,123,"Madison County, MO",Sep-19,5434,5292,142,2.6
20858,CN2912500000000,29,125,"Maries County, MO",Sep-19,3821,3726,95,2.5
20859,CN2912700000000,29,127,"Marion County, MO",Sep-19,14545,14203,342,2.4
20860,CN2912900000000,29,129,"Mercer County, MO",Sep-19,1809,1767,42,2.3
20861,CN2913100000000,29,131,"Miller County, MO",Sep-19,12398,12086,312,2.5
20862,CN2913300000000,29,133,"Mississippi County, MO",Sep-19,5685,5500,185,3.3
20863,CN2913500000000,29,135,"Moniteau County, MO",Sep-19,7194,7035,159,2.2
20864,CN2913700000000,29,137,"Monroe County, MO",Sep-19,3890,3769,121,3.1
20865,CN2913900000000,29,139,"Montgomery County, MO",Sep-19,5716,5590,126,2.2
20866,CN2914100000000,29,141,"Morgan County, MO",Sep-19,8051,7795,256,3.2
20867,CN2914300000000,29,143,"New Madrid County, MO",Sep-19,8064,7784,280,3.5
20868,CN2914500000000,29,145,"Newton County, MO",Sep-19,27218,26515,703,2.6
20869,CN2914700000000,29,147,"Nodaway County, MO",Sep-19,10900,10649,251,2.3
20870,CN2914900000000,29,149,"Oregon County, MO",Sep-19,4012,3848,164,4.1
20871,CN2915100000000,29,151,"Osage County, MO",Sep-19,7018,6903,115,1.6
20872,CN2915300000000,29,153,"Ozark County, MO",Sep-19,3434,3249,185,5.4
20873,CN2915500000000,29,155,"Pemiscot County, MO",Sep-19,6301,6056,245,3.9
20874,CN2915700000000,29,157,"Perry County, MO",Sep-19,9847,9642,205,2.1
20875,CN2915900000000,29,159,"Pettis County, MO",Sep-19,20862,20323,539,2.6
20876,CN2916100000000,29,161,"Phelps County, MO",Sep-19,19791,19276,515,2.6
20877,CN2916300000000,29,163,"Pike County, MO",Sep-19,7419,7198,221,3.0
20878,CN2916500000000,29,165,"Platte County, MO",Sep-19,58901,57659,1242,2.1
20879,CN2916700000000,29,167,"Polk County, MO",Sep-19,14589,14116,473,3.2
20880,CN2916900000000,29,169,"Pulaski County, MO",Sep-19,14680,14091,589,4.0
20881,CN2917100000000,29,171,"Putnam County, MO",Sep-19,2186,2116,70,3.2
20882,CN2917300000000,29,173,"Ralls County, MO",Sep-19,5623,5500,123,2.2
20883,CN2917500000000,29,175,"Randolph County, MO",Sep-19,10401,10071,330,3.2
20884,CN2917700000000,29,177,"Ray County, MO",Sep-19,10984,10687,297,2.7
20885,CN2917900000000,29,179,"Reynolds County, MO",Sep-19,3041,2953,88,2.9
20886,CN2918100000000,29,181,"Ripley County, MO",Sep-19,4974,4800,174,3.5
20887,CN2918300000000,29,183,"St. Charles County, MO",Sep-19,227777,223159,4618,2.0
20888,CN2918500000000,29,185,"St. Clair County, MO",Sep-19,3656,3520,136,3.7
20889,CN2918600000000,29,186,"Ste. Genevieve County, MO",Sep-19,9176,8997,179,2.0
20890,CN2918700000000,29,187,"St. Francois County, MO",Sep-19,26498,25728,770,2.9
20891,CN2918900000000,29,189,"St. Louis County, MO",Sep-19,534934,521484,13450,2.5
20892,CN2919500000000,29,195,"Saline County, MO",Sep-19,10476,10228,248,2.4
20893,CN2919700000000,29,197,"Schuyler County, MO",Sep-19,1898,1830,68,3.6
20894,CN2919900000000,29,199,"Scotland County, MO",Sep-19,2338,2283,55,2.4
20895,CN2920100000000,29,201,"Scott County, MO",Sep-19,19765,19191,574,2.9
20896,CN2920300000000,29,203,"Shannon County, MO",Sep-19,3169,3048,121,3.8
20897,CN2920500000000,29,205,"Shelby County, MO",Sep-19,3010,2955,55,1.8
20898,CN2920700000000,29,207,"Stoddard County, MO",Sep-19,12896,12446,450,3.5
20899,CN2920900000000,29,209,"Stone County, MO",Sep-19,13938,13526,412,3.0
20900,CN2921100000000,29,211,"Sullivan County, MO",Sep-19,2600,2526,74,2.8
20901,CN2921300000000,29,213,"Taney County, MO",Sep-19,27258,26466,792,2.9
20902,CN2921500000000,29,215,"Texas County, MO",Sep-19,8965,8636,329,3.7
20903,CN2921700000000,29,217,"Vernon County, MO",Sep-19,9238,8987,251,2.7
20904,CN2921900000000,29,219,"Warren County, MO",Sep-19,17943,17557,386,2.2
20905,CN2922100000000,29,221,"Washington County, MO",Sep-19,10252,9916,336,3.3
20906,CN2922300000000,29,223,"Wayne County, MO",Sep-19,5234,5051,183,3.5
20907,CN2922500000000,29,225,"Webster County, MO",Sep-19,17285,16731,554,3.2
20908,CN2922700000000,29,227,"Worth County, MO",Sep-19,1137,1114,23,2.0
20909,CN2922900000000,29,229,"Wright County, MO",Sep-19,7566,7072,494,6.5
20910,CN2951000000000,29,510,"St. Louis city, MO",Sep-19,153343,148480,4863,3.2
20911,CN3000100000000,30,1,"Beaverhead County, MT",Sep-19,5056,4932,124,2.5
20912,CN3000300000000,30,3,"Big Horn County, MT",Sep-19,4854,4546,308,6.3
20913,CN3000500000000,30,5,"Blaine County, MT",Sep-19,2509,2435,74,2.9
20914,CN3000700000000,30,7,"Broadwater County, MT",Sep-19,2577,2491,86,3.3
20915,CN3000900000000,30,9,"Carbon County, MT",Sep-19,5485,5340,145,2.6
20916,CN3001100000000,30,11,"Carter County, MT",Sep-19,661,646,15,2.3
20917,CN3001300000000,30,13,"Cascade County, MT",Sep-19,37879,36721,1158,3.1
20918,CN3001500000000,30,15,"Chouteau County, MT",Sep-19,2460,2400,60,2.4
20919,CN3001700000000,30,17,"Custer County, MT",Sep-19,6085,5937,148,2.4
20920,CN3001900000000,30,19,"Daniels County, MT",Sep-19,883,866,17,1.9
20921,CN3002100000000,30,21,"Dawson County, MT",Sep-19,4534,4421,113,2.5
20922,CN3002300000000,30,23,"Deer Lodge County, MT",Sep-19,5001,4865,136,2.7
20923,CN3002500000000,30,25,"Fallon County, MT",Sep-19,1696,1667,29,1.7
20924,CN3002700000000,30,27,"Fergus County, MT",Sep-19,6037,5891,146,2.4
20925,CN3002900000000,30,29,"Flathead County, MT",Sep-19,47813,46049,1764,3.7
20926,CN3003100000000,30,31,"Gallatin County, MT",Sep-19,69274,67923,1351,2.0
20927,CN3003300000000,30,33,"Garfield County, MT",Sep-19,749,732,17,2.3
20928,CN3003500000000,30,35,"Glacier County, MT",Sep-19,5929,5591,338,5.7
20929,CN3003700000000,30,37,"Golden Valley County, MT",Sep-19,371,357,14,3.8
20930,CN3003900000000,30,39,"Granite County, MT",Sep-19,1635,1564,71,4.3
20931,CN3004100000000,30,41,"Hill County, MT",Sep-19,7678,7421,257,3.3
20932,CN3004300000000,30,43,"Jefferson County, MT",Sep-19,5661,5499,162,2.9
20933,CN3004500000000,30,45,"Judith Basin County, MT",Sep-19,1002,978,24,2.4
20934,CN3004700000000,30,47,"Lake County, MT",Sep-19,13298,12815,483,3.6
20935,CN3004900000000,30,49,"Lewis and Clark County, MT",Sep-19,35586,34633,953,2.7
20936,CN3005100000000,30,51,"Liberty County, MT",Sep-19,967,943,24,2.5
20937,CN3005300000000,30,53,"Lincoln County, MT",Sep-19,8132,7646,486,6.0
20938,CN3005500000000,30,55,"McCone County, MT",Sep-19,970,950,20,2.1
20939,CN3005700000000,30,57,"Madison County, MT",Sep-19,4455,4331,124,2.8
20940,CN3005900000000,30,59,"Meagher County, MT",Sep-19,930,904,26,2.8
20941,CN3006100000000,30,61,"Mineral County, MT",Sep-19,1793,1710,83,4.6
20942,CN3006300000000,30,63,"Missoula County, MT",Sep-19,64326,62579,1747,2.7
20943,CN3006500000000,30,65,"Musselshell County, MT",Sep-19,2272,2189,83,3.7
20944,CN3006700000000,30,67,"Park County, MT",Sep-19,9105,8878,227,2.5
20945,CN3006900000000,30,69,"Petroleum County, MT",Sep-19,283,275,8,2.8
20946,CN3007100000000,30,71,"Phillips County, MT",Sep-19,1902,1849,53,2.8
20947,CN3007300000000,30,73,"Pondera County, MT",Sep-19,2643,2560,83,3.1
20948,CN3007500000000,30,75,"Powder River County, MT",Sep-19,984,963,21,2.1
20949,CN3007700000000,30,77,"Powell County, MT",Sep-19,3025,2928,97,3.2
20950,CN3007900000000,30,79,"Prairie County, MT",Sep-19,485,465,20,4.1
20951,CN3008100000000,30,81,"Ravalli County, MT",Sep-19,20279,19613,666,3.3
20952,CN3008300000000,30,83,"Richland County, MT",Sep-19,5833,5664,169,2.9
20953,CN3008500000000,30,85,"Roosevelt County, MT",Sep-19,4455,4292,163,3.7
20954,CN3008700000000,30,87,"Rosebud County, MT",Sep-19,3831,3669,162,4.2
20955,CN3008900000000,30,89,"Sanders County, MT",Sep-19,4891,4675,216,4.4
20956,CN3009100000000,30,91,"Sheridan County, MT",Sep-19,1738,1700,38,2.2
20957,CN3009300000000,30,93,"Silver Bow County, MT",Sep-19,17009,16465,544,3.2
20958,CN3009500000000,30,95,"Stillwater County, MT",Sep-19,5301,5164,137,2.6
20959,CN3009700000000,30,97,"Sweet Grass County, MT",Sep-19,1830,1788,42,2.3
20960,CN3009900000000,30,99,"Teton County, MT",Sep-19,2762,2686,76,2.8
20961,CN3010100000000,30,101,"Toole County, MT",Sep-19,2112,2065,47,2.2
20962,CN3010300000000,30,103,"Treasure County, MT",Sep-19,341,333,8,2.3
20963,CN3010500000000,30,105,"Valley County, MT",Sep-19,4101,3968,133,3.2
20964,CN3010700000000,30,107,"Wheatland County, MT",Sep-19,798,774,24,3.0
20965,CN3010900000000,30,109,"Wibaux County, MT",Sep-19,462,447,15,3.2
20966,CN3011100000000,30,111,"Yellowstone County, MT",Sep-19,81865,79527,2338,2.9
20967,CN3100100000000,31,1,"Adams County, NE",Sep-19,16777,16314,463,2.8
20968,CN3100300000000,31,3,"Antelope County, NE",Sep-19,3496,3416,80,2.3
20969,CN3100500000000,31,5,"Arthur County, NE",Sep-19,215,202,13,6.0
20970,CN3100700000000,31,7,"Banner County, NE",Sep-19,376,363,13,3.5
20971,CN3100900000000,31,9,"Blaine County, NE",Sep-19,252,241,11,4.4
20972,CN3101100000000,31,11,"Boone County, NE",Sep-19,2881,2812,69,2.4
20973,CN3101300000000,31,13,"Box Butte County, NE",Sep-19,5381,5221,160,3.0
20974,CN3101500000000,31,15,"Boyd County, NE",Sep-19,1062,1035,27,2.5
20975,CN3101700000000,31,17,"Brown County, NE",Sep-19,1349,1309,40,3.0
20976,CN3101900000000,31,19,"Buffalo County, NE",Sep-19,27472,26802,670,2.4
20977,CN3102100000000,31,21,"Burt County, NE",Sep-19,3403,3312,91,2.7
20978,CN3102300000000,31,23,"Butler County, NE",Sep-19,4536,4423,113,2.5
20979,CN3102500000000,31,25,"Cass County, NE",Sep-19,13453,13070,383,2.8
20980,CN3102700000000,31,27,"Cedar County, NE",Sep-19,4441,4336,105,2.4
20981,CN3102900000000,31,29,"Chase County, NE",Sep-19,2201,2150,51,2.3
20982,CN3103100000000,31,31,"Cherry County, NE",Sep-19,3325,3254,71,2.1
20983,CN3103300000000,31,33,"Cheyenne County, NE",Sep-19,4339,4177,162,3.7
20984,CN3103500000000,31,35,"Clay County, NE",Sep-19,3244,3160,84,2.6
20985,CN3103700000000,31,37,"Colfax County, NE",Sep-19,5526,5384,142,2.6
20986,CN3103900000000,31,39,"Cuming County, NE",Sep-19,4589,4475,114,2.5
20987,CN3104100000000,31,41,"Custer County, NE",Sep-19,6243,6096,147,2.4
20988,CN3104300000000,31,43,"Dakota County, NE",Sep-19,10721,10396,325,3.0
20989,CN3104500000000,31,45,"Dawes County, NE",Sep-19,5004,4871,133,2.7
20990,CN3104700000000,31,47,"Dawson County, NE",Sep-19,12923,12578,345,2.7
20991,CN3104900000000,31,49,"Deuel County, NE",Sep-19,941,903,38,4.0
20992,CN3105100000000,31,51,"Dixon County, NE",Sep-19,2986,2910,76,2.5
20993,CN3105300000000,31,53,"Dodge County, NE",Sep-19,19438,18926,512,2.6
20994,CN3105500000000,31,55,"Douglas County, NE",Sep-19,298502,289683,8819,3.0
20995,CN3105700000000,31,57,"Dundy County, NE",Sep-19,1140,1111,29,2.5
20996,CN3105900000000,31,59,"Fillmore County, NE",Sep-19,3066,2995,71,2.3
20997,CN3106100000000,31,61,"Franklin County, NE",Sep-19,1402,1355,47,3.4
20998,CN3106300000000,31,63,"Frontier County, NE",Sep-19,1590,1537,53,3.3
20999,CN3106500000000,31,65,"Furnas County, NE",Sep-19,2517,2450,67,2.7
21000,CN3106700000000,31,67,"Gage County, NE",Sep-19,10909,10589,320,2.9
21001,CN3106900000000,31,69,"Garden County, NE",Sep-19,1047,1013,34,3.2
21002,CN3107100000000,31,71,"Garfield County, NE",Sep-19,1173,1146,27,2.3
21003,CN3107300000000,31,73,"Gosper County, NE",Sep-19,1054,1025,29,2.8
21004,CN3107500000000,31,75,"Grant County, NE",Sep-19,413,400,13,3.1
21005,CN3107700000000,31,77,"Greeley County, NE",Sep-19,1175,1142,33,2.8
21006,CN3107900000000,31,79,"Hall County, NE",Sep-19,31813,30894,919,2.9
21007,CN3108100000000,31,81,"Hamilton County, NE",Sep-19,4745,4598,147,3.1
21008,CN3108300000000,31,83,"Harlan County, NE",Sep-19,1780,1731,49,2.8
21009,CN3108500000000,31,85,"Hayes County, NE",Sep-19,614,599,15,2.4
21010,CN3108700000000,31,87,"Hitchcock County, NE",Sep-19,1244,1208,36,2.9
21011,CN3108900000000,31,89,"Holt County, NE",Sep-19,5603,5474,129,2.3
21012,CN3109100000000,31,91,"Hooker County, NE",Sep-19,433,420,13,3.0
21013,CN3109300000000,31,93,"Howard County, NE",Sep-19,3326,3233,93,2.8
21014,CN3109500000000,31,95,"Jefferson County, NE",Sep-19,4036,3936,100,2.5
21015,CN3109700000000,31,97,"Johnson County, NE",Sep-19,2028,1966,62,3.1
21016,CN3109900000000,31,99,"Kearney County, NE",Sep-19,3771,3687,84,2.2
21017,CN3110100000000,31,101,"Keith County, NE",Sep-19,4613,4419,194,4.2
21018,CN3110300000000,31,103,"Keya Paha County, NE",Sep-19,566,550,16,2.8
21019,CN3110500000000,31,105,"Kimball County, NE",Sep-19,1996,1938,58,2.9
21020,CN3110700000000,31,107,"Knox County, NE",Sep-19,4465,4352,113,2.5
21021,CN3110900000000,31,109,"Lancaster County, NE",Sep-19,177441,172868,4573,2.6
21022,CN3111100000000,31,111,"Lincoln County, NE",Sep-19,18274,17671,603,3.3
21023,CN3111300000000,31,113,"Logan County, NE",Sep-19,465,447,18,3.9
21024,CN3111500000000,31,115,"Loup County, NE",Sep-19,401,385,16,4.0
21025,CN3111700000000,31,117,"McPherson County, NE",Sep-19,445,434,11,2.5
21026,CN3111900000000,31,119,"Madison County, NE",Sep-19,19791,19308,483,2.4
21027,CN3112100000000,31,121,"Merrick County, NE",Sep-19,3977,3864,113,2.8
21028,CN3112300000000,31,123,"Morrill County, NE",Sep-19,2562,2497,65,2.5
21029,CN3112500000000,31,125,"Nance County, NE",Sep-19,1932,1885,47,2.4
21030,CN3112700000000,31,127,"Nemaha County, NE",Sep-19,3579,3466,113,3.2
21031,CN3112900000000,31,129,"Nuckolls County, NE",Sep-19,2359,2301,58,2.5
21032,CN3113100000000,31,131,"Otoe County, NE",Sep-19,8362,8137,225,2.7
21033,CN3113300000000,31,133,"Pawnee County, NE",Sep-19,1425,1391,34,2.4
21034,CN3113500000000,31,135,"Perkins County, NE",Sep-19,1772,1736,36,2.0
21035,CN3113700000000,31,137,"Phelps County, NE",Sep-19,4863,4736,127,2.6
21036,CN3113900000000,31,139,"Pierce County, NE",Sep-19,4059,3959,100,2.5
21037,CN3114100000000,31,141,"Platte County, NE",Sep-19,17693,17234,459,2.6
21038,CN3114300000000,31,143,"Polk County, NE",Sep-19,2873,2797,76,2.6
21039,CN3114500000000,31,145,"Red Willow County, NE",Sep-19,5765,5622,143,2.5
21040,CN3114700000000,31,147,"Richardson County, NE",Sep-19,4192,4078,114,2.7
21041,CN3114900000000,31,149,"Rock County, NE",Sep-19,865,840,25,2.9
21042,CN3115100000000,31,151,"Saline County, NE",Sep-19,7210,7008,202,2.8
21043,CN3115300000000,31,153,"Sarpy County, NE",Sep-19,96399,93794,2605,2.7
21044,CN3115500000000,31,155,"Saunders County, NE",Sep-19,11061,10780,281,2.5
21045,CN3115700000000,31,157,"Scotts Bluff County, NE",Sep-19,18178,17604,574,3.2
21046,CN3115900000000,31,159,"Seward County, NE",Sep-19,8860,8622,238,2.7
21047,CN3116100000000,31,161,"Sheridan County, NE",Sep-19,2610,2543,67,2.6
21048,CN3116300000000,31,163,"Sherman County, NE",Sep-19,1635,1588,47,2.9
21049,CN3116500000000,31,165,"Sioux County, NE",Sep-19,729,711,18,2.5
21050,CN3116700000000,31,167,"Stanton County, NE",Sep-19,3491,3415,76,2.2
21051,CN3116900000000,31,169,"Thayer County, NE",Sep-19,2681,2612,69,2.6
21052,CN3117100000000,31,171,"Thomas County, NE",Sep-19,414,401,13,3.1
21053,CN3117300000000,31,173,"Thurston County, NE",Sep-19,3048,2921,127,4.2
21054,CN3117500000000,31,175,"Valley County, NE",Sep-19,2067,2011,56,2.7
21055,CN3117700000000,31,177,"Washington County, NE",Sep-19,11203,10913,290,2.6
21056,CN3117900000000,31,179,"Wayne County, NE",Sep-19,5751,5615,136,2.4
21057,CN3118100000000,31,181,"Webster County, NE",Sep-19,1647,1591,56,3.4
21058,CN3118300000000,31,183,"Wheeler County, NE",Sep-19,507,491,16,3.2
21059,CN3118500000000,31,185,"York County, NE",Sep-19,7290,7112,178,2.4
21060,CN3200100000000,32,1,"Churchill County, NV",Sep-19,11247,10900,347,3.1
21061,CN3200300000000,32,3,"Clark County, NV",Sep-19,1138060,1093454,44606,3.9
21062,CN3200500000000,32,5,"Douglas County, NV",Sep-19,23532,22742,790,3.4
21063,CN3200700000000,32,7,"Elko County, NV",Sep-19,27151,26436,715,2.6
21064,CN3200900000000,32,9,"Esmeralda County, NV",Sep-19,475,457,18,3.8
21065,CN3201100000000,32,11,"Eureka County, NV",Sep-19,1150,1122,28,2.4
21066,CN3201300000000,32,13,"Humboldt County, NV",Sep-19,8428,8204,224,2.7
21067,CN3201500000000,32,15,"Lander County, NV",Sep-19,3232,3138,94,2.9
21068,CN3201700000000,32,17,"Lincoln County, NV",Sep-19,2189,2115,74,3.4
21069,CN3201900000000,32,19,"Lyon County, NV",Sep-19,23357,22345,1012,4.3
21070,CN3202100000000,32,21,"Mineral County, NV",Sep-19,2037,1964,73,3.6
21071,CN3202300000000,32,23,"Nye County, NV",Sep-19,17607,16738,869,4.9
21072,CN3202700000000,32,27,"Pershing County, NV",Sep-19,2631,2540,91,3.5
21073,CN3202900000000,32,29,"Storey County, NV",Sep-19,2052,1986,66,3.2
21074,CN3203100000000,32,31,"Washoe County, NV",Sep-19,258102,250421,7681,3.0
21075,CN3203300000000,32,33,"White Pine County, NV",Sep-19,4762,4645,117,2.5
21076,CN3251000000000,32,510,"Carson City, NV",Sep-19,26399,25466,933,3.5
21077,CN3300100000000,33,1,"Belknap County, NH",Sep-19,32001,31283,718,2.2
21078,CN3300300000000,33,3,"Carroll County, NH",Sep-19,24332,23791,541,2.2
21079,CN3300500000000,33,5,"Cheshire County, NH",Sep-19,40703,39724,979,2.4
21080,CN3300700000000,33,7,"Coos County, NH",Sep-19,14824,14464,360,2.4
21081,CN3300900000000,33,9,"Grafton County, NH",Sep-19,49738,48697,1041,2.1
21082,CN3301100000000,33,11,"Hillsborough County, NH",Sep-19,241396,235651,5745,2.4
21083,CN3301300000000,33,13,"Merrimack County, NH",Sep-19,83562,81820,1742,2.1
21084,CN3301500000000,33,15,"Rockingham County, NH",Sep-19,188414,183863,4551,2.4
21085,CN3301700000000,33,17,"Strafford County, NH",Sep-19,74686,73035,1651,2.2
21086,CN3301900000000,33,19,"Sullivan County, NH",Sep-19,23034,22529,505,2.2
21087,CN3400100000000,34,1,"Atlantic County, NJ",Sep-19,121817,116272,5545,4.6
21088,CN3400300000000,34,3,"Bergen County, NJ",Sep-19,482308,468519,13789,2.9
21089,CN3400500000000,34,5,"Burlington County, NJ",Sep-19,231555,224312,7243,3.1
21090,CN3400700000000,34,7,"Camden County, NJ",Sep-19,253913,244006,9907,3.9
21091,CN3400900000000,34,9,"Cape May County, NJ",Sep-19,48624,46586,2038,4.2
21092,CN3401100000000,34,11,"Cumberland County, NJ",Sep-19,65097,61869,3228,5.0
21093,CN3401300000000,34,13,"Essex County, NJ",Sep-19,368035,351848,16187,4.4
21094,CN3401500000000,34,15,"Gloucester County, NJ",Sep-19,150205,144950,5255,3.5
21095,CN3401700000000,34,17,"Hudson County, NJ",Sep-19,361011,349459,11552,3.2
21096,CN3401900000000,34,19,"Hunterdon County, NJ",Sep-19,64508,62817,1691,2.6
21097,CN3402100000000,34,21,"Mercer County, NJ",Sep-19,202650,196325,6325,3.1
21098,CN3402300000000,34,23,"Middlesex County, NJ",Sep-19,439020,425770,13250,3.0
21099,CN3402500000000,34,25,"Monmouth County, NJ",Sep-19,329152,319337,9815,3.0
21100,CN3402700000000,34,27,"Morris County, NJ",Sep-19,256177,249190,6987,2.7
21101,CN3402900000000,34,29,"Ocean County, NJ",Sep-19,275085,265782,9303,3.4
21102,CN3403100000000,34,31,"Passaic County, NJ",Sep-19,241585,231823,9762,4.0
21103,CN3403300000000,34,33,"Salem County, NJ",Sep-19,29154,27814,1340,4.6
21104,CN3403500000000,34,35,"Somerset County, NJ",Sep-19,170987,165955,5032,2.9
21105,CN3403700000000,34,37,"Sussex County, NJ",Sep-19,73777,71465,2312,3.1
21106,CN3403900000000,34,39,"Union County, NJ",Sep-19,275394,265593,9801,3.6
21107,CN3404100000000,34,41,"Warren County, NJ",Sep-19,56153,54449,1704,3.0
21108,CN3500100000000,35,1,"Bernalillo County, NM",Sep-19,334563,320103,14460,4.3
21109,CN3500300000000,35,3,"Catron County, NM",Sep-19,1198,1138,60,5.0
21110,CN3500500000000,35,5,"Chaves County, NM",Sep-19,27033,25729,1304,4.8
21111,CN3500600000000,35,6,"Cibola County, NM",Sep-19,8968,8425,543,6.1
21112,CN3500700000000,35,7,"Colfax County, NM",Sep-19,5225,4978,247,4.7
21113,CN3500900000000,35,9,"Curry County, NM",Sep-19,21651,20749,902,4.2
21114,CN3501100000000,35,11,"De Baca County, NM",Sep-19,787,757,30,3.8
21115,CN3501300000000,35,13,"Dona Ana County, NM",Sep-19,97576,92545,5031,5.2
21116,CN3501500000000,35,15,"Eddy County, NM",Sep-19,34794,33743,1051,3.0
21117,CN3501700000000,35,17,"Grant County, NM",Sep-19,12059,11497,562,4.7
21118,CN3501900000000,35,19,"Guadalupe County, NM",Sep-19,1560,1488,72,4.6
21119,CN3502100000000,35,21,"Harding County, NM",Sep-19,271,257,14,5.2
21120,CN3502300000000,35,23,"Hidalgo County, NM",Sep-19,2111,2017,94,4.5
21121,CN3502500000000,35,25,"Lea County, NM",Sep-19,31041,29844,1197,3.9
21122,CN3502700000000,35,27,"Lincoln County, NM",Sep-19,9049,8674,375,4.1
21123,CN3502800000000,35,28,"Los Alamos County, NM",Sep-19,9739,9456,283,2.9
21124,CN3502900000000,35,29,"Luna County, NM",Sep-19,10585,9715,870,8.2
21125,CN3503100000000,35,31,"McKinley County, NM",Sep-19,24162,22543,1619,6.7
21126,CN3503300000000,35,33,"Mora County, NM",Sep-19,2210,2095,115,5.2
21127,CN3503500000000,35,35,"Otero County, NM",Sep-19,24671,23532,1139,4.6
21128,CN3503700000000,35,37,"Quay County, NM",Sep-19,3218,3061,157,4.9
21129,CN3503900000000,35,39,"Rio Arriba County, NM",Sep-19,17035,16207,828,4.9
21130,CN3504100000000,35,41,"Roosevelt County, NM",Sep-19,7999,7653,346,4.3
21131,CN3504300000000,35,43,"Sandoval County, NM",Sep-19,66598,63463,3135,4.7
21132,CN3504500000000,35,45,"San Juan County, NM",Sep-19,52136,49271,2865,5.5
21133,CN3504700000000,35,47,"San Miguel County, NM",Sep-19,10878,10264,614,5.6
21134,CN3504900000000,35,49,"Santa Fe County, NM",Sep-19,75124,72339,2785,3.7
21135,CN3505100000000,35,51,"Sierra County, NM",Sep-19,3860,3631,229,5.9
21136,CN3505300000000,35,53,"Socorro County, NM",Sep-19,6449,6080,369,5.7
21137,CN3505500000000,35,55,"Taos County, NM",Sep-19,14913,14065,848,5.7
21138,CN3505700000000,35,57,"Torrance County, NM",Sep-19,5759,5402,357,6.2
21139,CN3505900000000,35,59,"Union County, NM",Sep-19,1861,1801,60,3.2
21140,CN3506100000000,35,61,"Valencia County, NM",Sep-19,30809,29182,1627,5.3
21141,CN3600100000000,36,1,"Albany County, NY",Sep-19,157582,152030,5552,3.5
21142,CN3600300000000,36,3,"Allegany County, NY",Sep-19,19825,18931,894,4.5
21143,CN3600500000000,36,5,"Bronx County, NY",Sep-19,595001,566480,28521,4.8
21144,CN3600700000000,36,7,"Broome County, NY",Sep-19,83254,79680,3574,4.3
21145,CN3600900000000,36,9,"Cattaraugus County, NY",Sep-19,33925,32479,1446,4.3
21146,CN3601100000000,36,11,"Cayuga County, NY",Sep-19,36142,34851,1291,3.6
21147,CN3601300000000,36,13,"Chautauqua County, NY",Sep-19,54596,52329,2267,4.2
21148,CN3601500000000,36,15,"Chemung County, NY",Sep-19,35206,33825,1381,3.9
21149,CN3601700000000,36,17,"Chenango County, NY",Sep-19,22104,21284,820,3.7
21150,CN3601900000000,36,19,"Clinton County, NY",Sep-19,36488,35086,1402,3.8
21151,CN3602100000000,36,21,"Columbia County, NY",Sep-19,31551,30662,889,2.8
21152,CN3602300000000,36,23,"Cortland County, NY",Sep-19,22996,22089,907,3.9
21153,CN3602500000000,36,25,"Delaware County, NY",Sep-19,19222,18462,760,4.0
21154,CN3602700000000,36,27,"Dutchess County, NY",Sep-19,143854,138774,5080,3.5
21155,CN3602900000000,36,29,"Erie County, NY",Sep-19,442364,425114,17250,3.9
21156,CN3603100000000,36,31,"Essex County, NY",Sep-19,17045,16444,601,3.5
21157,CN3603300000000,36,33,"Franklin County, NY",Sep-19,19788,18985,803,4.1
21158,CN3603500000000,36,35,"Fulton County, NY",Sep-19,22681,21677,1004,4.4
21159,CN3603700000000,36,37,"Genesee County, NY",Sep-19,29914,28928,986,3.3
21160,CN3603900000000,36,39,"Greene County, NY",Sep-19,20198,19416,782,3.9
21161,CN3604100000000,36,41,"Hamilton County, NY",Sep-19,2271,2187,84,3.7
21162,CN3604300000000,36,43,"Herkimer County, NY",Sep-19,27668,26579,1089,3.9
21163,CN3604500000000,36,45,"Jefferson County, NY",Sep-19,43876,41812,2064,4.7
21164,CN3604700000000,36,47,"Kings County, NY",Sep-19,1193642,1150503,43139,3.6
21165,CN3604900000000,36,49,"Lewis County, NY",Sep-19,11695,11218,477,4.1
21166,CN3605100000000,36,51,"Livingston County, NY",Sep-19,30866,29724,1142,3.7
21167,CN3605300000000,36,53,"Madison County, NY",Sep-19,32947,31648,1299,3.9
21168,CN3605500000000,36,55,"Monroe County, NY",Sep-19,361831,347428,14403,4.0
21169,CN3605700000000,36,57,"Montgomery County, NY",Sep-19,22438,21452,986,4.4
21170,CN3605900000000,36,59,"Nassau County, NY",Sep-19,708021,684035,23986,3.4
21171,CN3606100000000,36,61,"New York County, NY",Sep-19,908764,880362,28402,3.1
21172,CN3606300000000,36,63,"Niagara County, NY",Sep-19,98734,94581,4153,4.2
21173,CN3606500000000,36,65,"Oneida County, NY",Sep-19,100627,96678,3949,3.9
21174,CN3606700000000,36,67,"Onondaga County, NY",Sep-19,221432,213134,8298,3.7
21175,CN3606900000000,36,69,"Ontario County, NY",Sep-19,55463,53554,1909,3.4
21176,CN3607100000000,36,71,"Orange County, NY",Sep-19,185148,178250,6898,3.7
21177,CN3607300000000,36,73,"Orleans County, NY",Sep-19,17666,16972,694,3.9
21178,CN3607500000000,36,75,"Oswego County, NY",Sep-19,52945,50444,2501,4.7
21179,CN3607700000000,36,77,"Otsego County, NY",Sep-19,28203,27195,1008,3.6
21180,CN3607900000000,36,79,"Putnam County, NY",Sep-19,51080,49241,1839,3.6
21181,CN3608100000000,36,81,"Queens County, NY",Sep-19,1136055,1101224,34831,3.1
21182,CN3608300000000,36,83,"Rensselaer County, NY",Sep-19,81051,78230,2821,3.5
21183,CN3608500000000,36,85,"Richmond County, NY",Sep-19,221536,214030,7506,3.4
21184,CN3608700000000,36,87,"Rockland County, NY",Sep-19,155035,149597,5438,3.5
21185,CN3608900000000,36,89,"St. Lawrence County, NY",Sep-19,43961,41913,2048,4.7
21186,CN3609100000000,36,91,"Saratoga County, NY",Sep-19,118958,115224,3734,3.1
21187,CN3609300000000,36,93,"Schenectady County, NY",Sep-19,76000,73267,2733,3.6
21188,CN3609500000000,36,95,"Schoharie County, NY",Sep-19,14637,14080,557,3.8
21189,CN3609700000000,36,97,"Schuyler County, NY",Sep-19,8220,7940,280,3.4
21190,CN3609900000000,36,99,"Seneca County, NY",Sep-19,16118,15580,538,3.3
21191,CN3610100000000,36,101,"Steuben County, NY",Sep-19,42832,41170,1662,3.9
21192,CN3610300000000,36,103,"Suffolk County, NY",Sep-19,776821,750203,26618,3.4
21193,CN3610500000000,36,105,"Sullivan County, NY",Sep-19,37070,35761,1309,3.5
21194,CN3610700000000,36,107,"Tioga County, NY",Sep-19,22668,21843,825,3.6
21195,CN3610900000000,36,109,"Tompkins County, NY",Sep-19,49325,47512,1813,3.7
21196,CN3611100000000,36,111,"Ulster County, NY",Sep-19,88179,85113,3066,3.5
21197,CN3611300000000,36,113,"Warren County, NY",Sep-19,31343,30221,1122,3.6
21198,CN3611500000000,36,115,"Washington County, NY",Sep-19,28132,27187,945,3.4
21199,CN3611700000000,36,117,"Wayne County, NY",Sep-19,44053,42516,1537,3.5
21200,CN3611900000000,36,119,"Westchester County, NY",Sep-19,483459,465664,17795,3.7
21201,CN3612100000000,36,121,"Wyoming County, NY",Sep-19,18310,17701,609,3.3
21202,CN3612300000000,36,123,"Yates County, NY",Sep-19,12014,11636,378,3.1
21203,CN3700100000000,37,1,"Alamance County, NC",Sep-19,82832,80042,2790,3.4
21204,CN3700300000000,37,3,"Alexander County, NC",Sep-19,18129,17595,534,2.9
21205,CN3700500000000,37,5,"Alleghany County, NC",Sep-19,4455,4276,179,4.0
21206,CN3700700000000,37,7,"Anson County, NC",Sep-19,10773,10359,414,3.8
21207,CN3700900000000,37,9,"Ashe County, NC",Sep-19,13064,12673,391,3.0
21208,CN3701100000000,37,11,"Avery County, NC",Sep-19,7757,7522,235,3.0
21209,CN3701300000000,37,13,"Beaufort County, NC",Sep-19,19432,18627,805,4.1
21210,CN3701500000000,37,15,"Bertie County, NC",Sep-19,7716,7385,331,4.3
21211,CN3701700000000,37,17,"Bladen County, NC",Sep-19,14591,13958,633,4.3
21212,CN3701900000000,37,19,"Brunswick County, NC",Sep-19,54829,52338,2491,4.5
21213,CN3702100000000,37,21,"Buncombe County, NC",Sep-19,142784,139040,3744,2.6
21214,CN3702300000000,37,23,"Burke County, NC",Sep-19,41351,39970,1381,3.3
21215,CN3702500000000,37,25,"Cabarrus County, NC",Sep-19,110458,106902,3556,3.2
21216,CN3702700000000,37,27,"Caldwell County, NC",Sep-19,36870,35555,1315,3.6
21217,CN3702900000000,37,29,"Camden County, NC",Sep-19,4614,4467,147,3.2
21218,CN3703100000000,37,31,"Carteret County, NC",Sep-19,32289,31192,1097,3.4
21219,CN3703300000000,37,33,"Caswell County, NC",Sep-19,9909,9515,394,4.0
21220,CN3703500000000,37,35,"Catawba County, NC",Sep-19,79613,77079,2534,3.2
21221,CN3703700000000,37,37,"Chatham County, NC",Sep-19,35986,34928,1058,2.9
21222,CN3703900000000,37,39,"Cherokee County, NC",Sep-19,11243,10806,437,3.9
21223,CN3704100000000,37,41,"Chowan County, NC",Sep-19,5435,5211,224,4.1
21224,CN3704300000000,37,43,"Clay County, NC",Sep-19,4174,4007,167,4.0
21225,CN3704500000000,37,45,"Cleveland County, NC",Sep-19,48598,46805,1793,3.7
21226,CN3704700000000,37,47,"Columbus County, NC",Sep-19,23085,22080,1005,4.4
21227,CN3704900000000,37,49,"Craven County, NC",Sep-19,42152,40655,1497,3.6
21228,CN3705100000000,37,51,"Cumberland County, NC",Sep-19,128690,122832,5858,4.6
21229,CN3705300000000,37,53,"Currituck County, NC",Sep-19,14132,13691,441,3.1
21230,CN3705500000000,37,55,"Dare County, NC",Sep-19,20965,20291,674,3.2
21231,CN3705700000000,37,57,"Davidson County, NC",Sep-19,82033,79337,2696,3.3
21232,CN3705900000000,37,59,"Davie County, NC",Sep-19,20920,20282,638,3.0
21233,CN3706100000000,37,61,"Duplin County, NC",Sep-19,25195,24312,883,3.5
21234,CN3706300000000,37,63,"Durham County, NC",Sep-19,172846,167627,5219,3.0
21235,CN3706500000000,37,65,"Edgecombe County, NC",Sep-19,21184,20052,1132,5.3
21236,CN3706700000000,37,67,"Forsyth County, NC",Sep-19,190453,184139,6314,3.3
21237,CN3706900000000,37,69,"Franklin County, NC",Sep-19,31685,30560,1125,3.6
21238,CN3707100000000,37,71,"Gaston County, NC",Sep-19,112459,108603,3856,3.4
21239,CN3707300000000,37,73,"Gates County, NC",Sep-19,5345,5150,195,3.6
21240,CN3707500000000,37,75,"Graham County, NC",Sep-19,3280,3133,147,4.5
21241,CN3707700000000,37,77,"Granville County, NC",Sep-19,30080,29167,913,3.0
21242,CN3707900000000,37,79,"Greene County, NC",Sep-19,9494,9180,314,3.3
21243,CN3708100000000,37,81,"Guilford County, NC",Sep-19,265865,256117,9748,3.7
21244,CN3708300000000,37,83,"Halifax County, NC",Sep-19,20307,19217,1090,5.4
21245,CN3708500000000,37,85,"Harnett County, NC",Sep-19,53923,51739,2184,4.1
21246,CN3708700000000,37,87,"Haywood County, NC",Sep-19,30392,29511,881,2.9
21247,CN3708900000000,37,89,"Henderson County, NC",Sep-19,55879,54288,1591,2.8
21248,CN3709100000000,37,91,"Hertford County, NC",Sep-19,9172,8751,421,4.6
21249,CN3709300000000,37,93,"Hoke County, NC",Sep-19,20287,19364,923,4.5
21250,CN3709500000000,37,95,"Hyde County, NC",Sep-19,1916,1806,110,5.7
21251,CN3709700000000,37,97,"Iredell County, NC",Sep-19,90628,87695,2933,3.2
21252,CN3709900000000,37,99,"Jackson County, NC",Sep-19,20530,19839,691,3.4
21253,CN3710100000000,37,101,"Johnston County, NC",Sep-19,100262,97030,3232,3.2
21254,CN3710300000000,37,103,"Jones County, NC",Sep-19,4380,4236,144,3.3
21255,CN3710500000000,37,105,"Lee County, NC",Sep-19,26089,25042,1047,4.0
21256,CN3710700000000,37,107,"Lenoir County, NC",Sep-19,27903,26955,948,3.4
21257,CN3710900000000,37,109,"Lincoln County, NC",Sep-19,44014,42657,1357,3.1
21258,CN3711100000000,37,111,"McDowell County, NC",Sep-19,20909,20178,731,3.5
21259,CN3711300000000,37,113,"Macon County, NC",Sep-19,15905,15387,518,3.3
21260,CN3711500000000,37,115,"Madison County, NC",Sep-19,10324,9988,336,3.3
21261,CN3711700000000,37,117,"Martin County, NC",Sep-19,9038,8634,404,4.5
21262,CN3711900000000,37,119,"Mecklenburg County, NC",Sep-19,630299,609739,20560,3.3
21263,CN3712100000000,37,121,"Mitchell County, NC",Sep-19,6134,5900,234,3.8
21264,CN3712300000000,37,123,"Montgomery County, NC",Sep-19,11589,11162,427,3.7
21265,CN3712500000000,37,125,"Moore County, NC",Sep-19,43122,41690,1432,3.3
21266,CN3712700000000,37,127,"Nash County, NC",Sep-19,43237,41332,1905,4.4
21267,CN3712900000000,37,129,"New Hanover County, NC",Sep-19,125763,121912,3851,3.1
21268,CN3713100000000,37,131,"Northampton County, NC",Sep-19,7695,7326,369,4.8
21269,CN3713300000000,37,133,"Onslow County, NC",Sep-19,65232,62598,2634,4.0
21270,CN3713500000000,37,135,"Orange County, NC",Sep-19,79657,77388,2269,2.8
21271,CN3713700000000,37,137,"Pamlico County, NC",Sep-19,5368,5193,175,3.3
21272,CN3713900000000,37,139,"Pasquotank County, NC",Sep-19,16695,16041,654,3.9
21273,CN3714100000000,37,141,"Pender County, NC",Sep-19,29177,28187,990,3.4
21274,CN3714300000000,37,143,"Perquimans County, NC",Sep-19,4937,4720,217,4.4
21275,CN3714500000000,37,145,"Person County, NC",Sep-19,18572,17869,703,3.8
21276,CN3714700000000,37,147,"Pitt County, NC",Sep-19,91113,87651,3462,3.8
21277,CN3714900000000,37,149,"Polk County, NC",Sep-19,9209,8897,312,3.4
21278,CN3715100000000,37,151,"Randolph County, NC",Sep-19,66966,64744,2222,3.3
21279,CN3715300000000,37,153,"Richmond County, NC",Sep-19,16680,15882,798,4.8
21280,CN3715500000000,37,155,"Robeson County, NC",Sep-19,50113,47674,2439,4.9
21281,CN3715700000000,37,157,"Rockingham County, NC",Sep-19,40574,38995,1579,3.9
21282,CN3715900000000,37,159,"Rowan County, NC",Sep-19,66998,64622,2376,3.5
21283,CN3716100000000,37,161,"Rutherford County, NC",Sep-19,25431,24314,1117,4.4
21284,CN3716300000000,37,163,"Sampson County, NC",Sep-19,28740,27755,985,3.4
21285,CN3716500000000,37,165,"Scotland County, NC",Sep-19,11441,10755,686,6.0
21286,CN3716700000000,37,167,"Stanly County, NC",Sep-19,30499,29449,1050,3.4
21287,CN3716900000000,37,169,"Stokes County, NC",Sep-19,22001,21313,688,3.1
21288,CN3717100000000,37,171,"Surry County, NC",Sep-19,34171,33044,1127,3.3
21289,CN3717300000000,37,173,"Swain County, NC",Sep-19,7167,6937,230,3.2
21290,CN3717500000000,37,175,"Transylvania County, NC",Sep-19,14797,14323,474,3.2
21291,CN3717700000000,37,177,"Tyrrell County, NC",Sep-19,1518,1445,73,4.8
21292,CN3717900000000,37,179,"Union County, NC",Sep-19,125377,121539,3838,3.1
21293,CN3718100000000,37,181,"Vance County, NC",Sep-19,17534,16594,940,5.4
21294,CN3718300000000,37,183,"Wake County, NC",Sep-19,604029,586183,17846,3.0
21295,CN3718500000000,37,185,"Warren County, NC",Sep-19,6641,6300,341,5.1
21296,CN3718700000000,37,187,"Washington County, NC",Sep-19,4471,4247,224,5.0
21297,CN3718900000000,37,189,"Watauga County, NC",Sep-19,30275,29374,901,3.0
21298,CN3719100000000,37,191,"Wayne County, NC",Sep-19,51747,49852,1895,3.7
21299,CN3719300000000,37,193,"Wilkes County, NC",Sep-19,29384,28322,1062,3.6
21300,CN3719500000000,37,195,"Wilson County, NC",Sep-19,35032,33156,1876,5.4
21301,CN3719700000000,37,197,"Yadkin County, NC",Sep-19,17904,17370,534,3.0
21302,CN3719900000000,37,199,"Yancey County, NC",Sep-19,8586,8307,279,3.2
21303,CN3800100000000,38,1,"Adams County, ND",Sep-19,1071,1051,20,1.9
21304,CN3800300000000,38,3,"Barnes County, ND",Sep-19,5151,5052,99,1.9
21305,CN3800500000000,38,5,"Benson County, ND",Sep-19,2306,2234,72,3.1
21306,CN3800700000000,38,7,"Billings County, ND",Sep-19,500,491,9,1.8
21307,CN3800900000000,38,9,"Bottineau County, ND",Sep-19,2939,2877,62,2.1
21308,CN3801100000000,38,11,"Bowman County, ND",Sep-19,1710,1686,24,1.4
21309,CN3801300000000,38,13,"Burke County, ND",Sep-19,1039,1019,20,1.9
21310,CN3801500000000,38,15,"Burleigh County, ND",Sep-19,48800,47912,888,1.8
21311,CN3801700000000,38,17,"Cass County, ND",Sep-19,102572,100831,1741,1.7
21312,CN3801900000000,38,19,"Cavalier County, ND",Sep-19,1914,1878,36,1.9
21313,CN3802100000000,38,21,"Dickey County, ND",Sep-19,2278,2238,40,1.8
21314,CN3802300000000,38,23,"Divide County, ND",Sep-19,1417,1397,20,1.4
21315,CN3802500000000,38,25,"Dunn County, ND",Sep-19,3217,3173,44,1.4
21316,CN3802700000000,38,27,"Eddy County, ND",Sep-19,1224,1190,34,2.8
21317,CN3802900000000,38,29,"Emmons County, ND",Sep-19,1427,1392,35,2.5
21318,CN3803100000000,38,31,"Foster County, ND",Sep-19,1489,1459,30,2.0
21319,CN3803300000000,38,33,"Golden Valley County, ND",Sep-19,825,812,13,1.6
21320,CN3803500000000,38,35,"Grand Forks County, ND",Sep-19,37117,36499,618,1.7
21321,CN3803700000000,38,37,"Grant County, ND",Sep-19,1183,1165,18,1.5
21322,CN3803900000000,38,39,"Griggs County, ND",Sep-19,1021,1002,19,1.9
21323,CN3804100000000,38,41,"Hettinger County, ND",Sep-19,1370,1347,23,1.7
21324,CN3804300000000,38,43,"Kidder County, ND",Sep-19,1230,1202,28,2.3
21325,CN3804500000000,38,45,"LaMoure County, ND",Sep-19,2064,2033,31,1.5
21326,CN3804700000000,38,47,"Logan County, ND",Sep-19,871,858,13,1.5
21327,CN3804900000000,38,49,"McHenry County, ND",Sep-19,3034,2966,68,2.2
21328,CN3805100000000,38,51,"McIntosh County, ND",Sep-19,1107,1082,25,2.3
21329,CN3805300000000,38,53,"McKenzie County, ND",Sep-19,10430,10271,159,1.5
21330,CN3805500000000,38,55,"McLean County, ND",Sep-19,4647,4544,103,2.2
21331,CN3805700000000,38,57,"Mercer County, ND",Sep-19,3509,3412,97,2.8
21332,CN3805900000000,38,59,"Morton County, ND",Sep-19,16016,15677,339,2.1
21333,CN3806100000000,38,61,"Mountrail County, ND",Sep-19,7450,7362,88,1.2
21334,CN3806300000000,38,63,"Nelson County, ND",Sep-19,1387,1356,31,2.2
21335,CN3806500000000,38,65,"Oliver County, ND",Sep-19,852,832,20,2.3
21336,CN3806700000000,38,67,"Pembina County, ND",Sep-19,3347,3260,87,2.6
21337,CN3806900000000,38,69,"Pierce County, ND",Sep-19,1651,1611,40,2.4
21338,CN3807100000000,38,71,"Ramsey County, ND",Sep-19,5558,5441,117,2.1
21339,CN3807300000000,38,73,"Ransom County, ND",Sep-19,2796,2758,38,1.4
21340,CN3807500000000,38,75,"Renville County, ND",Sep-19,1216,1193,23,1.9
21341,CN3807700000000,38,77,"Richland County, ND",Sep-19,8498,8349,149,1.8
21342,CN3807900000000,38,79,"Rolette County, ND",Sep-19,4486,4250,236,5.3
21343,CN3808100000000,38,81,"Sargent County, ND",Sep-19,2639,2599,40,1.5
21344,CN3808300000000,38,83,"Sheridan County, ND",Sep-19,671,652,19,2.8
21345,CN3808500000000,38,85,"Sioux County, ND",Sep-19,1233,1189,44,3.6
21346,CN3808700000000,38,87,"Slope County, ND",Sep-19,402,393,9,2.2
21347,CN3808900000000,38,89,"Stark County, ND",Sep-19,18404,18095,309,1.7
21348,CN3809100000000,38,91,"Steele County, ND",Sep-19,974,958,16,1.6
21349,CN3809300000000,38,93,"Stutsman County, ND",Sep-19,10144,9971,173,1.7
21350,CN3809500000000,38,95,"Towner County, ND",Sep-19,1111,1085,26,2.3
21351,CN3809700000000,38,97,"Traill County, ND",Sep-19,4356,4266,90,2.1
21352,CN3809900000000,38,99,"Walsh County, ND",Sep-19,5104,4976,128,2.5
21353,CN3810100000000,38,101,"Ward County, ND",Sep-19,31367,30762,605,1.9
21354,CN3810300000000,38,103,"Wells County, ND",Sep-19,1900,1855,45,2.4
21355,CN3810500000000,38,105,"Williams County, ND",Sep-19,24873,24499,374,1.5
21356,CN3900100000000,39,1,"Adams County, OH",Sep-19,10592,9974,618,5.8
21357,CN3900300000000,39,3,"Allen County, OH",Sep-19,47614,45771,1843,3.9
21358,CN3900500000000,39,5,"Ashland County, OH",Sep-19,26733,25730,1003,3.8
21359,CN3900700000000,39,7,"Ashtabula County, OH",Sep-19,44533,42612,1921,4.3
21360,CN3900900000000,39,9,"Athens County, OH",Sep-19,28992,27577,1415,4.9
21361,CN3901100000000,39,11,"Auglaize County, OH",Sep-19,24703,23966,737,3.0
21362,CN3901300000000,39,13,"Belmont County, OH",Sep-19,29965,28441,1524,5.1
21363,CN3901500000000,39,15,"Brown County, OH",Sep-19,19624,18735,889,4.5
21364,CN3901700000000,39,17,"Butler County, OH",Sep-19,195975,188665,7310,3.7
21365,CN3901900000000,39,19,"Carroll County, OH",Sep-19,12860,12317,543,4.2
21366,CN3902100000000,39,21,"Champaign County, OH",Sep-19,19864,19156,708,3.6
21367,CN3902300000000,39,23,"Clark County, OH",Sep-19,62697,60167,2530,4.0
21368,CN3902500000000,39,25,"Clermont County, OH",Sep-19,107288,103469,3819,3.6
21369,CN3902700000000,39,27,"Clinton County, OH",Sep-19,17679,16902,777,4.4
21370,CN3902900000000,39,29,"Columbiana County, OH",Sep-19,47472,45333,2139,4.5
21371,CN3903100000000,39,31,"Coshocton County, OH",Sep-19,14351,13568,783,5.5
21372,CN3903300000000,39,33,"Crawford County, OH",Sep-19,18157,17365,792,4.4
21373,CN3903500000000,39,35,"Cuyahoga County, OH",Sep-19,616686,592833,23853,3.9
21374,CN3903700000000,39,37,"Darke County, OH",Sep-19,25520,24622,898,3.5
21375,CN3903900000000,39,39,"Defiance County, OH",Sep-19,17999,17288,711,4.0
21376,CN3904100000000,39,41,"Delaware County, OH",Sep-19,110819,107286,3533,3.2
21377,CN3904300000000,39,43,"Erie County, OH",Sep-19,37862,36335,1527,4.0
21378,CN3904500000000,39,45,"Fairfield County, OH",Sep-19,78036,75246,2790,3.6
21379,CN3904700000000,39,47,"Fayette County, OH",Sep-19,13676,13162,514,3.8
21380,CN3904900000000,39,49,"Franklin County, OH",Sep-19,699910,675266,24644,3.5
21381,CN3905100000000,39,51,"Fulton County, OH",Sep-19,22275,21487,788,3.5
21382,CN3905300000000,39,53,"Gallia County, OH",Sep-19,11746,11155,591,5.0
21383,CN3905500000000,39,55,"Geauga County, OH",Sep-19,49543,48012,1531,3.1
21384,CN3905700000000,39,57,"Greene County, OH",Sep-19,83272,80211,3061,3.7
21385,CN3905900000000,39,59,"Guernsey County, OH",Sep-19,18450,17570,880,4.8
21386,CN3906100000000,39,61,"Hamilton County, OH",Sep-19,418568,402842,15726,3.8
21387,CN3906300000000,39,63,"Hancock County, OH",Sep-19,41688,40391,1297,3.1
21388,CN3906500000000,39,65,"Hardin County, OH",Sep-19,13639,13060,579,4.2
21389,CN3906700000000,39,67,"Harrison County, OH",Sep-19,6743,6406,337,5.0
21390,CN3906900000000,39,69,"Henry County, OH",Sep-19,13176,12689,487,3.7
21391,CN3907100000000,39,71,"Highland County, OH",Sep-19,16876,16063,813,4.8
21392,CN3907300000000,39,73,"Hocking County, OH",Sep-19,13054,12541,513,3.9
21393,CN3907500000000,39,75,"Holmes County, OH",Sep-19,20666,20047,619,3.0
21394,CN3907700000000,39,77,"Huron County, OH",Sep-19,27697,26431,1266,4.6
21395,CN3907900000000,39,79,"Jackson County, OH",Sep-19,12486,11821,665,5.3
21396,CN3908100000000,39,81,"Jefferson County, OH",Sep-19,27828,26257,1571,5.6
21397,CN3908300000000,39,83,"Knox County, OH",Sep-19,31499,30344,1155,3.7
21398,CN3908500000000,39,85,"Lake County, OH",Sep-19,126873,122764,4109,3.2
21399,CN3908700000000,39,87,"Lawrence County, OH",Sep-19,23911,22720,1191,5.0
21400,CN3908900000000,39,89,"Licking County, OH",Sep-19,90693,87408,3285,3.6
21401,CN3909100000000,39,91,"Logan County, OH",Sep-19,22469,21659,810,3.6
21402,CN3909300000000,39,93,"Lorain County, OH",Sep-19,154252,148348,5904,3.8
21403,CN3909500000000,39,95,"Lucas County, OH",Sep-19,209791,200898,8893,4.2
21404,CN3909700000000,39,97,"Madison County, OH",Sep-19,20724,20046,678,3.3
21405,CN3909900000000,39,99,"Mahoning County, OH",Sep-19,102850,97378,5472,5.3
21406,CN3910100000000,39,101,"Marion County, OH",Sep-19,28073,26988,1085,3.9
21407,CN3910300000000,39,103,"Medina County, OH",Sep-19,98161,95058,3103,3.2
21408,CN3910500000000,39,105,"Meigs County, OH",Sep-19,9009,8466,543,6.0
21409,CN3910700000000,39,107,"Mercer County, OH",Sep-19,23036,22423,613,2.7
21410,CN3910900000000,39,109,"Miami County, OH",Sep-19,54037,52113,1924,3.6
21411,CN3911100000000,39,111,"Monroe County, OH",Sep-19,5234,4885,349,6.7
21412,CN3911300000000,39,113,"Montgomery County, OH",Sep-19,252762,242424,10338,4.1
21413,CN3911500000000,39,115,"Morgan County, OH",Sep-19,6599,6259,340,5.2
21414,CN3911700000000,39,117,"Morrow County, OH",Sep-19,16776,16173,603,3.6
21415,CN3911900000000,39,119,"Muskingum County, OH",Sep-19,39457,37770,1687,4.3
21416,CN3912100000000,39,121,"Noble County, OH",Sep-19,4653,4390,263,5.7
21417,CN3912300000000,39,123,"Ottawa County, OH",Sep-19,21388,20528,860,4.0
21418,CN3912500000000,39,125,"Paulding County, OH",Sep-19,8560,8240,320,3.7
21419,CN3912700000000,39,127,"Perry County, OH",Sep-19,15826,15098,728,4.6
21420,CN3912900000000,39,129,"Pickaway County, OH",Sep-19,26412,25424,988,3.7
21421,CN3913100000000,39,131,"Pike County, OH",Sep-19,10722,10136,586,5.5
21422,CN3913300000000,39,133,"Portage County, OH",Sep-19,87404,83991,3413,3.9
21423,CN3913500000000,39,135,"Preble County, OH",Sep-19,21030,20283,747,3.6
21424,CN3913700000000,39,137,"Putnam County, OH",Sep-19,18548,18031,517,2.8
21425,CN3913900000000,39,139,"Richland County, OH",Sep-19,51969,49782,2187,4.2
21426,CN3914100000000,39,141,"Ross County, OH",Sep-19,35047,33701,1346,3.8
21427,CN3914300000000,39,143,"Sandusky County, OH",Sep-19,30223,29053,1170,3.9
21428,CN3914500000000,39,145,"Scioto County, OH",Sep-19,28862,27247,1615,5.6
21429,CN3914700000000,39,147,"Seneca County, OH",Sep-19,27089,26040,1049,3.9
21430,CN3914900000000,39,149,"Shelby County, OH",Sep-19,23959,23132,827,3.5
21431,CN3915100000000,39,151,"Stark County, OH",Sep-19,185249,177604,7645,4.1
21432,CN3915300000000,39,153,"Summit County, OH",Sep-19,272833,261832,11001,4.0
21433,CN3915500000000,39,155,"Trumbull County, OH",Sep-19,86574,81673,4901,5.7
21434,CN3915700000000,39,157,"Tuscarawas County, OH",Sep-19,44797,43021,1776,4.0
21435,CN3915900000000,39,159,"Union County, OH",Sep-19,29017,28062,955,3.3
21436,CN3916100000000,39,161,"Van Wert County, OH",Sep-19,14958,14471,487,3.3
21437,CN3916300000000,39,163,"Vinton County, OH",Sep-19,5516,5251,265,4.8
21438,CN3916500000000,39,165,"Warren County, OH",Sep-19,119810,115644,4166,3.5
21439,CN3916700000000,39,167,"Washington County, OH",Sep-19,27385,26083,1302,4.8
21440,CN3916900000000,39,169,"Wayne County, OH",Sep-19,61540,59596,1944,3.2
21441,CN3917100000000,39,171,"Williams County, OH",Sep-19,18917,18305,612,3.2
21442,CN3917300000000,39,173,"Wood County, OH",Sep-19,71159,68651,2508,3.5
21443,CN3917500000000,39,175,"Wyandot County, OH",Sep-19,12811,12434,377,2.9
21444,CN4000100000000,40,1,"Adair County, OK",Sep-19,8108,7814,294,3.6
21445,CN4000300000000,40,3,"Alfalfa County, OK",Sep-19,2831,2770,61,2.2
21446,CN4000500000000,40,5,"Atoka County, OK",Sep-19,4923,4722,201,4.1
21447,CN4000700000000,40,7,"Beaver County, OK",Sep-19,2913,2861,52,1.8
21448,CN4000900000000,40,9,"Beckham County, OK",Sep-19,10235,9876,359,3.5
21449,CN4001100000000,40,11,"Blaine County, OK",Sep-19,4759,4666,93,2.0
21450,CN4001300000000,40,13,"Bryan County, OK",Sep-19,21267,20667,600,2.8
21451,CN4001500000000,40,15,"Caddo County, OK",Sep-19,11742,11321,421,3.6
21452,CN4001700000000,40,17,"Canadian County, OK",Sep-19,74647,72554,2093,2.8
21453,CN4001900000000,40,19,"Carter County, OK",Sep-19,21501,20799,702,3.3
21454,CN4002100000000,40,21,"Cherokee County, OK",Sep-19,18836,18135,701,3.7
21455,CN4002300000000,40,23,"Choctaw County, OK",Sep-19,5421,5192,229,4.2
21456,CN4002500000000,40,25,"Cimarron County, OK",Sep-19,1325,1302,23,1.7
21457,CN4002700000000,40,27,"Cleveland County, OK",Sep-19,143455,139592,3863,2.7
21458,CN4002900000000,40,29,"Coal County, OK",Sep-19,2345,2254,91,3.9
21459,CN4003100000000,40,31,"Comanche County, OK",Sep-19,47980,46247,1733,3.6
21460,CN4003300000000,40,33,"Cotton County, OK",Sep-19,2707,2625,82,3.0
21461,CN4003500000000,40,35,"Craig County, OK",Sep-19,5915,5709,206,3.5
21462,CN4003700000000,40,37,"Creek County, OK",Sep-19,31689,30576,1113,3.5
21463,CN4003900000000,40,39,"Custer County, OK",Sep-19,15660,15267,393,2.5
21464,CN4004100000000,40,41,"Delaware County, OK",Sep-19,18117,17499,618,3.4
21465,CN4004300000000,40,43,"Dewey County, OK",Sep-19,2840,2777,63,2.2
21466,CN4004500000000,40,45,"Ellis County, OK",Sep-19,2112,2057,55,2.6
21467,CN4004700000000,40,47,"Garfield County, OK",Sep-19,26835,26058,777,2.9
21468,CN4004900000000,40,49,"Garvin County, OK",Sep-19,12350,11975,375,3.0
21469,CN4005100000000,40,51,"Grady County, OK",Sep-19,26617,25802,815,3.1
21470,CN4005300000000,40,53,"Grant County, OK",Sep-19,2616,2566,50,1.9
21471,CN4005500000000,40,55,"Greer County, OK",Sep-19,1836,1768,68,3.7
21472,CN4005700000000,40,57,"Harmon County, OK",Sep-19,1176,1143,33,2.8
21473,CN4005900000000,40,59,"Harper County, OK",Sep-19,1769,1717,52,2.9
21474,CN4006100000000,40,61,"Haskell County, OK",Sep-19,4209,3991,218,5.2
21475,CN4006300000000,40,63,"Hughes County, OK",Sep-19,5288,5050,238,4.5
21476,CN4006500000000,40,65,"Jackson County, OK",Sep-19,10656,10357,299,2.8
21477,CN4006700000000,40,67,"Jefferson County, OK",Sep-19,2521,2441,80,3.2
21478,CN4006900000000,40,69,"Johnston County, OK",Sep-19,3694,3529,165,4.5
21479,CN4007100000000,40,71,"Kay County, OK",Sep-19,18297,17590,707,3.9
21480,CN4007300000000,40,73,"Kingfisher County, OK",Sep-19,9016,8843,173,1.9
21481,CN4007500000000,40,75,"Kiowa County, OK",Sep-19,3485,3350,135,3.9
21482,CN4007700000000,40,77,"Latimer County, OK",Sep-19,3131,2938,193,6.2
21483,CN4007900000000,40,79,"Le Flore County, OK",Sep-19,18973,18132,841,4.4
21484,CN4008100000000,40,81,"Lincoln County, OK",Sep-19,15827,15299,528,3.3
21485,CN4008300000000,40,83,"Logan County, OK",Sep-19,22184,21568,616,2.8
21486,CN4008500000000,40,85,"Love County, OK",Sep-19,6174,6031,143,2.3
21487,CN4008700000000,40,87,"McClain County, OK",Sep-19,19723,19195,528,2.7
21488,CN4008900000000,40,89,"McCurtain County, OK",Sep-19,14648,13897,751,5.1
21489,CN4009100000000,40,91,"McIntosh County, OK",Sep-19,7066,6694,372,5.3
21490,CN4009300000000,40,93,"Major County, OK",Sep-19,3797,3712,85,2.2
21491,CN4009500000000,40,95,"Marshall County, OK",Sep-19,6934,6710,224,3.2
21492,CN4009700000000,40,97,"Mayes County, OK",Sep-19,19700,19133,567,2.9
21493,CN4009900000000,40,99,"Murray County, OK",Sep-19,6364,6184,180,2.8
21494,CN4010100000000,40,101,"Muskogee County, OK",Sep-19,29936,28855,1081,3.6
21495,CN4010300000000,40,103,"Noble County, OK",Sep-19,5620,5480,140,2.5
21496,CN4010500000000,40,105,"Nowata County, OK",Sep-19,4606,4469,137,3.0
21497,CN4010700000000,40,107,"Okfuskee County, OK",Sep-19,4615,4415,200,4.3
21498,CN4010900000000,40,109,"Oklahoma County, OK",Sep-19,386360,374779,11581,3.0
21499,CN4011100000000,40,111,"Okmulgee County, OK",Sep-19,15726,15001,725,4.6
21500,CN4011300000000,40,113,"Osage County, OK",Sep-19,20721,20001,720,3.5
21501,CN4011500000000,40,115,"Ottawa County, OK",Sep-19,14048,13605,443,3.2
21502,CN4011700000000,40,117,"Pawnee County, OK",Sep-19,7356,7098,258,3.5
21503,CN4011900000000,40,119,"Payne County, OK",Sep-19,37600,36560,1040,2.8
21504,CN4012100000000,40,121,"Pittsburg County, OK",Sep-19,16919,16169,750,4.4
21505,CN4012300000000,40,123,"Pontotoc County, OK",Sep-19,19247,18715,532,2.8
21506,CN4012500000000,40,125,"Pottawatomie County, OK",Sep-19,32457,31356,1101,3.4
21507,CN4012700000000,40,127,"Pushmataha County, OK",Sep-19,4269,4069,200,4.7
21508,CN4012900000000,40,129,"Roger Mills County, OK",Sep-19,1861,1799,62,3.3
21509,CN4013100000000,40,131,"Rogers County, OK",Sep-19,45268,43940,1328,2.9
21510,CN4013300000000,40,133,"Seminole County, OK",Sep-19,9505,9075,430,4.5
21511,CN4013500000000,40,135,"Sequoyah County, OK",Sep-19,16114,15491,623,3.9
21512,CN4013700000000,40,137,"Stephens County, OK",Sep-19,18403,17576,827,4.5
21513,CN4013900000000,40,139,"Texas County, OK",Sep-19,11254,11045,209,1.9
21514,CN4014100000000,40,141,"Tillman County, OK",Sep-19,2975,2882,93,3.1
21515,CN4014300000000,40,143,"Tulsa County, OK",Sep-19,324296,314557,9739,3.0
21516,CN4014500000000,40,145,"Wagoner County, OK",Sep-19,38096,36946,1150,3.0
21517,CN4014700000000,40,147,"Washington County, OK",Sep-19,22156,21454,702,3.2
21518,CN4014900000000,40,149,"Washita County, OK",Sep-19,5241,5067,174,3.3
21519,CN4015100000000,40,151,"Woods County, OK",Sep-19,4652,4557,95,2.0
21520,CN4015300000000,40,153,"Woodward County, OK",Sep-19,8898,8629,269,3.0
21521,CN4100100000000,41,1,"Baker County, OR",Sep-19,7171,6938,233,3.2
21522,CN4100300000000,41,3,"Benton County, OR",Sep-19,47015,45697,1318,2.8
21523,CN4100500000000,41,5,"Clackamas County, OR",Sep-19,219773,213403,6370,2.9
21524,CN4100700000000,41,7,"Clatsop County, OR",Sep-19,19849,19268,581,2.9
21525,CN4100900000000,41,9,"Columbia County, OR",Sep-19,24384,23436,948,3.9
21526,CN4101100000000,41,11,"Coos County, OR",Sep-19,26057,25057,1000,3.8
21527,CN4101300000000,41,13,"Crook County, OR",Sep-19,9751,9383,368,3.8
21528,CN4101500000000,41,15,"Curry County, OR",Sep-19,9170,8816,354,3.9
21529,CN4101700000000,41,17,"Deschutes County, OR",Sep-19,96932,94109,2823,2.9
21530,CN4101900000000,41,19,"Douglas County, OR",Sep-19,46645,44806,1839,3.9
21531,CN4102100000000,41,21,"Gilliam County, OR",Sep-19,912,882,30,3.3
21532,CN4102300000000,41,23,"Grant County, OR",Sep-19,3240,3127,113,3.5
21533,CN4102500000000,41,25,"Harney County, OR",Sep-19,3616,3501,115,3.2
21534,CN4102700000000,41,27,"Hood River County, OR",Sep-19,15474,15124,350,2.3
21535,CN4102900000000,41,29,"Jackson County, OR",Sep-19,104447,101039,3408,3.3
21536,CN4103100000000,41,31,"Jefferson County, OR",Sep-19,10118,9762,356,3.5
21537,CN4103300000000,41,33,"Josephine County, OR",Sep-19,35985,34610,1375,3.8
21538,CN4103500000000,41,35,"Klamath County, OR",Sep-19,29479,28057,1422,4.8
21539,CN4103700000000,41,37,"Lake County, OR",Sep-19,3770,3645,125,3.3
21540,CN4103900000000,41,39,"Lane County, OR",Sep-19,179020,172882,6138,3.4
21541,CN4104100000000,41,41,"Lincoln County, OR",Sep-19,21243,20525,718,3.4
21542,CN4104300000000,41,43,"Linn County, OR",Sep-19,58338,56235,2103,3.6
21543,CN4104500000000,41,45,"Malheur County, OR",Sep-19,12515,12135,380,3.0
21544,CN4104700000000,41,47,"Marion County, OR",Sep-19,163333,158076,5257,3.2
21545,CN4104900000000,41,49,"Morrow County, OR",Sep-19,5917,5744,173,2.9
21546,CN4105100000000,41,51,"Multnomah County, OR",Sep-19,455572,442923,12649,2.8
21547,CN4105300000000,41,53,"Polk County, OR",Sep-19,40057,38677,1380,3.4
21548,CN4105500000000,41,55,"Sherman County, OR",Sep-19,976,948,28,2.9
21549,CN4105700000000,41,57,"Tillamook County, OR",Sep-19,12041,11669,372,3.1
21550,CN4105900000000,41,59,"Umatilla County, OR",Sep-19,37625,36349,1276,3.4
21551,CN4106100000000,41,61,"Union County, OR",Sep-19,11804,11393,411,3.5
21552,CN4106300000000,41,63,"Wallowa County, OR",Sep-19,3517,3403,114,3.2
21553,CN4106500000000,41,65,"Wasco County, OR",Sep-19,12648,12222,426,3.4
21554,CN4106700000000,41,67,"Washington County, OR",Sep-19,325157,316392,8765,2.7
21555,CN4106900000000,41,69,"Wheeler County, OR",Sep-19,739,714,25,3.4
21556,CN4107100000000,41,71,"Yamhill County, OR",Sep-19,55063,53469,1594,2.9
21557,CN4200100000000,42,1,"Adams County, PA",Sep-19,55672,53978,1694,3.0
21558,CN4200300000000,42,3,"Allegheny County, PA",Sep-19,651554,625768,25786,4.0
21559,CN4200500000000,42,5,"Armstrong County, PA",Sep-19,32170,30844,1326,4.1
21560,CN4200700000000,42,7,"Beaver County, PA",Sep-19,84266,80737,3529,4.2
21561,CN4200900000000,42,9,"Bedford County, PA",Sep-19,23701,22761,940,4.0
21562,CN4201100000000,42,11,"Berks County, PA",Sep-19,216562,207475,9087,4.2
21563,CN4201300000000,42,13,"Blair County, PA",Sep-19,59563,57042,2521,4.2
21564,CN4201500000000,42,15,"Bradford County, PA",Sep-19,29031,27872,1159,4.0
21565,CN4201700000000,42,17,"Bucks County, PA",Sep-19,346206,333268,12938,3.7
21566,CN4201900000000,42,19,"Butler County, PA",Sep-19,100048,96574,3474,3.5
21567,CN4202100000000,42,21,"Cambria County, PA",Sep-19,57805,55068,2737,4.7
21568,CN4202300000000,42,23,"Cameron County, PA",Sep-19,2081,1980,101,4.9
21569,CN4202500000000,42,25,"Carbon County, PA",Sep-19,32188,30544,1644,5.1
21570,CN4202700000000,42,27,"Centre County, PA",Sep-19,81121,78480,2641,3.3
21571,CN4202900000000,42,29,"Chester County, PA",Sep-19,288026,279027,8999,3.1
21572,CN4203100000000,42,31,"Clarion County, PA",Sep-19,17318,16593,725,4.2
21573,CN4203300000000,42,33,"Clearfield County, PA",Sep-19,35859,34207,1652,4.6
21574,CN4203500000000,42,35,"Clinton County, PA",Sep-19,18307,17447,860,4.7
21575,CN4203700000000,42,37,"Columbia County, PA",Sep-19,33766,32374,1392,4.1
21576,CN4203900000000,42,39,"Crawford County, PA",Sep-19,38485,36867,1618,4.2
21577,CN4204100000000,42,41,"Cumberland County, PA",Sep-19,132817,128402,4415,3.3
21578,CN4204300000000,42,43,"Dauphin County, PA",Sep-19,145064,139162,5902,4.1
21579,CN4204500000000,42,45,"Delaware County, PA",Sep-19,301297,288999,12298,4.1
21580,CN4204700000000,42,47,"Elk County, PA",Sep-19,15437,14730,707,4.6
21581,CN4204900000000,42,49,"Erie County, PA",Sep-19,129126,123832,5294,4.1
21582,CN4205100000000,42,51,"Fayette County, PA",Sep-19,57073,54139,2934,5.1
21583,CN4205300000000,42,53,"Forest County, PA",Sep-19,1811,1705,106,5.9
21584,CN4205500000000,42,55,"Franklin County, PA",Sep-19,78005,75195,2810,3.6
21585,CN4205700000000,42,57,"Fulton County, PA",Sep-19,7860,7561,299,3.8
21586,CN4205900000000,42,59,"Greene County, PA",Sep-19,16661,15879,782,4.7
21587,CN4206100000000,42,61,"Huntingdon County, PA",Sep-19,20109,19090,1019,5.1
21588,CN4206300000000,42,63,"Indiana County, PA",Sep-19,39735,38020,1715,4.3
21589,CN4206500000000,42,65,"Jefferson County, PA",Sep-19,20554,19704,850,4.1
21590,CN4206700000000,42,67,"Juniata County, PA",Sep-19,12750,12268,482,3.8
21591,CN4206900000000,42,69,"Lackawanna County, PA",Sep-19,105175,100378,4797,4.6
21592,CN4207100000000,42,71,"Lancaster County, PA",Sep-19,287049,277601,9448,3.3
21593,CN4207300000000,42,73,"Lawrence County, PA",Sep-19,40718,38957,1761,4.3
21594,CN4207500000000,42,75,"Lebanon County, PA",Sep-19,72909,70109,2800,3.8
21595,CN4207700000000,42,77,"Lehigh County, PA",Sep-19,193213,184773,8440,4.4
21596,CN4207900000000,42,79,"Luzerne County, PA",Sep-19,157533,149206,8327,5.3
21597,CN4208100000000,42,81,"Lycoming County, PA",Sep-19,57022,54466,2556,4.5
21598,CN4208300000000,42,83,"McKean County, PA",Sep-19,17342,16497,845,4.9
21599,CN4208500000000,42,85,"Mercer County, PA",Sep-19,49222,47011,2211,4.5
21600,CN4208700000000,42,87,"Mifflin County, PA",Sep-19,21040,20209,831,3.9
21601,CN4208900000000,42,89,"Monroe County, PA",Sep-19,82865,78548,4317,5.2
21602,CN4209100000000,42,91,"Montgomery County, PA",Sep-19,457737,441874,15863,3.5
21603,CN4209300000000,42,93,"Montour County, PA",Sep-19,9203,8910,293,3.2
21604,CN4209500000000,42,95,"Northampton County, PA",Sep-19,161635,154734,6901,4.3
21605,CN4209700000000,42,97,"Northumberland County, PA",Sep-19,43433,41318,2115,4.9
21606,CN4209900000000,42,99,"Perry County, PA",Sep-19,24592,23770,822,3.3
21607,CN4210100000000,42,101,"Philadelphia County/city, PA",Sep-19,725705,685263,40442,5.6
21608,CN4210300000000,42,103,"Pike County, PA",Sep-19,25239,23874,1365,5.4
21609,CN4210500000000,42,105,"Potter County, PA",Sep-19,7248,6902,346,4.8
21610,CN4210700000000,42,107,"Schuylkill County, PA",Sep-19,66587,63222,3365,5.1
21611,CN4210900000000,42,109,"Snyder County, PA",Sep-19,20103,19094,1009,5.0
21612,CN4211100000000,42,111,"Somerset County, PA",Sep-19,33414,31920,1494,4.5
21613,CN4211300000000,42,113,"Sullivan County, PA",Sep-19,2693,2569,124,4.6
21614,CN4211500000000,42,115,"Susquehanna County, PA",Sep-19,20625,19855,770,3.7
21615,CN4211700000000,42,117,"Tioga County, PA",Sep-19,19357,18518,839,4.3
21616,CN4211900000000,42,119,"Union County, PA",Sep-19,20158,19390,768,3.8
21617,CN4212100000000,42,121,"Venango County, PA",Sep-19,22287,21288,999,4.5
21618,CN4212300000000,42,123,"Warren County, PA",Sep-19,18881,18109,772,4.1
21619,CN4212500000000,42,125,"Washington County, PA",Sep-19,107540,102969,4571,4.3
21620,CN4212700000000,42,127,"Wayne County, PA",Sep-19,22178,21325,853,3.8
21621,CN4212900000000,42,129,"Westmoreland County, PA",Sep-19,181458,174155,7303,4.0
21622,CN4213100000000,42,131,"Wyoming County, PA",Sep-19,13598,13018,580,4.3
21623,CN4213300000000,42,133,"York County, PA",Sep-19,236323,227562,8761,3.7
21624,CN4400100000000,44,1,"Bristol County, RI",Sep-19,26060,25363,697,2.7
21625,CN4400300000000,44,3,"Kent County, RI",Sep-19,90793,88292,2501,2.8
21626,CN4400500000000,44,5,"Newport County, RI",Sep-19,44209,43139,1070,2.4
21627,CN4400700000000,44,7,"Providence County, RI",Sep-19,326001,314627,11374,3.5
21628,CN4400900000000,44,9,"Washington County, RI",Sep-19,69261,67409,1852,2.7
21629,CN4500100000000,45,1,"Abbeville County, SC",Sep-19,9971,9723,248,2.5
21630,CN4500300000000,45,3,"Aiken County, SC",Sep-19,74177,72647,1530,2.1
21631,CN4500500000000,45,5,"Allendale County, SC",Sep-19,2597,2481,116,4.5
21632,CN4500700000000,45,7,"Anderson County, SC",Sep-19,91258,89517,1741,1.9
21633,CN4500900000000,45,9,"Bamberg County, SC",Sep-19,4857,4623,234,4.8
21634,CN4501100000000,45,11,"Barnwell County, SC",Sep-19,8122,7845,277,3.4
21635,CN4501300000000,45,13,"Beaufort County, SC",Sep-19,77235,75848,1387,1.8
21636,CN4501500000000,45,15,"Berkeley County, SC",Sep-19,104291,102437,1854,1.8
21637,CN4501700000000,45,17,"Calhoun County, SC",Sep-19,6557,6374,183,2.8
21638,CN4501900000000,45,19,"Charleston County, SC",Sep-19,211700,208376,3324,1.6
21639,CN4502100000000,45,21,"Cherokee County, SC",Sep-19,25220,24655,565,2.2
21640,CN4502300000000,45,23,"Chester County, SC",Sep-19,13366,12959,407,3.0
21641,CN4502500000000,45,25,"Chesterfield County, SC",Sep-19,21738,21292,446,2.1
21642,CN4502700000000,45,27,"Clarendon County, SC",Sep-19,12553,12199,354,2.8
21643,CN4502900000000,45,29,"Colleton County, SC",Sep-19,16720,16328,392,2.3
21644,CN4503100000000,45,31,"Darlington County, SC",Sep-19,30267,29490,777,2.6
21645,CN4503300000000,45,33,"Dillon County, SC",Sep-19,12884,12491,393,3.1
21646,CN4503500000000,45,35,"Dorchester County, SC",Sep-19,78280,76934,1346,1.7
21647,CN4503700000000,45,37,"Edgefield County, SC",Sep-19,10546,10334,212,2.0
21648,CN4503900000000,45,39,"Fairfield County, SC",Sep-19,9551,9231,320,3.4
21649,CN4504100000000,45,41,"Florence County, SC",Sep-19,66789,65397,1392,2.1
21650,CN4504300000000,45,43,"Georgetown County, SC",Sep-19,25643,24999,644,2.5
21651,CN4504500000000,45,45,"Greenville County, SC",Sep-19,255332,250979,4353,1.7
21652,CN4504700000000,45,47,"Greenwood County, SC",Sep-19,31096,30392,704,2.3
21653,CN4504900000000,45,49,"Hampton County, SC",Sep-19,8270,8113,157,1.9
21654,CN4505100000000,45,51,"Horry County, SC",Sep-19,148074,144679,3395,2.3
21655,CN4505300000000,45,53,"Jasper County, SC",Sep-19,12518,12304,214,1.7
21656,CN4505500000000,45,55,"Kershaw County, SC",Sep-19,29216,28561,655,2.2
21657,CN4505700000000,45,57,"Lancaster County, SC",Sep-19,41201,40188,1013,2.5
21658,CN4505900000000,45,59,"Laurens County, SC",Sep-19,30143,29479,664,2.2
21659,CN4506100000000,45,61,"Lee County, SC",Sep-19,6578,6358,220,3.3
21660,CN4506300000000,45,63,"Lexington County, SC",Sep-19,150085,147642,2443,1.6
21661,CN4506500000000,45,65,"McCormick County, SC",Sep-19,3341,3272,69,2.1
21662,CN4506700000000,45,67,"Marion County, SC",Sep-19,12871,12469,402,3.1
21663,CN4506900000000,45,69,"Marlboro County, SC",Sep-19,9154,8864,290,3.2
21664,CN4507100000000,45,71,"Newberry County, SC",Sep-19,18849,18447,402,2.1
21665,CN4507300000000,45,73,"Oconee County, SC",Sep-19,35048,34377,671,1.9
21666,CN4507500000000,45,75,"Orangeburg County, SC",Sep-19,34361,32919,1442,4.2
21667,CN4507700000000,45,77,"Pickens County, SC",Sep-19,57479,56334,1145,2.0
21668,CN4507900000000,45,79,"Richland County, SC",Sep-19,199327,195343,3984,2.0
21669,CN4508100000000,45,81,"Saluda County, SC",Sep-19,8718,8545,173,2.0
21670,CN4508300000000,45,83,"Spartanburg County, SC",Sep-19,153637,150884,2753,1.8
21671,CN4508500000000,45,85,"Sumter County, SC",Sep-19,43401,42339,1062,2.4
21672,CN4508700000000,45,87,"Union County, SC",Sep-19,11667,11366,301,2.6
21673,CN4508900000000,45,89,"Williamsburg County, SC",Sep-19,11847,11443,404,3.4
21674,CN4509100000000,45,91,"York County, SC",Sep-19,140400,137612,2788,2.0
21675,CN4600300000000,46,3,"Aurora County, SD",Sep-19,1519,1470,49,3.2
21676,CN4600500000000,46,5,"Beadle County, SD",Sep-19,9449,9170,279,3.0
21677,CN4600700000000,46,7,"Bennett County, SD",Sep-19,1093,1033,60,5.5
21678,CN4600900000000,46,9,"Bon Homme County, SD",Sep-19,2881,2796,85,3.0
21679,CN4601100000000,46,11,"Brookings County, SD",Sep-19,19110,18555,555,2.9
21680,CN4601300000000,46,13,"Brown County, SD",Sep-19,20572,19970,602,2.9
21681,CN4601500000000,46,15,"Brule County, SD",Sep-19,2441,2364,77,3.2
21682,CN4601700000000,46,17,"Buffalo County, SD",Sep-19,664,613,51,7.7
21683,CN4601900000000,46,19,"Butte County, SD",Sep-19,5011,4854,157,3.1
21684,CN4602100000000,46,21,"Campbell County, SD",Sep-19,779,754,25,3.2
21685,CN4602300000000,46,23,"Charles Mix County, SD",Sep-19,3758,3632,126,3.4
21686,CN4602500000000,46,25,"Clark County, SD",Sep-19,1908,1840,68,3.6
21687,CN4602700000000,46,27,"Clay County, SD",Sep-19,7475,7258,217,2.9
21688,CN4602900000000,46,29,"Codington County, SD",Sep-19,15494,15064,430,2.8
21689,CN4603100000000,46,31,"Corson County, SD",Sep-19,1379,1298,81,5.9
21690,CN4603300000000,46,33,"Custer County, SD",Sep-19,4036,3883,153,3.8
21691,CN4603500000000,46,35,"Davison County, SD",Sep-19,10989,10695,294,2.7
21692,CN4603700000000,46,37,"Day County, SD",Sep-19,2764,2668,96,3.5
21693,CN4603900000000,46,39,"Deuel County, SD",Sep-19,2196,2117,79,3.6
21694,CN4604100000000,46,41,"Dewey County, SD",Sep-19,2247,2077,170,7.6
21695,CN4604300000000,46,43,"Douglas County, SD",Sep-19,1580,1540,40,2.5
21696,CN4604500000000,46,45,"Edmunds County, SD",Sep-19,2036,1976,60,2.9
21697,CN4604700000000,46,47,"Fall River County, SD",Sep-19,2964,2845,119,4.0
21698,CN4604900000000,46,49,"Faulk County, SD",Sep-19,1055,1021,34,3.2
21699,CN4605100000000,46,51,"Grant County, SD",Sep-19,4423,4308,115,2.6
21700,CN4605300000000,46,53,"Gregory County, SD",Sep-19,2046,1982,64,3.1
21701,CN4605500000000,46,55,"Haakon County, SD",Sep-19,1031,1003,28,2.7
21702,CN4605700000000,46,57,"Hamlin County, SD",Sep-19,3355,3266,89,2.7
21703,CN4605900000000,46,59,"Hand County, SD",Sep-19,1747,1700,47,2.7
21704,CN4606100000000,46,61,"Hanson County, SD",Sep-19,1722,1660,62,3.6
21705,CN4606300000000,46,63,"Harding County, SD",Sep-19,743,722,21,2.8
21706,CN4606500000000,46,65,"Hughes County, SD",Sep-19,9952,9709,243,2.4
21707,CN4606700000000,46,67,"Hutchinson County, SD",Sep-19,3584,3484,100,2.8
21708,CN4606900000000,46,69,"Hyde County, SD",Sep-19,691,668,23,3.3
21709,CN4607100000000,46,71,"Jackson County, SD",Sep-19,1327,1261,66,5.0
21710,CN4607300000000,46,73,"Jerauld County, SD",Sep-19,1125,1095,30,2.7
21711,CN4607500000000,46,75,"Jones County, SD",Sep-19,568,553,15,2.6
21712,CN4607700000000,46,77,"Kingsbury County, SD",Sep-19,2624,2556,68,2.6
21713,CN4607900000000,46,79,"Lake County, SD",Sep-19,6665,6437,228,3.4
21714,CN4608100000000,46,81,"Lawrence County, SD",Sep-19,13649,13240,409,3.0
21715,CN4608300000000,46,83,"Lincoln County, SD",Sep-19,34422,33583,839,2.4
21716,CN4608500000000,46,85,"Lyman County, SD",Sep-19,1696,1628,68,4.0
21717,CN4608700000000,46,87,"McCook County, SD",Sep-19,3068,2989,79,2.6
21718,CN4608900000000,46,89,"McPherson County, SD",Sep-19,1027,986,41,4.0
21719,CN4609100000000,46,91,"Marshall County, SD",Sep-19,2393,2310,83,3.5
21720,CN4609300000000,46,93,"Meade County, SD",Sep-19,14255,13791,464,3.3
21721,CN4609500000000,46,95,"Mellette County, SD",Sep-19,736,702,34,4.6
21722,CN4609700000000,46,97,"Miner County, SD",Sep-19,1168,1132,36,3.1
21723,CN4609900000000,46,99,"Minnehaha County, SD",Sep-19,112380,109417,2963,2.6
21724,CN4610100000000,46,101,"Moody County, SD",Sep-19,4059,3925,134,3.3
21725,CN4610200000000,46,102,"Oglala Lakota County, SD",Sep-19,3524,3188,336,9.5
21726,CN4610300000000,46,103,"Pennington County, SD",Sep-19,57324,55496,1828,3.2
21727,CN4610500000000,46,105,"Perkins County, SD",Sep-19,1430,1387,43,3.0
21728,CN4610700000000,46,107,"Potter County, SD",Sep-19,1046,1014,32,3.1
21729,CN4610900000000,46,109,"Roberts County, SD",Sep-19,4952,4790,162,3.3
21730,CN4611100000000,46,111,"Sanborn County, SD",Sep-19,1158,1124,34,2.9
21731,CN4611500000000,46,115,"Spink County, SD",Sep-19,3161,3063,98,3.1
21732,CN4611700000000,46,117,"Stanley County, SD",Sep-19,1838,1793,45,2.4
21733,CN4611900000000,46,119,"Sully County, SD",Sep-19,806,783,23,2.9
21734,CN4612100000000,46,121,"Todd County, SD",Sep-19,3095,2921,174,5.6
21735,CN4612300000000,46,123,"Tripp County, SD",Sep-19,3039,2948,91,3.0
21736,CN4612500000000,46,125,"Turner County, SD",Sep-19,4686,4554,132,2.8
21737,CN4612700000000,46,127,"Union County, SD",Sep-19,8453,8164,289,3.4
21738,CN4612900000000,46,129,"Walworth County, SD",Sep-19,2110,2014,96,4.5
21739,CN4613500000000,46,135,"Yankton County, SD",Sep-19,11776,11452,324,2.8
21740,CN4613700000000,46,137,"Ziebach County, SD",Sep-19,945,896,49,5.2
21741,CN4700100000000,47,1,"Anderson County, TN",Sep-19,34971,33829,1142,3.3
21742,CN4700300000000,47,3,"Bedford County, TN",Sep-19,21183,20430,753,3.6
21743,CN4700500000000,47,5,"Benton County, TN",Sep-19,6972,6682,290,4.2
21744,CN4700700000000,47,7,"Bledsoe County, TN",Sep-19,4426,4218,208,4.7
21745,CN4700900000000,47,9,"Blount County, TN",Sep-19,64179,62327,1852,2.9
21746,CN4701100000000,47,11,"Bradley County, TN",Sep-19,53123,51397,1726,3.2
21747,CN4701300000000,47,13,"Campbell County, TN",Sep-19,14950,14351,599,4.0
21748,CN4701500000000,47,15,"Cannon County, TN",Sep-19,6721,6525,196,2.9
21749,CN4701700000000,47,17,"Carroll County, TN",Sep-19,12160,11640,520,4.3
21750,CN4701900000000,47,19,"Carter County, TN",Sep-19,24252,23359,893,3.7
21751,CN4702100000000,47,21,"Cheatham County, TN",Sep-19,22285,21752,533,2.4
21752,CN4702300000000,47,23,"Chester County, TN",Sep-19,8658,8368,290,3.3
21753,CN4702500000000,47,25,"Claiborne County, TN",Sep-19,13129,12631,498,3.8
21754,CN4702700000000,47,27,"Clay County, TN",Sep-19,2841,2688,153,5.4
21755,CN4702900000000,47,29,"Cocke County, TN",Sep-19,15178,14599,579,3.8
21756,CN4703100000000,47,31,"Coffee County, TN",Sep-19,25767,24927,840,3.3
21757,CN4703300000000,47,33,"Crockett County, TN",Sep-19,7093,6865,228,3.2
21758,CN4703500000000,47,35,"Cumberland County, TN",Sep-19,23863,22924,939,3.9
21759,CN4703700000000,47,37,"Davidson County, TN",Sep-19,411570,401782,9788,2.4
21760,CN4703900000000,47,39,"Decatur County, TN",Sep-19,4601,4388,213,4.6
21761,CN4704100000000,47,41,"DeKalb County, TN",Sep-19,7845,7545,300,3.8
21762,CN4704300000000,47,43,"Dickson County, TN",Sep-19,27540,26756,784,2.8
21763,CN4704500000000,47,45,"Dyer County, TN",Sep-19,16647,15863,784,4.7
21764,CN4704700000000,47,47,"Fayette County, TN",Sep-19,19428,18689,739,3.8
21765,CN4704900000000,47,49,"Fentress County, TN",Sep-19,7617,7317,300,3.9
21766,CN4705100000000,47,51,"Franklin County, TN",Sep-19,20285,19631,654,3.2
21767,CN4705300000000,47,53,"Gibson County, TN",Sep-19,22341,21442,899,4.0
21768,CN4705500000000,47,55,"Giles County, TN",Sep-19,15054,14536,518,3.4
21769,CN4705700000000,47,57,"Grainger County, TN",Sep-19,9600,9272,328,3.4
21770,CN4705900000000,47,59,"Greene County, TN",Sep-19,29893,28518,1375,4.6
21771,CN4706100000000,47,61,"Grundy County, TN",Sep-19,5019,4828,191,3.8
21772,CN4706300000000,47,63,"Hamblen County, TN",Sep-19,28389,27361,1028,3.6
21773,CN4706500000000,47,65,"Hamilton County, TN",Sep-19,185618,179916,5702,3.1
21774,CN4706700000000,47,67,"Hancock County, TN",Sep-19,2153,2044,109,5.1
21775,CN4706900000000,47,69,"Hardeman County, TN",Sep-19,9625,9110,515,5.4
21776,CN4707100000000,47,71,"Hardin County, TN",Sep-19,10544,10156,388,3.7
21777,CN4707300000000,47,73,"Hawkins County, TN",Sep-19,23862,22898,964,4.0
21778,CN4707500000000,47,75,"Haywood County, TN",Sep-19,7792,7436,356,4.6
21779,CN4707700000000,47,77,"Henderson County, TN",Sep-19,12364,11895,469,3.8
21780,CN4707900000000,47,79,"Henry County, TN",Sep-19,14312,13764,548,3.8
21781,CN4708100000000,47,81,"Hickman County, TN",Sep-19,11661,11323,338,2.9
21782,CN4708300000000,47,83,"Houston County, TN",Sep-19,3330,3183,147,4.4
21783,CN4708500000000,47,85,"Humphreys County, TN",Sep-19,9085,8752,333,3.7
21784,CN4708700000000,47,87,"Jackson County, TN",Sep-19,4722,4537,185,3.9
21785,CN4708900000000,47,89,"Jefferson County, TN",Sep-19,24778,23943,835,3.4
21786,CN4709100000000,47,91,"Johnson County, TN",Sep-19,7752,7514,238,3.1
21787,CN4709300000000,47,93,"Knox County, TN",Sep-19,246586,239948,6638,2.7
21788,CN4709500000000,47,95,"Lake County, TN",Sep-19,1761,1675,86,4.9
21789,CN4709700000000,47,97,"Lauderdale County, TN",Sep-19,9802,9309,493,5.0
21790,CN4709900000000,47,99,"Lawrence County, TN",Sep-19,19544,18806,738,3.8
21791,CN4710100000000,47,101,"Lewis County, TN",Sep-19,5249,5081,168,3.2
21792,CN4710300000000,47,103,"Lincoln County, TN",Sep-19,16955,16457,498,2.9
21793,CN4710500000000,47,105,"Loudon County, TN",Sep-19,23748,23015,733,3.1
21794,CN4710700000000,47,107,"McMinn County, TN",Sep-19,23883,23058,825,3.5
21795,CN4710900000000,47,109,"McNairy County, TN",Sep-19,8655,8257,398,4.6
21796,CN4711100000000,47,111,"Macon County, TN",Sep-19,11509,11187,322,2.8
21797,CN4711300000000,47,113,"Madison County, TN",Sep-19,49559,47808,1751,3.5
21798,CN4711500000000,47,115,"Marion County, TN",Sep-19,12605,12095,510,4.0
21799,CN4711700000000,47,117,"Marshall County, TN",Sep-19,15792,15313,479,3.0
21800,CN4711900000000,47,119,"Maury County, TN",Sep-19,50156,48872,1284,2.6
21801,CN4712100000000,47,121,"Meigs County, TN",Sep-19,5251,5046,205,3.9
21802,CN4712300000000,47,123,"Monroe County, TN",Sep-19,20322,19659,663,3.3
21803,CN4712500000000,47,125,"Montgomery County, TN",Sep-19,86708,83574,3134,3.6
21804,CN4712700000000,47,127,"Moore County, TN",Sep-19,3673,3567,106,2.9
21805,CN4712900000000,47,129,"Morgan County, TN",Sep-19,7960,7665,295,3.7
21806,CN4713100000000,47,131,"Obion County, TN",Sep-19,12528,12028,500,4.0
21807,CN4713300000000,47,133,"Overton County, TN",Sep-19,10179,9856,323,3.2
21808,CN4713500000000,47,135,"Perry County, TN",Sep-19,3093,2982,111,3.6
21809,CN4713700000000,47,137,"Pickett County, TN",Sep-19,2440,2349,91,3.7
21810,CN4713900000000,47,139,"Polk County, TN",Sep-19,7670,7384,286,3.7
21811,CN4714100000000,47,141,"Putnam County, TN",Sep-19,35737,34580,1157,3.2
21812,CN4714300000000,47,143,"Rhea County, TN",Sep-19,13611,12934,677,5.0
21813,CN4714500000000,47,145,"Roane County, TN",Sep-19,23631,22750,881,3.7
21814,CN4714700000000,47,147,"Robertson County, TN",Sep-19,38738,37703,1035,2.7
21815,CN4714900000000,47,149,"Rutherford County, TN",Sep-19,187430,182923,4507,2.4
21816,CN4715100000000,47,151,"Scott County, TN",Sep-19,8332,7989,343,4.1
21817,CN4715300000000,47,153,"Sequatchie County, TN",Sep-19,6268,6011,257,4.1
21818,CN4715500000000,47,155,"Sevier County, TN",Sep-19,55505,54191,1314,2.4
21819,CN4715700000000,47,157,"Shelby County, TN",Sep-19,448743,431318,17425,3.9
21820,CN4715900000000,47,159,"Smith County, TN",Sep-19,9629,9367,262,2.7
21821,CN4716100000000,47,161,"Stewart County, TN",Sep-19,5572,5359,213,3.8
21822,CN4716300000000,47,163,"Sullivan County, TN",Sep-19,70484,68048,2436,3.5
21823,CN4716500000000,47,165,"Sumner County, TN",Sep-19,104275,101639,2636,2.5
21824,CN4716700000000,47,167,"Tipton County, TN",Sep-19,28413,27345,1068,3.8
21825,CN4716900000000,47,169,"Trousdale County, TN",Sep-19,5525,5372,153,2.8
21826,CN4717100000000,47,171,"Unicoi County, TN",Sep-19,7181,6859,322,4.5
21827,CN4717300000000,47,173,"Union County, TN",Sep-19,7691,7422,269,3.5
21828,CN4717500000000,47,175,"Van Buren County, TN",Sep-19,2086,2003,83,4.0
21829,CN4717700000000,47,177,"Warren County, TN",Sep-19,16808,16171,637,3.8
21830,CN4717900000000,47,179,"Washington County, TN",Sep-19,61083,59084,1999,3.3
21831,CN4718100000000,47,181,"Wayne County, TN",Sep-19,6253,6004,249,4.0
21832,CN4718300000000,47,183,"Weakley County, TN",Sep-19,16256,15695,561,3.5
21833,CN4718500000000,47,185,"White County, TN",Sep-19,12350,11919,431,3.5
21834,CN4718700000000,47,187,"Williamson County, TN",Sep-19,130866,127857,3009,2.3
21835,CN4718900000000,47,189,"Wilson County, TN",Sep-19,78064,76102,1962,2.5
21836,CN4800100000000,48,1,"Anderson County, TX",Sep-19,24091,23431,660,2.7
21837,CN4800300000000,48,3,"Andrews County, TX",Sep-19,9906,9677,229,2.3
21838,CN4800500000000,48,5,"Angelina County, TX",Sep-19,36136,34723,1413,3.9
21839,CN4800700000000,48,7,"Aransas County, TX",Sep-19,9369,9001,368,3.9
21840,CN4800900000000,48,9,"Archer County, TX",Sep-19,4147,4034,113,2.7
21841,CN4801100000000,48,11,"Armstrong County, TX",Sep-19,930,906,24,2.6
21842,CN4801300000000,48,13,"Atascosa County, TX",Sep-19,21811,21042,769,3.5
21843,CN4801500000000,48,15,"Austin County, TX",Sep-19,14136,13670,466,3.3
21844,CN4801700000000,48,17,"Bailey County, TX",Sep-19,2489,2405,84,3.4
21845,CN4801900000000,48,19,"Bandera County, TX",Sep-19,10126,9791,335,3.3
21846,CN4802100000000,48,21,"Bastrop County, TX",Sep-19,43122,41855,1267,2.9
21847,CN4802300000000,48,23,"Baylor County, TX",Sep-19,1780,1740,40,2.2
21848,CN4802500000000,48,25,"Bee County, TX",Sep-19,9887,9452,435,4.4
21849,CN4802700000000,48,27,"Bell County, TX",Sep-19,144386,139037,5349,3.7
21850,CN4802900000000,48,29,"Bexar County, TX",Sep-19,954352,925042,29310,3.1
21851,CN4803100000000,48,31,"Blanco County, TX",Sep-19,6472,6321,151,2.3
21852,CN4803300000000,48,33,"Borden County, TX",Sep-19,416,405,11,2.6
21853,CN4803500000000,48,35,"Bosque County, TX",Sep-19,8359,8076,283,3.4
21854,CN4803700000000,48,37,"Bowie County, TX",Sep-19,40095,38384,1711,4.3
21855,CN4803900000000,48,39,"Brazoria County, TX",Sep-19,180499,172774,7725,4.3
21856,CN4804100000000,48,41,"Brazos County, TX",Sep-19,120591,117445,3146,2.6
21857,CN4804300000000,48,43,"Brewster County, TX",Sep-19,4209,4087,122,2.9
21858,CN4804500000000,48,45,"Briscoe County, TX",Sep-19,573,552,21,3.7
21859,CN4804700000000,48,47,"Brooks County, TX",Sep-19,2575,2445,130,5.0
21860,CN4804900000000,48,49,"Brown County, TX",Sep-19,15663,15066,597,3.8
21861,CN4805100000000,48,51,"Burleson County, TX",Sep-19,8455,8209,246,2.9
21862,CN4805300000000,48,53,"Burnet County, TX",Sep-19,23598,22964,634,2.7
21863,CN4805500000000,48,55,"Caldwell County, TX",Sep-19,19776,19124,652,3.3
21864,CN4805700000000,48,57,"Calhoun County, TX",Sep-19,12109,11737,372,3.1
21865,CN4805900000000,48,59,"Callahan County, TX",Sep-19,6180,5996,184,3.0
21866,CN4806100000000,48,61,"Cameron County, TX",Sep-19,167073,158398,8675,5.2
21867,CN4806300000000,48,63,"Camp County, TX",Sep-19,5026,4822,204,4.1
21868,CN4806500000000,48,65,"Carson County, TX",Sep-19,3011,2942,69,2.3
21869,CN4806700000000,48,67,"Cass County, TX",Sep-19,12435,11910,525,4.2
21870,CN4806900000000,48,69,"Castro County, TX",Sep-19,3438,3350,88,2.6
21871,CN4807100000000,48,71,"Chambers County, TX",Sep-19,19510,18685,825,4.2
21872,CN4807300000000,48,73,"Cherokee County, TX",Sep-19,20806,20036,770,3.7
21873,CN4807500000000,48,75,"Childress County, TX",Sep-19,2958,2879,79,2.7
21874,CN4807700000000,48,77,"Clay County, TX",Sep-19,4946,4796,150,3.0
21875,CN4807900000000,48,79,"Cochran County, TX",Sep-19,1121,1088,33,2.9
21876,CN4808100000000,48,81,"Coke County, TX",Sep-19,1484,1439,45,3.0
21877,CN4808300000000,48,83,"Coleman County, TX",Sep-19,2891,2775,116,4.0
21878,CN4808500000000,48,85,"Collin County, TX",Sep-19,568636,551551,17085,3.0
21879,CN4808700000000,48,87,"Collingsworth County, TX",Sep-19,1153,1113,40,3.5
21880,CN4808900000000,48,89,"Colorado County, TX",Sep-19,9885,9592,293,3.0
21881,CN4809100000000,48,91,"Comal County, TX",Sep-19,73664,71527,2137,2.9
21882,CN4809300000000,48,93,"Comanche County, TX",Sep-19,5660,5487,173,3.1
21883,CN4809500000000,48,95,"Concho County, TX",Sep-19,1353,1311,42,3.1
21884,CN4809700000000,48,97,"Cooke County, TX",Sep-19,19688,19152,536,2.7
21885,CN4809900000000,48,99,"Coryell County, TX",Sep-19,24193,23284,909,3.8
21886,CN4810100000000,48,101,"Cottle County, TX",Sep-19,540,517,23,4.3
21887,CN4810300000000,48,103,"Crane County, TX",Sep-19,1590,1525,65,4.1
21888,CN4810500000000,48,105,"Crockett County, TX",Sep-19,1628,1574,54,3.3
21889,CN4810700000000,48,107,"Crosby County, TX",Sep-19,2508,2410,98,3.9
21890,CN4810900000000,48,109,"Culberson County, TX",Sep-19,1066,1022,44,4.1
21891,CN4811100000000,48,111,"Dallam County, TX",Sep-19,3891,3820,71,1.8
21892,CN4811300000000,48,113,"Dallas County, TX",Sep-19,1375918,1329943,45975,3.3
21893,CN4811500000000,48,115,"Dawson County, TX",Sep-19,4584,4400,184,4.0
21894,CN4811700000000,48,117,"Deaf Smith County, TX",Sep-19,8553,8325,228,2.7
21895,CN4811900000000,48,119,"Delta County, TX",Sep-19,2456,2371,85,3.5
21896,CN4812100000000,48,121,"Denton County, TX",Sep-19,499067,484662,14405,2.9
21897,CN4812300000000,48,123,"DeWitt County, TX",Sep-19,9856,9607,249,2.5
21898,CN4812500000000,48,125,"Dickens County, TX",Sep-19,674,644,30,4.5
21899,CN4812700000000,48,127,"Dimmit County, TX",Sep-19,7226,7045,181,2.5
21900,CN4812900000000,48,129,"Donley County, TX",Sep-19,1389,1342,47,3.4
21901,CN4813100000000,48,131,"Duval County, TX",Sep-19,4919,4714,205,4.2
21902,CN4813300000000,48,133,"Eastland County, TX",Sep-19,8134,7871,263,3.2
21903,CN4813500000000,48,135,"Ector County, TX",Sep-19,88187,85802,2385,2.7
21904,CN4813700000000,48,137,"Edwards County, TX",Sep-19,1140,1117,23,2.0
21905,CN4813900000000,48,139,"Ellis County, TX",Sep-19,93455,90667,2788,3.0
21906,CN4814100000000,48,141,"El Paso County, TX",Sep-19,365193,351539,13654,3.7
21907,CN4814300000000,48,143,"Erath County, TX",Sep-19,20705,20036,669,3.2
21908,CN4814500000000,48,145,"Falls County, TX",Sep-19,6601,6393,208,3.2
21909,CN4814700000000,48,147,"Fannin County, TX",Sep-19,17459,16991,468,2.7
21910,CN4814900000000,48,149,"Fayette County, TX",Sep-19,12099,11786,313,2.6
21911,CN4815100000000,48,151,"Fisher County, TX",Sep-19,1627,1575,52,3.2
21912,CN4815300000000,48,153,"Floyd County, TX",Sep-19,2562,2460,102,4.0
21913,CN4815500000000,48,155,"Foard County, TX",Sep-19,593,573,20,3.4
21914,CN4815700000000,48,157,"Fort Bend County, TX",Sep-19,393742,380281,13461,3.4
21915,CN4815900000000,48,159,"Franklin County, TX",Sep-19,4657,4496,161,3.5
21916,CN4816100000000,48,161,"Freestone County, TX",Sep-19,6448,6144,304,4.7
21917,CN4816300000000,48,163,"Frio County, TX",Sep-19,10431,10188,243,2.3
21918,CN4816500000000,48,165,"Gaines County, TX",Sep-19,9818,9587,231,2.4
21919,CN4816700000000,48,167,"Galveston County, TX",Sep-19,165994,159490,6504,3.9
21920,CN4816900000000,48,169,"Garza County, TX",Sep-19,2160,2103,57,2.6
21921,CN4817100000000,48,171,"Gillespie County, TX",Sep-19,13479,13162,317,2.4
21922,CN4817300000000,48,173,"Glasscock County, TX",Sep-19,798,781,17,2.1
21923,CN4817500000000,48,175,"Goliad County, TX",Sep-19,3260,3158,102,3.1
21924,CN4817700000000,48,177,"Gonzales County, TX",Sep-19,9630,9381,249,2.6
21925,CN4817900000000,48,179,"Gray County, TX",Sep-19,8124,7840,284,3.5
21926,CN4818100000000,48,181,"Grayson County, TX",Sep-19,64164,62209,1955,3.0
21927,CN4818300000000,48,183,"Gregg County, TX",Sep-19,58637,56470,2167,3.7
21928,CN4818500000000,48,185,"Grimes County, TX",Sep-19,11231,10794,437,3.9
21929,CN4818700000000,48,187,"Guadalupe County, TX",Sep-19,81896,79552,2344,2.9
21930,CN4818900000000,48,189,"Hale County, TX",Sep-19,12070,11562,508,4.2
21931,CN4819100000000,48,191,"Hall County, TX",Sep-19,1067,1025,42,3.9
21932,CN4819300000000,48,193,"Hamilton County, TX",Sep-19,3674,3561,113,3.1
21933,CN4819500000000,48,195,"Hansford County, TX",Sep-19,2770,2709,61,2.2
21934,CN4819700000000,48,197,"Hardeman County, TX",Sep-19,1759,1708,51,2.9
21935,CN4819900000000,48,199,"Hardin County, TX",Sep-19,25328,24223,1105,4.4
21936,CN4820100000000,48,201,"Harris County, TX",Sep-19,2324803,2238007,86796,3.7
21937,CN4820300000000,48,203,"Harrison County, TX",Sep-19,29753,28570,1183,4.0
21938,CN4820500000000,48,205,"Hartley County, TX",Sep-19,2788,2740,48,1.7
21939,CN4820700000000,48,207,"Haskell County, TX",Sep-19,2308,2233,75,3.2
21940,CN4820900000000,48,209,"Hays County, TX",Sep-19,120597,117278,3319,2.8
21941,CN4821100000000,48,211,"Hemphill County, TX",Sep-19,1922,1874,48,2.5
21942,CN4821300000000,48,213,"Henderson County, TX",Sep-19,36769,35509,1260,3.4
21943,CN4821500000000,48,215,"Hidalgo County, TX",Sep-19,352630,331530,21100,6.0
21944,CN4821700000000,48,217,"Hill County, TX",Sep-19,16604,16070,534,3.2
21945,CN4821900000000,48,219,"Hockley County, TX",Sep-19,11219,10903,316,2.8
21946,CN4822100000000,48,221,"Hood County, TX",Sep-19,27753,26820,933,3.4
21947,CN4822300000000,48,223,"Hopkins County, TX",Sep-19,17661,17153,508,2.9
21948,CN4822500000000,48,225,"Houston County, TX",Sep-19,10453,10140,313,3.0
21949,CN4822700000000,48,227,"Howard County, TX",Sep-19,14099,13657,442,3.1
21950,CN4822900000000,48,229,"Hudspeth County, TX",Sep-19,1850,1761,89,4.8
21951,CN4823100000000,48,231,"Hunt County, TX",Sep-19,43756,42260,1496,3.4
21952,CN4823300000000,48,233,"Hutchinson County, TX",Sep-19,8727,8342,385,4.4
21953,CN4823500000000,48,235,"Irion County, TX",Sep-19,761,743,18,2.4
21954,CN4823700000000,48,237,"Jack County, TX",Sep-19,3488,3378,110,3.2
21955,CN4823900000000,48,239,"Jackson County, TX",Sep-19,7664,7446,218,2.8
21956,CN4824100000000,48,241,"Jasper County, TX",Sep-19,12841,12094,747,5.8
21957,CN4824300000000,48,243,"Jeff Davis County, TX",Sep-19,1017,986,31,3.0
21958,CN4824500000000,48,245,"Jefferson County, TX",Sep-19,107197,101003,6194,5.8
21959,CN4824700000000,48,247,"Jim Hogg County, TX",Sep-19,1882,1801,81,4.3
21960,CN4824900000000,48,249,"Jim Wells County, TX",Sep-19,16671,15936,735,4.4
21961,CN4825100000000,48,251,"Johnson County, TX",Sep-19,82758,80164,2594,3.1
21962,CN4825300000000,48,253,"Jones County, TX",Sep-19,5806,5565,241,4.2
21963,CN4825500000000,48,255,"Karnes County, TX",Sep-19,7247,7064,183,2.5
21964,CN4825700000000,48,257,"Kaufman County, TX",Sep-19,65157,63093,2064,3.2
21965,CN4825900000000,48,259,"Kendall County, TX",Sep-19,22236,21640,596,2.7
21966,CN4826100000000,48,261,"Kenedy County, TX",Sep-19,200,192,8,4.0
21967,CN4826300000000,48,263,"Kent County, TX",Sep-19,488,477,11,2.3
21968,CN4826500000000,48,265,"Kerr County, TX",Sep-19,22208,21553,655,2.9
21969,CN4826700000000,48,267,"Kimble County, TX",Sep-19,1838,1779,59,3.2
21970,CN4826900000000,48,269,"King County, TX",Sep-19,251,247,4,1.6
21971,CN4827100000000,48,271,"Kinney County, TX",Sep-19,1399,1358,41,2.9
21972,CN4827300000000,48,273,"Kleberg County, TX",Sep-19,13392,12815,577,4.3
21973,CN4827500000000,48,275,"Knox County, TX",Sep-19,1439,1394,45,3.1
21974,CN4827700000000,48,277,"Lamar County, TX",Sep-19,24371,23581,790,3.2
21975,CN4827900000000,48,279,"Lamb County, TX",Sep-19,5340,5142,198,3.7
21976,CN4828100000000,48,281,"Lampasas County, TX",Sep-19,9235,8948,287,3.1
21977,CN4828300000000,48,283,"La Salle County, TX",Sep-19,4354,4241,113,2.6
21978,CN4828500000000,48,285,"Lavaca County, TX",Sep-19,8508,8257,251,3.0
21979,CN4828700000000,48,287,"Lee County, TX",Sep-19,10137,9879,258,2.5
21980,CN4828900000000,48,289,"Leon County, TX",Sep-19,6390,6100,290,4.5
21981,CN4829100000000,48,291,"Liberty County, TX",Sep-19,33174,31565,1609,4.9
21982,CN4829300000000,48,293,"Limestone County, TX",Sep-19,8616,8299,317,3.7
21983,CN4829500000000,48,295,"Lipscomb County, TX",Sep-19,1625,1585,40,2.5
21984,CN4829700000000,48,297,"Live Oak County, TX",Sep-19,5656,5489,167,3.0
21985,CN4829900000000,48,299,"Llano County, TX",Sep-19,8796,8503,293,3.3
21986,CN4830100000000,48,301,"Loving County, TX",Sep-19,615,611,4,0.7
21987,CN4830300000000,48,303,"Lubbock County, TX",Sep-19,158475,154172,4303,2.7
21988,CN4830500000000,48,305,"Lynn County, TX",Sep-19,2787,2702,85,3.0
21989,CN4830700000000,48,307,"McCulloch County, TX",Sep-19,3381,3193,188,5.6
21990,CN4830900000000,48,309,"McLennan County, TX",Sep-19,120169,116311,3858,3.2
21991,CN4831100000000,48,311,"McMullen County, TX",Sep-19,892,878,14,1.6
21992,CN4831300000000,48,313,"Madison County, TX",Sep-19,4561,4361,200,4.4
21993,CN4831500000000,48,315,"Marion County, TX",Sep-19,4227,4059,168,4.0
21994,CN4831700000000,48,317,"Martin County, TX",Sep-19,2898,2823,75,2.6
21995,CN4831900000000,48,319,"Mason County, TX",Sep-19,1753,1699,54,3.1
21996,CN4832100000000,48,321,"Matagorda County, TX",Sep-19,16756,15803,953,5.7
21997,CN4832300000000,48,323,"Maverick County, TX",Sep-19,23399,21917,1482,6.3
21998,CN4832500000000,48,325,"Medina County, TX",Sep-19,21943,21259,684,3.1
21999,CN4832700000000,48,327,"Menard County, TX",Sep-19,882,852,30,3.4
22000,CN4832900000000,48,329,"Midland County, TX",Sep-19,107830,105609,2221,2.1
22001,CN4833100000000,48,331,"Milam County, TX",Sep-19,9791,9354,437,4.5
22002,CN4833300000000,48,333,"Mills County, TX",Sep-19,1915,1860,55,2.9
22003,CN4833500000000,48,335,"Mitchell County, TX",Sep-19,2333,2249,84,3.6
22004,CN4833700000000,48,337,"Montague County, TX",Sep-19,9406,9136,270,2.9
22005,CN4833900000000,48,339,"Montgomery County, TX",Sep-19,285075,275545,9530,3.3
22006,CN4834100000000,48,341,"Moore County, TX",Sep-19,10969,10713,256,2.3
22007,CN4834300000000,48,343,"Morris County, TX",Sep-19,4853,4607,246,5.1
22008,CN4834500000000,48,345,"Motley County, TX",Sep-19,483,467,16,3.3
22009,CN4834700000000,48,347,"Nacogdoches County, TX",Sep-19,28278,27249,1029,3.6
22010,CN4834900000000,48,349,"Navarro County, TX",Sep-19,24369,23644,725,3.0
22011,CN4835100000000,48,351,"Newton County, TX",Sep-19,5183,4870,313,6.0
22012,CN4835300000000,48,353,"Nolan County, TX",Sep-19,7241,7032,209,2.9
22013,CN4835500000000,48,355,"Nueces County, TX",Sep-19,166828,160207,6621,4.0
22014,CN4835700000000,48,357,"Ochiltree County, TX",Sep-19,4336,4221,115,2.7
22015,CN4835900000000,48,359,"Oldham County, TX",Sep-19,918,893,25,2.7
22016,CN4836100000000,48,361,"Orange County, TX",Sep-19,36458,34607,1851,5.1
22017,CN4836300000000,48,363,"Palo Pinto County, TX",Sep-19,13632,13217,415,3.0
22018,CN4836500000000,48,365,"Panola County, TX",Sep-19,10046,9640,406,4.0
22019,CN4836700000000,48,367,"Parker County, TX",Sep-19,67801,65879,1922,2.8
22020,CN4836900000000,48,369,"Parmer County, TX",Sep-19,4873,4768,105,2.2
22021,CN4837100000000,48,371,"Pecos County, TX",Sep-19,6335,6134,201,3.2
22022,CN4837300000000,48,373,"Polk County, TX",Sep-19,18051,17243,808,4.5
22023,CN4837500000000,48,375,"Potter County, TX",Sep-19,55314,53821,1493,2.7
22024,CN4837700000000,48,377,"Presidio County, TX",Sep-19,3124,2915,209,6.7
22025,CN4837900000000,48,379,"Rains County, TX",Sep-19,5996,5819,177,3.0
22026,CN4838100000000,48,381,"Randall County, TX",Sep-19,72262,70541,1721,2.4
22027,CN4838300000000,48,383,"Reagan County, TX",Sep-19,1915,1863,52,2.7
22028,CN4838500000000,48,385,"Real County, TX",Sep-19,1003,962,41,4.1
22029,CN4838700000000,48,387,"Red River County, TX",Sep-19,5148,4919,229,4.4
22030,CN4838900000000,48,389,"Reeves County, TX",Sep-19,11259,11047,212,1.9
22031,CN4839100000000,48,391,"Refugio County, TX",Sep-19,3149,3033,116,3.7
22032,CN4839300000000,48,393,"Roberts County, TX",Sep-19,423,412,11,2.6
22033,CN4839500000000,48,395,"Robertson County, TX",Sep-19,7745,7482,263,3.4
22034,CN4839700000000,48,397,"Rockwall County, TX",Sep-19,52557,50955,1602,3.0
22035,CN4839900000000,48,399,"Runnels County, TX",Sep-19,4632,4507,125,2.7
22036,CN4840100000000,48,401,"Rusk County, TX",Sep-19,23185,22361,824,3.6
22037,CN4840300000000,48,403,"Sabine County, TX",Sep-19,3716,3487,229,6.2
22038,CN4840500000000,48,405,"San Augustine County, TX",Sep-19,3393,3234,159,4.7
22039,CN4840700000000,48,407,"San Jacinto County, TX",Sep-19,11784,11252,532,4.5
22040,CN4840900000000,48,409,"San Patricio County, TX",Sep-19,29821,28226,1595,5.3
22041,CN4841100000000,48,411,"San Saba County, TX",Sep-19,2538,2464,74,2.9
22042,CN4841300000000,48,413,"Schleicher County, TX",Sep-19,1295,1255,40,3.1
22043,CN4841500000000,48,415,"Scurry County, TX",Sep-19,6709,6505,204,3.0
22044,CN4841700000000,48,417,"Shackelford County, TX",Sep-19,1897,1856,41,2.2
22045,CN4841900000000,48,419,"Shelby County, TX",Sep-19,11311,10885,426,3.8
22046,CN4842100000000,48,421,"Sherman County, TX",Sep-19,1385,1354,31,2.2
22047,CN4842300000000,48,423,"Smith County, TX",Sep-19,107227,103720,3507,3.3
22048,CN4842500000000,48,425,"Somervell County, TX",Sep-19,4393,4240,153,3.5
22049,CN4842700000000,48,427,"Starr County, TX",Sep-19,24613,22213,2400,9.8
22050,CN4842900000000,48,429,"Stephens County, TX",Sep-19,4062,3937,125,3.1
22051,CN4843100000000,48,431,"Sterling County, TX",Sep-19,580,563,17,2.9
22052,CN4843300000000,48,433,"Stonewall County, TX",Sep-19,595,578,17,2.9
22053,CN4843500000000,48,435,"Sutton County, TX",Sep-19,1319,1267,52,3.9
22054,CN4843700000000,48,437,"Swisher County, TX",Sep-19,2611,2519,92,3.5
22055,CN4843900000000,48,439,"Tarrant County, TX",Sep-19,1089878,1055280,34598,3.2
22056,CN4844100000000,48,441,"Taylor County, TX",Sep-19,67755,65871,1884,2.8
22057,CN4844300000000,48,443,"Terrell County, TX",Sep-19,377,360,17,4.5
22058,CN4844500000000,48,445,"Terry County, TX",Sep-19,4944,4774,170,3.4
22059,CN4844700000000,48,447,"Throckmorton County, TX",Sep-19,657,630,27,4.1
22060,CN4844900000000,48,449,"Titus County, TX",Sep-19,13169,12659,510,3.9
22061,CN4845100000000,48,451,"Tom Green County, TX",Sep-19,54658,53057,1601,2.9
22062,CN4845300000000,48,453,"Travis County, TX",Sep-19,745227,726312,18915,2.5
22063,CN4845500000000,48,455,"Trinity County, TX",Sep-19,5382,5133,249,4.6
22064,CN4845700000000,48,457,"Tyler County, TX",Sep-19,7134,6738,396,5.6
22065,CN4845900000000,48,459,"Upshur County, TX",Sep-19,17976,17338,638,3.5
22066,CN4846100000000,48,461,"Upton County, TX",Sep-19,1675,1630,45,2.7
22067,CN4846300000000,48,463,"Uvalde County, TX",Sep-19,11533,11121,412,3.6
22068,CN4846500000000,48,465,"Val Verde County, TX",Sep-19,23094,22374,720,3.1
22069,CN4846700000000,48,467,"Van Zandt County, TX",Sep-19,26105,25271,834,3.2
22070,CN4846900000000,48,469,"Victoria County, TX",Sep-19,42784,41345,1439,3.4
22071,CN4847100000000,48,471,"Walker County, TX",Sep-19,24434,23494,940,3.8
22072,CN4847300000000,48,473,"Waller County, TX",Sep-19,23555,22694,861,3.7
22073,CN4847500000000,48,475,"Ward County, TX",Sep-19,7414,7248,166,2.2
22074,CN4847700000000,48,477,"Washington County, TX",Sep-19,15408,14938,470,3.1
22075,CN4847900000000,48,479,"Webb County, TX",Sep-19,118808,114749,4059,3.4
22076,CN4848100000000,48,481,"Wharton County, TX",Sep-19,21840,21108,732,3.4
22077,CN4848300000000,48,483,"Wheeler County, TX",Sep-19,2275,2203,72,3.2
22078,CN4848500000000,48,485,"Wichita County, TX",Sep-19,56397,54683,1714,3.0
22079,CN4848700000000,48,487,"Wilbarger County, TX",Sep-19,4974,4814,160,3.2
22080,CN4848900000000,48,489,"Willacy County, TX",Sep-19,6672,6172,500,7.5
22081,CN4849100000000,48,491,"Williamson County, TX",Sep-19,315801,307030,8771,2.8
22082,CN4849300000000,48,493,"Wilson County, TX",Sep-19,24979,24308,671,2.7
22083,CN4849500000000,48,495,"Winkler County, TX",Sep-19,4041,3922,119,2.9
22084,CN4849700000000,48,497,"Wise County, TX",Sep-19,32075,31101,974,3.0
22085,CN4849900000000,48,499,"Wood County, TX",Sep-19,17866,17187,679,3.8
22086,CN4850100000000,48,501,"Yoakum County, TX",Sep-19,3725,3613,112,3.0
22087,CN4850300000000,48,503,"Young County, TX",Sep-19,8083,7848,235,2.9
22088,CN4850500000000,48,505,"Zapata County, TX",Sep-19,4844,4612,232,4.8
22089,CN4850700000000,48,507,"Zavala County, TX",Sep-19,3292,3023,269,8.2
22090,CN4900100000000,49,1,"Beaver County, UT",Sep-19,2813,2747,66,2.3
22091,CN4900300000000,49,3,"Box Elder County, UT",Sep-19,25903,25354,549,2.1
22092,CN4900500000000,49,5,"Cache County, UT",Sep-19,64726,63571,1155,1.8
22093,CN4900700000000,49,7,"Carbon County, UT",Sep-19,8511,8255,256,3.0
22094,CN4900900000000,49,9,"Daggett County, UT",Sep-19,431,420,11,2.6
22095,CN4901100000000,49,11,"Davis County, UT",Sep-19,174336,170783,3553,2.0
22096,CN4901300000000,49,13,"Duchesne County, UT",Sep-19,7756,7511,245,3.2
22097,CN4901500000000,49,15,"Emery County, UT",Sep-19,4187,4053,134,3.2
22098,CN4901700000000,49,17,"Garfield County, UT",Sep-19,3031,2944,87,2.9
22099,CN4901900000000,49,19,"Grand County, UT",Sep-19,6550,6440,110,1.7
22100,CN4902100000000,49,21,"Iron County, UT",Sep-19,24549,23974,575,2.3
22101,CN4902300000000,49,23,"Juab County, UT",Sep-19,5762,5651,111,1.9
22102,CN4902500000000,49,25,"Kane County, UT",Sep-19,3989,3910,79,2.0
22103,CN4902700000000,49,27,"Millard County, UT",Sep-19,5946,5815,131,2.2
22104,CN4902900000000,49,29,"Morgan County, UT",Sep-19,5579,5465,114,2.0
22105,CN4903100000000,49,31,"Piute County, UT",Sep-19,491,472,19,3.9
22106,CN4903300000000,49,33,"Rich County, UT",Sep-19,1298,1272,26,2.0
22107,CN4903500000000,49,35,"Salt Lake County, UT",Sep-19,637283,623667,13616,2.1
22108,CN4903700000000,49,37,"San Juan County, UT",Sep-19,5881,5667,214,3.6
22109,CN4903900000000,49,39,"Sanpete County, UT",Sep-19,12471,12160,311,2.5
22110,CN4904100000000,49,41,"Sevier County, UT",Sep-19,9733,9515,218,2.2
22111,CN4904300000000,49,43,"Summit County, UT",Sep-19,23979,23486,493,2.1
22112,CN4904500000000,49,45,"Tooele County, UT",Sep-19,34088,33257,831,2.4
22113,CN4904700000000,49,47,"Uintah County, UT",Sep-19,13653,13178,475,3.5
22114,CN4904900000000,49,49,"Utah County, UT",Sep-19,310720,304539,6181,2.0
22115,CN4905100000000,49,51,"Wasatch County, UT",Sep-19,16127,15768,359,2.2
22116,CN4905300000000,49,53,"Washington County, UT",Sep-19,77038,75109,1929,2.5
22117,CN4905500000000,49,55,"Wayne County, UT",Sep-19,1494,1450,44,2.9
22118,CN4905700000000,49,57,"Weber County, UT",Sep-19,127547,124577,2970,2.3
22119,CN5000100000000,50,1,"Addison County, VT",Sep-19,20394,19930,464,2.3
22120,CN5000300000000,50,3,"Bennington County, VT",Sep-19,17564,17076,488,2.8
22121,CN5000500000000,50,5,"Caledonia County, VT",Sep-19,14464,14090,374,2.6
22122,CN5000700000000,50,7,"Chittenden County, VT",Sep-19,96689,94783,1906,2.0
22123,CN5000900000000,50,9,"Essex County, VT",Sep-19,2668,2588,80,3.0
22124,CN5001100000000,50,11,"Franklin County, VT",Sep-19,27116,26531,585,2.2
22125,CN5001300000000,50,13,"Grand Isle County, VT",Sep-19,4013,3928,85,2.1
22126,CN5001500000000,50,15,"Lamoille County, VT",Sep-19,13765,13402,363,2.6
22127,CN5001700000000,50,17,"Orange County, VT",Sep-19,15800,15465,335,2.1
22128,CN5001900000000,50,19,"Orleans County, VT",Sep-19,12997,12536,461,3.5
22129,CN5002100000000,50,21,"Rutland County, VT",Sep-19,29988,29168,820,2.7
22130,CN5002300000000,50,23,"Washington County, VT",Sep-19,34071,33377,694,2.0
22131,CN5002500000000,50,25,"Windham County, VT",Sep-19,21333,20779,554,2.6
22132,CN5002700000000,50,27,"Windsor County, VT",Sep-19,28104,27478,626,2.2
22133,CN5100100000000,51,1,"Accomack County, VA",Sep-19,16605,16122,483,2.9
22134,CN5100300000000,51,3,"Albemarle County, VA",Sep-19,58797,57444,1353,2.3
22135,CN5100500000000,51,5,"Alleghany County, VA",Sep-19,6915,6697,218,3.2
22136,CN5100700000000,51,7,"Amelia County, VA",Sep-19,6295,6129,166,2.6
22137,CN5100900000000,51,9,"Amherst County, VA",Sep-19,15185,14732,453,3.0
22138,CN5101100000000,51,11,"Appomattox County, VA",Sep-19,7228,6996,232,3.2
22139,CN5101300000000,51,13,"Arlington County, VA",Sep-19,156199,153388,2811,1.8
22140,CN5101500000000,51,15,"Augusta County, VA",Sep-19,37889,37041,848,2.2
22141,CN5101700000000,51,17,"Bath County, VA",Sep-19,2566,2509,57,2.2
22142,CN5101900000000,51,19,"Bedford County, VA",Sep-19,38843,37771,1072,2.8
22143,CN5102100000000,51,21,"Bland County, VA",Sep-19,2859,2787,72,2.5
22144,CN5102300000000,51,23,"Botetourt County, VA",Sep-19,17551,17117,434,2.5
22145,CN5102500000000,51,25,"Brunswick County, VA",Sep-19,6025,5769,256,4.2
22146,CN5102700000000,51,27,"Buchanan County, VA",Sep-19,6638,6249,389,5.9
22147,CN5102900000000,51,29,"Buckingham County, VA",Sep-19,6543,6335,208,3.2
22148,CN5103100000000,51,31,"Campbell County, VA",Sep-19,26242,25483,759,2.9
22149,CN5103300000000,51,33,"Caroline County, VA",Sep-19,15344,14904,440,2.9
22150,CN5103500000000,51,35,"Carroll County, VA",Sep-19,13236,12819,417,3.2
22151,CN5103600000000,51,36,"Charles City County, VA",Sep-19,3683,3574,109,3.0
22152,CN5103700000000,51,37,"Charlotte County, VA",Sep-19,5267,5100,167,3.2
22153,CN5104100000000,51,41,"Chesterfield County, VA",Sep-19,189081,184176,4905,2.6
22154,CN5104300000000,51,43,"Clarke County, VA",Sep-19,7663,7494,169,2.2
22155,CN5104500000000,51,45,"Craig County, VA",Sep-19,2309,2243,66,2.9
22156,CN5104700000000,51,47,"Culpeper County, VA",Sep-19,24801,24207,594,2.4
22157,CN5104900000000,51,49,"Cumberland County, VA",Sep-19,4657,4530,127,2.7
22158,CN5105100000000,51,51,"Dickenson County, VA",Sep-19,4807,4596,211,4.4
22159,CN5105300000000,51,53,"Dinwiddie County, VA",Sep-19,13735,13321,414,3.0
22160,CN5105700000000,51,57,"Essex County, VA",Sep-19,5438,5274,164,3.0
22161,CN5105900000000,51,59,"Fairfax County, VA",Sep-19,642000,628309,13691,2.1
22162,CN5106100000000,51,61,"Fauquier County, VA",Sep-19,37595,36762,833,2.2
22163,CN5106300000000,51,63,"Floyd County, VA",Sep-19,8282,8089,193,2.3
22164,CN5106500000000,51,65,"Fluvanna County, VA",Sep-19,14293,13992,301,2.1
22165,CN5106700000000,51,67,"Franklin County, VA",Sep-19,26554,25812,742,2.8
22166,CN5106900000000,51,69,"Frederick County, VA",Sep-19,48571,47521,1050,2.2
22167,CN5107100000000,51,71,"Giles County, VA",Sep-19,7982,7758,224,2.8
22168,CN5107300000000,51,73,"Gloucester County, VA",Sep-19,19714,19246,468,2.4
22169,CN5107500000000,51,75,"Goochland County, VA",Sep-19,11278,10988,290,2.6
22170,CN5107700000000,51,77,"Grayson County, VA",Sep-19,7939,7742,197,2.5
22171,CN5107900000000,51,79,"Greene County, VA",Sep-19,10787,10543,244,2.3
22172,CN5108100000000,51,81,"Greensville County, VA",Sep-19,4279,4143,136,3.2
22173,CN5108300000000,51,83,"Halifax County, VA",Sep-19,15690,15107,583,3.7
22174,CN5108500000000,51,85,"Hanover County, VA",Sep-19,59741,58375,1366,2.3
22175,CN5108700000000,51,87,"Henrico County, VA",Sep-19,183553,178761,4792,2.6
22176,CN5108900000000,51,89,"Henry County, VA",Sep-19,23733,23003,730,3.1
22177,CN5109100000000,51,91,"Highland County, VA",Sep-19,1205,1175,30,2.5
22178,CN5109300000000,51,93,"Isle of Wight County, VA",Sep-19,19552,19059,493,2.5
22179,CN5109500000000,51,95,"James City County, VA",Sep-19,36845,35945,900,2.4
22180,CN5109700000000,51,97,"King and Queen County, VA",Sep-19,3828,3729,99,2.6
22181,CN5109900000000,51,99,"King George County, VA",Sep-19,13619,13286,333,2.4
22182,CN5110100000000,51,101,"King William County, VA",Sep-19,9212,8974,238,2.6
22183,CN5110300000000,51,103,"Lancaster County, VA",Sep-19,5464,5306,158,2.9
22184,CN5110500000000,51,105,"Lee County, VA",Sep-19,8349,7978,371,4.4
22185,CN5110700000000,51,107,"Loudoun County, VA",Sep-19,225145,220318,4827,2.1
22186,CN5110900000000,51,109,"Louisa County, VA",Sep-19,20205,19710,495,2.4
22187,CN5111100000000,51,111,"Lunenburg County, VA",Sep-19,5279,5116,163,3.1
22188,CN5111300000000,51,113,"Madison County, VA",Sep-19,7525,7370,155,2.1
22189,CN5111500000000,51,115,"Mathews County, VA",Sep-19,4165,4057,108,2.6
22190,CN5111700000000,51,117,"Mecklenburg County, VA",Sep-19,12363,11888,475,3.8
22191,CN5111900000000,51,119,"Middlesex County, VA",Sep-19,5306,5180,126,2.4
22192,CN5112100000000,51,121,"Montgomery County, VA",Sep-19,50949,49592,1357,2.7
22193,CN5112500000000,51,125,"Nelson County, VA",Sep-19,7600,7415,185,2.4
22194,CN5112700000000,51,127,"New Kent County, VA",Sep-19,12564,12292,272,2.2
22195,CN5113100000000,51,131,"Northampton County, VA",Sep-19,5460,5267,193,3.5
22196,CN5113300000000,51,133,"Northumberland County, VA",Sep-19,5637,5468,169,3.0
22197,CN5113500000000,51,135,"Nottoway County, VA",Sep-19,7266,7081,185,2.5
22198,CN5113700000000,51,137,"Orange County, VA",Sep-19,17557,17062,495,2.8
22199,CN5113900000000,51,139,"Page County, VA",Sep-19,12094,11756,338,2.8
22200,CN5114100000000,51,141,"Patrick County, VA",Sep-19,7208,6982,226,3.1
22201,CN5114300000000,51,143,"Pittsylvania County, VA",Sep-19,30089,29135,954,3.2
22202,CN5114500000000,51,145,"Powhatan County, VA",Sep-19,14241,13900,341,2.4
22203,CN5114700000000,51,147,"Prince Edward County, VA",Sep-19,10272,9922,350,3.4
22204,CN5114900000000,51,149,"Prince George County, VA",Sep-19,15220,14731,489,3.2
22205,CN5115300000000,51,153,"Prince William County, VA",Sep-19,248369,242540,5829,2.3
22206,CN5115500000000,51,155,"Pulaski County, VA",Sep-19,16262,15787,475,2.9
22207,CN5115700000000,51,157,"Rappahannock County, VA",Sep-19,3710,3625,85,2.3
22208,CN5115900000000,51,159,"Richmond County, VA",Sep-19,4066,3961,105,2.6
22209,CN5116100000000,51,161,"Roanoke County, VA",Sep-19,49719,48530,1189,2.4
22210,CN5116300000000,51,163,"Rockbridge County, VA",Sep-19,10854,10576,278,2.6
22211,CN5116500000000,51,165,"Rockingham County, VA",Sep-19,42625,41726,899,2.1
22212,CN5116700000000,51,167,"Russell County, VA",Sep-19,11278,10846,432,3.8
22213,CN5116900000000,51,169,"Scott County, VA",Sep-19,9140,8880,260,2.8
22214,CN5117100000000,51,171,"Shenandoah County, VA",Sep-19,22473,21947,526,2.3
22215,CN5117300000000,51,173,"Smyth County, VA",Sep-19,13866,13379,487,3.5
22216,CN5117500000000,51,175,"Southampton County, VA",Sep-19,9129,8888,241,2.6
22217,CN5117700000000,51,177,"Spotsylvania County, VA",Sep-19,67761,65945,1816,2.7
22218,CN5117900000000,51,179,"Stafford County, VA",Sep-19,72905,71050,1855,2.5
22219,CN5118100000000,51,181,"Surry County, VA",Sep-19,3714,3602,112,3.0
22220,CN5118300000000,51,183,"Sussex County, VA",Sep-19,3839,3670,169,4.4
22221,CN5118500000000,51,185,"Tazewell County, VA",Sep-19,15638,14994,644,4.1
22222,CN5118700000000,51,187,"Warren County, VA",Sep-19,20622,20081,541,2.6
22223,CN5119100000000,51,191,"Washington County, VA",Sep-19,26781,25975,806,3.0
22224,CN5119300000000,51,193,"Westmoreland County, VA",Sep-19,9488,9205,283,3.0
22225,CN5119500000000,51,195,"Wise County, VA",Sep-19,13498,12893,605,4.5
22226,CN5119700000000,51,197,"Wythe County, VA",Sep-19,13792,13355,437,3.2
22227,CN5119900000000,51,199,"York County, VA",Sep-19,33040,32221,819,2.5
22228,CN5151000000000,51,510,"Alexandria city, VA",Sep-19,102455,100464,1991,1.9
22229,CN5152000000000,51,520,"Bristol city, VA",Sep-19,7196,6945,251,3.5
22230,CN5153000000000,51,530,"Buena Vista city, VA",Sep-19,3547,3462,85,2.4
22231,CN5154000000000,51,540,"Charlottesville city, VA",Sep-19,27168,26615,553,2.0
22232,CN5155000000000,51,550,"Chesapeake city, VA",Sep-19,123785,120415,3370,2.7
22233,CN5157000000000,51,570,"Colonial Heights city, VA",Sep-19,8872,8610,262,3.0
22234,CN5158000000000,51,580,"Covington city, VA",Sep-19,2398,2305,93,3.9
22235,CN5159000000000,51,590,"Danville city, VA",Sep-19,19125,18213,912,4.8
22236,CN5159500000000,51,595,"Emporia city, VA",Sep-19,2272,2170,102,4.5
22237,CN5160000000000,51,600,"Fairfax city, VA",Sep-19,13580,13321,259,1.9
22238,CN5161000000000,51,610,"Falls Church city, VA",Sep-19,8694,8524,170,2.0
22239,CN5162000000000,51,620,"Franklin city, VA",Sep-19,3593,3455,138,3.8
22240,CN5163000000000,51,630,"Fredericksburg city, VA",Sep-19,14313,13864,449,3.1
22241,CN5164000000000,51,640,"Galax city, VA",Sep-19,2924,2834,90,3.1
22242,CN5165000000000,51,650,"Hampton city, VA",Sep-19,64826,62592,2234,3.4
22243,CN5166000000000,51,660,"Harrisonburg city, VA",Sep-19,25475,24724,751,2.9
22244,CN5167000000000,51,670,"Hopewell city, VA",Sep-19,9773,9369,404,4.1
22245,CN5167800000000,51,678,"Lexington city, VA",Sep-19,2116,2025,91,4.3
22246,CN5168000000000,51,680,"Lynchburg city, VA",Sep-19,36714,35455,1259,3.4
22247,CN5168300000000,51,683,"Manassas city, VA",Sep-19,22282,21772,510,2.3
22248,CN5168500000000,51,685,"Manassas Park city, VA",Sep-19,9458,9250,208,2.2
22249,CN5169000000000,51,690,"Martinsville city, VA",Sep-19,5483,5272,211,3.8
22250,CN5170000000000,51,700,"Newport News city, VA",Sep-19,89518,86655,2863,3.2
22251,CN5171000000000,51,710,"Norfolk city, VA",Sep-19,112499,108918,3581,3.2
22252,CN5172000000000,51,720,"Norton city, VA",Sep-19,1694,1634,60,3.5
22253,CN5173000000000,51,730,"Petersburg city, VA",Sep-19,13097,12426,671,5.1
22254,CN5173500000000,51,735,"Poquoson city, VA",Sep-19,6440,6290,150,2.3
22255,CN5174000000000,51,740,"Portsmouth city, VA",Sep-19,44611,42990,1621,3.6
22256,CN5175000000000,51,750,"Radford city, VA",Sep-19,8790,8501,289,3.3
22257,CN5176000000000,51,760,"Richmond city, VA",Sep-19,119235,115553,3682,3.1
22258,CN5177000000000,51,770,"Roanoke city, VA",Sep-19,49451,48077,1374,2.8
22259,CN5177500000000,51,775,"Salem city, VA",Sep-19,13082,12735,347,2.7
22260,CN5179000000000,51,790,"Staunton city, VA",Sep-19,12366,12068,298,2.4
22261,CN5180000000000,51,800,"Suffolk city, VA",Sep-19,45044,43742,1302,2.9
22262,CN5181000000000,51,810,"Virginia Beach city, VA",Sep-19,234938,228986,5952,2.5
22263,CN5182000000000,51,820,"Waynesboro city, VA",Sep-19,10815,10526,289,2.7
22264,CN5183000000000,51,830,"Williamsburg city, VA",Sep-19,6751,6494,257,3.8
22265,CN5184000000000,51,840,"Winchester city, VA",Sep-19,14921,14549,372,2.5
22266,CN5300100000000,53,1,"Adams County, WA",Sep-19,10830,10448,382,3.5
22267,CN5300300000000,53,3,"Asotin County, WA",Sep-19,10343,9996,347,3.4
22268,CN5300500000000,53,5,"Benton County, WA",Sep-19,104357,100156,4201,4.0
22269,CN5300700000000,53,7,"Chelan County, WA",Sep-19,46573,44974,1599,3.4
22270,CN5300900000000,53,9,"Clallam County, WA",Sep-19,28756,27213,1543,5.4
22271,CN5301100000000,53,11,"Clark County, WA",Sep-19,240483,230467,10016,4.2
22272,CN5301300000000,53,13,"Columbia County, WA",Sep-19,1835,1756,79,4.3
22273,CN5301500000000,53,15,"Cowlitz County, WA",Sep-19,47521,45078,2443,5.1
22274,CN5301700000000,53,17,"Douglas County, WA",Sep-19,22620,21742,878,3.9
22275,CN5301900000000,53,19,"Ferry County, WA",Sep-19,2437,2226,211,8.7
22276,CN5302100000000,53,21,"Franklin County, WA",Sep-19,43639,41721,1918,4.4
22277,CN5302300000000,53,23,"Garfield County, WA",Sep-19,929,892,37,4.0
22278,CN5302500000000,53,25,"Grant County, WA",Sep-19,48829,46608,2221,4.5
22279,CN5302700000000,53,27,"Grays Harbor County, WA",Sep-19,28578,26931,1647,5.8
22280,CN5302900000000,53,29,"Island County, WA",Sep-19,35896,34301,1595,4.4
22281,CN5303100000000,53,31,"Jefferson County, WA",Sep-19,13073,12463,610,4.7
22282,CN5303300000000,53,33,"King County, WA",Sep-19,1302772,1266525,36247,2.8
22283,CN5303500000000,53,35,"Kitsap County, WA",Sep-19,127763,122770,4993,3.9
22284,CN5303700000000,53,37,"Kittitas County, WA",Sep-19,23199,22186,1013,4.4
22285,CN5303900000000,53,39,"Klickitat County, WA",Sep-19,10394,9945,449,4.3
22286,CN5304100000000,53,41,"Lewis County, WA",Sep-19,34740,32995,1745,5.0
22287,CN5304300000000,53,43,"Lincoln County, WA",Sep-19,5101,4903,198,3.9
22288,CN5304500000000,53,45,"Mason County, WA",Sep-19,24795,23464,1331,5.4
22289,CN5304700000000,53,47,"Okanogan County, WA",Sep-19,21356,20451,905,4.2
22290,CN5304900000000,53,49,"Pacific County, WA",Sep-19,8733,8259,474,5.4
22291,CN5305100000000,53,51,"Pend Oreille County, WA",Sep-19,5036,4694,342,6.8
22292,CN5305300000000,53,53,"Pierce County, WA",Sep-19,441240,422011,19229,4.4
22293,CN5305500000000,53,55,"San Juan County, WA",Sep-19,9226,8952,274,3.0
22294,CN5305700000000,53,57,"Skagit County, WA",Sep-19,62815,59933,2882,4.6
22295,CN5305900000000,53,59,"Skamania County, WA",Sep-19,5511,5276,235,4.3
22296,CN5306100000000,53,61,"Snohomish County, WA",Sep-19,443684,430248,13436,3.0
22297,CN5306300000000,53,63,"Spokane County, WA",Sep-19,253277,242651,10626,4.2
22298,CN5306500000000,53,65,"Stevens County, WA",Sep-19,18782,17838,944,5.0
22299,CN5306700000000,53,67,"Thurston County, WA",Sep-19,142510,136572,5938,4.2
22300,CN5306900000000,53,69,"Wahkiakum County, WA",Sep-19,1382,1299,83,6.0
22301,CN5307100000000,53,71,"Walla Walla County, WA",Sep-19,30473,29260,1213,4.0
22302,CN5307300000000,53,73,"Whatcom County, WA",Sep-19,113899,108937,4962,4.4
22303,CN5307500000000,53,75,"Whitman County, WA",Sep-19,24835,23870,965,3.9
22304,CN5307700000000,53,77,"Yakima County, WA",Sep-19,139342,133205,6137,4.4
22305,CN5400100000000,54,1,"Barbour County, WV",Sep-19,7253,6893,360,5.0
22306,CN5400300000000,54,3,"Berkeley County, WV",Sep-19,58885,56951,1934,3.3
22307,CN5400500000000,54,5,"Boone County, WV",Sep-19,7489,7111,378,5.0
22308,CN5400700000000,54,7,"Braxton County, WV",Sep-19,5290,4986,304,5.7
22309,CN5400900000000,54,9,"Brooke County, WV",Sep-19,10133,9637,496,4.9
22310,CN5401100000000,54,11,"Cabell County, WV",Sep-19,42128,40543,1585,3.8
22311,CN5401300000000,54,13,"Calhoun County, WV",Sep-19,2520,2288,232,9.2
22312,CN5401500000000,54,15,"Clay County, WV",Sep-19,3123,2919,204,6.5
22313,CN5401700000000,54,17,"Doddridge County, WV",Sep-19,4049,3898,151,3.7
22314,CN5401900000000,54,19,"Fayette County, WV",Sep-19,16406,15615,791,4.8
22315,CN5402100000000,54,21,"Gilmer County, WV",Sep-19,2370,2241,129,5.4
22316,CN5402300000000,54,23,"Grant County, WV",Sep-19,6030,5744,286,4.7
22317,CN5402500000000,54,25,"Greenbrier County, WV",Sep-19,16371,15727,644,3.9
22318,CN5402700000000,54,27,"Hampshire County, WV",Sep-19,11000,10612,388,3.5
22319,CN5402900000000,54,29,"Hancock County, WV",Sep-19,13270,12588,682,5.1
22320,CN5403100000000,54,31,"Hardy County, WV",Sep-19,5860,5615,245,4.2
22321,CN5403300000000,54,33,"Harrison County, WV",Sep-19,34677,33301,1376,4.0
22322,CN5403500000000,54,35,"Jackson County, WV",Sep-19,13495,12925,570,4.2
22323,CN5403700000000,54,37,"Jefferson County, WV",Sep-19,30712,29818,894,2.9
22324,CN5403900000000,54,39,"Kanawha County, WV",Sep-19,82944,79464,3480,4.2
22325,CN5404100000000,54,41,"Lewis County, WV",Sep-19,6886,6492,394,5.7
22326,CN5404300000000,54,43,"Lincoln County, WV",Sep-19,7266,6864,402,5.5
22327,CN5404500000000,54,45,"Logan County, WV",Sep-19,11169,10556,613,5.5
22328,CN5404700000000,54,47,"McDowell County, WV",Sep-19,4427,4081,346,7.8
22329,CN5404900000000,54,49,"Marion County, WV",Sep-19,25721,24546,1175,4.6
22330,CN5405100000000,54,51,"Marshall County, WV",Sep-19,14262,13484,778,5.5
22331,CN5405300000000,54,53,"Mason County, WV",Sep-19,10382,9805,577,5.6
22332,CN5405500000000,54,55,"Mercer County, WV",Sep-19,21224,20136,1088,5.1
22333,CN5405700000000,54,57,"Mineral County, WV",Sep-19,12916,12154,762,5.9
22334,CN5405900000000,54,59,"Mingo County, WV",Sep-19,6963,6535,428,6.1
22335,CN5406100000000,54,61,"Monongalia County, WV",Sep-19,55748,53924,1824,3.3
22336,CN5406300000000,54,63,"Monroe County, WV",Sep-19,6158,5941,217,3.5
22337,CN5406500000000,54,65,"Morgan County, WV",Sep-19,8254,7964,290,3.5
22338,CN5406700000000,54,67,"Nicholas County, WV",Sep-19,9502,9001,501,5.3
22339,CN5406900000000,54,69,"Ohio County, WV",Sep-19,21445,20584,861,4.0
22340,CN5407100000000,54,71,"Pendleton County, WV",Sep-19,3786,3667,119,3.1
22341,CN5407300000000,54,73,"Pleasants County, WV",Sep-19,2938,2769,169,5.8
22342,CN5407500000000,54,75,"Pocahontas County, WV",Sep-19,3757,3604,153,4.1
22343,CN5407700000000,54,77,"Preston County, WV",Sep-19,15922,15320,602,3.8
22344,CN5407900000000,54,79,"Putnam County, WV",Sep-19,27102,26077,1025,3.8
22345,CN5408100000000,54,81,"Raleigh County, WV",Sep-19,30816,29557,1259,4.1
22346,CN5408300000000,54,83,"Randolph County, WV",Sep-19,12510,11892,618,4.9
22347,CN5408500000000,54,85,"Ritchie County, WV",Sep-19,4424,4227,197,4.5
22348,CN5408700000000,54,87,"Roane County, WV",Sep-19,5125,4759,366,7.1
22349,CN5408900000000,54,89,"Summers County, WV",Sep-19,4435,4234,201,4.5
22350,CN5409100000000,54,91,"Taylor County, WV",Sep-19,7967,7626,341,4.3
22351,CN5409300000000,54,93,"Tucker County, WV",Sep-19,3366,3222,144,4.3
22352,CN5409500000000,54,95,"Tyler County, WV",Sep-19,3153,2932,221,7.0
22353,CN5409700000000,54,97,"Upshur County, WV",Sep-19,9837,9315,522,5.3
22354,CN5409900000000,54,99,"Wayne County, WV",Sep-19,15981,15231,750,4.7
22355,CN5410100000000,54,101,"Webster County, WV",Sep-19,3391,3218,173,5.1
22356,CN5410300000000,54,103,"Wetzel County, WV",Sep-19,6667,6259,408,6.1
22357,CN5410500000000,54,105,"Wirt County, WV",Sep-19,2318,2166,152,6.6
22358,CN5410700000000,54,107,"Wood County, WV",Sep-19,37065,35465,1600,4.3
22359,CN5410900000000,54,109,"Wyoming County, WV",Sep-19,6712,6319,393,5.9
22360,CN5500100000000,55,1,"Adams County, WI",Sep-19,8173,7881,292,3.6
22361,CN5500300000000,55,3,"Ashland County, WI",Sep-19,8042,7759,283,3.5
22362,CN5500500000000,55,5,"Barron County, WI",Sep-19,24237,23532,705,2.9
22363,CN5500700000000,55,7,"Bayfield County, WI",Sep-19,7637,7361,276,3.6
22364,CN5500900000000,55,9,"Brown County, WI",Sep-19,141556,137685,3871,2.7
22365,CN5501100000000,55,11,"Buffalo County, WI",Sep-19,6426,6232,194,3.0
22366,CN5501300000000,55,13,"Burnett County, WI",Sep-19,7035,6782,253,3.6
22367,CN5501500000000,55,15,"Calumet County, WI",Sep-19,27410,26729,681,2.5
22368,CN5501700000000,55,17,"Chippewa County, WI",Sep-19,32891,31955,936,2.8
22369,CN5501900000000,55,19,"Clark County, WI",Sep-19,17508,17101,407,2.3
22370,CN5502100000000,55,21,"Columbia County, WI",Sep-19,31362,30589,773,2.5
22371,CN5502300000000,55,23,"Crawford County, WI",Sep-19,7470,7244,226,3.0
22372,CN5502500000000,55,25,"Dane County, WI",Sep-19,320928,313938,6990,2.2
22373,CN5502700000000,55,27,"Dodge County, WI",Sep-19,47676,46455,1221,2.6
22374,CN5502900000000,55,29,"Door County, WI",Sep-19,16229,15822,407,2.5
22375,CN5503100000000,55,31,"Douglas County, WI",Sep-19,22918,22191,727,3.2
22376,CN5503300000000,55,33,"Dunn County, WI",Sep-19,23826,23193,633,2.7
22377,CN5503500000000,55,35,"Eau Claire County, WI",Sep-19,58698,57218,1480,2.5
22378,CN5503700000000,55,37,"Florence County, WI",Sep-19,2198,2120,78,3.5
22379,CN5503900000000,55,39,"Fond du Lac County, WI",Sep-19,57372,55881,1491,2.6
22380,CN5504100000000,55,41,"Forest County, WI",Sep-19,3974,3822,152,3.8
22381,CN5504300000000,55,43,"Grant County, WI",Sep-19,27568,26860,708,2.6
22382,CN5504500000000,55,45,"Green County, WI",Sep-19,20872,20406,466,2.2
22383,CN5504700000000,55,47,"Green Lake County, WI",Sep-19,9553,9263,290,3.0
22384,CN5504900000000,55,49,"Iowa County, WI",Sep-19,13588,13296,292,2.1
22385,CN5505100000000,55,51,"Iron County, WI",Sep-19,2535,2417,118,4.7
22386,CN5505300000000,55,53,"Jackson County, WI",Sep-19,10219,9929,290,2.8
22387,CN5505500000000,55,55,"Jefferson County, WI",Sep-19,45701,44512,1189,2.6
22388,CN5505700000000,55,57,"Juneau County, WI",Sep-19,13434,13097,337,2.5
22389,CN5505900000000,55,59,"Kenosha County, WI",Sep-19,89796,86589,3207,3.6
22390,CN5506100000000,55,61,"Kewaunee County, WI",Sep-19,10975,10666,309,2.8
22391,CN5506300000000,55,63,"La Crosse County, WI",Sep-19,66015,64437,1578,2.4
22392,CN5506500000000,55,65,"Lafayette County, WI",Sep-19,10023,9818,205,2.0
22393,CN5506700000000,55,67,"Langlade County, WI",Sep-19,9138,8846,292,3.2
22394,CN5506900000000,55,69,"Lincoln County, WI",Sep-19,14914,14500,414,2.8
22395,CN5507100000000,55,71,"Manitowoc County, WI",Sep-19,40893,39737,1156,2.8
22396,CN5507300000000,55,73,"Marathon County, WI",Sep-19,73060,71281,1779,2.4
22397,CN5507500000000,55,75,"Marinette County, WI",Sep-19,19336,18561,775,4.0
22398,CN5507700000000,55,77,"Marquette County, WI",Sep-19,7728,7517,211,2.7
22399,CN5507800000000,55,78,"Menominee County, WI",Sep-19,1642,1494,148,9.0
22400,CN5507900000000,55,79,"Milwaukee County, WI",Sep-19,466351,448731,17620,3.8
22401,CN5508100000000,55,81,"Monroe County, WI",Sep-19,23190,22646,544,2.3
22402,CN5508300000000,55,83,"Oconto County, WI",Sep-19,20393,19827,566,2.8
22403,CN5508500000000,55,85,"Oneida County, WI",Sep-19,17759,17180,579,3.3
22404,CN5508700000000,55,87,"Outagamie County, WI",Sep-19,102499,99930,2569,2.5
22405,CN5508900000000,55,89,"Ozaukee County, WI",Sep-19,48913,47644,1269,2.6
22406,CN5509100000000,55,91,"Pepin County, WI",Sep-19,4141,4030,111,2.7
22407,CN5509300000000,55,93,"Pierce County, WI",Sep-19,25237,24630,607,2.4
22408,CN5509500000000,55,95,"Polk County, WI",Sep-19,24235,23575,660,2.7
22409,CN5509700000000,55,97,"Portage County, WI",Sep-19,38461,37473,988,2.6
22410,CN5509900000000,55,99,"Price County, WI",Sep-19,6359,6157,202,3.2
22411,CN5510100000000,55,101,"Racine County, WI",Sep-19,98011,94423,3588,3.7
22412,CN5510300000000,55,103,"Richland County, WI",Sep-19,9116,8870,246,2.7
22413,CN5510500000000,55,105,"Rock County, WI",Sep-19,85040,82162,2878,3.4
22414,CN5510700000000,55,107,"Rusk County, WI",Sep-19,6577,6329,248,3.8
22415,CN5510900000000,55,109,"St. Croix County, WI",Sep-19,50346,49046,1300,2.6
22416,CN5511100000000,55,111,"Sauk County, WI",Sep-19,35575,34741,834,2.3
22417,CN5511300000000,55,113,"Sawyer County, WI",Sep-19,8068,7807,261,3.2
22418,CN5511500000000,55,115,"Shawano County, WI",Sep-19,20838,20300,538,2.6
22419,CN5511700000000,55,117,"Sheboygan County, WI",Sep-19,62228,60745,1483,2.4
22420,CN5511900000000,55,119,"Taylor County, WI",Sep-19,10805,10550,255,2.4
22421,CN5512100000000,55,121,"Trempealeau County, WI",Sep-19,15801,15372,429,2.7
22422,CN5512300000000,55,123,"Vernon County, WI",Sep-19,15103,14729,374,2.5
22423,CN5512500000000,55,125,"Vilas County, WI",Sep-19,10250,9956,294,2.9
22424,CN5512700000000,55,127,"Walworth County, WI",Sep-19,58018,56416,1602,2.8
22425,CN5512900000000,55,129,"Washburn County, WI",Sep-19,7901,7657,244,3.1
22426,CN5513100000000,55,131,"Washington County, WI",Sep-19,76928,74997,1931,2.5
22427,CN5513300000000,55,133,"Waukesha County, WI",Sep-19,224238,218367,5871,2.6
22428,CN5513500000000,55,135,"Waupaca County, WI",Sep-19,25919,25192,727,2.8
22429,CN5513700000000,55,137,"Waushara County, WI",Sep-19,11156,10803,353,3.2
22430,CN5513900000000,55,139,"Winnebago County, WI",Sep-19,91009,88556,2453,2.7
22431,CN5514100000000,55,141,"Wood County, WI",Sep-19,35014,33984,1030,2.9
22432,CN5600100000000,56,1,"Albany County, WY",Sep-19,20009,19409,600,3.0
22433,CN5600300000000,56,3,"Big Horn County, WY",Sep-19,5489,5287,202,3.7
22434,CN5600500000000,56,5,"Campbell County, WY",Sep-19,23123,22248,875,3.8
22435,CN5600700000000,56,7,"Carbon County, WY",Sep-19,8267,8039,228,2.8
22436,CN5600900000000,56,9,"Converse County, WY",Sep-19,8949,8714,235,2.6
22437,CN5601100000000,56,11,"Crook County, WY",Sep-19,3884,3778,106,2.7
22438,CN5601300000000,56,13,"Fremont County, WY",Sep-19,18781,18053,728,3.9
22439,CN5601500000000,56,15,"Goshen County, WY",Sep-19,6696,6470,226,3.4
22440,CN5601700000000,56,17,"Hot Springs County, WY",Sep-19,2160,2089,71,3.3
22441,CN5601900000000,56,19,"Johnson County, WY",Sep-19,4279,4156,123,2.9
22442,CN5602100000000,56,21,"Laramie County, WY",Sep-19,47863,46246,1617,3.4
22443,CN5602300000000,56,23,"Lincoln County, WY",Sep-19,9056,8793,263,2.9
22444,CN5602500000000,56,25,"Natrona County, WY",Sep-19,39108,37663,1445,3.7
22445,CN5602700000000,56,27,"Niobrara County, WY",Sep-19,1276,1245,31,2.4
22446,CN5602900000000,56,29,"Park County, WY",Sep-19,16161,15634,527,3.3
22447,CN5603100000000,56,31,"Platte County, WY",Sep-19,4639,4489,150,3.2
22448,CN5603300000000,56,33,"Sheridan County, WY",Sep-19,15715,15247,468,3.0
22449,CN5603500000000,56,35,"Sublette County, WY",Sep-19,4292,4130,162,3.8
22450,CN5603700000000,56,37,"Sweetwater County, WY",Sep-19,20911,20193,718,3.4
22451,CN5603900000000,56,39,"Teton County, WY",Sep-19,16399,16067,332,2.0
22452,CN5604100000000,56,41,"Uinta County, WY",Sep-19,8969,8640,329,3.7
22453,CN5604300000000,56,43,"Washakie County, WY",Sep-19,3923,3793,130,3.3
22454,CN5604500000000,56,45,"Weston County, WY",Sep-19,3822,3723,99,2.6
22455,CN7200100000000,72,1,"Adjuntas Municipio, PR",Sep-19,4043,3470,573,14.2
22456,CN7200300000000,72,3,"Aguada Municipio, PR",Sep-19,11481,10432,1049,9.1
22457,CN7200500000000,72,5,"Aguadilla Municipio, PR",Sep-19,14152,12757,1395,9.9
22458,CN7200700000000,72,7,"Aguas Buenas Municipio, PR",Sep-19,6396,5810,586,9.2
22459,CN7200900000000,72,9,"Aibonito Municipio, PR",Sep-19,6399,5743,656,10.3
22460,CN7201100000000,72,11,"Anasco Municipio, PR",Sep-19,8590,7894,696,8.1
22461,CN7201300000000,72,13,"Arecibo Municipio, PR",Sep-19,23523,21338,2185,9.3
22462,CN7201500000000,72,15,"Arroyo Municipio, PR",Sep-19,4476,3921,555,12.4
22463,CN7201700000000,72,17,"Barceloneta Municipio, PR",Sep-19,5790,5145,645,11.1
22464,CN7201900000000,72,19,"Barranquitas Municipio, PR",Sep-19,7220,6592,628,8.7
22465,CN7202100000000,72,21,"Bayamon Municipio, PR",Sep-19,63780,59692,4088,6.4
22466,CN7202300000000,72,23,"Cabo Rojo Municipio, PR",Sep-19,13350,12220,1130,8.5
22467,CN7202500000000,72,25,"Caguas Municipio, PR",Sep-19,46634,43488,3146,6.7
22468,CN7202700000000,72,27,"Camuy Municipio, PR",Sep-19,9370,8563,807,8.6
22469,CN7202900000000,72,29,"Canovanas Municipio, PR",Sep-19,15696,14641,1055,6.7
22470,CN7203100000000,72,31,"Carolina Municipio, PR",Sep-19,60105,56504,3601,6.0
22471,CN7203300000000,72,33,"Catano Municipio, PR",Sep-19,7652,7082,570,7.4
22472,CN7203500000000,72,35,"Cayey Municipio, PR",Sep-19,15722,14612,1110,7.1
22473,CN7203700000000,72,37,"Ceiba Municipio, PR",Sep-19,3624,3249,375,10.3
22474,CN7203900000000,72,39,"Ciales Municipio, PR",Sep-19,3630,3226,404,11.1
22475,CN7204100000000,72,41,"Cidra Municipio, PR",Sep-19,15081,14111,970,6.4
22476,CN7204300000000,72,43,"Coamo Municipio, PR",Sep-19,9867,8640,1227,12.4
22477,CN7204500000000,72,45,"Comerio Municipio, PR",Sep-19,4781,4366,415,8.7
22478,CN7204700000000,72,47,"Corozal Municipio, PR",Sep-19,8756,7966,790,9.0
22479,CN7204900000000,72,49,"Culebra Municipio, PR",Sep-19,884,853,31,3.5
22480,CN7205100000000,72,51,"Dorado Municipio, PR",Sep-19,12886,12125,761,5.9
22481,CN7205300000000,72,53,"Fajardo Municipio, PR",Sep-19,10673,9576,1097,10.3
22482,CN7205400000000,72,54,"Florida Municipio, PR",Sep-19,3244,2906,338,10.4
22483,CN7205500000000,72,55,"Guanica Municipio, PR",Sep-19,3999,3365,634,15.9
22484,CN7205700000000,72,57,"Guayama Municipio, PR",Sep-19,10783,9469,1314,12.2
22485,CN7205900000000,72,59,"Guayanilla Municipio, PR",Sep-19,5110,4421,689,13.5
22486,CN7206100000000,72,61,"Guaynabo Municipio, PR",Sep-19,36629,35084,1545,4.2
22487,CN7206300000000,72,63,"Gurabo Municipio, PR",Sep-19,17687,16651,1036,5.9
22488,CN7206500000000,72,65,"Hatillo Municipio, PR",Sep-19,12980,11753,1227,9.5
22489,CN7206700000000,72,67,"Hormigueros Municipio, PR",Sep-19,5236,4797,439,8.4
22490,CN7206900000000,72,69,"Humacao Municipio, PR",Sep-19,16765,15086,1679,10.0
22491,CN7207100000000,72,71,"Isabela Municipio, PR",Sep-19,12012,10963,1049,8.7
22492,CN7207300000000,72,73,"Jayuya Municipio, PR",Sep-19,4173,3578,595,14.3
22493,CN7207500000000,72,75,"Juana Diaz Municipio, PR",Sep-19,14745,13231,1514,10.3
22494,CN7207700000000,72,77,"Juncos Municipio, PR",Sep-19,12062,11018,1044,8.7
22495,CN7207900000000,72,79,"Lajas Municipio, PR",Sep-19,5109,4473,636,12.4
22496,CN7208100000000,72,81,"Lares Municipio, PR",Sep-19,6776,5927,849,12.5
22497,CN7208300000000,72,83,"Las Marias Municipio, PR",Sep-19,2502,2215,287,11.5
22498,CN7208500000000,72,85,"Las Piedras Municipio, PR",Sep-19,11073,10051,1022,9.2
22499,CN7208700000000,72,87,"Loiza Municipio, PR",Sep-19,8277,7608,669,8.1
22500,CN7208900000000,72,89,"Luquillo Municipio, PR",Sep-19,6055,5474,581,9.6
22501,CN7209100000000,72,91,"Manati Municipio, PR",Sep-19,11224,10307,917,8.2
22502,CN7209300000000,72,93,"Maricao Municipio, PR",Sep-19,1836,1625,211,11.5
22503,CN7209500000000,72,95,"Maunabo Municipio, PR",Sep-19,2830,2448,382,13.5
22504,CN7209700000000,72,97,"Mayaguez Municipio, PR",Sep-19,21269,19081,2188,10.3
22505,CN7209900000000,72,99,"Moca Municipio, PR",Sep-19,10171,9177,994,9.8
22506,CN7210100000000,72,101,"Morovis Municipio, PR",Sep-19,7823,7103,720,9.2
22507,CN7210300000000,72,103,"Naguabo Municipio, PR",Sep-19,7976,7241,735,9.2
22508,CN7210500000000,72,105,"Naranjito Municipio, PR",Sep-19,6932,6337,595,8.6
22509,CN7210700000000,72,107,"Orocovis Municipio, PR",Sep-19,4825,4347,478,9.9
22510,CN7210900000000,72,109,"Patillas Municipio, PR",Sep-19,4077,3548,529,13.0
22511,CN7211100000000,72,111,"Penuelas Municipio, PR",Sep-19,5801,4956,845,14.6
22512,CN7211300000000,72,113,"Ponce Municipio, PR",Sep-19,44569,40148,4421,9.9
22513,CN7211500000000,72,115,"Quebradillas Municipio, PR",Sep-19,5901,5256,645,10.9
22514,CN7211700000000,72,117,"Rincon Municipio, PR",Sep-19,4484,4008,476,10.6
22515,CN7211900000000,72,119,"Rio Grande Municipio, PR",Sep-19,16548,15343,1205,7.3
22516,CN7212100000000,72,121,"Sabana Grande Municipio, PR",Sep-19,6067,5312,755,12.4
22517,CN7212300000000,72,123,"Salinas Municipio, PR",Sep-19,6995,5922,1073,15.3
22518,CN7212500000000,72,125,"San German Municipio, PR",Sep-19,9542,8506,1036,10.9
22519,CN7212700000000,72,127,"San Juan Municipio, PR",Sep-19,130535,123145,7390,5.7
22520,CN7212900000000,72,129,"San Lorenzo Municipio, PR",Sep-19,11433,10439,994,8.7
22521,CN7213100000000,72,131,"San Sebastian Municipio, PR",Sep-19,9982,8762,1220,12.2
22522,CN7213300000000,72,133,"Santa Isabel Municipio, PR",Sep-19,7729,6592,1137,14.7
22523,CN7213500000000,72,135,"Toa Alta Municipio, PR",Sep-19,26499,24959,1540,5.8
22524,CN7213700000000,72,137,"Toa Baja Municipio, PR",Sep-19,28554,26871,1683,5.9
22525,CN7213900000000,72,139,"Trujillo Alto Municipio, PR",Sep-19,26399,25111,1288,4.9
22526,CN7214100000000,72,141,"Utuado Municipio, PR",Sep-19,6557,5811,746,11.4
22527,CN7214300000000,72,143,"Vega Alta Municipio, PR",Sep-19,9519,8744,775,8.1
22528,CN7214500000000,72,145,"Vega Baja Municipio, PR",Sep-19,13020,11758,1262,9.7
22529,CN7214700000000,72,147,"Vieques Municipio, PR",Sep-19,2509,2353,156,6.2
22530,CN7214900000000,72,149,"Villalba Municipio, PR",Sep-19,7241,6166,1075,14.8
22531,CN7215100000000,72,151,"Yabucoa Municipio, PR",Sep-19,8604,7505,1099,12.8
22532,CN7215300000000,72,153,"Yauco Municipio, PR",Sep-19,9633,8273,1360,14.1
22533,CN0100100000000,01,1,"Autauga County, AL",Oct-19,26143,25530,613,2.3
22534,CN0100300000000,01,3,"Baldwin County, AL",Oct-19,97213,94967,2246,2.3
22535,CN0100500000000,01,5,"Barbour County, AL",Oct-19,8672,8374,298,3.4
22536,CN0100700000000,01,7,"Bibb County, AL",Oct-19,8722,8501,221,2.5
22537,CN0100900000000,01,9,"Blount County, AL",Oct-19,25460,24890,570,2.2
22538,CN0101100000000,01,11,"Bullock County, AL",Oct-19,4850,4674,176,3.6
22539,CN0101300000000,01,13,"Butler County, AL",Oct-19,9258,8957,301,3.3
22540,CN0101500000000,01,15,"Calhoun County, AL",Oct-19,46508,45127,1381,3.0
22541,CN0101700000000,01,17,"Chambers County, AL",Oct-19,15874,15477,397,2.5
22542,CN0101900000000,01,19,"Cherokee County, AL",Oct-19,11527,11251,276,2.4
22543,CN0102100000000,01,21,"Chilton County, AL",Oct-19,19946,19481,465,2.3
22544,CN0102300000000,01,23,"Choctaw County, AL",Oct-19,4567,4372,195,4.3
22545,CN0102500000000,01,25,"Clarke County, AL",Oct-19,7456,7089,367,4.9
22546,CN0102700000000,01,27,"Clay County, AL",Oct-19,6147,6001,146,2.4
22547,CN0102900000000,01,29,"Cleburne County, AL",Oct-19,5792,5648,144,2.5
22548,CN0103100000000,01,31,"Coffee County, AL",Oct-19,21263,20739,524,2.5
22549,CN0103300000000,01,33,"Colbert County, AL",Oct-19,23759,23045,714,3.0
22550,CN0103500000000,01,35,"Conecuh County, AL",Oct-19,4510,4353,157,3.5
22551,CN0103700000000,01,37,"Coosa County, AL",Oct-19,4544,4435,109,2.4
22552,CN0103900000000,01,39,"Covington County, AL",Oct-19,15659,15230,429,2.7
22553,CN0104100000000,01,41,"Crenshaw County, AL",Oct-19,6482,6341,141,2.2
22554,CN0104300000000,01,43,"Cullman County, AL",Oct-19,38849,38013,836,2.2
22555,CN0104500000000,01,45,"Dale County, AL",Oct-19,20771,20247,524,2.5
22556,CN0104700000000,01,47,"Dallas County, AL",Oct-19,14628,13980,648,4.4
22557,CN0104900000000,01,49,"DeKalb County, AL",Oct-19,31115,30405,710,2.3
22558,CN0105100000000,01,51,"Elmore County, AL",Oct-19,37549,36677,872,2.3
22559,CN0105300000000,01,53,"Escambia County, AL",Oct-19,14886,14434,452,3.0
22560,CN0105500000000,01,55,"Etowah County, AL",Oct-19,42766,41481,1285,3.0
22561,CN0105700000000,01,57,"Fayette County, AL",Oct-19,6582,6409,173,2.6
22562,CN0105900000000,01,59,"Franklin County, AL",Oct-19,14776,14428,348,2.4
22563,CN0106100000000,01,61,"Geneva County, AL",Oct-19,11095,10823,272,2.5
22564,CN0106300000000,01,63,"Greene County, AL",Oct-19,2880,2740,140,4.9
22565,CN0106500000000,01,65,"Hale County, AL",Oct-19,6234,6020,214,3.4
22566,CN0106700000000,01,67,"Henry County, AL",Oct-19,6952,6748,204,2.9
22567,CN0106900000000,01,69,"Houston County, AL",Oct-19,46326,45190,1136,2.5
22568,CN0107100000000,01,71,"Jackson County, AL",Oct-19,23308,22649,659,2.8
22569,CN0107300000000,01,73,"Jefferson County, AL",Oct-19,320306,312557,7749,2.4
22570,CN0107500000000,01,75,"Lamar County, AL",Oct-19,5880,5729,151,2.6
22571,CN0107700000000,01,77,"Lauderdale County, AL",Oct-19,42816,41644,1172,2.7
22572,CN0107900000000,01,79,"Lawrence County, AL",Oct-19,14362,13993,369,2.6
22573,CN0108100000000,01,81,"Lee County, AL",Oct-19,77850,76103,1747,2.2
22574,CN0108300000000,01,83,"Limestone County, AL",Oct-19,44215,43253,962,2.2
22575,CN0108500000000,01,85,"Lowndes County, AL",Oct-19,3570,3398,172,4.8
22576,CN0108700000000,01,87,"Macon County, AL",Oct-19,7926,7647,279,3.5
22577,CN0108900000000,01,89,"Madison County, AL",Oct-19,186819,182792,4027,2.2
22578,CN0109100000000,01,91,"Marengo County, AL",Oct-19,7664,7435,229,3.0
22579,CN0109300000000,01,93,"Marion County, AL",Oct-19,12879,12504,375,2.9
22580,CN0109500000000,01,95,"Marshall County, AL",Oct-19,44217,43302,915,2.1
22581,CN0109700000000,01,97,"Mobile County, AL",Oct-19,190090,184147,5943,3.1
22582,CN0109900000000,01,99,"Monroe County, AL",Oct-19,7357,7032,325,4.4
22583,CN0110100000000,01,101,"Montgomery County, AL",Oct-19,105617,102815,2802,2.7
22584,CN0110300000000,01,103,"Morgan County, AL",Oct-19,58611,57310,1301,2.2
22585,CN0110500000000,01,105,"Perry County, AL",Oct-19,3422,3278,144,4.2
22586,CN0110700000000,01,107,"Pickens County, AL",Oct-19,8046,7821,225,2.8
22587,CN0110900000000,01,109,"Pike County, AL",Oct-19,15653,15214,439,2.8
22588,CN0111100000000,01,111,"Randolph County, AL",Oct-19,9758,9508,250,2.6
22589,CN0111300000000,01,113,"Russell County, AL",Oct-19,23932,23346,586,2.4
22590,CN0111500000000,01,115,"St. Clair County, AL",Oct-19,40738,39806,932,2.3
22591,CN0111700000000,01,117,"Shelby County, AL",Oct-19,116598,114463,2135,1.8
22592,CN0111900000000,01,119,"Sumter County, AL",Oct-19,4915,4734,181,3.7
22593,CN0112100000000,01,121,"Talladega County, AL",Oct-19,35873,34813,1060,3.0
22594,CN0112300000000,01,123,"Tallapoosa County, AL",Oct-19,18643,18164,479,2.6
22595,CN0112500000000,01,125,"Tuscaloosa County, AL",Oct-19,106733,104372,2361,2.2
22596,CN0112700000000,01,127,"Walker County, AL",Oct-19,25446,24733,713,2.8
22597,CN0112900000000,01,129,"Washington County, AL",Oct-19,6823,6567,256,3.8
22598,CN0113100000000,01,131,"Wilcox County, AL",Oct-19,2751,2574,177,6.4
22599,CN0113300000000,01,133,"Winston County, AL",Oct-19,10212,9898,314,3.1
22600,CN0201300000000,02,13,"Aleutians East Borough, AK",Oct-19,2294,2232,62,2.7
22601,CN0201600000000,02,16,"Aleutians West Census Area, AK",Oct-19,3230,3088,142,4.4
22602,CN0202000000000,02,20,"Anchorage Borough/municipality, AK",Oct-19,146368,139300,7068,4.8
22603,CN0205000000000,02,50,"Bethel Census Area, AK",Oct-19,7155,6338,817,11.4
22604,CN0206000000000,02,60,"Bristol Bay Borough, AK",Oct-19,276,254,22,8.0
22605,CN0206800000000,02,68,"Denali Borough, AK",Oct-19,928,841,87,9.4
22606,CN0207000000000,02,70,"Dillingham Census Area, AK",Oct-19,1813,1683,130,7.2
22607,CN0209000000000,02,90,"Fairbanks North Star Borough, AK",Oct-19,44717,42492,2225,5.0
22608,CN0210000000000,02,100,"Haines Borough, AK",Oct-19,1088,997,91,8.4
22609,CN0210500000000,02,105,"Hoonah-Angoon Census Area, AK",Oct-19,1031,927,104,10.1
22610,CN0211000000000,02,110,"Juneau Borough/city, AK",Oct-19,16854,16153,701,4.2
22611,CN0212200000000,02,122,"Kenai Peninsula Borough, AK",Oct-19,25612,23951,1661,6.5
22612,CN0213000000000,02,130,"Ketchikan Gateway Borough, AK",Oct-19,6783,6367,416,6.1
22613,CN0215000000000,02,150,"Kodiak Island Borough, AK",Oct-19,5945,5667,278,4.7
22614,CN0215800000000,02,158,"Kusilvak Census Area, AK",Oct-19,2679,2256,423,15.8
22615,CN0216400000000,02,164,"Lake and Peninsula Borough, AK",Oct-19,718,662,56,7.8
22616,CN0217000000000,02,170,"Matanuska-Susitna Borough, AK",Oct-19,46364,43508,2856,6.2
22617,CN0218000000000,02,180,"Nome Census Area, AK",Oct-19,4177,3809,368,8.8
22618,CN0218500000000,02,185,"North Slope Borough, AK",Oct-19,3435,3196,239,7.0
22619,CN0218800000000,02,188,"Northwest Arctic Borough, AK",Oct-19,3102,2712,390,12.6
22620,CN0219500000000,02,195,"Petersburg Borough, AK",Oct-19,1330,1213,117,8.8
22621,CN0219800000000,02,198,"Prince of Wales-Hyder Census Area, AK",Oct-19,2781,2548,233,8.4
22622,CN0222000000000,02,220,"Sitka Borough/city, AK",Oct-19,4068,3893,175,4.3
22623,CN0223000000000,02,230,"Skagway Municipality, AK",Oct-19,843,779,64,7.6
22624,CN0224000000000,02,240,"Southeast Fairbanks Census Area, AK",Oct-19,2794,2574,220,7.9
22625,CN0226100000000,02,261,"Valdez-Cordova Census Area, AK",Oct-19,4480,4102,378,8.4
22626,CN0227500000000,02,275,"Wrangell Borough/city, AK",Oct-19,997,926,71,7.1
22627,CN0228200000000,02,282,"Yakutat Borough/city, AK",Oct-19,243,224,19,7.8
22628,CN0229000000000,02,290,"Yukon-Koyukuk Census Area, AK",Oct-19,2502,2214,288,11.5
22629,CN0400100000000,04,1,"Apache County, AZ",Oct-19,20507,18603,1904,9.3
22630,CN0400300000000,04,3,"Cochise County, AZ",Oct-19,51646,48914,2732,5.3
22631,CN0400500000000,04,5,"Coconino County, AZ",Oct-19,79349,75428,3921,4.9
22632,CN0400700000000,04,7,"Gila County, AZ",Oct-19,21794,20663,1131,5.2
22633,CN0400900000000,04,9,"Graham County, AZ",Oct-19,15731,15046,685,4.4
22634,CN0401100000000,04,11,"Greenlee County, AZ",Oct-19,4569,4405,164,3.6
22635,CN0401200000000,04,12,"La Paz County, AZ",Oct-19,9811,9309,502,5.1
22636,CN0401300000000,04,13,"Maricopa County, AZ",Oct-19,2344335,2255484,88851,3.8
22637,CN0401500000000,04,15,"Mohave County, AZ",Oct-19,88263,83475,4788,5.4
22638,CN0401700000000,04,17,"Navajo County, AZ",Oct-19,41657,38935,2722,6.5
22639,CN0401900000000,04,19,"Pima County, AZ",Oct-19,501592,480312,21280,4.2
22640,CN0402100000000,04,21,"Pinal County, AZ",Oct-19,191534,182681,8853,4.6
22641,CN0402300000000,04,23,"Santa Cruz County, AZ",Oct-19,19606,17634,1972,10.1
22642,CN0402500000000,04,25,"Yavapai County, AZ",Oct-19,107722,103184,4538,4.2
22643,CN0402700000000,04,27,"Yuma County, AZ",Oct-19,102978,85886,17092,16.6
22644,CN0500100000000,05,1,"Arkansas County, AR",Oct-19,9450,9211,239,2.5
22645,CN0500300000000,05,3,"Ashley County, AR",Oct-19,7592,7265,327,4.3
22646,CN0500500000000,05,5,"Baxter County, AR",Oct-19,16215,15670,545,3.4
22647,CN0500700000000,05,7,"Benton County, AR",Oct-19,139190,135989,3201,2.3
22648,CN0500900000000,05,9,"Boone County, AR",Oct-19,16101,15643,458,2.8
22649,CN0501100000000,05,11,"Bradley County, AR",Oct-19,4516,4362,154,3.4
22650,CN0501300000000,05,13,"Calhoun County, AR",Oct-19,2459,2377,82,3.3
22651,CN0501500000000,05,15,"Carroll County, AR",Oct-19,13075,12749,326,2.5
22652,CN0501700000000,05,17,"Chicot County, AR",Oct-19,3279,3097,182,5.6
22653,CN0501900000000,05,19,"Clark County, AR",Oct-19,9821,9493,328,3.3
22654,CN0502100000000,05,21,"Clay County, AR",Oct-19,5642,5429,213,3.8
22655,CN0502300000000,05,23,"Cleburne County, AR",Oct-19,9160,8779,381,4.2
22656,CN0502500000000,05,25,"Cleveland County, AR",Oct-19,3243,3128,115,3.5
22657,CN0502700000000,05,27,"Columbia County, AR",Oct-19,9247,8889,358,3.9
22658,CN0502900000000,05,29,"Conway County, AR",Oct-19,8340,8030,310,3.7
22659,CN0503100000000,05,31,"Craighead County, AR",Oct-19,56337,54998,1339,2.4
22660,CN0503300000000,05,33,"Crawford County, AR",Oct-19,26915,26121,794,3.0
22661,CN0503500000000,05,35,"Crittenden County, AR",Oct-19,21432,20660,772,3.6
22662,CN0503700000000,05,37,"Cross County, AR",Oct-19,7469,7195,274,3.7
22663,CN0503900000000,05,39,"Dallas County, AR",Oct-19,2841,2729,112,3.9
22664,CN0504100000000,05,41,"Desha County, AR",Oct-19,5462,5258,204,3.7
22665,CN0504300000000,05,43,"Drew County, AR",Oct-19,7952,7612,340,4.3
22666,CN0504500000000,05,45,"Faulkner County, AR",Oct-19,62297,60622,1675,2.7
22667,CN0504700000000,05,47,"Franklin County, AR",Oct-19,7554,7328,226,3.0
22668,CN0504900000000,05,49,"Fulton County, AR",Oct-19,4956,4797,159,3.2
22669,CN0505100000000,05,51,"Garland County, AR",Oct-19,40921,39546,1375,3.4
22670,CN0505300000000,05,53,"Grant County, AR",Oct-19,8417,8174,243,2.9
22671,CN0505500000000,05,55,"Greene County, AR",Oct-19,20130,19526,604,3.0
22672,CN0505700000000,05,57,"Hempstead County, AR",Oct-19,9943,9611,332,3.3
22673,CN0505900000000,05,59,"Hot Spring County, AR",Oct-19,14049,13588,461,3.3
22674,CN0506100000000,05,61,"Howard County, AR",Oct-19,5733,5578,155,2.7
22675,CN0506300000000,05,63,"Independence County, AR",Oct-19,16570,15977,593,3.6
22676,CN0506500000000,05,65,"Izard County, AR",Oct-19,4857,4644,213,4.4
22677,CN0506700000000,05,67,"Jackson County, AR",Oct-19,5884,5540,344,5.8
22678,CN0506900000000,05,69,"Jefferson County, AR",Oct-19,27765,26440,1325,4.8
22679,CN0507100000000,05,71,"Johnson County, AR",Oct-19,10237,9862,375,3.7
22680,CN0507300000000,05,73,"Lafayette County, AR",Oct-19,2463,2358,105,4.3
22681,CN0507500000000,05,75,"Lawrence County, AR",Oct-19,6897,6661,236,3.4
22682,CN0507700000000,05,77,"Lee County, AR",Oct-19,2854,2742,112,3.9
22683,CN0507900000000,05,79,"Lincoln County, AR",Oct-19,3967,3820,147,3.7
22684,CN0508100000000,05,81,"Little River County, AR",Oct-19,5519,5308,211,3.8
22685,CN0508300000000,05,83,"Logan County, AR",Oct-19,8597,8245,352,4.1
22686,CN0508500000000,05,85,"Lonoke County, AR",Oct-19,34462,33475,987,2.9
22687,CN0508700000000,05,87,"Madison County, AR",Oct-19,7577,7398,179,2.4
22688,CN0508900000000,05,89,"Marion County, AR",Oct-19,6636,6399,237,3.6
22689,CN0509100000000,05,91,"Miller County, AR",Oct-19,19685,19002,683,3.5
22690,CN0509300000000,05,93,"Mississippi County, AR",Oct-19,17393,16702,691,4.0
22691,CN0509500000000,05,95,"Monroe County, AR",Oct-19,2767,2661,106,3.8
22692,CN0509700000000,05,97,"Montgomery County, AR",Oct-19,2941,2819,122,4.1
22693,CN0509900000000,05,99,"Nevada County, AR",Oct-19,3649,3520,129,3.5
22694,CN0510100000000,05,101,"Newton County, AR",Oct-19,3342,3245,97,2.9
22695,CN0510300000000,05,103,"Ouachita County, AR",Oct-19,9840,9408,432,4.4
22696,CN0510500000000,05,105,"Perry County, AR",Oct-19,4245,4108,137,3.2
22697,CN0510700000000,05,107,"Phillips County, AR",Oct-19,6336,6000,336,5.3
22698,CN0510900000000,05,109,"Pike County, AR",Oct-19,4245,4098,147,3.5
22699,CN0511100000000,05,111,"Poinsett County, AR",Oct-19,10438,10131,307,2.9
22700,CN0511300000000,05,113,"Polk County, AR",Oct-19,8159,7837,322,3.9
22701,CN0511500000000,05,115,"Pope County, AR",Oct-19,29011,28034,977,3.4
22702,CN0511700000000,05,117,"Prairie County, AR",Oct-19,3612,3484,128,3.5
22703,CN0511900000000,05,119,"Pulaski County, AR",Oct-19,189786,183949,5837,3.1
22704,CN0512100000000,05,121,"Randolph County, AR",Oct-19,7382,7152,230,3.1
22705,CN0512300000000,05,123,"St. Francis County, AR",Oct-19,8181,7832,349,4.3
22706,CN0512500000000,05,125,"Saline County, AR",Oct-19,59026,57494,1532,2.6
22707,CN0512700000000,05,127,"Scott County, AR",Oct-19,4346,4212,134,3.1
22708,CN0512900000000,05,129,"Searcy County, AR",Oct-19,2848,2728,120,4.2
22709,CN0513100000000,05,131,"Sebastian County, AR",Oct-19,56640,54959,1681,3.0
22710,CN0513300000000,05,133,"Sevier County, AR",Oct-19,5549,5311,238,4.3
22711,CN0513500000000,05,135,"Sharp County, AR",Oct-19,5723,5470,253,4.4
22712,CN0513700000000,05,137,"Stone County, AR",Oct-19,4680,4504,176,3.8
22713,CN0513900000000,05,139,"Union County, AR",Oct-19,15816,15082,734,4.6
22714,CN0514100000000,05,141,"Van Buren County, AR",Oct-19,5698,5453,245,4.3
22715,CN0514300000000,05,143,"Washington County, AR",Oct-19,126763,124020,2743,2.2
22716,CN0514500000000,05,145,"White County, AR",Oct-19,33766,32512,1254,3.7
22717,CN0514700000000,05,147,"Woodruff County, AR",Oct-19,2803,2678,125,4.5
22718,CN0514900000000,05,149,"Yell County, AR",Oct-19,8507,8239,268,3.2
22719,CN0600100000000,06,1,"Alameda County, CA",Oct-19,848333,824883,23450,2.8
22720,CN0600300000000,06,3,"Alpine County, CA",Oct-19,455,431,24,5.3
22721,CN0600500000000,06,5,"Amador County, CA",Oct-19,15107,14603,504,3.3
22722,CN0600700000000,06,7,"Butte County, CA",Oct-19,100659,96479,4180,4.2
22723,CN0600900000000,06,9,"Calaveras County, CA",Oct-19,21706,20983,723,3.3
22724,CN0601100000000,06,11,"Colusa County, CA",Oct-19,10918,10070,848,7.8
22725,CN0601300000000,06,13,"Contra Costa County, CA",Oct-19,564347,548106,16241,2.9
22726,CN0601500000000,06,15,"Del Norte County, CA",Oct-19,9777,9257,520,5.3
22727,CN0601700000000,06,17,"El Dorado County, CA",Oct-19,92298,89409,2889,3.1
22728,CN0601900000000,06,19,"Fresno County, CA",Oct-19,448769,421325,27444,6.1
22729,CN0602100000000,06,21,"Glenn County, CA",Oct-19,13322,12723,599,4.5
22730,CN0602300000000,06,23,"Humboldt County, CA",Oct-19,63070,61103,1967,3.1
22731,CN0602500000000,06,25,"Imperial County, CA",Oct-19,72614,58424,14190,19.5
22732,CN0602700000000,06,27,"Inyo County, CA",Oct-19,8814,8559,255,2.9
22733,CN0602900000000,06,29,"Kern County, CA",Oct-19,399408,374344,25064,6.3
22734,CN0603100000000,06,31,"Kings County, CA",Oct-19,57617,53827,3790,6.6
22735,CN0603300000000,06,33,"Lake County, CA",Oct-19,29003,27713,1290,4.4
22736,CN0603500000000,06,35,"Lassen County, CA",Oct-19,10562,10212,350,3.3
22737,CN0603700000000,06,37,"Los Angeles County, CA",Oct-19,5157853,4936189,221664,4.3
22738,CN0603900000000,06,39,"Madera County, CA",Oct-19,61525,58067,3458,5.6
22739,CN0604100000000,06,41,"Marin County, CA",Oct-19,141147,138133,3014,2.1
22740,CN0604300000000,06,43,"Mariposa County, CA",Oct-19,7756,7481,275,3.5
22741,CN0604500000000,06,45,"Mendocino County, CA",Oct-19,39095,37828,1267,3.2
22742,CN0604700000000,06,47,"Merced County, CA",Oct-19,118481,111360,7121,6.0
22743,CN0604900000000,06,49,"Modoc County, CA",Oct-19,3254,3101,153,4.7
22744,CN0605100000000,06,51,"Mono County, CA",Oct-19,7968,7648,320,4.0
22745,CN0605300000000,06,53,"Monterey County, CA",Oct-19,224987,216223,8764,3.9
22746,CN0605500000000,06,55,"Napa County, CA",Oct-19,75561,73747,1814,2.4
22747,CN0605700000000,06,57,"Nevada County, CA",Oct-19,48417,46964,1453,3.0
22748,CN0605900000000,06,59,"Orange County, CA",Oct-19,1631968,1588998,42970,2.6
22749,CN0606100000000,06,61,"Placer County, CA",Oct-19,188716,183305,5411,2.9
22750,CN0606300000000,06,63,"Plumas County, CA",Oct-19,7980,7582,398,5.0
22751,CN0606500000000,06,65,"Riverside County, CA",Oct-19,1110812,1065345,45467,4.1
22752,CN0606700000000,06,67,"Sacramento County, CA",Oct-19,715047,690825,24222,3.4
22753,CN0606900000000,06,69,"San Benito County, CA",Oct-19,31573,30242,1331,4.2
22754,CN0607100000000,06,71,"San Bernardino County, CA",Oct-19,973253,938057,35196,3.6
22755,CN0607300000000,06,73,"San Diego County, CA",Oct-19,1598643,1550782,47861,3.0
22756,CN0607500000000,06,75,"San Francisco County/city, CA",Oct-19,589787,577708,12079,2.0
22757,CN0607700000000,06,77,"San Joaquin County, CA",Oct-19,327968,310984,16984,5.2
22758,CN0607900000000,06,79,"San Luis Obispo County, CA",Oct-19,142355,138706,3649,2.6
22759,CN0608100000000,06,81,"San Mateo County, CA",Oct-19,465302,456399,8903,1.9
22760,CN0608300000000,06,83,"Santa Barbara County, CA",Oct-19,220335,213465,6870,3.1
22761,CN0608500000000,06,85,"Santa Clara County, CA",Oct-19,1059060,1034036,25024,2.4
22762,CN0608700000000,06,87,"Santa Cruz County, CA",Oct-19,143704,138705,4999,3.5
22763,CN0608900000000,06,89,"Shasta County, CA",Oct-19,75417,72460,2957,3.9
22764,CN0609100000000,06,91,"Sierra County, CA",Oct-19,1370,1315,55,4.0
22765,CN0609300000000,06,93,"Siskiyou County, CA",Oct-19,17479,16659,820,4.7
22766,CN0609500000000,06,95,"Solano County, CA",Oct-19,210932,203840,7092,3.4
22767,CN0609700000000,06,97,"Sonoma County, CA",Oct-19,263296,257014,6282,2.4
22768,CN0609900000000,06,99,"Stanislaus County, CA",Oct-19,244850,232483,12367,5.1
22769,CN0610100000000,06,101,"Sutter County, CA",Oct-19,46260,43770,2490,5.4
22770,CN0610300000000,06,103,"Tehama County, CA",Oct-19,26431,25245,1186,4.5
22771,CN0610500000000,06,105,"Trinity County, CA",Oct-19,4692,4481,211,4.5
22772,CN0610700000000,06,107,"Tulare County, CA",Oct-19,202214,185254,16960,8.4
22773,CN0610900000000,06,109,"Tuolumne County, CA",Oct-19,21325,20513,812,3.8
22774,CN0611100000000,06,111,"Ventura County, CA",Oct-19,425299,410833,14466,3.4
22775,CN0611300000000,06,113,"Yolo County, CA",Oct-19,108749,105079,3670,3.4
22776,CN0611500000000,06,115,"Yuba County, CA",Oct-19,30617,29081,1536,5.0
22777,CN0800100000000,08,1,"Adams County, CO",Oct-19,278819,271894,6925,2.5
22778,CN0800300000000,08,3,"Alamosa County, CO",Oct-19,9145,8879,266,2.9
22779,CN0800500000000,08,5,"Arapahoe County, CO",Oct-19,372285,363443,8842,2.4
22780,CN0800700000000,08,7,"Archuleta County, CO",Oct-19,7112,6933,179,2.5
22781,CN0800900000000,08,9,"Baca County, CO",Oct-19,2325,2291,34,1.5
22782,CN0801100000000,08,11,"Bent County, CO",Oct-19,2080,2033,47,2.3
22783,CN0801300000000,08,13,"Boulder County, CO",Oct-19,198261,194133,4128,2.1
22784,CN0801400000000,08,14,"Broomfield County/city, CO",Oct-19,41022,40132,890,2.2
22785,CN0801500000000,08,15,"Chaffee County, CO",Oct-19,9673,9460,213,2.2
22786,CN0801700000000,08,17,"Cheyenne County, CO",Oct-19,1301,1283,18,1.4
22787,CN0801900000000,08,19,"Clear Creek County, CO",Oct-19,6173,6044,129,2.1
22788,CN0802100000000,08,21,"Conejos County, CO",Oct-19,4427,4315,112,2.5
22789,CN0802300000000,08,23,"Costilla County, CO",Oct-19,1959,1905,54,2.8
22790,CN0802500000000,08,25,"Crowley County, CO",Oct-19,1573,1521,52,3.3
22791,CN0802700000000,08,27,"Custer County, CO",Oct-19,2135,2080,55,2.6
22792,CN0802900000000,08,29,"Delta County, CO",Oct-19,15200,14823,377,2.5
22793,CN0803100000000,08,31,"Denver County/city, CO",Oct-19,425612,415644,9968,2.3
22794,CN0803300000000,08,33,"Dolores County, CO",Oct-19,1254,1226,28,2.2
22795,CN0803500000000,08,35,"Douglas County, CO",Oct-19,198556,194346,4210,2.1
22796,CN0803700000000,08,37,"Eagle County, CO",Oct-19,35353,34645,708,2.0
22797,CN0803900000000,08,39,"Elbert County, CO",Oct-19,15736,15450,286,1.8
22798,CN0804100000000,08,41,"El Paso County, CO",Oct-19,345876,336141,9735,2.8
22799,CN0804300000000,08,43,"Fremont County, CO",Oct-19,15193,14593,600,3.9
22800,CN0804500000000,08,45,"Garfield County, CO",Oct-19,31863,31121,742,2.3
22801,CN0804700000000,08,47,"Gilpin County, CO",Oct-19,3856,3778,78,2.0
22802,CN0804900000000,08,49,"Grand County, CO",Oct-19,9166,8981,185,2.0
22803,CN0805100000000,08,51,"Gunnison County, CO",Oct-19,11450,11246,204,1.8
22804,CN0805300000000,08,53,"Hinsdale County, CO",Oct-19,408,390,18,4.4
22805,CN0805500000000,08,55,"Huerfano County, CO",Oct-19,2574,2459,115,4.5
22806,CN0805700000000,08,57,"Jackson County, CO",Oct-19,1118,1100,18,1.6
22807,CN0805900000000,08,59,"Jefferson County, CO",Oct-19,342188,334617,7571,2.2
22808,CN0806100000000,08,61,"Kiowa County, CO",Oct-19,1083,1068,15,1.4
22809,CN0806300000000,08,63,"Kit Carson County, CO",Oct-19,4696,4627,69,1.5
22810,CN0806500000000,08,65,"Lake County, CO",Oct-19,4772,4657,115,2.4
22811,CN0806700000000,08,67,"La Plata County, CO",Oct-19,32835,32182,653,2.0
22812,CN0806900000000,08,69,"Larimer County, CO",Oct-19,211959,207740,4219,2.0
22813,CN0807100000000,08,71,"Las Animas County, CO",Oct-19,6776,6570,206,3.0
22814,CN0807300000000,08,73,"Lincoln County, CO",Oct-19,2508,2459,49,2.0
22815,CN0807500000000,08,75,"Logan County, CO",Oct-19,11495,11278,217,1.9
22816,CN0807700000000,08,77,"Mesa County, CO",Oct-19,77377,75226,2151,2.8
22817,CN0807900000000,08,79,"Mineral County, CO",Oct-19,459,449,10,2.2
22818,CN0808100000000,08,81,"Moffat County, CO",Oct-19,7393,7213,180,2.4
22819,CN0808300000000,08,83,"Montezuma County, CO",Oct-19,13349,12953,396,3.0
22820,CN0808500000000,08,85,"Montrose County, CO",Oct-19,22603,22075,528,2.3
22821,CN0808700000000,08,87,"Morgan County, CO",Oct-19,17420,17043,377,2.2
22822,CN0808900000000,08,89,"Otero County, CO",Oct-19,8876,8592,284,3.2
22823,CN0809100000000,08,91,"Ouray County, CO",Oct-19,2496,2441,55,2.2
22824,CN0809300000000,08,93,"Park County, CO",Oct-19,11380,11155,225,2.0
22825,CN0809500000000,08,95,"Phillips County, CO",Oct-19,2922,2884,38,1.3
22826,CN0809700000000,08,97,"Pitkin County, CO",Oct-19,11030,10658,372,3.4
22827,CN0809900000000,08,99,"Prowers County, CO",Oct-19,6805,6657,148,2.2
22828,CN0810100000000,08,101,"Pueblo County, CO",Oct-19,77084,74430,2654,3.4
22829,CN0810300000000,08,103,"Rio Blanco County, CO",Oct-19,3124,3036,88,2.8
22830,CN0810500000000,08,105,"Rio Grande County, CO",Oct-19,5851,5679,172,2.9
22831,CN0810700000000,08,107,"Routt County, CO",Oct-19,15799,15490,309,2.0
22832,CN0810900000000,08,109,"Saguache County, CO",Oct-19,3912,3798,114,2.9
22833,CN0811100000000,08,111,"San Juan County, CO",Oct-19,605,592,13,2.1
22834,CN0811300000000,08,113,"San Miguel County, CO",Oct-19,5523,5416,107,1.9
22835,CN0811500000000,08,115,"Sedgwick County, CO",Oct-19,1353,1329,24,1.8
22836,CN0811700000000,08,117,"Summit County, CO",Oct-19,20760,20347,413,2.0
22837,CN0811900000000,08,119,"Teller County, CO",Oct-19,12872,12528,344,2.7
22838,CN0812100000000,08,121,"Washington County, CO",Oct-19,3127,3072,55,1.8
22839,CN0812300000000,08,123,"Weld County, CO",Oct-19,175276,171442,3834,2.2
22840,CN0812500000000,08,125,"Yuma County, CO",Oct-19,6618,6526,92,1.4
22841,CN0900100000000,09,1,"Fairfield County, CT",Oct-19,482001,465630,16371,3.4
22842,CN0900300000000,09,3,"Hartford County, CT",Oct-19,487268,469592,17676,3.6
22843,CN0900500000000,09,5,"Litchfield County, CT",Oct-19,105707,102556,3151,3.0
22844,CN0900700000000,09,7,"Middlesex County, CT",Oct-19,94641,91808,2833,3.0
22845,CN0900900000000,09,9,"New Haven County, CT",Oct-19,465906,448681,17225,3.7
22846,CN0901100000000,09,11,"New London County, CT",Oct-19,137621,133073,4548,3.3
22847,CN0901300000000,09,13,"Tolland County, CT",Oct-19,87694,85103,2591,3.0
22848,CN0901500000000,09,15,"Windham County, CT",Oct-19,64656,62416,2240,3.5
22849,CN1000100000000,10,1,"Kent County, DE",Oct-19,80257,76861,3396,4.2
22850,CN1000300000000,10,3,"New Castle County, DE",Oct-19,300235,288693,11542,3.8
22851,CN1000500000000,10,5,"Sussex County, DE",Oct-19,107283,103471,3812,3.6
22852,CN1100100000000,11,1,District of Columbia,Oct-19,409726,388209,21517,5.3
22853,CN1200100000000,12,1,"Alachua County, FL",Oct-19,142433,138577,3856,2.7
22854,CN1200300000000,12,3,"Baker County, FL",Oct-19,12086,11750,336,2.8
22855,CN1200500000000,12,5,"Bay County, FL",Oct-19,83908,81344,2564,3.1
22856,CN1200700000000,12,7,"Bradford County, FL",Oct-19,11338,11017,321,2.8
22857,CN1200900000000,12,9,"Brevard County, FL",Oct-19,288618,280184,8434,2.9
22858,CN1201100000000,12,11,"Broward County, FL",Oct-19,1053729,1024008,29721,2.8
22859,CN1201300000000,12,13,"Calhoun County, FL",Oct-19,4866,4690,176,3.6
22860,CN1201500000000,12,15,"Charlotte County, FL",Oct-19,71956,69566,2390,3.3
22861,CN1201700000000,12,17,"Citrus County, FL",Oct-19,47560,45530,2030,4.3
22862,CN1201900000000,12,19,"Clay County, FL",Oct-19,109932,106889,3043,2.8
22863,CN1202100000000,12,21,"Collier County, FL",Oct-19,180325,174924,5401,3.0
22864,CN1202300000000,12,23,"Columbia County, FL",Oct-19,30511,29636,875,2.9
22865,CN1202700000000,12,27,"DeSoto County, FL",Oct-19,14120,13648,472,3.3
22866,CN1202900000000,12,29,"Dixie County, FL",Oct-19,6040,5837,203,3.4
22867,CN1203100000000,12,31,"Duval County, FL",Oct-19,501891,486950,14941,3.0
22868,CN1203300000000,12,33,"Escambia County, FL",Oct-19,147434,143107,4327,2.9
22869,CN1203500000000,12,35,"Flagler County, FL",Oct-19,47214,45576,1638,3.5
22870,CN1203700000000,12,37,"Franklin County, FL",Oct-19,4567,4436,131,2.9
22871,CN1203900000000,12,39,"Gadsden County, FL",Oct-19,19487,18744,743,3.8
22872,CN1204100000000,12,41,"Gilchrist County, FL",Oct-19,7307,7076,231,3.2
22873,CN1204300000000,12,43,"Glades County, FL",Oct-19,5440,5245,195,3.6
22874,CN1204500000000,12,45,"Gulf County, FL",Oct-19,5730,5520,210,3.7
22875,CN1204700000000,12,47,"Hamilton County, FL",Oct-19,4539,4371,168,3.7
22876,CN1204900000000,12,49,"Hardee County, FL",Oct-19,8555,8143,412,4.8
22877,CN1205100000000,12,51,"Hendry County, FL",Oct-19,15837,14891,946,6.0
22878,CN1205300000000,12,53,"Hernando County, FL",Oct-19,73028,70218,2810,3.8
22879,CN1205500000000,12,55,"Highlands County, FL",Oct-19,36060,34572,1488,4.1
22880,CN1205700000000,12,57,"Hillsborough County, FL",Oct-19,761135,739355,21780,2.9
22881,CN1205900000000,12,59,"Holmes County, FL",Oct-19,7098,6875,223,3.1
22882,CN1206100000000,12,61,"Indian River County, FL",Oct-19,65470,63147,2323,3.5
22883,CN1206300000000,12,63,"Jackson County, FL",Oct-19,17329,16795,534,3.1
22884,CN1206500000000,12,65,"Jefferson County, FL",Oct-19,5729,5558,171,3.0
22885,CN1206700000000,12,67,"Lafayette County, FL",Oct-19,2869,2789,80,2.8
22886,CN1206900000000,12,69,"Lake County, FL",Oct-19,161180,156472,4708,2.9
22887,CN1207100000000,12,71,"Lee County, FL",Oct-19,351228,341096,10132,2.9
22888,CN1207300000000,12,73,"Leon County, FL",Oct-19,158581,154075,4506,2.8
22889,CN1207500000000,12,75,"Levy County, FL",Oct-19,16972,16418,554,3.3
22890,CN1207700000000,12,77,"Liberty County, FL",Oct-19,2670,2582,88,3.3
22891,CN1207900000000,12,79,"Madison County, FL",Oct-19,7605,7351,254,3.3
22892,CN1208100000000,12,81,"Manatee County, FL",Oct-19,180308,175058,5250,2.9
22893,CN1208300000000,12,83,"Marion County, FL",Oct-19,139117,134320,4797,3.4
22894,CN1208500000000,12,85,"Martin County, FL",Oct-19,74680,72586,2094,2.8
22895,CN1208600000000,12,86,"Miami-Dade County, FL",Oct-19,1399889,1371540,28349,2.0
22896,CN1208700000000,12,87,"Monroe County, FL",Oct-19,46529,45643,886,1.9
22897,CN1208900000000,12,89,"Nassau County, FL",Oct-19,42041,40917,1124,2.7
22898,CN1209100000000,12,91,"Okaloosa County, FL",Oct-19,97693,95387,2306,2.4
22899,CN1209300000000,12,93,"Okeechobee County, FL",Oct-19,18028,17469,559,3.1
22900,CN1209500000000,12,95,"Orange County, FL",Oct-19,773112,752294,20818,2.7
22901,CN1209700000000,12,97,"Osceola County, FL",Oct-19,186807,181017,5790,3.1
22902,CN1209900000000,12,99,"Palm Beach County, FL",Oct-19,737312,714672,22640,3.1
22903,CN1210100000000,12,101,"Pasco County, FL",Oct-19,241528,233812,7716,3.2
22904,CN1210300000000,12,103,"Pinellas County, FL",Oct-19,501699,488248,13451,2.7
22905,CN1210500000000,12,105,"Polk County, FL",Oct-19,309933,299315,10618,3.4
22906,CN1210700000000,12,107,"Putnam County, FL",Oct-19,26719,25681,1038,3.9
22907,CN1210900000000,12,109,"St. Johns County, FL",Oct-19,135017,131814,3203,2.4
22908,CN1211100000000,12,111,"St. Lucie County, FL",Oct-19,146174,140798,5376,3.7
22909,CN1211300000000,12,113,"Santa Rosa County, FL",Oct-19,83759,81516,2243,2.7
22910,CN1211500000000,12,115,"Sarasota County, FL",Oct-19,189771,184481,5290,2.8
22911,CN1211700000000,12,117,"Seminole County, FL",Oct-19,258997,251986,7011,2.7
22912,CN1211900000000,12,119,"Sumter County, FL",Oct-19,32901,31606,1295,3.9
22913,CN1212100000000,12,121,"Suwannee County, FL",Oct-19,18289,17709,580,3.2
22914,CN1212300000000,12,123,"Taylor County, FL",Oct-19,8335,8064,271,3.3
22915,CN1212500000000,12,125,"Union County, FL",Oct-19,4712,4582,130,2.8
22916,CN1212700000000,12,127,"Volusia County, FL",Oct-19,255779,247613,8166,3.2
22917,CN1212900000000,12,129,"Wakulla County, FL",Oct-19,15215,14804,411,2.7
22918,CN1213100000000,12,131,"Walton County, FL",Oct-19,31844,31064,780,2.4
22919,CN1213300000000,12,133,"Washington County, FL",Oct-19,9655,9361,294,3.0
22920,CN1300100000000,13,1,"Appling County, GA",Oct-19,9466,9170,296,3.1
22921,CN1300300000000,13,3,"Atkinson County, GA",Oct-19,4673,4557,116,2.5
22922,CN1300500000000,13,5,"Bacon County, GA",Oct-19,4921,4742,179,3.6
22923,CN1300700000000,13,7,"Baker County, GA",Oct-19,1166,1117,49,4.2
22924,CN1300900000000,13,9,"Baldwin County, GA",Oct-19,17455,16807,648,3.7
22925,CN1301100000000,13,11,"Banks County, GA",Oct-19,9720,9480,240,2.5
22926,CN1301300000000,13,13,"Barrow County, GA",Oct-19,40762,39722,1040,2.6
22927,CN1301500000000,13,15,"Bartow County, GA",Oct-19,50979,49475,1504,3.0
22928,CN1301700000000,13,17,"Ben Hill County, GA",Oct-19,5336,5072,264,4.9
22929,CN1301900000000,13,19,"Berrien County, GA",Oct-19,7566,7217,349,4.6
22930,CN1302100000000,13,21,"Bibb County, GA",Oct-19,67645,65249,2396,3.5
22931,CN1302300000000,13,23,"Bleckley County, GA",Oct-19,4488,4284,204,4.5
22932,CN1302500000000,13,25,"Brantley County, GA",Oct-19,7239,6975,264,3.6
22933,CN1302700000000,13,27,"Brooks County, GA",Oct-19,6944,6723,221,3.2
22934,CN1302900000000,13,29,"Bryan County, GA",Oct-19,18278,17759,519,2.8
22935,CN1303100000000,13,31,"Bulloch County, GA",Oct-19,36460,35253,1207,3.3
22936,CN1303300000000,13,33,"Burke County, GA",Oct-19,9124,8733,391,4.3
22937,CN1303500000000,13,35,"Butts County, GA",Oct-19,10813,10502,311,2.9
22938,CN1303700000000,13,37,"Calhoun County, GA",Oct-19,2275,2199,76,3.3
22939,CN1303900000000,13,39,"Camden County, GA",Oct-19,20857,20163,694,3.3
22940,CN1304300000000,13,43,"Candler County, GA",Oct-19,5620,5470,150,2.7
22941,CN1304500000000,13,45,"Carroll County, GA",Oct-19,55681,53972,1709,3.1
22942,CN1304700000000,13,47,"Catoosa County, GA",Oct-19,33738,32845,893,2.6
22943,CN1304900000000,13,49,"Charlton County, GA",Oct-19,4809,4648,161,3.3
22944,CN1305100000000,13,51,"Chatham County, GA",Oct-19,139417,135191,4226,3.0
22945,CN1305300000000,13,53,"Chattahoochee County, GA",Oct-19,1990,1912,78,3.9
22946,CN1305500000000,13,55,"Chattooga County, GA",Oct-19,10178,9789,389,3.8
22947,CN1305700000000,13,57,"Cherokee County, GA",Oct-19,137120,133722,3398,2.5
22948,CN1305900000000,13,59,"Clarke County, GA",Oct-19,59713,57813,1900,3.2
22949,CN1306100000000,13,61,"Clay County, GA",Oct-19,894,839,55,6.2
22950,CN1306300000000,13,63,"Clayton County, GA",Oct-19,138750,133575,5175,3.7
22951,CN1306500000000,13,65,"Clinch County, GA",Oct-19,2513,2424,89,3.5
22952,CN1306700000000,13,67,"Cobb County, GA",Oct-19,429043,417598,11445,2.7
22953,CN1306900000000,13,69,"Coffee County, GA",Oct-19,18887,18264,623,3.3
22954,CN1307100000000,13,71,"Colquitt County, GA",Oct-19,21494,20881,613,2.9
22955,CN1307300000000,13,73,"Columbia County, GA",Oct-19,75310,73227,2083,2.8
22956,CN1307500000000,13,75,"Cook County, GA",Oct-19,8053,7798,255,3.2
22957,CN1307700000000,13,77,"Coweta County, GA",Oct-19,75259,73286,1973,2.6
22958,CN1307900000000,13,79,"Crawford County, GA",Oct-19,5596,5406,190,3.4
22959,CN1308100000000,13,81,"Crisp County, GA",Oct-19,9441,9079,362,3.8
22960,CN1308300000000,13,83,"Dade County, GA",Oct-19,8259,8024,235,2.8
22961,CN1308500000000,13,85,"Dawson County, GA",Oct-19,12434,12116,318,2.6
22962,CN1308700000000,13,87,"Decatur County, GA",Oct-19,11484,11082,402,3.5
22963,CN1308900000000,13,89,"DeKalb County, GA",Oct-19,402686,390376,12310,3.1
22964,CN1309100000000,13,91,"Dodge County, GA",Oct-19,7039,6687,352,5.0
22965,CN1309300000000,13,93,"Dooly County, GA",Oct-19,5115,4933,182,3.6
22966,CN1309500000000,13,95,"Dougherty County, GA",Oct-19,38424,36777,1647,4.3
22967,CN1309700000000,13,97,"Douglas County, GA",Oct-19,73857,71496,2361,3.2
22968,CN1309900000000,13,99,"Early County, GA",Oct-19,4474,4324,150,3.4
22969,CN1310100000000,13,101,"Echols County, GA",Oct-19,1919,1871,48,2.5
22970,CN1310300000000,13,103,"Effingham County, GA",Oct-19,30859,30028,831,2.7
22971,CN1310500000000,13,105,"Elbert County, GA",Oct-19,7715,7416,299,3.9
22972,CN1310700000000,13,107,"Emanuel County, GA",Oct-19,8284,7867,417,5.0
22973,CN1310900000000,13,109,"Evans County, GA",Oct-19,4925,4776,149,3.0
22974,CN1311100000000,13,111,"Fannin County, GA",Oct-19,11532,11175,357,3.1
22975,CN1311300000000,13,113,"Fayette County, GA",Oct-19,58497,56936,1561,2.7
22976,CN1311500000000,13,115,"Floyd County, GA",Oct-19,44467,42979,1488,3.3
22977,CN1311700000000,13,117,"Forsyth County, GA",Oct-19,123257,120175,3082,2.5
22978,CN1311900000000,13,119,"Franklin County, GA",Oct-19,9882,9553,329,3.3
22979,CN1312100000000,13,121,"Fulton County, GA",Oct-19,561635,544120,17515,3.1
22980,CN1312300000000,13,123,"Gilmer County, GA",Oct-19,11959,11582,377,3.2
22981,CN1312500000000,13,125,"Glascock County, GA",Oct-19,1283,1239,44,3.4
22982,CN1312700000000,13,127,"Glynn County, GA",Oct-19,39249,38046,1203,3.1
22983,CN1312900000000,13,129,"Gordon County, GA",Oct-19,28031,27136,895,3.2
22984,CN1313100000000,13,131,"Grady County, GA",Oct-19,10385,10044,341,3.3
22985,CN1313300000000,13,133,"Greene County, GA",Oct-19,6950,6705,245,3.5
22986,CN1313500000000,13,135,"Gwinnett County, GA",Oct-19,494085,480646,13439,2.7
22987,CN1313700000000,13,137,"Habersham County, GA",Oct-19,19034,18434,600,3.2
22988,CN1313900000000,13,139,"Hall County, GA",Oct-19,102981,100423,2558,2.5
22989,CN1314100000000,13,141,"Hancock County, GA",Oct-19,2445,2332,113,4.6
22990,CN1314300000000,13,143,"Haralson County, GA",Oct-19,12675,12289,386,3.0
22991,CN1314500000000,13,145,"Harris County, GA",Oct-19,16656,16188,468,2.8
22992,CN1314700000000,13,147,"Hart County, GA",Oct-19,11071,10610,461,4.2
22993,CN1314900000000,13,149,"Heard County, GA",Oct-19,5290,5134,156,2.9
22994,CN1315100000000,13,151,"Henry County, GA",Oct-19,116423,112754,3669,3.2
22995,CN1315300000000,13,153,"Houston County, GA",Oct-19,70268,68083,2185,3.1
22996,CN1315500000000,13,155,"Irwin County, GA",Oct-19,3357,3222,135,4.0
22997,CN1315700000000,13,157,"Jackson County, GA",Oct-19,36867,35996,871,2.4
22998,CN1315900000000,13,159,"Jasper County, GA",Oct-19,6997,6807,190,2.7
22999,CN1316100000000,13,161,"Jeff Davis County, GA",Oct-19,5988,5744,244,4.1
23000,CN1316300000000,13,163,"Jefferson County, GA",Oct-19,6609,6319,290,4.4
23001,CN1316500000000,13,165,"Jenkins County, GA",Oct-19,3128,2999,129,4.1
23002,CN1316700000000,13,167,"Johnson County, GA",Oct-19,3973,3846,127,3.2
23003,CN1316900000000,13,169,"Jones County, GA",Oct-19,13663,13266,397,2.9
23004,CN1317100000000,13,171,"Lamar County, GA",Oct-19,8305,8010,295,3.6
23005,CN1317300000000,13,173,"Lanier County, GA",Oct-19,3762,3628,134,3.6
23006,CN1317500000000,13,175,"Laurens County, GA",Oct-19,18875,18056,819,4.3
23007,CN1317700000000,13,177,"Lee County, GA",Oct-19,14782,14372,410,2.8
23008,CN1317900000000,13,179,"Liberty County, GA",Oct-19,26212,25305,907,3.5
23009,CN1318100000000,13,181,"Lincoln County, GA",Oct-19,3558,3435,123,3.5
23010,CN1318300000000,13,183,"Long County, GA",Oct-19,8168,7901,267,3.3
23011,CN1318500000000,13,185,"Lowndes County, GA",Oct-19,51435,49752,1683,3.3
23012,CN1318700000000,13,187,"Lumpkin County, GA",Oct-19,16951,16462,489,2.9
23013,CN1318900000000,13,189,"McDuffie County, GA",Oct-19,8879,8443,436,4.9
23014,CN1319100000000,13,191,"McIntosh County, GA",Oct-19,6149,5953,196,3.2
23015,CN1319300000000,13,193,"Macon County, GA",Oct-19,4672,4476,196,4.2
23016,CN1319500000000,13,195,"Madison County, GA",Oct-19,13443,13061,382,2.8
23017,CN1319700000000,13,197,"Marion County, GA",Oct-19,3297,3176,121,3.7
23018,CN1319900000000,13,199,"Meriwether County, GA",Oct-19,8969,8613,356,4.0
23019,CN1320100000000,13,201,"Miller County, GA",Oct-19,2752,2670,82,3.0
23020,CN1320500000000,13,205,"Mitchell County, GA",Oct-19,8549,8191,358,4.2
23021,CN1320700000000,13,207,"Monroe County, GA",Oct-19,12944,12581,363,2.8
23022,CN1320900000000,13,209,"Montgomery County, GA",Oct-19,3796,3617,179,4.7
23023,CN1321100000000,13,211,"Morgan County, GA",Oct-19,9327,9061,266,2.9
23024,CN1321300000000,13,213,"Murray County, GA",Oct-19,15502,14719,783,5.1
23025,CN1321500000000,13,215,"Muscogee County, GA",Oct-19,77325,74189,3136,4.1
23026,CN1321700000000,13,217,"Newton County, GA",Oct-19,52603,50794,1809,3.4
23027,CN1321900000000,13,219,"Oconee County, GA",Oct-19,19741,19286,455,2.3
23028,CN1322100000000,13,221,"Oglethorpe County, GA",Oct-19,7000,6801,199,2.8
23029,CN1322300000000,13,223,"Paulding County, GA",Oct-19,86707,84405,2302,2.7
23030,CN1322500000000,13,225,"Peach County, GA",Oct-19,11850,11364,486,4.1
23031,CN1322700000000,13,227,"Pickens County, GA",Oct-19,15418,14995,423,2.7
23032,CN1322900000000,13,229,"Pierce County, GA",Oct-19,8691,8414,277,3.2
23033,CN1323100000000,13,231,"Pike County, GA",Oct-19,8979,8736,243,2.7
23034,CN1323300000000,13,233,"Polk County, GA",Oct-19,18520,17933,587,3.2
23035,CN1323500000000,13,235,"Pulaski County, GA",Oct-19,4039,3904,135,3.3
23036,CN1323700000000,13,237,"Putnam County, GA",Oct-19,8226,7921,305,3.7
23037,CN1323900000000,13,239,"Quitman County, GA",Oct-19,792,758,34,4.3
23038,CN1324100000000,13,241,"Rabun County, GA",Oct-19,7214,6964,250,3.5
23039,CN1324300000000,13,243,"Randolph County, GA",Oct-19,2546,2436,110,4.3
23040,CN1324500000000,13,245,"Richmond County, GA",Oct-19,85013,81632,3381,4.0
23041,CN1324700000000,13,247,"Rockdale County, GA",Oct-19,45095,43582,1513,3.4
23042,CN1324900000000,13,249,"Schley County, GA",Oct-19,2248,2170,78,3.5
23043,CN1325100000000,13,251,"Screven County, GA",Oct-19,5046,4833,213,4.2
23044,CN1325300000000,13,253,"Seminole County, GA",Oct-19,2987,2868,119,4.0
23045,CN1325500000000,13,255,"Spalding County, GA",Oct-19,28888,27862,1026,3.6
23046,CN1325700000000,13,257,"Stephens County, GA",Oct-19,10644,10280,364,3.4
23047,CN1325900000000,13,259,"Stewart County, GA",Oct-19,2418,2331,87,3.6
23048,CN1326100000000,13,261,"Sumter County, GA",Oct-19,12948,12385,563,4.3
23049,CN1326300000000,13,263,"Talbot County, GA",Oct-19,2806,2698,108,3.8
23050,CN1326500000000,13,265,"Taliaferro County, GA",Oct-19,566,536,30,5.3
23051,CN1326700000000,13,267,"Tattnall County, GA",Oct-19,9578,9260,318,3.3
23052,CN1326900000000,13,269,"Taylor County, GA",Oct-19,3189,3057,132,4.1
23053,CN1327100000000,13,271,"Telfair County, GA",Oct-19,3851,3489,362,9.4
23054,CN1327300000000,13,273,"Terrell County, GA",Oct-19,3498,3358,140,4.0
23055,CN1327500000000,13,275,"Thomas County, GA",Oct-19,16431,15808,623,3.8
23056,CN1327700000000,13,277,"Tift County, GA",Oct-19,19923,19311,612,3.1
23057,CN1327900000000,13,279,"Toombs County, GA",Oct-19,11652,11113,539,4.6
23058,CN1328100000000,13,281,"Towns County, GA",Oct-19,3957,3783,174,4.4
23059,CN1328300000000,13,283,"Treutlen County, GA",Oct-19,2590,2455,135,5.2
23060,CN1328500000000,13,285,"Troup County, GA",Oct-19,37393,36313,1080,2.9
23061,CN1328700000000,13,287,"Turner County, GA",Oct-19,3147,3036,111,3.5
23062,CN1328900000000,13,289,"Twiggs County, GA",Oct-19,2860,2721,139,4.9
23063,CN1329100000000,13,291,"Union County, GA",Oct-19,10287,10004,283,2.8
23064,CN1329300000000,13,293,"Upson County, GA",Oct-19,11391,11003,388,3.4
23065,CN1329500000000,13,295,"Walker County, GA",Oct-19,31475,30545,930,3.0
23066,CN1329700000000,13,297,"Walton County, GA",Oct-19,46419,45140,1279,2.8
23067,CN1329900000000,13,299,"Ware County, GA",Oct-19,15529,14999,530,3.4
23068,CN1330100000000,13,301,"Warren County, GA",Oct-19,2854,2733,121,4.2
23069,CN1330300000000,13,303,"Washington County, GA",Oct-19,7031,6774,257,3.7
23070,CN1330500000000,13,305,"Wayne County, GA",Oct-19,11267,10860,407,3.6
23071,CN1330700000000,13,307,"Webster County, GA",Oct-19,1031,986,45,4.4
23072,CN1330900000000,13,309,"Wheeler County, GA",Oct-19,1598,1480,118,7.4
23073,CN1331100000000,13,311,"White County, GA",Oct-19,16618,16226,392,2.4
23074,CN1331300000000,13,313,"Whitfield County, GA",Oct-19,43567,41612,1955,4.5
23075,CN1331500000000,13,315,"Wilcox County, GA",Oct-19,2708,2603,105,3.9
23076,CN1331700000000,13,317,"Wilkes County, GA",Oct-19,3810,3634,176,4.6
23077,CN1331900000000,13,319,"Wilkinson County, GA",Oct-19,3971,3839,132,3.3
23078,CN1332100000000,13,321,"Worth County, GA",Oct-19,8934,8616,318,3.6
23079,CN1500100000000,15,1,"Hawaii County, HI",Oct-19,90994,87808,3186,3.5
23080,CN1500300000000,15,3,"Honolulu County/city, HI",Oct-19,450270,439160,11110,2.5
23081,CN1500700000000,15,7,"Kauai County, HI",Oct-19,36359,35403,956,2.6
23082,CN1500900000000,15,9,"Maui County, HI",Oct-19,86124,83836,2288,2.7
23083,CN1600100000000,16,1,"Ada County, ID",Oct-19,253818,248233,5585,2.2
23084,CN1600300000000,16,3,"Adams County, ID",Oct-19,1676,1608,68,4.1
23085,CN1600500000000,16,5,"Bannock County, ID",Oct-19,43005,41994,1011,2.4
23086,CN1600700000000,16,7,"Bear Lake County, ID",Oct-19,3026,2962,64,2.1
23087,CN1600900000000,16,9,"Benewah County, ID",Oct-19,4089,3960,129,3.2
23088,CN1601100000000,16,11,"Bingham County, ID",Oct-19,25302,24798,504,2.0
23089,CN1601300000000,16,13,"Blaine County, ID",Oct-19,11873,11627,246,2.1
23090,CN1601500000000,16,15,"Boise County, ID",Oct-19,3477,3369,108,3.1
23091,CN1601700000000,16,17,"Bonner County, ID",Oct-19,19605,18974,631,3.2
23092,CN1601900000000,16,19,"Bonneville County, ID",Oct-19,57346,56206,1140,2.0
23093,CN1602100000000,16,21,"Boundary County, ID",Oct-19,5380,5210,170,3.2
23094,CN1602300000000,16,23,"Butte County, ID",Oct-19,1458,1429,29,2.0
23095,CN1602500000000,16,25,"Camas County, ID",Oct-19,725,706,19,2.6
23096,CN1602700000000,16,27,"Canyon County, ID",Oct-19,104599,101843,2756,2.6
23097,CN1602900000000,16,29,"Caribou County, ID",Oct-19,4382,4295,87,2.0
23098,CN1603100000000,16,31,"Cassia County, ID",Oct-19,13045,12817,228,1.7
23099,CN1603300000000,16,33,"Clark County, ID",Oct-19,418,405,13,3.1
23100,CN1603500000000,16,35,"Clearwater County, ID",Oct-19,2875,2745,130,4.5
23101,CN1603700000000,16,37,"Custer County, ID",Oct-19,2245,2166,79,3.5
23102,CN1603900000000,16,39,"Elmore County, ID",Oct-19,11517,11227,290,2.5
23103,CN1604100000000,16,41,"Franklin County, ID",Oct-19,7358,7232,126,1.7
23104,CN1604300000000,16,43,"Fremont County, ID",Oct-19,8690,8560,130,1.5
23105,CN1604500000000,16,45,"Gem County, ID",Oct-19,8340,8116,224,2.7
23106,CN1604700000000,16,47,"Gooding County, ID",Oct-19,8283,8114,169,2.0
23107,CN1604900000000,16,49,"Idaho County, ID",Oct-19,6504,6299,205,3.2
23108,CN1605100000000,16,51,"Jefferson County, ID",Oct-19,14385,14122,263,1.8
23109,CN1605300000000,16,53,"Jerome County, ID",Oct-19,12340,12099,241,2.0
23110,CN1605500000000,16,55,"Kootenai County, ID",Oct-19,79673,77469,2204,2.8
23111,CN1605700000000,16,57,"Latah County, ID",Oct-19,21113,20674,439,2.1
23112,CN1605900000000,16,59,"Lemhi County, ID",Oct-19,3544,3428,116,3.3
23113,CN1606100000000,16,61,"Lewis County, ID",Oct-19,1651,1584,67,4.1
23114,CN1606300000000,16,63,"Lincoln County, ID",Oct-19,2740,2679,61,2.2
23115,CN1606500000000,16,65,"Madison County, ID",Oct-19,23185,22846,339,1.5
23116,CN1606700000000,16,67,"Minidoka County, ID",Oct-19,12109,11888,221,1.8
23117,CN1606900000000,16,69,"Nez Perce County, ID",Oct-19,21135,20649,486,2.3
23118,CN1607100000000,16,71,"Oneida County, ID",Oct-19,2377,2340,37,1.6
23119,CN1607300000000,16,73,"Owyhee County, ID",Oct-19,5301,5169,132,2.5
23120,CN1607500000000,16,75,"Payette County, ID",Oct-19,11792,11458,334,2.8
23121,CN1607700000000,16,77,"Power County, ID",Oct-19,4802,4719,83,1.7
23122,CN1607900000000,16,79,"Shoshone County, ID",Oct-19,4921,4697,224,4.6
23123,CN1608100000000,16,81,"Teton County, ID",Oct-19,6931,6786,145,2.1
23124,CN1608300000000,16,83,"Twin Falls County, ID",Oct-19,41763,40819,944,2.3
23125,CN1608500000000,16,85,"Valley County, ID",Oct-19,5354,5190,164,3.1
23126,CN1608700000000,16,87,"Washington County, ID",Oct-19,4701,4555,146,3.1
23127,CN1700100000000,17,1,"Adams County, IL",Oct-19,32234,31196,1038,3.2
23128,CN1700300000000,17,3,"Alexander County, IL",Oct-19,2057,1943,114,5.5
23129,CN1700500000000,17,5,"Bond County, IL",Oct-19,7918,7653,265,3.3
23130,CN1700700000000,17,7,"Boone County, IL",Oct-19,26184,25009,1175,4.5
23131,CN1700900000000,17,9,"Brown County, IL",Oct-19,3049,2981,68,2.2
23132,CN1701100000000,17,11,"Bureau County, IL",Oct-19,17436,16760,676,3.9
23133,CN1701300000000,17,13,"Calhoun County, IL",Oct-19,2352,2260,92,3.9
23134,CN1701500000000,17,15,"Carroll County, IL",Oct-19,7469,7212,257,3.4
23135,CN1701700000000,17,17,"Cass County, IL",Oct-19,6144,5935,209,3.4
23136,CN1701900000000,17,19,"Champaign County, IL",Oct-19,112731,108902,3829,3.4
23137,CN1702100000000,17,21,"Christian County, IL",Oct-19,14417,13807,610,4.2
23138,CN1702300000000,17,23,"Clark County, IL",Oct-19,7731,7439,292,3.8
23139,CN1702500000000,17,25,"Clay County, IL",Oct-19,6563,6304,259,3.9
23140,CN1702700000000,17,27,"Clinton County, IL",Oct-19,20797,20173,624,3.0
23141,CN1702900000000,17,29,"Coles County, IL",Oct-19,24353,23480,873,3.6
23142,CN1703100000000,17,31,"Cook County, IL",Oct-19,2584954,2497641,87313,3.4
23143,CN1703300000000,17,33,"Crawford County, IL",Oct-19,8770,8440,330,3.8
23144,CN1703500000000,17,35,"Cumberland County, IL",Oct-19,6203,6029,174,2.8
23145,CN1703700000000,17,37,"DeKalb County, IL",Oct-19,55729,53693,2036,3.7
23146,CN1703900000000,17,39,"De Witt County, IL",Oct-19,7579,7320,259,3.4
23147,CN1704100000000,17,41,"Douglas County, IL",Oct-19,10401,10066,335,3.2
23148,CN1704300000000,17,43,"DuPage County, IL",Oct-19,506480,493220,13260,2.6
23149,CN1704500000000,17,45,"Edgar County, IL",Oct-19,9031,8682,349,3.9
23150,CN1704700000000,17,47,"Edwards County, IL",Oct-19,2695,2598,97,3.6
23151,CN1704900000000,17,49,"Effingham County, IL",Oct-19,19369,18811,558,2.9
23152,CN1705100000000,17,51,"Fayette County, IL",Oct-19,9963,9598,365,3.7
23153,CN1705300000000,17,53,"Ford County, IL",Oct-19,6740,6504,236,3.5
23154,CN1705500000000,17,55,"Franklin County, IL",Oct-19,16487,15689,798,4.8
23155,CN1705700000000,17,57,"Fulton County, IL",Oct-19,15293,14599,694,4.5
23156,CN1705900000000,17,59,"Gallatin County, IL",Oct-19,2349,2252,97,4.1
23157,CN1706100000000,17,61,"Greene County, IL",Oct-19,6112,5886,226,3.7
23158,CN1706300000000,17,63,"Grundy County, IL",Oct-19,25186,24357,829,3.3
23159,CN1706500000000,17,65,"Hamilton County, IL",Oct-19,4511,4357,154,3.4
23160,CN1706700000000,17,67,"Hancock County, IL",Oct-19,8613,8280,333,3.9
23161,CN1706900000000,17,69,"Hardin County, IL",Oct-19,1331,1258,73,5.5
23162,CN1707100000000,17,71,"Henderson County, IL",Oct-19,3628,3503,125,3.4
23163,CN1707300000000,17,73,"Henry County, IL",Oct-19,25391,24329,1062,4.2
23164,CN1707500000000,17,75,"Iroquois County, IL",Oct-19,14694,14172,522,3.6
23165,CN1707700000000,17,77,"Jackson County, IL",Oct-19,28426,27389,1037,3.6
23166,CN1707900000000,17,79,"Jasper County, IL",Oct-19,4704,4540,164,3.5
23167,CN1708100000000,17,81,"Jefferson County, IL",Oct-19,17555,16812,743,4.2
23168,CN1708300000000,17,83,"Jersey County, IL",Oct-19,11081,10670,411,3.7
23169,CN1708500000000,17,85,"Jo Daviess County, IL",Oct-19,10964,10619,345,3.1
23170,CN1708700000000,17,87,"Johnson County, IL",Oct-19,4176,3977,199,4.8
23171,CN1708900000000,17,89,"Kane County, IL",Oct-19,274663,264581,10082,3.7
23172,CN1709100000000,17,91,"Kankakee County, IL",Oct-19,56899,54486,2413,4.2
23173,CN1709300000000,17,93,"Kendall County, IL",Oct-19,68344,66428,1916,2.8
23174,CN1709500000000,17,95,"Knox County, IL",Oct-19,21796,20806,990,4.5
23175,CN1709700000000,17,97,"Lake County, IL",Oct-19,377502,364410,13092,3.5
23176,CN1709900000000,17,99,"LaSalle County, IL",Oct-19,54794,52495,2299,4.2
23177,CN1710100000000,17,101,"Lawrence County, IL",Oct-19,5822,5573,249,4.3
23178,CN1710300000000,17,103,"Lee County, IL",Oct-19,17909,17334,575,3.2
23179,CN1710500000000,17,105,"Livingston County, IL",Oct-19,16923,16346,577,3.4
23180,CN1710700000000,17,107,"Logan County, IL",Oct-19,12724,12232,492,3.9
23181,CN1710900000000,17,109,"McDonough County, IL",Oct-19,13857,13336,521,3.8
23182,CN1711100000000,17,111,"McHenry County, IL",Oct-19,164879,160295,4584,2.8
23183,CN1711300000000,17,113,"McLean County, IL",Oct-19,89514,86494,3020,3.4
23184,CN1711500000000,17,115,"Macon County, IL",Oct-19,48737,46368,2369,4.9
23185,CN1711700000000,17,117,"Macoupin County, IL",Oct-19,23272,22427,845,3.6
23186,CN1711900000000,17,119,"Madison County, IL",Oct-19,135607,130848,4759,3.5
23187,CN1712100000000,17,121,"Marion County, IL",Oct-19,17668,16870,798,4.5
23188,CN1712300000000,17,123,"Marshall County, IL",Oct-19,5392,5170,222,4.1
23189,CN1712500000000,17,125,"Mason County, IL",Oct-19,6423,6140,283,4.4
23190,CN1712700000000,17,127,"Massac County, IL",Oct-19,5638,5361,277,4.9
23191,CN1712900000000,17,129,"Menard County, IL",Oct-19,6545,6336,209,3.2
23192,CN1713100000000,17,131,"Mercer County, IL",Oct-19,8215,7886,329,4.0
23193,CN1713300000000,17,133,"Monroe County, IL",Oct-19,19052,18491,561,2.9
23194,CN1713500000000,17,135,"Montgomery County, IL",Oct-19,11769,11262,507,4.3
23195,CN1713700000000,17,137,"Morgan County, IL",Oct-19,16662,16072,590,3.5
23196,CN1713900000000,17,139,"Moultrie County, IL",Oct-19,7685,7458,227,3.0
23197,CN1714100000000,17,141,"Ogle County, IL",Oct-19,25027,23989,1038,4.1
23198,CN1714300000000,17,143,"Peoria County, IL",Oct-19,85250,81344,3906,4.6
23199,CN1714500000000,17,145,"Perry County, IL",Oct-19,8487,8004,483,5.7
23200,CN1714700000000,17,147,"Piatt County, IL",Oct-19,8941,8669,272,3.0
23201,CN1714900000000,17,149,"Pike County, IL",Oct-19,7076,6833,243,3.4
23202,CN1715100000000,17,151,"Pope County, IL",Oct-19,1697,1619,78,4.6
23203,CN1715300000000,17,153,"Pulaski County, IL",Oct-19,2080,1970,110,5.3
23204,CN1715500000000,17,155,"Putnam County, IL",Oct-19,3061,2953,108,3.5
23205,CN1715700000000,17,157,"Randolph County, IL",Oct-19,14596,13964,632,4.3
23206,CN1715900000000,17,159,"Richland County, IL",Oct-19,7289,7027,262,3.6
23207,CN1716100000000,17,161,"Rock Island County, IL",Oct-19,72288,68927,3361,4.6
23208,CN1716300000000,17,163,"St. Clair County, IL",Oct-19,127893,122710,5183,4.1
23209,CN1716500000000,17,165,"Saline County, IL",Oct-19,9776,9314,462,4.7
23210,CN1716700000000,17,167,"Sangamon County, IL",Oct-19,101397,97798,3599,3.5
23211,CN1716900000000,17,169,"Schuyler County, IL",Oct-19,3313,3190,123,3.7
23212,CN1717100000000,17,171,"Scott County, IL",Oct-19,2549,2455,94,3.7
23213,CN1717300000000,17,173,"Shelby County, IL",Oct-19,10799,10435,364,3.4
23214,CN1717500000000,17,175,"Stark County, IL",Oct-19,2565,2450,115,4.5
23215,CN1717700000000,17,177,"Stephenson County, IL",Oct-19,21906,21069,837,3.8
23216,CN1717900000000,17,179,"Tazewell County, IL",Oct-19,64133,61642,2491,3.9
23217,CN1718100000000,17,181,"Union County, IL",Oct-19,7584,7254,330,4.4
23218,CN1718300000000,17,183,"Vermilion County, IL",Oct-19,33480,31909,1571,4.7
23219,CN1718500000000,17,185,"Wabash County, IL",Oct-19,5966,5772,194,3.3
23220,CN1718700000000,17,187,"Warren County, IL",Oct-19,8575,8272,303,3.5
23221,CN1718900000000,17,189,"Washington County, IL",Oct-19,10280,9936,344,3.3
23222,CN1719100000000,17,191,"Wayne County, IL",Oct-19,7229,6931,298,4.1
23223,CN1719300000000,17,193,"White County, IL",Oct-19,6717,6487,230,3.4
23224,CN1719500000000,17,195,"Whiteside County, IL",Oct-19,28946,27833,1113,3.8
23225,CN1719700000000,17,197,"Will County, IL",Oct-19,355213,343847,11366,3.2
23226,CN1719900000000,17,199,"Williamson County, IL",Oct-19,32384,31160,1224,3.8
23227,CN1720100000000,17,201,"Winnebago County, IL",Oct-19,139810,132695,7115,5.1
23228,CN1720300000000,17,203,"Woodford County, IL",Oct-19,18889,18285,604,3.2
23229,CN1800100000000,18,1,"Adams County, IN",Oct-19,17218,16774,444,2.6
23230,CN1800300000000,18,3,"Allen County, IN",Oct-19,189802,183503,6299,3.3
23231,CN1800500000000,18,5,"Bartholomew County, IN",Oct-19,44861,43862,999,2.2
23232,CN1800700000000,18,7,"Benton County, IN",Oct-19,4656,4532,124,2.7
23233,CN1800900000000,18,9,"Blackford County, IN",Oct-19,4931,4756,175,3.5
23234,CN1801100000000,18,11,"Boone County, IN",Oct-19,36529,35716,813,2.2
23235,CN1801300000000,18,13,"Brown County, IN",Oct-19,7745,7552,193,2.5
23236,CN1801500000000,18,15,"Carroll County, IN",Oct-19,10428,10168,260,2.5
23237,CN1801700000000,18,17,"Cass County, IN",Oct-19,17817,17311,506,2.8
23238,CN1801900000000,18,19,"Clark County, IN",Oct-19,61754,59896,1858,3.0
23239,CN1802100000000,18,21,"Clay County, IN",Oct-19,12100,11729,371,3.1
23240,CN1802300000000,18,23,"Clinton County, IN",Oct-19,17300,16867,433,2.5
23241,CN1802500000000,18,25,"Crawford County, IN",Oct-19,4828,4666,162,3.4
23242,CN1802700000000,18,27,"Daviess County, IN",Oct-19,16769,16387,382,2.3
23243,CN1802900000000,18,29,"Dearborn County, IN",Oct-19,25837,25009,828,3.2
23244,CN1803100000000,18,31,"Decatur County, IN",Oct-19,14627,14267,360,2.5
23245,CN1803300000000,18,33,"DeKalb County, IN",Oct-19,22839,22146,693,3.0
23246,CN1803500000000,18,35,"Delaware County, IN",Oct-19,54541,52581,1960,3.6
23247,CN1803700000000,18,37,"Dubois County, IN",Oct-19,22952,22470,482,2.1
23248,CN1803900000000,18,39,"Elkhart County, IN",Oct-19,111645,108410,3235,2.9
23249,CN1804100000000,18,41,"Fayette County, IN",Oct-19,8637,8242,395,4.6
23250,CN1804300000000,18,43,"Floyd County, IN",Oct-19,41736,40522,1214,2.9
23251,CN1804500000000,18,45,"Fountain County, IN",Oct-19,8074,7819,255,3.2
23252,CN1804700000000,18,47,"Franklin County, IN",Oct-19,11404,11062,342,3.0
23253,CN1804900000000,18,49,"Fulton County, IN",Oct-19,9911,9618,293,3.0
23254,CN1805100000000,18,51,"Gibson County, IN",Oct-19,19544,19100,444,2.3
23255,CN1805300000000,18,53,"Grant County, IN",Oct-19,32215,31080,1135,3.5
23256,CN1805500000000,18,55,"Greene County, IN",Oct-19,13780,13298,482,3.5
23257,CN1805700000000,18,57,"Hamilton County, IN",Oct-19,185018,180702,4316,2.3
23258,CN1805900000000,18,59,"Hancock County, IN",Oct-19,40507,39486,1021,2.5
23259,CN1806100000000,18,61,"Harrison County, IN",Oct-19,20314,19755,559,2.8
23260,CN1806300000000,18,63,"Hendricks County, IN",Oct-19,90555,88297,2258,2.5
23261,CN1806500000000,18,65,"Henry County, IN",Oct-19,22138,21503,635,2.9
23262,CN1806700000000,18,67,"Howard County, IN",Oct-19,37042,35827,1215,3.3
23263,CN1806900000000,18,69,"Huntington County, IN",Oct-19,18511,17892,619,3.3
23264,CN1807100000000,18,71,"Jackson County, IN",Oct-19,22968,22439,529,2.3
23265,CN1807300000000,18,73,"Jasper County, IN",Oct-19,16446,15969,477,2.9
23266,CN1807500000000,18,75,"Jay County, IN",Oct-19,9442,9185,257,2.7
23267,CN1807700000000,18,77,"Jefferson County, IN",Oct-19,15004,14542,462,3.1
23268,CN1807900000000,18,79,"Jennings County, IN",Oct-19,13603,13243,360,2.6
23269,CN1808100000000,18,81,"Johnson County, IN",Oct-19,83529,81466,2063,2.5
23270,CN1808300000000,18,83,"Knox County, IN",Oct-19,18640,18140,500,2.7
23271,CN1808500000000,18,85,"Kosciusko County, IN",Oct-19,42206,41060,1146,2.7
23272,CN1808700000000,18,87,"LaGrange County, IN",Oct-19,20062,19551,511,2.5
23273,CN1808900000000,18,89,"Lake County, IN",Oct-19,232296,222573,9723,4.2
23274,CN1809100000000,18,91,"LaPorte County, IN",Oct-19,47828,46149,1679,3.5
23275,CN1809300000000,18,93,"Lawrence County, IN",Oct-19,21383,20701,682,3.2
23276,CN1809500000000,18,95,"Madison County, IN",Oct-19,59442,57508,1934,3.3
23277,CN1809700000000,18,97,"Marion County, IN",Oct-19,493369,478609,14760,3.0
23278,CN1809900000000,18,99,"Marshall County, IN",Oct-19,23043,22399,644,2.8
23279,CN1810100000000,18,101,"Martin County, IN",Oct-19,5393,5267,126,2.3
23280,CN1810300000000,18,103,"Miami County, IN",Oct-19,15247,14710,537,3.5
23281,CN1810500000000,18,105,"Monroe County, IN",Oct-19,72149,69960,2189,3.0
23282,CN1810700000000,18,107,"Montgomery County, IN",Oct-19,18932,18397,535,2.8
23283,CN1810900000000,18,109,"Morgan County, IN",Oct-19,36524,35556,968,2.7
23284,CN1811100000000,18,111,"Newton County, IN",Oct-19,7040,6809,231,3.3
23285,CN1811300000000,18,113,"Noble County, IN",Oct-19,23681,23001,680,2.9
23286,CN1811500000000,18,115,"Ohio County, IN",Oct-19,3184,3086,98,3.1
23287,CN1811700000000,18,117,"Orange County, IN",Oct-19,8548,8284,264,3.1
23288,CN1811900000000,18,119,"Owen County, IN",Oct-19,9612,9301,311,3.2
23289,CN1812100000000,18,121,"Parke County, IN",Oct-19,7151,6916,235,3.3
23290,CN1812300000000,18,123,"Perry County, IN",Oct-19,9212,8946,266,2.9
23291,CN1812500000000,18,125,"Pike County, IN",Oct-19,6140,5980,160,2.6
23292,CN1812700000000,18,127,"Porter County, IN",Oct-19,87730,84872,2858,3.3
23293,CN1812900000000,18,129,"Posey County, IN",Oct-19,13660,13318,342,2.5
23294,CN1813100000000,18,131,"Pulaski County, IN",Oct-19,6495,6320,175,2.7
23295,CN1813300000000,18,133,"Putnam County, IN",Oct-19,16875,16364,511,3.0
23296,CN1813500000000,18,135,"Randolph County, IN",Oct-19,11500,11132,368,3.2
23297,CN1813700000000,18,137,"Ripley County, IN",Oct-19,14119,13735,384,2.7
23298,CN1813900000000,18,139,"Rush County, IN",Oct-19,8958,8745,213,2.4
23299,CN1814100000000,18,141,"St. Joseph County, IN",Oct-19,136095,131444,4651,3.4
23300,CN1814300000000,18,143,"Scott County, IN",Oct-19,10566,10233,333,3.2
23301,CN1814500000000,18,145,"Shelby County, IN",Oct-19,23300,22701,599,2.6
23302,CN1814700000000,18,147,"Spencer County, IN",Oct-19,10724,10438,286,2.7
23303,CN1814900000000,18,149,"Starke County, IN",Oct-19,9919,9566,353,3.6
23304,CN1815100000000,18,151,"Steuben County, IN",Oct-19,21062,20496,566,2.7
23305,CN1815300000000,18,153,"Sullivan County, IN",Oct-19,8414,8117,297,3.5
23306,CN1815500000000,18,155,"Switzerland County, IN",Oct-19,4997,4842,155,3.1
23307,CN1815700000000,18,157,"Tippecanoe County, IN",Oct-19,100785,98018,2767,2.7
23308,CN1815900000000,18,159,"Tipton County, IN",Oct-19,9280,9087,193,2.1
23309,CN1816100000000,18,161,"Union County, IN",Oct-19,3564,3462,102,2.9
23310,CN1816300000000,18,163,"Vanderburgh County, IN",Oct-19,94682,91955,2727,2.9
23311,CN1816500000000,18,165,"Vermillion County, IN",Oct-19,6990,6701,289,4.1
23312,CN1816700000000,18,167,"Vigo County, IN",Oct-19,48326,46505,1821,3.8
23313,CN1816900000000,18,169,"Wabash County, IN",Oct-19,15292,14857,435,2.8
23314,CN1817100000000,18,171,"Warren County, IN",Oct-19,4242,4127,115,2.7
23315,CN1817300000000,18,173,"Warrick County, IN",Oct-19,33079,32217,862,2.6
23316,CN1817500000000,18,175,"Washington County, IN",Oct-19,13774,13368,406,2.9
23317,CN1817700000000,18,177,"Wayne County, IN",Oct-19,30605,29601,1004,3.3
23318,CN1817900000000,18,179,"Wells County, IN",Oct-19,14722,14342,380,2.6
23319,CN1818100000000,18,181,"White County, IN",Oct-19,13572,13252,320,2.4
23320,CN1818300000000,18,183,"Whitley County, IN",Oct-19,18221,17611,610,3.3
23321,CN1900100000000,19,1,"Adair County, IA",Oct-19,4302,4231,71,1.7
23322,CN1900300000000,19,3,"Adams County, IA",Oct-19,2186,2153,33,1.5
23323,CN1900500000000,19,5,"Allamakee County, IA",Oct-19,7539,7375,164,2.2
23324,CN1900700000000,19,7,"Appanoose County, IA",Oct-19,6078,5872,206,3.4
23325,CN1900900000000,19,9,"Audubon County, IA",Oct-19,3149,3081,68,2.2
23326,CN1901100000000,19,11,"Benton County, IA",Oct-19,13834,13507,327,2.4
23327,CN1901300000000,19,13,"Black Hawk County, IA",Oct-19,71156,69087,2069,2.9
23328,CN1901500000000,19,15,"Boone County, IA",Oct-19,15382,15086,296,1.9
23329,CN1901700000000,19,17,"Bremer County, IA",Oct-19,14252,13983,269,1.9
23330,CN1901900000000,19,19,"Buchanan County, IA",Oct-19,11476,11211,265,2.3
23331,CN1902100000000,19,21,"Buena Vista County, IA",Oct-19,12243,12032,211,1.7
23332,CN1902300000000,19,23,"Butler County, IA",Oct-19,8134,7934,200,2.5
23333,CN1902500000000,19,25,"Calhoun County, IA",Oct-19,4331,4247,84,1.9
23334,CN1902700000000,19,27,"Carroll County, IA",Oct-19,11189,11004,185,1.7
23335,CN1902900000000,19,29,"Cass County, IA",Oct-19,6982,6836,146,2.1
23336,CN1903100000000,19,31,"Cedar County, IA",Oct-19,11094,10883,211,1.9
23337,CN1903300000000,19,33,"Cerro Gordo County, IA",Oct-19,24012,23475,537,2.2
23338,CN1903500000000,19,35,"Cherokee County, IA",Oct-19,6286,6150,136,2.2
23339,CN1903700000000,19,37,"Chickasaw County, IA",Oct-19,6715,6556,159,2.4
23340,CN1903900000000,19,39,"Clarke County, IA",Oct-19,4924,4817,107,2.2
23341,CN1904100000000,19,41,"Clay County, IA",Oct-19,8660,8469,191,2.2
23342,CN1904300000000,19,43,"Clayton County, IA",Oct-19,10284,10039,245,2.4
23343,CN1904500000000,19,45,"Clinton County, IA",Oct-19,23309,22453,856,3.7
23344,CN1904700000000,19,47,"Crawford County, IA",Oct-19,8324,8118,206,2.5
23345,CN1904900000000,19,49,"Dallas County, IA",Oct-19,51124,50285,839,1.6
23346,CN1905100000000,19,51,"Davis County, IA",Oct-19,4326,4177,149,3.4
23347,CN1905300000000,19,53,"Decatur County, IA",Oct-19,4545,4471,74,1.6
23348,CN1905500000000,19,55,"Delaware County, IA",Oct-19,10792,10591,201,1.9
23349,CN1905700000000,19,57,"Des Moines County, IA",Oct-19,19339,18644,695,3.6
23350,CN1905900000000,19,59,"Dickinson County, IA",Oct-19,10160,9949,211,2.1
23351,CN1906100000000,19,61,"Dubuque County, IA",Oct-19,57465,56263,1202,2.1
23352,CN1906300000000,19,63,"Emmet County, IA",Oct-19,5356,5265,91,1.7
23353,CN1906500000000,19,65,"Fayette County, IA",Oct-19,10978,10701,277,2.5
23354,CN1906700000000,19,67,"Floyd County, IA",Oct-19,8772,8421,351,4.0
23355,CN1906900000000,19,69,"Franklin County, IA",Oct-19,5756,5660,96,1.7
23356,CN1907100000000,19,71,"Fremont County, IA",Oct-19,3794,3719,75,2.0
23357,CN1907300000000,19,73,"Greene County, IA",Oct-19,5580,5487,93,1.7
23358,CN1907500000000,19,75,"Grundy County, IA",Oct-19,6688,6532,156,2.3
23359,CN1907700000000,19,77,"Guthrie County, IA",Oct-19,5740,5624,116,2.0
23360,CN1907900000000,19,79,"Hamilton County, IA",Oct-19,7067,6900,167,2.4
23361,CN1908100000000,19,81,"Hancock County, IA",Oct-19,6036,5910,126,2.1
23362,CN1908300000000,19,83,"Hardin County, IA",Oct-19,8178,7981,197,2.4
23363,CN1908500000000,19,85,"Harrison County, IA",Oct-19,7558,7423,135,1.8
23364,CN1908700000000,19,87,"Henry County, IA",Oct-19,10010,9781,229,2.3
23365,CN1908900000000,19,89,"Howard County, IA",Oct-19,5245,5155,90,1.7
23366,CN1909100000000,19,91,"Humboldt County, IA",Oct-19,5227,5108,119,2.3
23367,CN1909300000000,19,93,"Ida County, IA",Oct-19,4226,4170,56,1.3
23368,CN1909500000000,19,95,"Iowa County, IA",Oct-19,10798,10621,177,1.6
23369,CN1909700000000,19,97,"Jackson County, IA",Oct-19,11115,10859,256,2.3
23370,CN1909900000000,19,99,"Jasper County, IA",Oct-19,20383,19866,517,2.5
23371,CN1910100000000,19,101,"Jefferson County, IA",Oct-19,10492,10231,261,2.5
23372,CN1910300000000,19,103,"Johnson County, IA",Oct-19,89012,87511,1501,1.7
23373,CN1910500000000,19,105,"Jones County, IA",Oct-19,10905,10662,243,2.2
23374,CN1910700000000,19,107,"Keokuk County, IA",Oct-19,5331,5175,156,2.9
23375,CN1910900000000,19,109,"Kossuth County, IA",Oct-19,8509,8354,155,1.8
23376,CN1911100000000,19,111,"Lee County, IA",Oct-19,16625,16050,575,3.5
23377,CN1911300000000,19,113,"Linn County, IA",Oct-19,125550,122263,3287,2.6
23378,CN1911500000000,19,115,"Louisa County, IA",Oct-19,6187,6033,154,2.5
23379,CN1911700000000,19,117,"Lucas County, IA",Oct-19,4673,4588,85,1.8
23380,CN1911900000000,19,119,"Lyon County, IA",Oct-19,7178,7094,84,1.2
23381,CN1912100000000,19,121,"Madison County, IA",Oct-19,8793,8554,239,2.7
23382,CN1912300000000,19,123,"Mahaska County, IA",Oct-19,12194,11898,296,2.4
23383,CN1912500000000,19,125,"Marion County, IA",Oct-19,18890,18560,330,1.7
23384,CN1912700000000,19,127,"Marshall County, IA",Oct-19,18005,17462,543,3.0
23385,CN1912900000000,19,129,"Mills County, IA",Oct-19,7611,7465,146,1.9
23386,CN1913100000000,19,131,"Mitchell County, IA",Oct-19,7259,7158,101,1.4
23387,CN1913300000000,19,133,"Monona County, IA",Oct-19,4505,4399,106,2.4
23388,CN1913500000000,19,135,"Monroe County, IA",Oct-19,4120,4004,116,2.8
23389,CN1913700000000,19,137,"Montgomery County, IA",Oct-19,5048,4936,112,2.2
23390,CN1913900000000,19,139,"Muscatine County, IA",Oct-19,22266,21721,545,2.4
23391,CN1914100000000,19,141,"O'Brien County, IA",Oct-19,8428,8290,138,1.6
23392,CN1914300000000,19,143,"Osceola County, IA",Oct-19,3572,3513,59,1.7
23393,CN1914500000000,19,145,"Page County, IA",Oct-19,6453,6288,165,2.6
23394,CN1914700000000,19,147,"Palo Alto County, IA",Oct-19,4896,4811,85,1.7
23395,CN1914900000000,19,149,"Plymouth County, IA",Oct-19,15245,14881,364,2.4
23396,CN1915100000000,19,151,"Pocahontas County, IA",Oct-19,4981,4903,78,1.6
23397,CN1915300000000,19,153,"Polk County, IA",Oct-19,277597,270860,6737,2.4
23398,CN1915500000000,19,155,"Pottawattamie County, IA",Oct-19,49973,48998,975,2.0
23399,CN1915700000000,19,157,"Poweshiek County, IA",Oct-19,10968,10690,278,2.5
23400,CN1915900000000,19,159,"Ringgold County, IA",Oct-19,2520,2462,58,2.3
23401,CN1916100000000,19,161,"Sac County, IA",Oct-19,5366,5278,88,1.6
23402,CN1916300000000,19,163,"Scott County, IA",Oct-19,91839,88981,2858,3.1
23403,CN1916500000000,19,165,"Shelby County, IA",Oct-19,6790,6686,104,1.5
23404,CN1916700000000,19,167,"Sioux County, IA",Oct-19,21711,21449,262,1.2
23405,CN1916900000000,19,169,"Story County, IA",Oct-19,61675,60761,914,1.5
23406,CN1917100000000,19,171,"Tama County, IA",Oct-19,9576,9379,197,2.1
23407,CN1917300000000,19,173,"Taylor County, IA",Oct-19,3242,3190,52,1.6
23408,CN1917500000000,19,175,"Union County, IA",Oct-19,6414,6259,155,2.4
23409,CN1917700000000,19,177,"Van Buren County, IA",Oct-19,3760,3667,93,2.5
23410,CN1917900000000,19,179,"Wapello County, IA",Oct-19,18243,17419,824,4.5
23411,CN1918100000000,19,181,"Warren County, IA",Oct-19,29153,28574,579,2.0
23412,CN1918300000000,19,183,"Washington County, IA",Oct-19,12342,12112,230,1.9
23413,CN1918500000000,19,185,"Wayne County, IA",Oct-19,2862,2803,59,2.1
23414,CN1918700000000,19,187,"Webster County, IA",Oct-19,20014,19545,469,2.3
23415,CN1918900000000,19,189,"Winnebago County, IA",Oct-19,5252,5138,114,2.2
23416,CN1919100000000,19,191,"Winneshiek County, IA",Oct-19,12643,12420,223,1.8
23417,CN1919300000000,19,193,"Woodbury County, IA",Oct-19,57050,55710,1340,2.3
23418,CN1919500000000,19,195,"Worth County, IA",Oct-19,4324,4215,109,2.5
23419,CN1919700000000,19,197,"Wright County, IA",Oct-19,7145,6984,161,2.3
23420,CN2000100000000,20,1,"Allen County, KS",Oct-19,6416,6222,194,3.0
23421,CN2000300000000,20,3,"Anderson County, KS",Oct-19,4245,4131,114,2.7
23422,CN2000500000000,20,5,"Atchison County, KS",Oct-19,7049,6678,371,5.3
23423,CN2000700000000,20,7,"Barber County, KS",Oct-19,2388,2326,62,2.6
23424,CN2000900000000,20,9,"Barton County, KS",Oct-19,13400,13043,357,2.7
23425,CN2001100000000,20,11,"Bourbon County, KS",Oct-19,6638,6399,239,3.6
23426,CN2001300000000,20,13,"Brown County, KS",Oct-19,5381,5242,139,2.6
23427,CN2001500000000,20,15,"Butler County, KS",Oct-19,32503,31553,950,2.9
23428,CN2001700000000,20,17,"Chase County, KS",Oct-19,1532,1501,31,2.0
23429,CN2001900000000,20,19,"Chautauqua County, KS",Oct-19,1466,1416,50,3.4
23430,CN2002100000000,20,21,"Cherokee County, KS",Oct-19,10171,9859,312,3.1
23431,CN2002300000000,20,23,"Cheyenne County, KS",Oct-19,1376,1345,31,2.3
23432,CN2002500000000,20,25,"Clark County, KS",Oct-19,1120,1097,23,2.1
23433,CN2002700000000,20,27,"Clay County, KS",Oct-19,3875,3774,101,2.6
23434,CN2002900000000,20,29,"Cloud County, KS",Oct-19,3842,3728,114,3.0
23435,CN2003100000000,20,31,"Coffey County, KS",Oct-19,4260,4120,140,3.3
23436,CN2003300000000,20,33,"Comanche County, KS",Oct-19,885,861,24,2.7
23437,CN2003500000000,20,35,"Cowley County, KS",Oct-19,16518,16021,497,3.0
23438,CN2003700000000,20,37,"Crawford County, KS",Oct-19,18663,17996,667,3.6
23439,CN2003900000000,20,39,"Decatur County, KS",Oct-19,1247,1214,33,2.6
23440,CN2004100000000,20,41,"Dickinson County, KS",Oct-19,8936,8679,257,2.9
23441,CN2004300000000,20,43,"Doniphan County, KS",Oct-19,4173,4055,118,2.8
23442,CN2004500000000,20,45,"Douglas County, KS",Oct-19,66705,64958,1747,2.6
23443,CN2004700000000,20,47,"Edwards County, KS",Oct-19,1544,1504,40,2.6
23444,CN2004900000000,20,49,"Elk County, KS",Oct-19,1208,1166,42,3.5
23445,CN2005100000000,20,51,"Ellis County, KS",Oct-19,17304,16966,338,2.0
23446,CN2005300000000,20,53,"Ellsworth County, KS",Oct-19,2774,2705,69,2.5
23447,CN2005500000000,20,55,"Finney County, KS",Oct-19,20744,20318,426,2.1
23448,CN2005700000000,20,57,"Ford County, KS",Oct-19,17221,16817,404,2.3
23449,CN2005900000000,20,59,"Franklin County, KS",Oct-19,14079,13691,388,2.8
23450,CN2006100000000,20,61,"Geary County, KS",Oct-19,11436,10975,461,4.0
23451,CN2006300000000,20,63,"Gove County, KS",Oct-19,1533,1505,28,1.8
23452,CN2006500000000,20,65,"Graham County, KS",Oct-19,1152,1119,33,2.9
23453,CN2006700000000,20,67,"Grant County, KS",Oct-19,3328,3250,78,2.3
23454,CN2006900000000,20,69,"Gray County, KS",Oct-19,3438,3377,61,1.8
23455,CN2007100000000,20,71,"Greeley County, KS",Oct-19,831,814,17,2.0
23456,CN2007300000000,20,73,"Greenwood County, KS",Oct-19,3376,3291,85,2.5
23457,CN2007500000000,20,75,"Hamilton County, KS",Oct-19,1733,1705,28,1.6
23458,CN2007700000000,20,77,"Harper County, KS",Oct-19,2866,2800,66,2.3
23459,CN2007900000000,20,79,"Harvey County, KS",Oct-19,17046,16583,463,2.7
23460,CN2008100000000,20,81,"Haskell County, KS",Oct-19,2262,2222,40,1.8
23461,CN2008300000000,20,83,"Hodgeman County, KS",Oct-19,1036,1010,26,2.5
23462,CN2008500000000,20,85,"Jackson County, KS",Oct-19,7143,6973,170,2.4
23463,CN2008700000000,20,87,"Jefferson County, KS",Oct-19,10096,9826,270,2.7
23464,CN2008900000000,20,89,"Jewell County, KS",Oct-19,1317,1282,35,2.7
23465,CN2009100000000,20,91,"Johnson County, KS",Oct-19,339163,330734,8429,2.5
23466,CN2009300000000,20,93,"Kearny County, KS",Oct-19,2126,2077,49,2.3
23467,CN2009500000000,20,95,"Kingman County, KS",Oct-19,3506,3405,101,2.9
23468,CN2009700000000,20,97,"Kiowa County, KS",Oct-19,1347,1319,28,2.1
23469,CN2009900000000,20,99,"Labette County, KS",Oct-19,9924,9596,328,3.3
23470,CN2010100000000,20,101,"Lane County, KS",Oct-19,827,808,19,2.3
23471,CN2010300000000,20,103,"Leavenworth County, KS",Oct-19,36495,35380,1115,3.1
23472,CN2010500000000,20,105,"Lincoln County, KS",Oct-19,1791,1760,31,1.7
23473,CN2010700000000,20,107,"Linn County, KS",Oct-19,4451,4231,220,4.9
23474,CN2010900000000,20,109,"Logan County, KS",Oct-19,1698,1669,29,1.7
23475,CN2011100000000,20,111,"Lyon County, KS",Oct-19,16704,16227,477,2.9
23476,CN2011300000000,20,113,"McPherson County, KS",Oct-19,17218,16873,345,2.0
23477,CN2011500000000,20,115,"Marion County, KS",Oct-19,6099,5940,159,2.6
23478,CN2011700000000,20,117,"Marshall County, KS",Oct-19,5563,5436,127,2.3
23479,CN2011900000000,20,119,"Meade County, KS",Oct-19,2189,2147,42,1.9
23480,CN2012100000000,20,121,"Miami County, KS",Oct-19,17481,16980,501,2.9
23481,CN2012300000000,20,123,"Mitchell County, KS",Oct-19,3327,3259,68,2.0
23482,CN2012500000000,20,125,"Montgomery County, KS",Oct-19,14846,14243,603,4.1
23483,CN2012700000000,20,127,"Morris County, KS",Oct-19,3093,3018,75,2.4
23484,CN2012900000000,20,129,"Morton County, KS",Oct-19,1196,1167,29,2.4
23485,CN2013100000000,20,131,"Nemaha County, KS",Oct-19,5451,5305,146,2.7
23486,CN2013300000000,20,133,"Neosho County, KS",Oct-19,6239,5976,263,4.2
23487,CN2013500000000,20,135,"Ness County, KS",Oct-19,1386,1353,33,2.4
23488,CN2013700000000,20,137,"Norton County, KS",Oct-19,2749,2697,52,1.9
23489,CN2013900000000,20,139,"Osage County, KS",Oct-19,7974,7731,243,3.0
23490,CN2014100000000,20,141,"Osborne County, KS",Oct-19,2124,2088,36,1.7
23491,CN2014300000000,20,143,"Ottawa County, KS",Oct-19,3053,2980,73,2.4
23492,CN2014500000000,20,145,"Pawnee County, KS",Oct-19,2979,2908,71,2.4
23493,CN2014700000000,20,147,"Phillips County, KS",Oct-19,2701,2639,62,2.3
23494,CN2014900000000,20,149,"Pottawatomie County, KS",Oct-19,12821,12525,296,2.3
23495,CN2015100000000,20,151,"Pratt County, KS",Oct-19,4986,4879,107,2.1
23496,CN2015300000000,20,153,"Rawlins County, KS",Oct-19,1541,1512,29,1.9
23497,CN2015500000000,20,155,"Reno County, KS",Oct-19,29640,28791,849,2.9
23498,CN2015700000000,20,157,"Republic County, KS",Oct-19,2332,2283,49,2.1
23499,CN2015900000000,20,159,"Rice County, KS",Oct-19,5220,5100,120,2.3
23500,CN2016100000000,20,161,"Riley County, KS",Oct-19,36144,35248,896,2.5
23501,CN2016300000000,20,163,"Rooks County, KS",Oct-19,2577,2504,73,2.8
23502,CN2016500000000,20,165,"Rush County, KS",Oct-19,1669,1634,35,2.1
23503,CN2016700000000,20,167,"Russell County, KS",Oct-19,3325,3244,81,2.4
23504,CN2016900000000,20,169,"Saline County, KS",Oct-19,29983,29203,780,2.6
23505,CN2017100000000,20,171,"Scott County, KS",Oct-19,2965,2918,47,1.6
23506,CN2017300000000,20,173,"Sedgwick County, KS",Oct-19,250607,242724,7883,3.1
23507,CN2017500000000,20,175,"Seward County, KS",Oct-19,9468,9189,279,2.9
23508,CN2017700000000,20,177,"Shawnee County, KS",Oct-19,89847,87148,2699,3.0
23509,CN2017900000000,20,179,"Sheridan County, KS",Oct-19,1471,1442,29,2.0
23510,CN2018100000000,20,181,"Sherman County, KS",Oct-19,2880,2800,80,2.8
23511,CN2018300000000,20,183,"Smith County, KS",Oct-19,2046,2004,42,2.1
23512,CN2018500000000,20,185,"Stafford County, KS",Oct-19,2127,2080,47,2.2
23513,CN2018700000000,20,187,"Stanton County, KS",Oct-19,1041,1015,26,2.5
23514,CN2018900000000,20,189,"Stevens County, KS",Oct-19,2646,2582,64,2.4
23515,CN2019100000000,20,191,"Sumner County, KS",Oct-19,10950,10635,315,2.9
23516,CN2019300000000,20,193,"Thomas County, KS",Oct-19,4412,4325,87,2.0
23517,CN2019500000000,20,195,"Trego County, KS",Oct-19,1447,1418,29,2.0
23518,CN2019700000000,20,197,"Wabaunsee County, KS",Oct-19,3692,3583,109,3.0
23519,CN2019900000000,20,199,"Wallace County, KS",Oct-19,846,829,17,2.0
23520,CN2020100000000,20,201,"Washington County, KS",Oct-19,3033,2974,59,1.9
23521,CN2020300000000,20,203,"Wichita County, KS",Oct-19,1308,1284,24,1.8
23522,CN2020500000000,20,205,"Wilson County, KS",Oct-19,4014,3868,146,3.6
23523,CN2020700000000,20,207,"Woodson County, KS",Oct-19,1583,1528,55,3.5
23524,CN2020900000000,20,209,"Wyandotte County, KS",Oct-19,77341,74192,3149,4.1
23525,CN2100100000000,21,1,"Adair County, KY",Oct-19,7101,6774,327,4.6
23526,CN2100300000000,21,3,"Allen County, KY",Oct-19,9125,8781,344,3.8
23527,CN2100500000000,21,5,"Anderson County, KY",Oct-19,12276,11825,451,3.7
23528,CN2100700000000,21,7,"Ballard County, KY",Oct-19,3503,3347,156,4.5
23529,CN2100900000000,21,9,"Barren County, KY",Oct-19,18710,17957,753,4.0
23530,CN2101100000000,21,11,"Bath County, KY",Oct-19,4615,4382,233,5.0
23531,CN2101300000000,21,13,"Bell County, KY",Oct-19,8446,7897,549,6.5
23532,CN2101500000000,21,15,"Boone County, KY",Oct-19,71415,69222,2193,3.1
23533,CN2101700000000,21,17,"Bourbon County, KY",Oct-19,9860,9524,336,3.4
23534,CN2101900000000,21,19,"Boyd County, KY",Oct-19,17850,16968,882,4.9
23535,CN2102100000000,21,21,"Boyle County, KY",Oct-19,12469,11909,560,4.5
23536,CN2102300000000,21,23,"Bracken County, KY",Oct-19,3811,3663,148,3.9
23537,CN2102500000000,21,25,"Breathitt County, KY",Oct-19,3399,3153,246,7.2
23538,CN2102700000000,21,27,"Breckinridge County, KY",Oct-19,7862,7505,357,4.5
23539,CN2102900000000,21,29,"Bullitt County, KY",Oct-19,43085,41526,1559,3.6
23540,CN2103100000000,21,31,"Butler County, KY",Oct-19,5150,4934,216,4.2
23541,CN2103300000000,21,33,"Caldwell County, KY",Oct-19,5476,5221,255,4.7
23542,CN2103500000000,21,35,"Calloway County, KY",Oct-19,18707,18027,680,3.6
23543,CN2103700000000,21,37,"Campbell County, KY",Oct-19,51068,49479,1589,3.1
23544,CN2103900000000,21,39,"Carlisle County, KY",Oct-19,2272,2191,81,3.6
23545,CN2104100000000,21,41,"Carroll County, KY",Oct-19,5319,5139,180,3.4
23546,CN2104300000000,21,43,"Carter County, KY",Oct-19,9679,9072,607,6.3
23547,CN2104500000000,21,45,"Casey County, KY",Oct-19,6656,6401,255,3.8
23548,CN2104700000000,21,47,"Christian County, KY",Oct-19,25524,23912,1612,6.3
23549,CN2104900000000,21,49,"Clark County, KY",Oct-19,17362,16761,601,3.5
23550,CN2105100000000,21,51,"Clay County, KY",Oct-19,5184,4843,341,6.6
23551,CN2105300000000,21,53,"Clinton County, KY",Oct-19,3972,3780,192,4.8
23552,CN2105500000000,21,55,"Crittenden County, KY",Oct-19,3786,3635,151,4.0
23553,CN2105700000000,21,57,"Cumberland County, KY",Oct-19,3168,3061,107,3.4
23554,CN2105900000000,21,59,"Daviess County, KY",Oct-19,47650,46034,1616,3.4
23555,CN2106100000000,21,61,"Edmonson County, KY",Oct-19,4866,4663,203,4.2
23556,CN2106300000000,21,63,"Elliott County, KY",Oct-19,2045,1894,151,7.4
23557,CN2106500000000,21,65,"Estill County, KY",Oct-19,5447,5199,248,4.6
23558,CN2106700000000,21,67,"Fayette County, KY",Oct-19,177244,172072,5172,2.9
23559,CN2106900000000,21,69,"Fleming County, KY",Oct-19,6080,5796,284,4.7
23560,CN2107100000000,21,71,"Floyd County, KY",Oct-19,10972,10325,647,5.9
23561,CN2107300000000,21,73,"Franklin County, KY",Oct-19,25657,24767,890,3.5
23562,CN2107500000000,21,75,"Fulton County, KY",Oct-19,2047,1952,95,4.6
23563,CN2107700000000,21,77,"Gallatin County, KY",Oct-19,4100,3957,143,3.5
23564,CN2107900000000,21,79,"Garrard County, KY",Oct-19,7716,7385,331,4.3
23565,CN2108100000000,21,81,"Grant County, KY",Oct-19,11752,11343,409,3.5
23566,CN2108300000000,21,83,"Graves County, KY",Oct-19,15940,15296,644,4.0
23567,CN2108500000000,21,85,"Grayson County, KY",Oct-19,11026,10545,481,4.4
23568,CN2108700000000,21,87,"Green County, KY",Oct-19,5145,4940,205,4.0
23569,CN2108900000000,21,89,"Greenup County, KY",Oct-19,13362,12633,729,5.5
23570,CN2109100000000,21,91,"Hancock County, KY",Oct-19,4002,3868,134,3.3
23571,CN2109300000000,21,93,"Hardin County, KY",Oct-19,48881,47084,1797,3.7
23572,CN2109500000000,21,95,"Harlan County, KY",Oct-19,6634,5922,712,10.7
23573,CN2109700000000,21,97,"Harrison County, KY",Oct-19,8901,8567,334,3.8
23574,CN2109900000000,21,99,"Hart County, KY",Oct-19,7810,7484,326,4.2
23575,CN2110100000000,21,101,"Henderson County, KY",Oct-19,22096,21332,764,3.5
23576,CN2110300000000,21,103,"Henry County, KY",Oct-19,8260,8002,258,3.1
23577,CN2110500000000,21,105,"Hickman County, KY",Oct-19,1739,1667,72,4.1
23578,CN2110700000000,21,107,"Hopkins County, KY",Oct-19,18504,17732,772,4.2
23579,CN2110900000000,21,109,"Jackson County, KY",Oct-19,4149,3913,236,5.7
23580,CN2111100000000,21,111,"Jefferson County, KY",Oct-19,402532,388402,14130,3.5
23581,CN2111300000000,21,113,"Jessamine County, KY",Oct-19,26857,25982,875,3.3
23582,CN2111500000000,21,115,"Johnson County, KY",Oct-19,6737,6349,388,5.8
23583,CN2111700000000,21,117,"Kenton County, KY",Oct-19,88394,85527,2867,3.2
23584,CN2111900000000,21,119,"Knott County, KY",Oct-19,4481,4197,284,6.3
23585,CN2112100000000,21,121,"Knox County, KY",Oct-19,9890,9345,545,5.5
23586,CN2112300000000,21,123,"Larue County, KY",Oct-19,5935,5699,236,4.0
23587,CN2112500000000,21,125,"Laurel County, KY",Oct-19,24591,23467,1124,4.6
23588,CN2112700000000,21,127,"Lawrence County, KY",Oct-19,5249,4938,311,5.9
23589,CN2112900000000,21,129,"Lee County, KY",Oct-19,2055,1957,98,4.8
23590,CN2113100000000,21,131,"Leslie County, KY",Oct-19,2728,2483,245,9.0
23591,CN2113300000000,21,133,"Letcher County, KY",Oct-19,6460,5957,503,7.8
23592,CN2113500000000,21,135,"Lewis County, KY",Oct-19,4549,4232,317,7.0
23593,CN2113700000000,21,137,"Lincoln County, KY",Oct-19,9216,8814,402,4.4
23594,CN2113900000000,21,139,"Livingston County, KY",Oct-19,3654,3490,164,4.5
23595,CN2114100000000,21,141,"Logan County, KY",Oct-19,12576,12090,486,3.9
23596,CN2114300000000,21,143,"Lyon County, KY",Oct-19,3033,2903,130,4.3
23597,CN2114500000000,21,145,"McCracken County, KY",Oct-19,29306,28054,1252,4.3
23598,CN2114700000000,21,147,"McCreary County, KY",Oct-19,4677,4428,249,5.3
23599,CN2114900000000,21,149,"McLean County, KY",Oct-19,4232,4069,163,3.9
23600,CN2115100000000,21,151,"Madison County, KY",Oct-19,48013,46417,1596,3.3
23601,CN2115300000000,21,153,"Magoffin County, KY",Oct-19,3184,2877,307,9.6
23602,CN2115500000000,21,155,"Marion County, KY",Oct-19,9691,9360,331,3.4
23603,CN2115700000000,21,157,"Marshall County, KY",Oct-19,15129,14554,575,3.8
23604,CN2115900000000,21,159,"Martin County, KY",Oct-19,2734,2557,177,6.5
23605,CN2116100000000,21,161,"Mason County, KY",Oct-19,7041,6694,347,4.9
23606,CN2116300000000,21,163,"Meade County, KY",Oct-19,12251,11727,524,4.3
23607,CN2116500000000,21,165,"Menifee County, KY",Oct-19,2317,2193,124,5.4
23608,CN2116700000000,21,167,"Mercer County, KY",Oct-19,10120,9614,506,5.0
23609,CN2116900000000,21,169,"Metcalfe County, KY",Oct-19,4086,3893,193,4.7
23610,CN2117100000000,21,171,"Monroe County, KY",Oct-19,4730,4564,166,3.5
23611,CN2117300000000,21,173,"Montgomery County, KY",Oct-19,11739,11215,524,4.5
23612,CN2117500000000,21,175,"Morgan County, KY",Oct-19,4574,4369,205,4.5
23613,CN2117700000000,21,177,"Muhlenberg County, KY",Oct-19,10393,9808,585,5.6
23614,CN2117900000000,21,179,"Nelson County, KY",Oct-19,23216,22329,887,3.8
23615,CN2118100000000,21,181,"Nicholas County, KY",Oct-19,3317,3182,135,4.1
23616,CN2118300000000,21,183,"Ohio County, KY",Oct-19,9778,9359,419,4.3
23617,CN2118500000000,21,185,"Oldham County, KY",Oct-19,33524,32563,961,2.9
23618,CN2118700000000,21,187,"Owen County, KY",Oct-19,5178,4989,189,3.7
23619,CN2118900000000,21,189,"Owsley County, KY",Oct-19,1135,1059,76,6.7
23620,CN2119100000000,21,191,"Pendleton County, KY",Oct-19,6990,6768,222,3.2
23621,CN2119300000000,21,193,"Perry County, KY",Oct-19,8287,7803,484,5.8
23622,CN2119500000000,21,195,"Pike County, KY",Oct-19,20056,18961,1095,5.5
23623,CN2119700000000,21,197,"Powell County, KY",Oct-19,5065,4833,232,4.6
23624,CN2119900000000,21,199,"Pulaski County, KY",Oct-19,26896,25778,1118,4.2
23625,CN2120100000000,21,201,"Robertson County, KY",Oct-19,830,793,37,4.5
23626,CN2120300000000,21,203,"Rockcastle County, KY",Oct-19,6773,6491,282,4.2
23627,CN2120500000000,21,205,"Rowan County, KY",Oct-19,10488,9984,504,4.8
23628,CN2120700000000,21,207,"Russell County, KY",Oct-19,6184,5861,323,5.2
23629,CN2120900000000,21,209,"Scott County, KY",Oct-19,29532,28596,936,3.2
23630,CN2121100000000,21,211,"Shelby County, KY",Oct-19,25690,24895,795,3.1
23631,CN2121300000000,21,213,"Simpson County, KY",Oct-19,8948,8522,426,4.8
23632,CN2121500000000,21,215,"Spencer County, KY",Oct-19,10271,9951,320,3.1
23633,CN2121700000000,21,217,"Taylor County, KY",Oct-19,12939,12461,478,3.7
23634,CN2121900000000,21,219,"Todd County, KY",Oct-19,5511,5273,238,4.3
23635,CN2122100000000,21,221,"Trigg County, KY",Oct-19,6081,5794,287,4.7
23636,CN2122300000000,21,223,"Trimble County, KY",Oct-19,3896,3749,147,3.8
23637,CN2122500000000,21,225,"Union County, KY",Oct-19,6146,5888,258,4.2
23638,CN2122700000000,21,227,"Warren County, KY",Oct-19,66142,63753,2389,3.6
23639,CN2122900000000,21,229,"Washington County, KY",Oct-19,6263,6043,220,3.5
23640,CN2123100000000,21,231,"Wayne County, KY",Oct-19,7380,7007,373,5.1
23641,CN2123300000000,21,233,"Webster County, KY",Oct-19,5732,5517,215,3.8
23642,CN2123500000000,21,235,"Whitley County, KY",Oct-19,13686,13033,653,4.8
23643,CN2123700000000,21,237,"Wolfe County, KY",Oct-19,1994,1872,122,6.1
23644,CN2123900000000,21,239,"Woodford County, KY",Oct-19,15073,14605,468,3.1
23645,CN2200100000000,22,1,"Acadia Parish, LA",Oct-19,24058,22724,1334,5.5
23646,CN2200300000000,22,3,"Allen Parish, LA",Oct-19,8985,8490,495,5.5
23647,CN2200500000000,22,5,"Ascension Parish, LA",Oct-19,64166,61373,2793,4.4
23648,CN2200700000000,22,7,"Assumption Parish, LA",Oct-19,8973,8406,567,6.3
23649,CN2200900000000,22,9,"Avoyelles Parish, LA",Oct-19,15197,14280,917,6.0
23650,CN2201100000000,22,11,"Beauregard Parish, LA",Oct-19,14899,14109,790,5.3
23651,CN2201300000000,22,13,"Bienville Parish, LA",Oct-19,5515,5186,329,6.0
23652,CN2201500000000,22,15,"Bossier Parish, LA",Oct-19,57800,55174,2626,4.5
23653,CN2201700000000,22,17,"Caddo Parish, LA",Oct-19,103777,97922,5855,5.6
23654,CN2201900000000,22,19,"Calcasieu Parish, LA",Oct-19,106004,101501,4503,4.2
23655,CN2202100000000,22,21,"Caldwell Parish, LA",Oct-19,3754,3509,245,6.5
23656,CN2202300000000,22,23,"Cameron Parish, LA",Oct-19,3934,3779,155,3.9
23657,CN2202500000000,22,25,"Catahoula Parish, LA",Oct-19,3445,3231,214,6.2
23658,CN2202700000000,22,27,"Claiborne Parish, LA",Oct-19,5868,5496,372,6.3
23659,CN2202900000000,22,29,"Concordia Parish, LA",Oct-19,7157,6724,433,6.1
23660,CN2203100000000,22,31,"De Soto Parish, LA",Oct-19,10917,10214,703,6.4
23661,CN2203300000000,22,33,"East Baton Rouge Parish, LA",Oct-19,231314,220520,10794,4.7
23662,CN2203500000000,22,35,"East Carroll Parish, LA",Oct-19,1894,1706,188,9.9
23663,CN2203700000000,22,37,"East Feliciana Parish, LA",Oct-19,7994,7611,383,4.8
23664,CN2203900000000,22,39,"Evangeline Parish, LA",Oct-19,11892,11170,722,6.1
23665,CN2204100000000,22,41,"Franklin Parish, LA",Oct-19,7415,6882,533,7.2
23666,CN2204300000000,22,43,"Grant Parish, LA",Oct-19,8184,7729,455,5.6
23667,CN2204500000000,22,45,"Iberia Parish, LA",Oct-19,28316,26723,1593,5.6
23668,CN2204700000000,22,47,"Iberville Parish, LA",Oct-19,14116,13230,886,6.3
23669,CN2204900000000,22,49,"Jackson Parish, LA",Oct-19,6863,6523,340,5.0
23670,CN2205100000000,22,51,"Jefferson Parish, LA",Oct-19,215208,205827,9381,4.4
23671,CN2205300000000,22,53,"Jefferson Davis Parish, LA",Oct-19,13380,12727,653,4.9
23672,CN2205500000000,22,55,"Lafayette Parish, LA",Oct-19,114464,109266,5198,4.5
23673,CN2205700000000,22,57,"Lafourche Parish, LA",Oct-19,42505,40545,1960,4.6
23674,CN2205900000000,22,59,"LaSalle Parish, LA",Oct-19,6773,6478,295,4.4
23675,CN2206100000000,22,61,"Lincoln Parish, LA",Oct-19,22529,21298,1231,5.5
23676,CN2206300000000,22,63,"Livingston Parish, LA",Oct-19,68866,65964,2902,4.2
23677,CN2206500000000,22,65,"Madison Parish, LA",Oct-19,3517,3238,279,7.9
23678,CN2206700000000,22,67,"Morehouse Parish, LA",Oct-19,10036,9207,829,8.3
23679,CN2206900000000,22,69,"Natchitoches Parish, LA",Oct-19,16599,15611,988,6.0
23680,CN2207100000000,22,71,"Orleans Parish, LA",Oct-19,180122,170950,9172,5.1
23681,CN2207300000000,22,73,"Ouachita Parish, LA",Oct-19,70185,66256,3929,5.6
23682,CN2207500000000,22,75,"Plaquemines Parish, LA",Oct-19,10137,9682,455,4.5
23683,CN2207700000000,22,77,"Pointe Coupee Parish, LA",Oct-19,9895,9354,541,5.5
23684,CN2207900000000,22,79,"Rapides Parish, LA",Oct-19,55396,52513,2883,5.2
23685,CN2208100000000,22,81,"Red River Parish, LA",Oct-19,3789,3580,209,5.5
23686,CN2208300000000,22,83,"Richland Parish, LA",Oct-19,8218,7684,534,6.5
23687,CN2208500000000,22,85,"Sabine Parish, LA",Oct-19,9239,8748,491,5.3
23688,CN2208700000000,22,87,"St. Bernard Parish, LA",Oct-19,19997,18975,1022,5.1
23689,CN2208900000000,22,89,"St. Charles Parish, LA",Oct-19,25306,24175,1131,4.5
23690,CN2209100000000,22,91,"St. Helena Parish, LA",Oct-19,4277,4017,260,6.1
23691,CN2209300000000,22,93,"St. James Parish, LA",Oct-19,9311,8728,583,6.3
23692,CN2209500000000,22,95,"St. John the Baptist Parish, LA",Oct-19,19850,18647,1203,6.1
23693,CN2209700000000,22,97,"St. Landry Parish, LA",Oct-19,32088,29993,2095,6.5
23694,CN2209900000000,22,99,"St. Martin Parish, LA",Oct-19,22374,21198,1176,5.3
23695,CN2210100000000,22,101,"St. Mary Parish, LA",Oct-19,20038,18790,1248,6.2
23696,CN2210300000000,22,103,"St. Tammany Parish, LA",Oct-19,120101,114874,5227,4.4
23697,CN2210500000000,22,105,"Tangipahoa Parish, LA",Oct-19,55250,52154,3096,5.6
23698,CN2210700000000,22,107,"Tensas Parish, LA",Oct-19,1420,1306,114,8.0
23699,CN2210900000000,22,109,"Terrebonne Parish, LA",Oct-19,46881,44631,2250,4.8
23700,CN2211100000000,22,111,"Union Parish, LA",Oct-19,9110,8570,540,5.9
23701,CN2211300000000,22,113,"Vermilion Parish, LA",Oct-19,24236,22984,1252,5.2
23702,CN2211500000000,22,115,"Vernon Parish, LA",Oct-19,16010,15005,1005,6.3
23703,CN2211700000000,22,117,"Washington Parish, LA",Oct-19,16760,15751,1009,6.0
23704,CN2211900000000,22,119,"Webster Parish, LA",Oct-19,14557,13621,936,6.4
23705,CN2212100000000,22,121,"West Baton Rouge Parish, LA",Oct-19,13673,13040,633,4.6
23706,CN2212300000000,22,123,"West Carroll Parish, LA",Oct-19,3614,3266,348,9.6
23707,CN2212500000000,22,125,"West Feliciana Parish, LA",Oct-19,5403,5165,238,4.4
23708,CN2212700000000,22,127,"Winn Parish, LA",Oct-19,4895,4574,321,6.6
23709,CN2300100000000,23,1,"Androscoggin County, ME",Oct-19,55932,54545,1387,2.5
23710,CN2300300000000,23,3,"Aroostook County, ME",Oct-19,29811,28759,1052,3.5
23711,CN2300500000000,23,5,"Cumberland County, ME",Oct-19,166694,163228,3466,2.1
23712,CN2300700000000,23,7,"Franklin County, ME",Oct-19,14134,13699,435,3.1
23713,CN2300900000000,23,9,"Hancock County, ME",Oct-19,29484,28856,628,2.1
23714,CN2301100000000,23,11,"Kennebec County, ME",Oct-19,61892,60410,1482,2.4
23715,CN2301300000000,23,13,"Knox County, ME",Oct-19,19831,19401,430,2.2
23716,CN2301500000000,23,15,"Lincoln County, ME",Oct-19,16741,16383,358,2.1
23717,CN2301700000000,23,17,"Oxford County, ME",Oct-19,25958,25221,737,2.8
23718,CN2301900000000,23,19,"Penobscot County, ME",Oct-19,78131,76117,2014,2.6
23719,CN2302100000000,23,21,"Piscataquis County, ME",Oct-19,7237,7028,209,2.9
23720,CN2302300000000,23,23,"Sagadahoc County, ME",Oct-19,19511,19146,365,1.9
23721,CN2302500000000,23,25,"Somerset County, ME",Oct-19,22085,21313,772,3.5
23722,CN2302700000000,23,27,"Waldo County, ME",Oct-19,20532,20033,499,2.4
23723,CN2302900000000,23,29,"Washington County, ME",Oct-19,13346,12904,442,3.3
23724,CN2303100000000,23,31,"York County, ME",Oct-19,114605,112140,2465,2.2
23725,CN2400100000000,24,1,"Allegany County, MD",Oct-19,32660,31089,1571,4.8
23726,CN2400300000000,24,3,"Anne Arundel County, MD",Oct-19,319286,310232,9054,2.8
23727,CN2400500000000,24,5,"Baltimore County, MD",Oct-19,459669,443776,15893,3.5
23728,CN2400900000000,24,9,"Calvert County, MD",Oct-19,50928,49502,1426,2.8
23729,CN2401100000000,24,11,"Caroline County, MD",Oct-19,18094,17533,561,3.1
23730,CN2401300000000,24,13,"Carroll County, MD",Oct-19,96598,94075,2523,2.6
23731,CN2401500000000,24,15,"Cecil County, MD",Oct-19,53501,51608,1893,3.5
23732,CN2401700000000,24,17,"Charles County, MD",Oct-19,88877,85912,2965,3.3
23733,CN2401900000000,24,19,"Dorchester County, MD",Oct-19,15539,14871,668,4.3
23734,CN2402100000000,24,21,"Frederick County, MD",Oct-19,136390,132377,4013,2.9
23735,CN2402300000000,24,23,"Garrett County, MD",Oct-19,15410,14821,589,3.8
23736,CN2402500000000,24,25,"Harford County, MD",Oct-19,142566,138143,4423,3.1
23737,CN2402700000000,24,27,"Howard County, MD",Oct-19,190141,185307,4834,2.5
23738,CN2402900000000,24,29,"Kent County, MD",Oct-19,9892,9558,334,3.4
23739,CN2403100000000,24,31,"Montgomery County, MD",Oct-19,570834,555249,15585,2.7
23740,CN2403300000000,24,33,"Prince George's County, MD",Oct-19,519108,500742,18366,3.5
23741,CN2403500000000,24,35,"Queen Anne's County, MD",Oct-19,28018,27250,768,2.7
23742,CN2403700000000,24,37,"St. Mary's County, MD",Oct-19,57687,55991,1696,2.9
23743,CN2403900000000,24,39,"Somerset County, MD",Oct-19,9029,8541,488,5.4
23744,CN2404100000000,24,41,"Talbot County, MD",Oct-19,19568,19021,547,2.8
23745,CN2404300000000,24,43,"Washington County, MD",Oct-19,76008,73374,2634,3.5
23746,CN2404500000000,24,45,"Wicomico County, MD",Oct-19,51174,49089,2085,4.1
23747,CN2404700000000,24,47,"Worcester County, MD",Oct-19,25140,23783,1357,5.4
23748,CN2451000000000,24,510,"Baltimore city, MD",Oct-19,291957,277812,14145,4.8
23749,CN2500100000000,25,1,"Barnstable County, MA",Oct-19,113834,110928,2906,2.6
23750,CN2500300000000,25,3,"Berkshire County, MA",Oct-19,64223,62524,1699,2.6
23751,CN2500500000000,25,5,"Bristol County, MA",Oct-19,303400,294432,8968,3.0
23752,CN2500700000000,25,7,"Dukes County, MA",Oct-19,9258,9036,222,2.4
23753,CN2500900000000,25,9,"Essex County, MA",Oct-19,430349,419800,10549,2.5
23754,CN2501100000000,25,11,"Franklin County, MA",Oct-19,41324,40457,867,2.1
23755,CN2501300000000,25,13,"Hampden County, MA",Oct-19,230695,223118,7577,3.3
23756,CN2501500000000,25,15,"Hampshire County, MA",Oct-19,91401,89422,1979,2.2
23757,CN2501700000000,25,17,"Middlesex County, MA",Oct-19,931248,913350,17898,1.9
23758,CN2501900000000,25,19,"Nantucket County/town, MA",Oct-19,7566,7426,140,1.9
23759,CN2502100000000,25,21,"Norfolk County, MA",Oct-19,396947,388473,8474,2.1
23760,CN2502300000000,25,23,"Plymouth County, MA",Oct-19,286911,279862,7049,2.5
23761,CN2502500000000,25,25,"Suffolk County, MA",Oct-19,462896,452607,10289,2.2
23762,CN2502700000000,25,27,"Worcester County, MA",Oct-19,449916,438492,11424,2.5
23763,CN2600100000000,26,1,"Alcona County, MI",Oct-19,3820,3652,168,4.4
23764,CN2600300000000,26,3,"Alger County, MI",Oct-19,3179,3030,149,4.7
23765,CN2600500000000,26,5,"Allegan County, MI",Oct-19,61913,60502,1411,2.3
23766,CN2600700000000,26,7,"Alpena County, MI",Oct-19,13236,12826,410,3.1
23767,CN2600900000000,26,9,"Antrim County, MI",Oct-19,10110,9768,342,3.4
23768,CN2601100000000,26,11,"Arenac County, MI",Oct-19,5970,5679,291,4.9
23769,CN2601300000000,26,13,"Baraga County, MI",Oct-19,3176,3044,132,4.2
23770,CN2601500000000,26,15,"Barry County, MI",Oct-19,31347,30590,757,2.4
23771,CN2601700000000,26,17,"Bay County, MI",Oct-19,49540,47645,1895,3.8
23772,CN2601900000000,26,19,"Benzie County, MI",Oct-19,8763,8482,281,3.2
23773,CN2602100000000,26,21,"Berrien County, MI",Oct-19,72591,70460,2131,2.9
23774,CN2602300000000,26,23,"Branch County, MI",Oct-19,19233,18516,717,3.7
23775,CN2602500000000,26,25,"Calhoun County, MI",Oct-19,61970,59925,2045,3.3
23776,CN2602700000000,26,27,"Cass County, MI",Oct-19,24232,23399,833,3.4
23777,CN2602900000000,26,29,"Charlevoix County, MI",Oct-19,12576,12183,393,3.1
23778,CN2603100000000,26,31,"Cheboygan County, MI",Oct-19,10370,10041,329,3.2
23779,CN2603300000000,26,33,"Chippewa County, MI",Oct-19,15871,15304,567,3.6
23780,CN2603500000000,26,35,"Clare County, MI",Oct-19,11551,11053,498,4.3
23781,CN2603700000000,26,37,"Clinton County, MI",Oct-19,41529,40430,1099,2.6
23782,CN2603900000000,26,39,"Crawford County, MI",Oct-19,5537,5322,215,3.9
23783,CN2604100000000,26,41,"Delta County, MI",Oct-19,17083,16489,594,3.5
23784,CN2604300000000,26,43,"Dickinson County, MI",Oct-19,12167,11794,373,3.1
23785,CN2604500000000,26,45,"Eaton County, MI",Oct-19,58050,55929,2121,3.7
23786,CN2604700000000,26,47,"Emmet County, MI",Oct-19,17384,16847,537,3.1
23787,CN2604900000000,26,49,"Genesee County, MI",Oct-19,183174,174906,8268,4.5
23788,CN2605100000000,26,51,"Gladwin County, MI",Oct-19,9787,9375,412,4.2
23789,CN2605300000000,26,53,"Gogebic County, MI",Oct-19,5913,5692,221,3.7
23790,CN2605500000000,26,55,"Grand Traverse County, MI",Oct-19,49562,48348,1214,2.4
23791,CN2605700000000,26,57,"Gratiot County, MI",Oct-19,18044,17418,626,3.5
23792,CN2605900000000,26,59,"Hillsdale County, MI",Oct-19,20269,19380,889,4.4
23793,CN2606100000000,26,61,"Houghton County, MI",Oct-19,16635,16084,551,3.3
23794,CN2606300000000,26,63,"Huron County, MI",Oct-19,15394,14978,416,2.7
23795,CN2606500000000,26,65,"Ingham County, MI",Oct-19,152921,147622,5299,3.5
23796,CN2606700000000,26,67,"Ionia County, MI",Oct-19,30296,29461,835,2.8
23797,CN2606900000000,26,69,"Iosco County, MI",Oct-19,10173,9745,428,4.2
23798,CN2607100000000,26,71,"Iron County, MI",Oct-19,5092,4887,205,4.0
23799,CN2607300000000,26,73,"Isabella County, MI",Oct-19,34601,33596,1005,2.9
23800,CN2607500000000,26,75,"Jackson County, MI",Oct-19,73197,70947,2250,3.1
23801,CN2607700000000,26,77,"Kalamazoo County, MI",Oct-19,133751,130000,3751,2.8
23802,CN2607900000000,26,79,"Kalkaska County, MI",Oct-19,7821,7528,293,3.7
23803,CN2608100000000,26,81,"Kent County, MI",Oct-19,356789,348499,8290,2.3
23804,CN2608300000000,26,83,"Keweenaw County, MI",Oct-19,894,860,34,3.8
23805,CN2608500000000,26,85,"Lake County, MI",Oct-19,3831,3666,165,4.3
23806,CN2608700000000,26,87,"Lapeer County, MI",Oct-19,41632,39765,1867,4.5
23807,CN2608900000000,26,89,"Leelanau County, MI",Oct-19,10453,10215,238,2.3
23808,CN2609100000000,26,91,"Lenawee County, MI",Oct-19,46371,44388,1983,4.3
23809,CN2609300000000,26,93,"Livingston County, MI",Oct-19,105143,101938,3205,3.0
23810,CN2609500000000,26,95,"Luce County, MI",Oct-19,2259,2171,88,3.9
23811,CN2609700000000,26,97,"Mackinac County, MI",Oct-19,5322,5186,136,2.6
23812,CN2609900000000,26,99,"Macomb County, MI",Oct-19,454616,436744,17872,3.9
23813,CN2610100000000,26,101,"Manistee County, MI",Oct-19,10439,10072,367,3.5
23814,CN2610300000000,26,103,"Marquette County, MI",Oct-19,32757,31738,1019,3.1
23815,CN2610500000000,26,105,"Mason County, MI",Oct-19,13613,13133,480,3.5
23816,CN2610700000000,26,107,"Mecosta County, MI",Oct-19,18496,17865,631,3.4
23817,CN2610900000000,26,109,"Menominee County, MI",Oct-19,10874,10574,300,2.8
23818,CN2611100000000,26,111,"Midland County, MI",Oct-19,39639,38476,1163,2.9
23819,CN2611300000000,26,113,"Missaukee County, MI",Oct-19,6897,6674,223,3.2
23820,CN2611500000000,26,115,"Monroe County, MI",Oct-19,74841,72773,2068,2.8
23821,CN2611700000000,26,117,"Montcalm County, MI",Oct-19,27952,27153,799,2.9
23822,CN2611900000000,26,119,"Montmorency County, MI",Oct-19,2955,2779,176,6.0
23823,CN2612100000000,26,121,"Muskegon County, MI",Oct-19,76240,73628,2612,3.4
23824,CN2612300000000,26,123,"Newaygo County, MI",Oct-19,23210,22494,716,3.1
23825,CN2612500000000,26,125,"Oakland County, MI",Oct-19,686281,664327,21954,3.2
23826,CN2612700000000,26,127,"Oceana County, MI",Oct-19,11995,11545,450,3.8
23827,CN2612900000000,26,129,"Ogemaw County, MI",Oct-19,7977,7624,353,4.4
23828,CN2613100000000,26,131,"Ontonagon County, MI",Oct-19,2080,1995,85,4.1
23829,CN2613300000000,26,133,"Osceola County, MI",Oct-19,11199,10894,305,2.7
23830,CN2613500000000,26,135,"Oscoda County, MI",Oct-19,3090,2904,186,6.0
23831,CN2613700000000,26,137,"Otsego County, MI",Oct-19,11479,11076,403,3.5
23832,CN2613900000000,26,139,"Ottawa County, MI",Oct-19,159874,156372,3502,2.2
23833,CN2614100000000,26,141,"Presque Isle County, MI",Oct-19,4847,4632,215,4.4
23834,CN2614300000000,26,143,"Roscommon County, MI",Oct-19,7637,7267,370,4.8
23835,CN2614500000000,26,145,"Saginaw County, MI",Oct-19,85380,81547,3833,4.5
23836,CN2614700000000,26,147,"St. Clair County, MI",Oct-19,76769,73396,3373,4.4
23837,CN2614900000000,26,149,"St. Joseph County, MI",Oct-19,27451,26251,1200,4.4
23838,CN2615100000000,26,151,"Sanilac County, MI",Oct-19,19265,18614,651,3.4
23839,CN2615300000000,26,153,"Schoolcraft County, MI",Oct-19,3260,3122,138,4.2
23840,CN2615500000000,26,155,"Shiawassee County, MI",Oct-19,33267,32098,1169,3.5
23841,CN2615700000000,26,157,"Tuscola County, MI",Oct-19,23524,22607,917,3.9
23842,CN2615900000000,26,159,"Van Buren County, MI",Oct-19,35001,33880,1121,3.2
23843,CN2616100000000,26,161,"Washtenaw County, MI",Oct-19,199449,194751,4698,2.4
23844,CN2616300000000,26,163,"Wayne County, MI",Oct-19,815755,777018,38737,4.7
23845,CN2616500000000,26,165,"Wexford County, MI",Oct-19,14662,14176,486,3.3
23846,CN2700100000000,27,1,"Aitkin County, MN",Oct-19,7247,6958,289,4.0
23847,CN2700300000000,27,3,"Anoka County, MN",Oct-19,199743,194520,5223,2.6
23848,CN2700500000000,27,5,"Becker County, MN",Oct-19,18840,18375,465,2.5
23849,CN2700700000000,27,7,"Beltrami County, MN",Oct-19,24683,23911,772,3.1
23850,CN2700900000000,27,9,"Benton County, MN",Oct-19,22316,21690,626,2.8
23851,CN2701100000000,27,11,"Big Stone County, MN",Oct-19,2582,2530,52,2.0
23852,CN2701300000000,27,13,"Blue Earth County, MN",Oct-19,42154,41253,901,2.1
23853,CN2701500000000,27,15,"Brown County, MN",Oct-19,14605,14243,362,2.5
23854,CN2701700000000,27,17,"Carlton County, MN",Oct-19,17947,17324,623,3.5
23855,CN2701900000000,27,19,"Carver County, MN",Oct-19,59467,58014,1453,2.4
23856,CN2702100000000,27,21,"Cass County, MN",Oct-19,14375,13856,519,3.6
23857,CN2702300000000,27,23,"Chippewa County, MN",Oct-19,7100,6895,205,2.9
23858,CN2702500000000,27,25,"Chisago County, MN",Oct-19,30173,29360,813,2.7
23859,CN2702700000000,27,27,"Clay County, MN",Oct-19,36710,35956,754,2.1
23860,CN2702900000000,27,29,"Clearwater County, MN",Oct-19,4512,4291,221,4.9
23861,CN2703100000000,27,31,"Cook County, MN",Oct-19,3153,3065,88,2.8
23862,CN2703300000000,27,33,"Cottonwood County, MN",Oct-19,6032,5856,176,2.9
23863,CN2703500000000,27,35,"Crow Wing County, MN",Oct-19,32187,31216,971,3.0
23864,CN2703700000000,27,37,"Dakota County, MN",Oct-19,244419,238243,6176,2.5
23865,CN2703900000000,27,39,"Dodge County, MN",Oct-19,12122,11828,294,2.4
23866,CN2704100000000,27,41,"Douglas County, MN",Oct-19,20979,20516,463,2.2
23867,CN2704300000000,27,43,"Faribault County, MN",Oct-19,7344,7134,210,2.9
23868,CN2704500000000,27,45,"Fillmore County, MN",Oct-19,11903,11643,260,2.2
23869,CN2704700000000,27,47,"Freeborn County, MN",Oct-19,16476,16056,420,2.5
23870,CN2704900000000,27,49,"Goodhue County, MN",Oct-19,27512,26909,603,2.2
23871,CN2705100000000,27,51,"Grant County, MN",Oct-19,3403,3299,104,3.1
23872,CN2705300000000,27,53,"Hennepin County, MN",Oct-19,715461,696920,18541,2.6
23873,CN2705500000000,27,55,"Houston County, MN",Oct-19,10583,10341,242,2.3
23874,CN2705700000000,27,57,"Hubbard County, MN",Oct-19,9968,9598,370,3.7
23875,CN2705900000000,27,59,"Isanti County, MN",Oct-19,21434,20804,630,2.9
23876,CN2706100000000,27,61,"Itasca County, MN",Oct-19,21753,20840,913,4.2
23877,CN2706300000000,27,63,"Jackson County, MN",Oct-19,5874,5752,122,2.1
23878,CN2706500000000,27,65,"Kanabec County, MN",Oct-19,9070,8761,309,3.4
23879,CN2706700000000,27,67,"Kandiyohi County, MN",Oct-19,24668,24106,562,2.3
23880,CN2706900000000,27,69,"Kittson County, MN",Oct-19,2471,2410,61,2.5
23881,CN2707100000000,27,71,"Koochiching County, MN",Oct-19,5942,5581,361,6.1
23882,CN2707300000000,27,73,"Lac qui Parle County, MN",Oct-19,3731,3639,92,2.5
23883,CN2707500000000,27,75,"Lake County, MN",Oct-19,5504,5353,151,2.7
23884,CN2707700000000,27,77,"Lake of the Woods County, MN",Oct-19,2465,2377,88,3.6
23885,CN2707900000000,27,79,"Le Sueur County, MN",Oct-19,16235,15810,425,2.6
23886,CN2708100000000,27,81,"Lincoln County, MN",Oct-19,3428,3344,84,2.5
23887,CN2708300000000,27,83,"Lyon County, MN",Oct-19,14865,14547,318,2.1
23888,CN2708500000000,27,85,"McLeod County, MN",Oct-19,19372,18853,519,2.7
23889,CN2708700000000,27,87,"Mahnomen County, MN",Oct-19,2294,2215,79,3.4
23890,CN2708900000000,27,89,"Marshall County, MN",Oct-19,5574,5407,167,3.0
23891,CN2709100000000,27,91,"Martin County, MN",Oct-19,10212,9928,284,2.8
23892,CN2709300000000,27,93,"Meeker County, MN",Oct-19,13513,13183,330,2.4
23893,CN2709500000000,27,95,"Mille Lacs County, MN",Oct-19,12917,12476,441,3.4
23894,CN2709700000000,27,97,"Morrison County, MN",Oct-19,17703,17145,558,3.2
23895,CN2709900000000,27,99,"Mower County, MN",Oct-19,20567,20057,510,2.5
23896,CN2710100000000,27,101,"Murray County, MN",Oct-19,4971,4849,122,2.5
23897,CN2710300000000,27,103,"Nicollet County, MN",Oct-19,21800,21385,415,1.9
23898,CN2710500000000,27,105,"Nobles County, MN",Oct-19,11627,11291,336,2.9
23899,CN2710700000000,27,107,"Norman County, MN",Oct-19,3333,3250,83,2.5
23900,CN2710900000000,27,109,"Olmsted County, MN",Oct-19,89674,87810,1864,2.1
23901,CN2711100000000,27,111,"Otter Tail County, MN",Oct-19,31636,30780,856,2.7
23902,CN2711300000000,27,113,"Pennington County, MN",Oct-19,8700,8456,244,2.8
23903,CN2711500000000,27,115,"Pine County, MN",Oct-19,15170,14625,545,3.6
23904,CN2711700000000,27,117,"Pipestone County, MN",Oct-19,5068,4960,108,2.1
23905,CN2711900000000,27,119,"Polk County, MN",Oct-19,16965,16531,434,2.6
23906,CN2712100000000,27,121,"Pope County, MN",Oct-19,6719,6581,138,2.1
23907,CN2712300000000,27,123,"Ramsey County, MN",Oct-19,293270,285165,8105,2.8
23908,CN2712500000000,27,125,"Red Lake County, MN",Oct-19,2253,2169,84,3.7
23909,CN2712700000000,27,127,"Redwood County, MN",Oct-19,7826,7625,201,2.6
23910,CN2712900000000,27,129,"Renville County, MN",Oct-19,9212,8957,255,2.8
23911,CN2713100000000,27,131,"Rice County, MN",Oct-19,37361,36516,845,2.3
23912,CN2713300000000,27,133,"Rock County, MN",Oct-19,5803,5692,111,1.9
23913,CN2713500000000,27,135,"Roseau County, MN",Oct-19,7875,7672,203,2.6
23914,CN2713700000000,27,137,"St. Louis County, MN",Oct-19,102575,99264,3311,3.2
23915,CN2713900000000,27,139,"Scott County, MN",Oct-19,84496,82499,1997,2.4
23916,CN2714100000000,27,141,"Sherburne County, MN",Oct-19,52817,51448,1369,2.6
23917,CN2714300000000,27,143,"Sibley County, MN",Oct-19,8850,8620,230,2.6
23918,CN2714500000000,27,145,"Stearns County, MN",Oct-19,92251,90108,2143,2.3
23919,CN2714700000000,27,147,"Steele County, MN",Oct-19,21494,20959,535,2.5
23920,CN2714900000000,27,149,"Stevens County, MN",Oct-19,5623,5521,102,1.8
23921,CN2715100000000,27,151,"Swift County, MN",Oct-19,5077,4924,153,3.0
23922,CN2715300000000,27,153,"Todd County, MN",Oct-19,13830,13450,380,2.7
23923,CN2715500000000,27,155,"Traverse County, MN",Oct-19,1812,1771,41,2.3
23924,CN2715700000000,27,157,"Wabasha County, MN",Oct-19,12669,12369,300,2.4
23925,CN2715900000000,27,159,"Wadena County, MN",Oct-19,5937,5723,214,3.6
23926,CN2716100000000,27,161,"Waseca County, MN",Oct-19,9294,9016,278,3.0
23927,CN2716300000000,27,163,"Washington County, MN",Oct-19,145056,141507,3549,2.4
23928,CN2716500000000,27,165,"Watonwan County, MN",Oct-19,6617,6416,201,3.0
23929,CN2716700000000,27,167,"Wilkin County, MN",Oct-19,3657,3574,83,2.3
23930,CN2716900000000,27,169,"Winona County, MN",Oct-19,29041,28366,675,2.3
23931,CN2717100000000,27,171,"Wright County, MN",Oct-19,76431,74531,1900,2.5
23932,CN2717300000000,27,173,"Yellow Medicine County, MN",Oct-19,5573,5422,151,2.7
23933,CN2800100000000,28,1,"Adams County, MS",Oct-19,11332,10591,741,6.5
23934,CN2800300000000,28,3,"Alcorn County, MS",Oct-19,15812,15098,714,4.5
23935,CN2800500000000,28,5,"Amite County, MS",Oct-19,4322,4023,299,6.9
23936,CN2800700000000,28,7,"Attala County, MS",Oct-19,6978,6586,392,5.6
23937,CN2800900000000,28,9,"Benton County, MS",Oct-19,3070,2884,186,6.1
23938,CN2801100000000,28,11,"Bolivar County, MS",Oct-19,11968,11183,785,6.6
23939,CN2801300000000,28,13,"Calhoun County, MS",Oct-19,5528,5226,302,5.5
23940,CN2801500000000,28,15,"Carroll County, MS",Oct-19,3453,3243,210,6.1
23941,CN2801700000000,28,17,"Chickasaw County, MS",Oct-19,6867,6471,396,5.8
23942,CN2801900000000,28,19,"Choctaw County, MS",Oct-19,3713,3496,217,5.8
23943,CN2802100000000,28,21,"Claiborne County, MS",Oct-19,3018,2705,313,10.4
23944,CN2802300000000,28,23,"Clarke County, MS",Oct-19,5825,5473,352,6.0
23945,CN2802500000000,28,25,"Clay County, MS",Oct-19,7723,7145,578,7.5
23946,CN2802700000000,28,27,"Coahoma County, MS",Oct-19,8197,7628,569,6.9
23947,CN2802900000000,28,29,"Copiah County, MS",Oct-19,11218,10527,691,6.2
23948,CN2803100000000,28,31,"Covington County, MS",Oct-19,8164,7794,370,4.5
23949,CN2803300000000,28,33,"DeSoto County, MS",Oct-19,91869,88031,3838,4.2
23950,CN2803500000000,28,35,"Forrest County, MS",Oct-19,33596,32019,1577,4.7
23951,CN2803700000000,28,37,"Franklin County, MS",Oct-19,2753,2569,184,6.7
23952,CN2803900000000,28,39,"George County, MS",Oct-19,8694,8100,594,6.8
23953,CN2804100000000,28,41,"Greene County, MS",Oct-19,4277,3985,292,6.8
23954,CN2804300000000,28,43,"Grenada County, MS",Oct-19,9319,8856,463,5.0
23955,CN2804500000000,28,45,"Hancock County, MS",Oct-19,18809,17838,971,5.2
23956,CN2804700000000,28,47,"Harrison County, MS",Oct-19,86725,82425,4300,5.0
23957,CN2804900000000,28,49,"Hinds County, MS",Oct-19,107842,102566,5276,4.9
23958,CN2805100000000,28,51,"Holmes County, MS",Oct-19,5652,5123,529,9.4
23959,CN2805300000000,28,53,"Humphreys County, MS",Oct-19,2141,1938,203,9.5
23960,CN2805500000000,28,55,"Issaquena County, MS",Oct-19,372,338,34,9.1
23961,CN2805700000000,28,57,"Itawamba County, MS",Oct-19,10501,10034,467,4.4
23962,CN2805900000000,28,59,"Jackson County, MS",Oct-19,58529,55297,3232,5.5
23963,CN2806100000000,28,61,"Jasper County, MS",Oct-19,6094,5707,387,6.4
23964,CN2806300000000,28,63,"Jefferson County, MS",Oct-19,1970,1705,265,13.5
23965,CN2806500000000,28,65,"Jefferson Davis County, MS",Oct-19,4106,3858,248,6.0
23966,CN2806700000000,28,67,"Jones County, MS",Oct-19,26042,24723,1319,5.1
23967,CN2806900000000,28,69,"Kemper County, MS",Oct-19,3456,3185,271,7.8
23968,CN2807100000000,28,71,"Lafayette County, MS",Oct-19,29699,28513,1186,4.0
23969,CN2807300000000,28,73,"Lamar County, MS",Oct-19,31083,29883,1200,3.9
23970,CN2807500000000,28,75,"Lauderdale County, MS",Oct-19,30094,28513,1581,5.3
23971,CN2807700000000,28,77,"Lawrence County, MS",Oct-19,4568,4285,283,6.2
23972,CN2807900000000,28,79,"Leake County, MS",Oct-19,7805,7384,421,5.4
23973,CN2808100000000,28,81,"Lee County, MS",Oct-19,41373,39596,1777,4.3
23974,CN2808300000000,28,83,"Leflore County, MS",Oct-19,9943,9255,688,6.9
23975,CN2808500000000,28,85,"Lincoln County, MS",Oct-19,14613,13784,829,5.7
23976,CN2808700000000,28,87,"Lowndes County, MS",Oct-19,25758,24487,1271,4.9
23977,CN2808900000000,28,89,"Madison County, MS",Oct-19,53720,51533,2187,4.1
23978,CN2809100000000,28,91,"Marion County, MS",Oct-19,9887,9394,493,5.0
23979,CN2809300000000,28,93,"Marshall County, MS",Oct-19,14580,13760,820,5.6
23980,CN2809500000000,28,95,"Monroe County, MS",Oct-19,15652,14798,854,5.5
23981,CN2809700000000,28,97,"Montgomery County, MS",Oct-19,3883,3653,230,5.9
23982,CN2809900000000,28,99,"Neshoba County, MS",Oct-19,9990,9414,576,5.8
23983,CN2810100000000,28,101,"Newton County, MS",Oct-19,8860,8400,460,5.2
23984,CN2810300000000,28,103,"Noxubee County, MS",Oct-19,3716,3445,271,7.3
23985,CN2810500000000,28,105,"Oktibbeha County, MS",Oct-19,23230,22005,1225,5.3
23986,CN2810700000000,28,107,"Panola County, MS",Oct-19,12482,11722,760,6.1
23987,CN2810900000000,28,109,"Pearl River County, MS",Oct-19,23848,22681,1167,4.9
23988,CN2811100000000,28,111,"Perry County, MS",Oct-19,4300,4045,255,5.9
23989,CN2811300000000,28,113,"Pike County, MS",Oct-19,14324,13426,898,6.3
23990,CN2811500000000,28,115,"Pontotoc County, MS",Oct-19,14799,14184,615,4.2
23991,CN2811700000000,28,117,"Prentiss County, MS",Oct-19,11273,10759,514,4.6
23992,CN2811900000000,28,119,"Quitman County, MS",Oct-19,2290,2113,177,7.7
23993,CN2812100000000,28,121,"Rankin County, MS",Oct-19,76830,73962,2868,3.7
23994,CN2812300000000,28,123,"Scott County, MS",Oct-19,12529,11995,534,4.3
23995,CN2812500000000,28,125,"Sharkey County, MS",Oct-19,1566,1453,113,7.2
23996,CN2812700000000,28,127,"Simpson County, MS",Oct-19,10758,10259,499,4.6
23997,CN2812900000000,28,129,"Smith County, MS",Oct-19,6697,6368,329,4.9
23998,CN2813100000000,28,131,"Stone County, MS",Oct-19,6892,6478,414,6.0
23999,CN2813300000000,28,133,"Sunflower County, MS",Oct-19,7505,6883,622,8.3
24000,CN2813500000000,28,135,"Tallahatchie County, MS",Oct-19,5092,4832,260,5.1
24001,CN2813700000000,28,137,"Tate County, MS",Oct-19,12383,11718,665,5.4
24002,CN2813900000000,28,139,"Tippah County, MS",Oct-19,9405,8963,442,4.7
24003,CN2814100000000,28,141,"Tishomingo County, MS",Oct-19,8439,8025,414,4.9
24004,CN2814300000000,28,143,"Tunica County, MS",Oct-19,4398,4154,244,5.5
24005,CN2814500000000,28,145,"Union County, MS",Oct-19,14362,13773,589,4.1
24006,CN2814700000000,28,147,"Walthall County, MS",Oct-19,4840,4497,343,7.1
24007,CN2814900000000,28,149,"Warren County, MS",Oct-19,20285,19157,1128,5.6
24008,CN2815100000000,28,151,"Washington County, MS",Oct-19,16795,15642,1153,6.9
24009,CN2815300000000,28,153,"Wayne County, MS",Oct-19,7311,6890,421,5.8
24010,CN2815500000000,28,155,"Webster County, MS",Oct-19,4045,3789,256,6.3
24011,CN2815700000000,28,157,"Wilkinson County, MS",Oct-19,2801,2536,265,9.5
24012,CN2815900000000,28,159,"Winston County, MS",Oct-19,7368,6960,408,5.5
24013,CN2816100000000,28,161,"Yalobusha County, MS",Oct-19,5031,4782,249,4.9
24014,CN2816300000000,28,163,"Yazoo County, MS",Oct-19,9373,8807,566,6.0
24015,CN2900100000000,29,1,"Adair County, MO",Oct-19,10442,10162,280,2.7
24016,CN2900300000000,29,3,"Andrew County, MO",Oct-19,9843,9629,214,2.2
24017,CN2900500000000,29,5,"Atchison County, MO",Oct-19,2784,2712,72,2.6
24018,CN2900700000000,29,7,"Audrain County, MO",Oct-19,10759,10476,283,2.6
24019,CN2900900000000,29,9,"Barry County, MO",Oct-19,15719,15255,464,3.0
24020,CN2901100000000,29,11,"Barton County, MO",Oct-19,5301,5167,134,2.5
24021,CN2901300000000,29,13,"Bates County, MO",Oct-19,7989,7758,231,2.9
24022,CN2901500000000,29,15,"Benton County, MO",Oct-19,7251,6992,259,3.6
24023,CN2901700000000,29,17,"Bollinger County, MO",Oct-19,5549,5380,169,3.0
24024,CN2901900000000,29,19,"Boone County, MO",Oct-19,99703,97819,1884,1.9
24025,CN2902100000000,29,21,"Buchanan County, MO",Oct-19,44832,43685,1147,2.6
24026,CN2902300000000,29,23,"Butler County, MO",Oct-19,17978,17377,601,3.3
24027,CN2902500000000,29,25,"Caldwell County, MO",Oct-19,4436,4332,104,2.3
24028,CN2902700000000,29,27,"Callaway County, MO",Oct-19,21366,20893,473,2.2
24029,CN2902900000000,29,29,"Camden County, MO",Oct-19,18600,17926,674,3.6
24030,CN2903100000000,29,31,"Cape Girardeau County, MO",Oct-19,41182,40133,1049,2.5
24031,CN2903300000000,29,33,"Carroll County, MO",Oct-19,4842,4699,143,3.0
24032,CN2903500000000,29,35,"Carter County, MO",Oct-19,2557,2462,95,3.7
24033,CN2903700000000,29,37,"Cass County, MO",Oct-19,55186,53887,1299,2.4
24034,CN2903900000000,29,39,"Cedar County, MO",Oct-19,5878,5700,178,3.0
24035,CN2904100000000,29,41,"Chariton County, MO",Oct-19,3829,3746,83,2.2
24036,CN2904300000000,29,43,"Christian County, MO",Oct-19,45199,44201,998,2.2
24037,CN2904500000000,29,45,"Clark County, MO",Oct-19,3250,3173,77,2.4
24038,CN2904700000000,29,47,"Clay County, MO",Oct-19,137455,134032,3423,2.5
24039,CN2904900000000,29,49,"Clinton County, MO",Oct-19,10811,10573,238,2.2
24040,CN2905100000000,29,51,"Cole County, MO",Oct-19,38999,38212,787,2.0
24041,CN2905300000000,29,53,"Cooper County, MO",Oct-19,7598,7402,196,2.6
24042,CN2905500000000,29,55,"Crawford County, MO",Oct-19,11003,10662,341,3.1
24043,CN2905700000000,29,57,"Dade County, MO",Oct-19,3627,3532,95,2.6
24044,CN2905900000000,29,59,"Dallas County, MO",Oct-19,7197,6880,317,4.4
24045,CN2906100000000,29,61,"Daviess County, MO",Oct-19,4248,4139,109,2.6
24046,CN2906300000000,29,63,"DeKalb County, MO",Oct-19,4890,4777,113,2.3
24047,CN2906500000000,29,65,"Dent County, MO",Oct-19,6376,6174,202,3.2
24048,CN2906700000000,29,67,"Douglas County, MO",Oct-19,5104,4897,207,4.1
24049,CN2906900000000,29,69,"Dunklin County, MO",Oct-19,11593,11123,470,4.1
24050,CN2907100000000,29,71,"Franklin County, MO",Oct-19,53758,52058,1700,3.2
24051,CN2907300000000,29,73,"Gasconade County, MO",Oct-19,8083,7650,433,5.4
24052,CN2907500000000,29,75,"Gentry County, MO",Oct-19,3576,3492,84,2.3
24053,CN2907700000000,29,77,"Greene County, MO",Oct-19,152127,148696,3431,2.3
24054,CN2907900000000,29,79,"Grundy County, MO",Oct-19,4477,4367,110,2.5
24055,CN2908100000000,29,81,"Harrison County, MO",Oct-19,3883,3777,106,2.7
24056,CN2908300000000,29,83,"Henry County, MO",Oct-19,9757,9469,288,3.0
24057,CN2908500000000,29,85,"Hickory County, MO",Oct-19,3946,3809,137,3.5
24058,CN2908700000000,29,87,"Holt County, MO",Oct-19,2635,2582,53,2.0
24059,CN2908900000000,29,89,"Howard County, MO",Oct-19,4940,4824,116,2.3
24060,CN2909100000000,29,91,"Howell County, MO",Oct-19,16802,16137,665,4.0
24061,CN2909300000000,29,93,"Iron County, MO",Oct-19,3491,3373,118,3.4
24062,CN2909500000000,29,95,"Jackson County, MO",Oct-19,365288,353499,11789,3.2
24063,CN2909700000000,29,97,"Jasper County, MO",Oct-19,57637,56136,1501,2.6
24064,CN2909900000000,29,99,"Jefferson County, MO",Oct-19,118536,115560,2976,2.5
24065,CN2910100000000,29,101,"Johnson County, MO",Oct-19,23572,22785,787,3.3
24066,CN2910300000000,29,103,"Knox County, MO",Oct-19,1823,1787,36,2.0
24067,CN2910500000000,29,105,"Laclede County, MO",Oct-19,17909,16227,1682,9.4
24068,CN2910700000000,29,107,"Lafayette County, MO",Oct-19,17009,16590,419,2.5
24069,CN2910900000000,29,109,"Lawrence County, MO",Oct-19,18274,17766,508,2.8
24070,CN2911100000000,29,111,"Lewis County, MO",Oct-19,5088,4957,131,2.6
24071,CN2911300000000,29,113,"Lincoln County, MO",Oct-19,28737,27814,923,3.2
24072,CN2911500000000,29,115,"Linn County, MO",Oct-19,5238,5050,188,3.6
24073,CN2911700000000,29,117,"Livingston County, MO",Oct-19,7432,7268,164,2.2
24074,CN2911900000000,29,119,"McDonald County, MO",Oct-19,10867,10573,294,2.7
24075,CN2912100000000,29,121,"Macon County, MO",Oct-19,7609,7425,184,2.4
24076,CN2912300000000,29,123,"Madison County, MO",Oct-19,5504,5361,143,2.6
24077,CN2912500000000,29,125,"Maries County, MO",Oct-19,3936,3824,112,2.8
24078,CN2912700000000,29,127,"Marion County, MO",Oct-19,14670,14292,378,2.6
24079,CN2912900000000,29,129,"Mercer County, MO",Oct-19,1964,1926,38,1.9
24080,CN2913100000000,29,131,"Miller County, MO",Oct-19,12445,12043,402,3.2
24081,CN2913300000000,29,133,"Mississippi County, MO",Oct-19,5867,5685,182,3.1
24082,CN2913500000000,29,135,"Moniteau County, MO",Oct-19,7366,7205,161,2.2
24083,CN2913700000000,29,137,"Monroe County, MO",Oct-19,3959,3828,131,3.3
24084,CN2913900000000,29,139,"Montgomery County, MO",Oct-19,5900,5712,188,3.2
24085,CN2914100000000,29,141,"Morgan County, MO",Oct-19,8215,7917,298,3.6
24086,CN2914300000000,29,143,"New Madrid County, MO",Oct-19,8353,8068,285,3.4
24087,CN2914500000000,29,145,"Newton County, MO",Oct-19,27588,26836,752,2.7
24088,CN2914700000000,29,147,"Nodaway County, MO",Oct-19,11109,10874,235,2.1
24089,CN2914900000000,29,149,"Oregon County, MO",Oct-19,4087,3947,140,3.4
24090,CN2915100000000,29,151,"Osage County, MO",Oct-19,7173,7030,143,2.0
24091,CN2915300000000,29,153,"Ozark County, MO",Oct-19,3443,3283,160,4.6
24092,CN2915500000000,29,155,"Pemiscot County, MO",Oct-19,6374,6125,249,3.9
24093,CN2915700000000,29,157,"Perry County, MO",Oct-19,10050,9842,208,2.1
24094,CN2915900000000,29,159,"Pettis County, MO",Oct-19,21168,20597,571,2.7
24095,CN2916100000000,29,161,"Phelps County, MO",Oct-19,19864,19335,529,2.7
24096,CN2916300000000,29,163,"Pike County, MO",Oct-19,7528,7297,231,3.1
24097,CN2916500000000,29,165,"Platte County, MO",Oct-19,59202,57823,1379,2.3
24098,CN2916700000000,29,167,"Polk County, MO",Oct-19,14799,14339,460,3.1
24099,CN2916900000000,29,169,"Pulaski County, MO",Oct-19,14708,14168,540,3.7
24100,CN2917100000000,29,171,"Putnam County, MO",Oct-19,2331,2266,65,2.8
24101,CN2917300000000,29,173,"Ralls County, MO",Oct-19,5715,5579,136,2.4
24102,CN2917500000000,29,175,"Randolph County, MO",Oct-19,10475,10155,320,3.1
24103,CN2917700000000,29,177,"Ray County, MO",Oct-19,11089,10768,321,2.9
24104,CN2917900000000,29,179,"Reynolds County, MO",Oct-19,3056,2961,95,3.1
24105,CN2918100000000,29,181,"Ripley County, MO",Oct-19,5069,4881,188,3.7
24106,CN2918300000000,29,183,"St. Charles County, MO",Oct-19,228399,223263,5136,2.2
24107,CN2918500000000,29,185,"St. Clair County, MO",Oct-19,3796,3656,140,3.7
24108,CN2918600000000,29,186,"Ste. Genevieve County, MO",Oct-19,9243,9053,190,2.1
24109,CN2918700000000,29,187,"St. Francois County, MO",Oct-19,26571,25777,794,3.0
24110,CN2918900000000,29,189,"St. Louis County, MO",Oct-19,535475,521425,14050,2.6
24111,CN2919500000000,29,195,"Saline County, MO",Oct-19,10711,10458,253,2.4
24112,CN2919700000000,29,197,"Schuyler County, MO",Oct-19,2012,1932,80,4.0
24113,CN2919900000000,29,199,"Scotland County, MO",Oct-19,2479,2417,62,2.5
24114,CN2920100000000,29,201,"Scott County, MO",Oct-19,20146,19540,606,3.0
24115,CN2920300000000,29,203,"Shannon County, MO",Oct-19,3306,3163,143,4.3
24116,CN2920500000000,29,205,"Shelby County, MO",Oct-19,3141,3081,60,1.9
24117,CN2920700000000,29,207,"Stoddard County, MO",Oct-19,13284,12784,500,3.8
24118,CN2920900000000,29,209,"Stone County, MO",Oct-19,13910,13477,433,3.1
24119,CN2921100000000,29,211,"Sullivan County, MO",Oct-19,2724,2641,83,3.0
24120,CN2921300000000,29,213,"Taney County, MO",Oct-19,27082,26247,835,3.1
24121,CN2921500000000,29,215,"Texas County, MO",Oct-19,9242,8904,338,3.7
24122,CN2921700000000,29,217,"Vernon County, MO",Oct-19,9596,9329,267,2.8
24123,CN2921900000000,29,219,"Warren County, MO",Oct-19,18136,17648,488,2.7
24124,CN2922100000000,29,221,"Washington County, MO",Oct-19,10247,9899,348,3.4
24125,CN2922300000000,29,223,"Wayne County, MO",Oct-19,5284,5096,188,3.6
24126,CN2922500000000,29,225,"Webster County, MO",Oct-19,17511,16952,559,3.2
24127,CN2922700000000,29,227,"Worth County, MO",Oct-19,1211,1188,23,1.9
24128,CN2922900000000,29,229,"Wright County, MO",Oct-19,7760,7353,407,5.2
24129,CN2951000000000,29,510,"St. Louis city, MO",Oct-19,153435,148387,5048,3.3
24130,CN3000100000000,30,1,"Beaverhead County, MT",Oct-19,5105,4974,131,2.6
24131,CN3000300000000,30,3,"Big Horn County, MT",Oct-19,4849,4541,308,6.4
24132,CN3000500000000,30,5,"Blaine County, MT",Oct-19,2561,2481,80,3.1
24133,CN3000700000000,30,7,"Broadwater County, MT",Oct-19,2581,2494,87,3.4
24134,CN3000900000000,30,9,"Carbon County, MT",Oct-19,5511,5348,163,3.0
24135,CN3001100000000,30,11,"Carter County, MT",Oct-19,689,672,17,2.5
24136,CN3001300000000,30,13,"Cascade County, MT",Oct-19,37962,36765,1197,3.2
24137,CN3001500000000,30,15,"Chouteau County, MT",Oct-19,2540,2472,68,2.7
24138,CN3001700000000,30,17,"Custer County, MT",Oct-19,6115,5961,154,2.5
24139,CN3001900000000,30,19,"Daniels County, MT",Oct-19,910,893,17,1.9
24140,CN3002100000000,30,21,"Dawson County, MT",Oct-19,4580,4468,112,2.4
24141,CN3002300000000,30,23,"Deer Lodge County, MT",Oct-19,4965,4830,135,2.7
24142,CN3002500000000,30,25,"Fallon County, MT",Oct-19,1730,1695,35,2.0
24143,CN3002700000000,30,27,"Fergus County, MT",Oct-19,6111,5963,148,2.4
24144,CN3002900000000,30,29,"Flathead County, MT",Oct-19,47428,45495,1933,4.1
24145,CN3003100000000,30,31,"Gallatin County, MT",Oct-19,69254,67586,1668,2.4
24146,CN3003300000000,30,33,"Garfield County, MT",Oct-19,768,752,16,2.1
24147,CN3003500000000,30,35,"Glacier County, MT",Oct-19,5586,5198,388,6.9
24148,CN3003700000000,30,37,"Golden Valley County, MT",Oct-19,375,362,13,3.5
24149,CN3003900000000,30,39,"Granite County, MT",Oct-19,1618,1544,74,4.6
24150,CN3004100000000,30,41,"Hill County, MT",Oct-19,7729,7447,282,3.6
24151,CN3004300000000,30,43,"Jefferson County, MT",Oct-19,5681,5504,177,3.1
24152,CN3004500000000,30,45,"Judith Basin County, MT",Oct-19,1038,1010,28,2.7
24153,CN3004700000000,30,47,"Lake County, MT",Oct-19,13273,12758,515,3.9
24154,CN3004900000000,30,49,"Lewis and Clark County, MT",Oct-19,35525,34562,963,2.7
24155,CN3005100000000,30,51,"Liberty County, MT",Oct-19,1000,974,26,2.6
24156,CN3005300000000,30,53,"Lincoln County, MT",Oct-19,8172,7667,505,6.2
24157,CN3005500000000,30,55,"McCone County, MT",Oct-19,998,976,22,2.2
24158,CN3005700000000,30,57,"Madison County, MT",Oct-19,4209,4064,145,3.4
24159,CN3005900000000,30,59,"Meagher County, MT",Oct-19,951,923,28,2.9
24160,CN3006100000000,30,61,"Mineral County, MT",Oct-19,1747,1666,81,4.6
24161,CN3006300000000,30,63,"Missoula County, MT",Oct-19,64444,62603,1841,2.9
24162,CN3006500000000,30,65,"Musselshell County, MT",Oct-19,2282,2205,77,3.4
24163,CN3006700000000,30,67,"Park County, MT",Oct-19,9020,8768,252,2.8
24164,CN3006900000000,30,69,"Petroleum County, MT",Oct-19,292,283,9,3.1
24165,CN3007100000000,30,71,"Phillips County, MT",Oct-19,1948,1890,58,3.0
24166,CN3007300000000,30,73,"Pondera County, MT",Oct-19,2705,2625,80,3.0
24167,CN3007500000000,30,75,"Powder River County, MT",Oct-19,1007,985,22,2.2
24168,CN3007700000000,30,77,"Powell County, MT",Oct-19,3040,2940,100,3.3
24169,CN3007900000000,30,79,"Prairie County, MT",Oct-19,490,471,19,3.9
24170,CN3008100000000,30,81,"Ravalli County, MT",Oct-19,20449,19774,675,3.3
24171,CN3008300000000,30,83,"Richland County, MT",Oct-19,6015,5854,161,2.7
24172,CN3008500000000,30,85,"Roosevelt County, MT",Oct-19,4508,4345,163,3.6
24173,CN3008700000000,30,87,"Rosebud County, MT",Oct-19,3904,3725,179,4.6
24174,CN3008900000000,30,89,"Sanders County, MT",Oct-19,4888,4670,218,4.5
24175,CN3009100000000,30,91,"Sheridan County, MT",Oct-19,1768,1729,39,2.2
24176,CN3009300000000,30,93,"Silver Bow County, MT",Oct-19,17123,16522,601,3.5
24177,CN3009500000000,30,95,"Stillwater County, MT",Oct-19,5353,5213,140,2.6
24178,CN3009700000000,30,97,"Sweet Grass County, MT",Oct-19,1863,1814,49,2.6
24179,CN3009900000000,30,99,"Teton County, MT",Oct-19,2801,2718,83,3.0
24180,CN3010100000000,30,101,"Toole County, MT",Oct-19,2142,2082,60,2.8
24181,CN3010300000000,30,103,"Treasure County, MT",Oct-19,346,339,7,2.0
24182,CN3010500000000,30,105,"Valley County, MT",Oct-19,4151,4017,134,3.2
24183,CN3010700000000,30,107,"Wheatland County, MT",Oct-19,820,795,25,3.0
24184,CN3010900000000,30,109,"Wibaux County, MT",Oct-19,478,463,15,3.1
24185,CN3011100000000,30,111,"Yellowstone County, MT",Oct-19,81675,79293,2382,2.9
24186,CN3100100000000,31,1,"Adams County, NE",Oct-19,16884,16407,477,2.8
24187,CN3100300000000,31,3,"Antelope County, NE",Oct-19,3506,3421,85,2.4
24188,CN3100500000000,31,5,"Arthur County, NE",Oct-19,215,204,11,5.1
24189,CN3100700000000,31,7,"Banner County, NE",Oct-19,382,367,15,3.9
24190,CN3100900000000,31,9,"Blaine County, NE",Oct-19,251,240,11,4.4
24191,CN3101100000000,31,11,"Boone County, NE",Oct-19,2901,2829,72,2.5
24192,CN3101300000000,31,13,"Box Butte County, NE",Oct-19,5455,5294,161,3.0
24193,CN3101500000000,31,15,"Boyd County, NE",Oct-19,1059,1030,29,2.7
24194,CN3101700000000,31,17,"Brown County, NE",Oct-19,1358,1317,41,3.0
24195,CN3101900000000,31,19,"Buffalo County, NE",Oct-19,27902,27211,691,2.5
24196,CN3102100000000,31,21,"Burt County, NE",Oct-19,3422,3323,99,2.9
24197,CN3102300000000,31,23,"Butler County, NE",Oct-19,4554,4445,109,2.4
24198,CN3102500000000,31,25,"Cass County, NE",Oct-19,13637,13246,391,2.9
24199,CN3102700000000,31,27,"Cedar County, NE",Oct-19,4437,4330,107,2.4
24200,CN3102900000000,31,29,"Chase County, NE",Oct-19,2230,2178,52,2.3
24201,CN3103100000000,31,31,"Cherry County, NE",Oct-19,3310,3232,78,2.4
24202,CN3103300000000,31,33,"Cheyenne County, NE",Oct-19,4319,4169,150,3.5
24203,CN3103500000000,31,35,"Clay County, NE",Oct-19,3250,3159,91,2.8
24204,CN3103700000000,31,37,"Colfax County, NE",Oct-19,5536,5391,145,2.6
24205,CN3103900000000,31,39,"Cuming County, NE",Oct-19,4599,4478,121,2.6
24206,CN3104100000000,31,41,"Custer County, NE",Oct-19,6273,6125,148,2.4
24207,CN3104300000000,31,43,"Dakota County, NE",Oct-19,10786,10447,339,3.1
24208,CN3104500000000,31,45,"Dawes County, NE",Oct-19,4990,4860,130,2.6
24209,CN3104700000000,31,47,"Dawson County, NE",Oct-19,12943,12612,331,2.6
24210,CN3104900000000,31,49,"Deuel County, NE",Oct-19,945,914,31,3.3
24211,CN3105100000000,31,51,"Dixon County, NE",Oct-19,3010,2930,80,2.7
24212,CN3105300000000,31,53,"Dodge County, NE",Oct-19,19537,19021,516,2.6
24213,CN3105500000000,31,55,"Douglas County, NE",Oct-19,302491,293822,8669,2.9
24214,CN3105700000000,31,57,"Dundy County, NE",Oct-19,1154,1123,31,2.7
24215,CN3105900000000,31,59,"Fillmore County, NE",Oct-19,3096,3021,75,2.4
24216,CN3106100000000,31,61,"Franklin County, NE",Oct-19,1418,1371,47,3.3
24217,CN3106300000000,31,63,"Frontier County, NE",Oct-19,1593,1547,46,2.9
24218,CN3106500000000,31,65,"Furnas County, NE",Oct-19,2535,2468,67,2.6
24219,CN3106700000000,31,67,"Gage County, NE",Oct-19,11153,10557,596,5.3
24220,CN3106900000000,31,69,"Garden County, NE",Oct-19,1046,1015,31,3.0
24221,CN3107100000000,31,71,"Garfield County, NE",Oct-19,1163,1134,29,2.5
24222,CN3107300000000,31,73,"Gosper County, NE",Oct-19,1085,1057,28,2.6
24223,CN3107500000000,31,75,"Grant County, NE",Oct-19,422,411,11,2.6
24224,CN3107700000000,31,77,"Greeley County, NE",Oct-19,1189,1152,37,3.1
24225,CN3107900000000,31,79,"Hall County, NE",Oct-19,32019,30693,1326,4.1
24226,CN3108100000000,31,81,"Hamilton County, NE",Oct-19,4754,4575,179,3.8
24227,CN3108300000000,31,83,"Harlan County, NE",Oct-19,1758,1709,49,2.8
24228,CN3108500000000,31,85,"Hayes County, NE",Oct-19,621,606,15,2.4
24229,CN3108700000000,31,87,"Hitchcock County, NE",Oct-19,1244,1207,37,3.0
24230,CN3108900000000,31,89,"Holt County, NE",Oct-19,5611,5477,134,2.4
24231,CN3109100000000,31,91,"Hooker County, NE",Oct-19,392,381,11,2.8
24232,CN3109300000000,31,93,"Howard County, NE",Oct-19,3393,3220,173,5.1
24233,CN3109500000000,31,95,"Jefferson County, NE",Oct-19,4120,3996,124,3.0
24234,CN3109700000000,31,97,"Johnson County, NE",Oct-19,2038,1963,75,3.7
24235,CN3109900000000,31,99,"Kearney County, NE",Oct-19,3800,3714,86,2.3
24236,CN3110100000000,31,101,"Keith County, NE",Oct-19,4478,4331,147,3.3
24237,CN3110300000000,31,103,"Keya Paha County, NE",Oct-19,576,561,15,2.6
24238,CN3110500000000,31,105,"Kimball County, NE",Oct-19,1997,1940,57,2.9
24239,CN3110700000000,31,107,"Knox County, NE",Oct-19,4497,4383,114,2.5
24240,CN3110900000000,31,109,"Lancaster County, NE",Oct-19,178518,173978,4540,2.5
24241,CN3111100000000,31,111,"Lincoln County, NE",Oct-19,18236,17653,583,3.2
24242,CN3111300000000,31,113,"Logan County, NE",Oct-19,467,451,16,3.4
24243,CN3111500000000,31,115,"Loup County, NE",Oct-19,399,384,15,3.8
24244,CN3111700000000,31,117,"McPherson County, NE",Oct-19,442,432,10,2.3
24245,CN3111900000000,31,119,"Madison County, NE",Oct-19,19896,19409,487,2.4
24246,CN3112100000000,31,121,"Merrick County, NE",Oct-19,4009,3848,161,4.0
24247,CN3112300000000,31,123,"Morrill County, NE",Oct-19,2572,2504,68,2.6
24248,CN3112500000000,31,125,"Nance County, NE",Oct-19,1937,1885,52,2.7
24249,CN3112700000000,31,127,"Nemaha County, NE",Oct-19,3589,3480,109,3.0
24250,CN3112900000000,31,129,"Nuckolls County, NE",Oct-19,2356,2297,59,2.5
24251,CN3113100000000,31,131,"Otoe County, NE",Oct-19,8457,8231,226,2.7
24252,CN3113300000000,31,133,"Pawnee County, NE",Oct-19,1455,1409,46,3.2
24253,CN3113500000000,31,135,"Perkins County, NE",Oct-19,1786,1747,39,2.2
24254,CN3113700000000,31,137,"Phelps County, NE",Oct-19,4915,4791,124,2.5
24255,CN3113900000000,31,139,"Pierce County, NE",Oct-19,4078,3980,98,2.4
24256,CN3114100000000,31,141,"Platte County, NE",Oct-19,17737,17274,463,2.6
24257,CN3114300000000,31,143,"Polk County, NE",Oct-19,2903,2825,78,2.7
24258,CN3114500000000,31,145,"Red Willow County, NE",Oct-19,5794,5643,151,2.6
24259,CN3114700000000,31,147,"Richardson County, NE",Oct-19,4177,4058,119,2.8
24260,CN3114900000000,31,149,"Rock County, NE",Oct-19,861,838,23,2.7
24261,CN3115100000000,31,151,"Saline County, NE",Oct-19,7296,7086,210,2.9
24262,CN3115300000000,31,153,"Sarpy County, NE",Oct-19,97787,95180,2607,2.7
24263,CN3115500000000,31,155,"Saunders County, NE",Oct-19,11188,10900,288,2.6
24264,CN3115700000000,31,157,"Scotts Bluff County, NE",Oct-19,18378,17813,565,3.1
24265,CN3115900000000,31,159,"Seward County, NE",Oct-19,8902,8667,235,2.6
24266,CN3116100000000,31,161,"Sheridan County, NE",Oct-19,2625,2555,70,2.7
24267,CN3116300000000,31,163,"Sherman County, NE",Oct-19,1659,1607,52,3.1
24268,CN3116500000000,31,165,"Sioux County, NE",Oct-19,728,708,20,2.7
24269,CN3116700000000,31,167,"Stanton County, NE",Oct-19,3496,3416,80,2.3
24270,CN3116900000000,31,169,"Thayer County, NE",Oct-19,2701,2634,67,2.5
24271,CN3117100000000,31,171,"Thomas County, NE",Oct-19,406,395,11,2.7
24272,CN3117300000000,31,173,"Thurston County, NE",Oct-19,3056,2949,107,3.5
24273,CN3117500000000,31,175,"Valley County, NE",Oct-19,2078,2019,59,2.8
24274,CN3117700000000,31,177,"Washington County, NE",Oct-19,11366,11073,293,2.6
24275,CN3117900000000,31,179,"Wayne County, NE",Oct-19,5833,5703,130,2.2
24276,CN3118100000000,31,181,"Webster County, NE",Oct-19,1651,1597,54,3.3
24277,CN3118300000000,31,183,"Wheeler County, NE",Oct-19,539,526,13,2.4
24278,CN3118500000000,31,185,"York County, NE",Oct-19,7245,7066,179,2.5
24279,CN3200100000000,32,1,"Churchill County, NV",Oct-19,11459,11120,339,3.0
24280,CN3200300000000,32,3,"Clark County, NV",Oct-19,1138969,1096041,42928,3.8
24281,CN3200500000000,32,5,"Douglas County, NV",Oct-19,23448,22664,784,3.3
24282,CN3200700000000,32,7,"Elko County, NV",Oct-19,27272,26571,701,2.6
24283,CN3200900000000,32,9,"Esmeralda County, NV",Oct-19,481,463,18,3.7
24284,CN3201100000000,32,11,"Eureka County, NV",Oct-19,1202,1178,24,2.0
24285,CN3201300000000,32,13,"Humboldt County, NV",Oct-19,8595,8368,227,2.6
24286,CN3201500000000,32,15,"Lander County, NV",Oct-19,3256,3164,92,2.8
24287,CN3201700000000,32,17,"Lincoln County, NV",Oct-19,2228,2155,73,3.3
24288,CN3201900000000,32,19,"Lyon County, NV",Oct-19,23523,22588,935,4.0
24289,CN3202100000000,32,21,"Mineral County, NV",Oct-19,2010,1942,68,3.4
24290,CN3202300000000,32,23,"Nye County, NV",Oct-19,17701,16878,823,4.6
24291,CN3202700000000,32,27,"Pershing County, NV",Oct-19,2674,2585,89,3.3
24292,CN3202900000000,32,29,"Storey County, NV",Oct-19,2057,1997,60,2.9
24293,CN3203100000000,32,31,"Washoe County, NV",Oct-19,259121,251824,7297,2.8
24294,CN3203300000000,32,33,"White Pine County, NV",Oct-19,4757,4639,118,2.5
24295,CN3251000000000,32,510,"Carson City, NV",Oct-19,26409,25535,874,3.3
24296,CN3300100000000,33,1,"Belknap County, NH",Oct-19,31343,30654,689,2.2
24297,CN3300300000000,33,3,"Carroll County, NH",Oct-19,23669,23162,507,2.1
24298,CN3300500000000,33,5,"Cheshire County, NH",Oct-19,41208,40284,924,2.2
24299,CN3300700000000,33,7,"Coos County, NH",Oct-19,14634,14293,341,2.3
24300,CN3300900000000,33,9,"Grafton County, NH",Oct-19,50041,49104,937,1.9
24301,CN3301100000000,33,11,"Hillsborough County, NH",Oct-19,242384,236889,5495,2.3
24302,CN3301300000000,33,13,"Merrimack County, NH",Oct-19,83686,82041,1645,2.0
24303,CN3301500000000,33,15,"Rockingham County, NH",Oct-19,188260,183805,4455,2.4
24304,CN3301700000000,33,17,"Strafford County, NH",Oct-19,75123,73600,1523,2.0
24305,CN3301900000000,33,19,"Sullivan County, NH",Oct-19,23019,22546,473,2.1
24306,CN3400100000000,34,1,"Atlantic County, NJ",Oct-19,121075,115257,5818,4.8
24307,CN3400300000000,34,3,"Bergen County, NJ",Oct-19,488407,474455,13952,2.9
24308,CN3400500000000,34,5,"Burlington County, NJ",Oct-19,233313,225930,7383,3.2
24309,CN3400700000000,34,7,"Camden County, NJ",Oct-19,255811,245660,10151,4.0
24310,CN3400900000000,34,9,"Cape May County, NJ",Oct-19,43924,41467,2457,5.6
24311,CN3401100000000,34,11,"Cumberland County, NJ",Oct-19,66107,62778,3329,5.0
24312,CN3401300000000,34,13,"Essex County, NJ",Oct-19,371963,355526,16437,4.4
24313,CN3401500000000,34,15,"Gloucester County, NJ",Oct-19,151306,145947,5359,3.5
24314,CN3401700000000,34,17,"Hudson County, NJ",Oct-19,365671,353803,11868,3.2
24315,CN3401900000000,34,19,"Hunterdon County, NJ",Oct-19,65263,63560,1703,2.6
24316,CN3402100000000,34,21,"Mercer County, NJ",Oct-19,205097,198796,6301,3.1
24317,CN3402300000000,34,23,"Middlesex County, NJ",Oct-19,441376,428103,13273,3.0
24318,CN3402500000000,34,25,"Monmouth County, NJ",Oct-19,331346,321362,9984,3.0
24319,CN3402700000000,34,27,"Morris County, NJ",Oct-19,258824,251826,6998,2.7
24320,CN3402900000000,34,29,"Ocean County, NJ",Oct-19,276991,267437,9554,3.4
24321,CN3403100000000,34,31,"Passaic County, NJ",Oct-19,244639,234725,9914,4.1
24322,CN3403300000000,34,33,"Salem County, NJ",Oct-19,29551,28174,1377,4.7
24323,CN3403500000000,34,35,"Somerset County, NJ",Oct-19,172740,167699,5041,2.9
24324,CN3403700000000,34,37,"Sussex County, NJ",Oct-19,74631,72276,2355,3.2
24325,CN3403900000000,34,39,"Union County, NJ",Oct-19,278298,268319,9979,3.6
24326,CN3404100000000,34,41,"Warren County, NJ",Oct-19,57018,55290,1728,3.0
24327,CN3500100000000,35,1,"Bernalillo County, NM",Oct-19,337070,322518,14552,4.3
24328,CN3500300000000,35,3,"Catron County, NM",Oct-19,1154,1083,71,6.2
24329,CN3500500000000,35,5,"Chaves County, NM",Oct-19,27231,25872,1359,5.0
24330,CN3500600000000,35,6,"Cibola County, NM",Oct-19,9014,8460,554,6.1
24331,CN3500700000000,35,7,"Colfax County, NM",Oct-19,5167,4928,239,4.6
24332,CN3500900000000,35,9,"Curry County, NM",Oct-19,21732,20815,917,4.2
24333,CN3501100000000,35,11,"De Baca County, NM",Oct-19,789,757,32,4.1
24334,CN3501300000000,35,13,"Dona Ana County, NM",Oct-19,98847,93796,5051,5.1
24335,CN3501500000000,35,15,"Eddy County, NM",Oct-19,35463,34357,1106,3.1
24336,CN3501700000000,35,17,"Grant County, NM",Oct-19,12512,11946,566,4.5
24337,CN3501900000000,35,19,"Guadalupe County, NM",Oct-19,1543,1470,73,4.7
24338,CN3502100000000,35,21,"Harding County, NM",Oct-19,272,259,13,4.8
24339,CN3502300000000,35,23,"Hidalgo County, NM",Oct-19,2094,2001,93,4.4
24340,CN3502500000000,35,25,"Lea County, NM",Oct-19,32362,31074,1288,4.0
24341,CN3502700000000,35,27,"Lincoln County, NM",Oct-19,8855,8456,399,4.5
24342,CN3502800000000,35,28,"Los Alamos County, NM",Oct-19,9371,9077,294,3.1
24343,CN3502900000000,35,29,"Luna County, NM",Oct-19,10160,9315,845,8.3
24344,CN3503100000000,35,31,"McKinley County, NM",Oct-19,24104,22495,1609,6.7
24345,CN3503300000000,35,33,"Mora County, NM",Oct-19,2207,2089,118,5.3
24346,CN3503500000000,35,35,"Otero County, NM",Oct-19,24840,23663,1177,4.7
24347,CN3503700000000,35,37,"Quay County, NM",Oct-19,3225,3068,157,4.9
24348,CN3503900000000,35,39,"Rio Arriba County, NM",Oct-19,16792,15950,842,5.0
24349,CN3504100000000,35,41,"Roosevelt County, NM",Oct-19,8041,7680,361,4.5
24350,CN3504300000000,35,43,"Sandoval County, NM",Oct-19,67101,63958,3143,4.7
24351,CN3504500000000,35,45,"San Juan County, NM",Oct-19,52844,49965,2879,5.4
24352,CN3504700000000,35,47,"San Miguel County, NM",Oct-19,11069,10452,617,5.6
24353,CN3504900000000,35,49,"Santa Fe County, NM",Oct-19,75279,72478,2801,3.7
24354,CN3505100000000,35,51,"Sierra County, NM",Oct-19,3966,3743,223,5.6
24355,CN3505300000000,35,53,"Socorro County, NM",Oct-19,6462,6085,377,5.8
24356,CN3505500000000,35,55,"Taos County, NM",Oct-19,14968,14105,863,5.8
24357,CN3505700000000,35,57,"Torrance County, NM",Oct-19,6127,5757,370,6.0
24358,CN3505900000000,35,59,"Union County, NM",Oct-19,1819,1758,61,3.4
24359,CN3506100000000,35,61,"Valencia County, NM",Oct-19,30950,29323,1627,5.3
24360,CN3600100000000,36,1,"Albany County, NY",Oct-19,158948,153371,5577,3.5
24361,CN3600300000000,36,3,"Allegany County, NY",Oct-19,19876,18963,913,4.6
24362,CN3600500000000,36,5,"Bronx County, NY",Oct-19,597792,567740,30052,5.0
24363,CN3600700000000,36,7,"Broome County, NY",Oct-19,83697,80098,3599,4.3
24364,CN3600900000000,36,9,"Cattaraugus County, NY",Oct-19,33969,32471,1498,4.4
24365,CN3601100000000,36,11,"Cayuga County, NY",Oct-19,35726,34384,1342,3.8
24366,CN3601300000000,36,13,"Chautauqua County, NY",Oct-19,54067,51776,2291,4.2
24367,CN3601500000000,36,15,"Chemung County, NY",Oct-19,35222,33820,1402,4.0
24368,CN3601700000000,36,17,"Chenango County, NY",Oct-19,21926,21098,828,3.8
24369,CN3601900000000,36,19,"Clinton County, NY",Oct-19,36436,35021,1415,3.9
24370,CN3602100000000,36,21,"Columbia County, NY",Oct-19,31096,30196,900,2.9
24371,CN3602300000000,36,23,"Cortland County, NY",Oct-19,22988,22057,931,4.0
24372,CN3602500000000,36,25,"Delaware County, NY",Oct-19,19062,18283,779,4.1
24373,CN3602700000000,36,27,"Dutchess County, NY",Oct-19,144971,139859,5112,3.5
24374,CN3602900000000,36,29,"Erie County, NY",Oct-19,444019,426336,17683,4.0
24375,CN3603100000000,36,31,"Essex County, NY",Oct-19,16448,15814,634,3.9
24376,CN3603300000000,36,33,"Franklin County, NY",Oct-19,19537,18729,808,4.1
24377,CN3603500000000,36,35,"Fulton County, NY",Oct-19,22689,21666,1023,4.5
24378,CN3603700000000,36,37,"Genesee County, NY",Oct-19,29718,28718,1000,3.4
24379,CN3603900000000,36,39,"Greene County, NY",Oct-19,20053,19251,802,4.0
24380,CN3604100000000,36,41,"Hamilton County, NY",Oct-19,2143,2059,84,3.9
24381,CN3604300000000,36,43,"Herkimer County, NY",Oct-19,27716,26570,1146,4.1
24382,CN3604500000000,36,45,"Jefferson County, NY",Oct-19,43558,41424,2134,4.9
24383,CN3604700000000,36,47,"Kings County, NY",Oct-19,1199008,1153301,45707,3.8
24384,CN3604900000000,36,49,"Lewis County, NY",Oct-19,11569,11087,482,4.2
24385,CN3605100000000,36,51,"Livingston County, NY",Oct-19,30829,29685,1144,3.7
24386,CN3605300000000,36,53,"Madison County, NY",Oct-19,32872,31578,1294,3.9
24387,CN3605500000000,36,55,"Monroe County, NY",Oct-19,364651,350138,14513,4.0
24388,CN3605700000000,36,57,"Montgomery County, NY",Oct-19,22382,21413,969,4.3
24389,CN3605900000000,36,59,"Nassau County, NY",Oct-19,712936,688582,24354,3.4
24390,CN3606100000000,36,61,"New York County, NY",Oct-19,912586,882508,30078,3.3
24391,CN3606300000000,36,63,"Niagara County, NY",Oct-19,99035,94701,4334,4.4
24392,CN3606500000000,36,65,"Oneida County, NY",Oct-19,100898,96964,3934,3.9
24393,CN3606700000000,36,67,"Onondaga County, NY",Oct-19,222579,214201,8378,3.8
24394,CN3606900000000,36,69,"Ontario County, NY",Oct-19,55696,53738,1958,3.5
24395,CN3607100000000,36,71,"Orange County, NY",Oct-19,185360,178419,6941,3.7
24396,CN3607300000000,36,73,"Orleans County, NY",Oct-19,17604,16887,717,4.1
24397,CN3607500000000,36,75,"Oswego County, NY",Oct-19,53074,50598,2476,4.7
24398,CN3607700000000,36,77,"Otsego County, NY",Oct-19,28244,27204,1040,3.7
24399,CN3607900000000,36,79,"Putnam County, NY",Oct-19,51601,49714,1887,3.7
24400,CN3608100000000,36,81,"Queens County, NY",Oct-19,1140962,1103794,37168,3.3
24401,CN3608300000000,36,83,"Rensselaer County, NY",Oct-19,81706,78855,2851,3.5
24402,CN3608500000000,36,85,"Richmond County, NY",Oct-19,222594,214671,7923,3.6
24403,CN3608700000000,36,87,"Rockland County, NY",Oct-19,155509,150033,5476,3.5
24404,CN3608900000000,36,89,"St. Lawrence County, NY",Oct-19,43862,41774,2088,4.8
24405,CN3609100000000,36,91,"Saratoga County, NY",Oct-19,119883,116064,3819,3.2
24406,CN3609300000000,36,93,"Schenectady County, NY",Oct-19,76657,73899,2758,3.6
24407,CN3609500000000,36,95,"Schoharie County, NY",Oct-19,14619,14065,554,3.8
24408,CN3609700000000,36,97,"Schuyler County, NY",Oct-19,8134,7836,298,3.7
24409,CN3609900000000,36,99,"Seneca County, NY",Oct-19,16087,15534,553,3.4
24410,CN3610100000000,36,101,"Steuben County, NY",Oct-19,42582,40859,1723,4.0
24411,CN3610300000000,36,103,"Suffolk County, NY",Oct-19,782005,754784,27221,3.5
24412,CN3610500000000,36,105,"Sullivan County, NY",Oct-19,36592,35237,1355,3.7
24413,CN3610700000000,36,107,"Tioga County, NY",Oct-19,22776,21912,864,3.8
24414,CN3610900000000,36,109,"Tompkins County, NY",Oct-19,50174,48363,1811,3.6
24415,CN3611100000000,36,111,"Ulster County, NY",Oct-19,88786,85702,3084,3.5
24416,CN3611300000000,36,113,"Warren County, NY",Oct-19,31161,29990,1171,3.8
24417,CN3611500000000,36,115,"Washington County, NY",Oct-19,27721,26757,964,3.5
24418,CN3611700000000,36,117,"Wayne County, NY",Oct-19,44026,42473,1553,3.5
24419,CN3611900000000,36,119,"Westchester County, NY",Oct-19,484961,467003,17958,3.7
24420,CN3612100000000,36,121,"Wyoming County, NY",Oct-19,17965,17358,607,3.4
24421,CN3612300000000,36,123,"Yates County, NY",Oct-19,11860,11457,403,3.4
24422,CN3700100000000,37,1,"Alamance County, NC",Oct-19,83405,80555,2850,3.4
24423,CN3700300000000,37,3,"Alexander County, NC",Oct-19,18212,17651,561,3.1
24424,CN3700500000000,37,5,"Alleghany County, NC",Oct-19,4438,4242,196,4.4
24425,CN3700700000000,37,7,"Anson County, NC",Oct-19,10926,10505,421,3.9
24426,CN3700900000000,37,9,"Ashe County, NC",Oct-19,13086,12687,399,3.0
24427,CN3701100000000,37,11,"Avery County, NC",Oct-19,7712,7469,243,3.2
24428,CN3701300000000,37,13,"Beaufort County, NC",Oct-19,19404,18590,814,4.2
24429,CN3701500000000,37,15,"Bertie County, NC",Oct-19,7736,7403,333,4.3
24430,CN3701700000000,37,17,"Bladen County, NC",Oct-19,14410,13763,647,4.5
24431,CN3701900000000,37,19,"Brunswick County, NC",Oct-19,54463,51901,2562,4.7
24432,CN3702100000000,37,21,"Buncombe County, NC",Oct-19,143971,140077,3894,2.7
24433,CN3702300000000,37,23,"Burke County, NC",Oct-19,41545,40116,1429,3.4
24434,CN3702500000000,37,25,"Cabarrus County, NC",Oct-19,111292,107640,3652,3.3
24435,CN3702700000000,37,27,"Caldwell County, NC",Oct-19,37045,35690,1355,3.7
24436,CN3702900000000,37,29,"Camden County, NC",Oct-19,4628,4469,159,3.4
24437,CN3703100000000,37,31,"Carteret County, NC",Oct-19,32046,30917,1129,3.5
24438,CN3703300000000,37,33,"Caswell County, NC",Oct-19,9987,9570,417,4.2
24439,CN3703500000000,37,35,"Catawba County, NC",Oct-19,80062,77412,2650,3.3
24440,CN3703700000000,37,37,"Chatham County, NC",Oct-19,36151,35030,1121,3.1
24441,CN3703900000000,37,39,"Cherokee County, NC",Oct-19,11230,10786,444,4.0
24442,CN3704100000000,37,41,"Chowan County, NC",Oct-19,5508,5278,230,4.2
24443,CN3704300000000,37,43,"Clay County, NC",Oct-19,4204,4036,168,4.0
24444,CN3704500000000,37,45,"Cleveland County, NC",Oct-19,49292,47473,1819,3.7
24445,CN3704700000000,37,47,"Columbus County, NC",Oct-19,23273,22226,1047,4.5
24446,CN3704900000000,37,49,"Craven County, NC",Oct-19,42143,40620,1523,3.6
24447,CN3705100000000,37,51,"Cumberland County, NC",Oct-19,128898,122862,6036,4.7
24448,CN3705300000000,37,53,"Currituck County, NC",Oct-19,14137,13691,446,3.2
24449,CN3705500000000,37,55,"Dare County, NC",Oct-19,19801,19127,674,3.4
24450,CN3705700000000,37,57,"Davidson County, NC",Oct-19,82602,79786,2816,3.4
24451,CN3705900000000,37,59,"Davie County, NC",Oct-19,21039,20389,650,3.1
24452,CN3706100000000,37,61,"Duplin County, NC",Oct-19,25158,24258,900,3.6
24453,CN3706300000000,37,63,"Durham County, NC",Oct-19,173851,168451,5400,3.1
24454,CN3706500000000,37,65,"Edgecombe County, NC",Oct-19,21468,20310,1158,5.4
24455,CN3706700000000,37,67,"Forsyth County, NC",Oct-19,191735,185251,6484,3.4
24456,CN3706900000000,37,69,"Franklin County, NC",Oct-19,31920,30766,1154,3.6
24457,CN3707100000000,37,71,"Gaston County, NC",Oct-19,113356,109380,3976,3.5
24458,CN3707300000000,37,73,"Gates County, NC",Oct-19,5341,5145,196,3.7
24459,CN3707500000000,37,75,"Graham County, NC",Oct-19,3261,3114,147,4.5
24460,CN3707700000000,37,77,"Granville County, NC",Oct-19,30203,29278,925,3.1
24461,CN3707900000000,37,79,"Greene County, NC",Oct-19,9450,9128,322,3.4
24462,CN3708100000000,37,81,"Guilford County, NC",Oct-19,267697,257740,9957,3.7
24463,CN3708300000000,37,83,"Halifax County, NC",Oct-19,20513,19377,1136,5.5
24464,CN3708500000000,37,85,"Harnett County, NC",Oct-19,54280,52067,2213,4.1
24465,CN3708700000000,37,87,"Haywood County, NC",Oct-19,30637,29729,908,3.0
24466,CN3708900000000,37,89,"Henderson County, NC",Oct-19,56347,54663,1684,3.0
24467,CN3709100000000,37,91,"Hertford County, NC",Oct-19,9239,8820,419,4.5
24468,CN3709300000000,37,93,"Hoke County, NC",Oct-19,20301,19354,947,4.7
24469,CN3709500000000,37,95,"Hyde County, NC",Oct-19,1976,1795,181,9.2
24470,CN3709700000000,37,97,"Iredell County, NC",Oct-19,91312,88285,3027,3.3
24471,CN3709900000000,37,99,"Jackson County, NC",Oct-19,20508,19793,715,3.5
24472,CN3710100000000,37,101,"Johnston County, NC",Oct-19,100939,97630,3309,3.3
24473,CN3710300000000,37,103,"Jones County, NC",Oct-19,4371,4215,156,3.6
24474,CN3710500000000,37,105,"Lee County, NC",Oct-19,26294,25230,1064,4.0
24475,CN3710700000000,37,107,"Lenoir County, NC",Oct-19,27815,26840,975,3.5
24476,CN3710900000000,37,109,"Lincoln County, NC",Oct-19,44357,42928,1429,3.2
24477,CN3711100000000,37,111,"McDowell County, NC",Oct-19,20987,20102,885,4.2
24478,CN3711300000000,37,113,"Macon County, NC",Oct-19,15829,15308,521,3.3
24479,CN3711500000000,37,115,"Madison County, NC",Oct-19,10400,10060,340,3.3
24480,CN3711700000000,37,117,"Martin County, NC",Oct-19,9061,8654,407,4.5
24481,CN3711900000000,37,119,"Mecklenburg County, NC",Oct-19,635182,614079,21103,3.3
24482,CN3712100000000,37,121,"Mitchell County, NC",Oct-19,6153,5903,250,4.1
24483,CN3712300000000,37,123,"Montgomery County, NC",Oct-19,11527,11086,441,3.8
24484,CN3712500000000,37,125,"Moore County, NC",Oct-19,42862,41363,1499,3.5
24485,CN3712700000000,37,127,"Nash County, NC",Oct-19,43822,41885,1937,4.4
24486,CN3712900000000,37,129,"New Hanover County, NC",Oct-19,126332,122358,3974,3.1
24487,CN3713100000000,37,131,"Northampton County, NC",Oct-19,7749,7375,374,4.8
24488,CN3713300000000,37,133,"Onslow County, NC",Oct-19,65817,63007,2810,4.3
24489,CN3713500000000,37,135,"Orange County, NC",Oct-19,80083,77731,2352,2.9
24490,CN3713700000000,37,137,"Pamlico County, NC",Oct-19,5364,5183,181,3.4
24491,CN3713900000000,37,139,"Pasquotank County, NC",Oct-19,16758,16068,690,4.1
24492,CN3714100000000,37,141,"Pender County, NC",Oct-19,29290,28251,1039,3.5
24493,CN3714300000000,37,143,"Perquimans County, NC",Oct-19,4943,4713,230,4.7
24494,CN3714500000000,37,145,"Person County, NC",Oct-19,18668,17943,725,3.9
24495,CN3714700000000,37,147,"Pitt County, NC",Oct-19,91338,87828,3510,3.8
24496,CN3714900000000,37,149,"Polk County, NC",Oct-19,9193,8870,323,3.5
24497,CN3715100000000,37,151,"Randolph County, NC",Oct-19,67411,65104,2307,3.4
24498,CN3715300000000,37,153,"Richmond County, NC",Oct-19,16740,15892,848,5.1
24499,CN3715500000000,37,155,"Robeson County, NC",Oct-19,50407,47906,2501,5.0
24500,CN3715700000000,37,157,"Rockingham County, NC",Oct-19,40858,39216,1642,4.0
24501,CN3715900000000,37,159,"Rowan County, NC",Oct-19,67492,65038,2454,3.6
24502,CN3716100000000,37,161,"Rutherford County, NC",Oct-19,25601,24452,1149,4.5
24503,CN3716300000000,37,163,"Sampson County, NC",Oct-19,29179,28145,1034,3.5
24504,CN3716500000000,37,165,"Scotland County, NC",Oct-19,11583,10859,724,6.3
24505,CN3716700000000,37,167,"Stanly County, NC",Oct-19,30706,29620,1086,3.5
24506,CN3716900000000,37,169,"Stokes County, NC",Oct-19,22149,21424,725,3.3
24507,CN3717100000000,37,171,"Surry County, NC",Oct-19,34422,33227,1195,3.5
24508,CN3717300000000,37,173,"Swain County, NC",Oct-19,7133,6902,231,3.2
24509,CN3717500000000,37,175,"Transylvania County, NC",Oct-19,14838,14337,501,3.4
24510,CN3717700000000,37,177,"Tyrrell County, NC",Oct-19,1433,1359,74,5.2
24511,CN3717900000000,37,179,"Union County, NC",Oct-19,126229,122302,3927,3.1
24512,CN3718100000000,37,181,"Vance County, NC",Oct-19,17532,16579,953,5.4
24513,CN3718300000000,37,183,"Wake County, NC",Oct-19,608754,590387,18367,3.0
24514,CN3718500000000,37,185,"Warren County, NC",Oct-19,6654,6304,350,5.3
24515,CN3718700000000,37,187,"Washington County, NC",Oct-19,4437,4204,233,5.3
24516,CN3718900000000,37,189,"Watauga County, NC",Oct-19,30472,29561,911,3.0
24517,CN3719100000000,37,191,"Wayne County, NC",Oct-19,51591,49606,1985,3.8
24518,CN3719300000000,37,193,"Wilkes County, NC",Oct-19,29523,28404,1119,3.8
24519,CN3719500000000,37,195,"Wilson County, NC",Oct-19,34960,33099,1861,5.3
24520,CN3719700000000,37,197,"Yadkin County, NC",Oct-19,18004,17448,556,3.1
24521,CN3719900000000,37,199,"Yancey County, NC",Oct-19,8652,8364,288,3.3
24522,CN3800100000000,38,1,"Adams County, ND",Oct-19,1056,1036,20,1.9
24523,CN3800300000000,38,3,"Barnes County, ND",Oct-19,5158,5069,89,1.7
24524,CN3800500000000,38,5,"Benson County, ND",Oct-19,2314,2247,67,2.9
24525,CN3800700000000,38,7,"Billings County, ND",Oct-19,401,392,9,2.2
24526,CN3800900000000,38,9,"Bottineau County, ND",Oct-19,2927,2873,54,1.8
24527,CN3801100000000,38,11,"Bowman County, ND",Oct-19,1713,1688,25,1.5
24528,CN3801300000000,38,13,"Burke County, ND",Oct-19,1045,1026,19,1.8
24529,CN3801500000000,38,15,"Burleigh County, ND",Oct-19,48905,48106,799,1.6
24530,CN3801700000000,38,17,"Cass County, ND",Oct-19,102661,101221,1440,1.4
24531,CN3801900000000,38,19,"Cavalier County, ND",Oct-19,1917,1880,37,1.9
24532,CN3802100000000,38,21,"Dickey County, ND",Oct-19,2265,2239,26,1.1
24533,CN3802300000000,38,23,"Divide County, ND",Oct-19,1418,1401,17,1.2
24534,CN3802500000000,38,25,"Dunn County, ND",Oct-19,3222,3182,40,1.2
24535,CN3802700000000,38,27,"Eddy County, ND",Oct-19,1209,1175,34,2.8
24536,CN3802900000000,38,29,"Emmons County, ND",Oct-19,1440,1407,33,2.3
24537,CN3803100000000,38,31,"Foster County, ND",Oct-19,1467,1439,28,1.9
24538,CN3803300000000,38,33,"Golden Valley County, ND",Oct-19,827,816,11,1.3
24539,CN3803500000000,38,35,"Grand Forks County, ND",Oct-19,37183,36643,540,1.5
24540,CN3803700000000,38,37,"Grant County, ND",Oct-19,1208,1192,16,1.3
24541,CN3803900000000,38,39,"Griggs County, ND",Oct-19,1023,1006,17,1.7
24542,CN3804100000000,38,41,"Hettinger County, ND",Oct-19,1397,1371,26,1.9
24543,CN3804300000000,38,43,"Kidder County, ND",Oct-19,1243,1219,24,1.9
24544,CN3804500000000,38,45,"LaMoure County, ND",Oct-19,2060,2031,29,1.4
24545,CN3804700000000,38,47,"Logan County, ND",Oct-19,866,855,11,1.3
24546,CN3804900000000,38,49,"McHenry County, ND",Oct-19,3041,2977,64,2.1
24547,CN3805100000000,38,51,"McIntosh County, ND",Oct-19,1103,1082,21,1.9
24548,CN3805300000000,38,53,"McKenzie County, ND",Oct-19,10432,10280,152,1.5
24549,CN3805500000000,38,55,"McLean County, ND",Oct-19,4630,4543,87,1.9
24550,CN3805700000000,38,57,"Mercer County, ND",Oct-19,3449,3363,86,2.5
24551,CN3805900000000,38,59,"Morton County, ND",Oct-19,16061,15749,312,1.9
24552,CN3806100000000,38,61,"Mountrail County, ND",Oct-19,7417,7331,86,1.2
24553,CN3806300000000,38,63,"Nelson County, ND",Oct-19,1381,1353,28,2.0
24554,CN3806500000000,38,65,"Oliver County, ND",Oct-19,856,841,15,1.8
24555,CN3806700000000,38,67,"Pembina County, ND",Oct-19,3307,3241,66,2.0
24556,CN3806900000000,38,69,"Pierce County, ND",Oct-19,1689,1653,36,2.1
24557,CN3807100000000,38,71,"Ramsey County, ND",Oct-19,5503,5395,108,2.0
24558,CN3807300000000,38,73,"Ransom County, ND",Oct-19,2790,2761,29,1.0
24559,CN3807500000000,38,75,"Renville County, ND",Oct-19,1231,1210,21,1.7
24560,CN3807700000000,38,77,"Richland County, ND",Oct-19,8608,8474,134,1.6
24561,CN3807900000000,38,79,"Rolette County, ND",Oct-19,4454,4237,217,4.9
24562,CN3808100000000,38,81,"Sargent County, ND",Oct-19,2637,2607,30,1.1
24563,CN3808300000000,38,83,"Sheridan County, ND",Oct-19,678,659,19,2.8
24564,CN3808500000000,38,85,"Sioux County, ND",Oct-19,1237,1199,38,3.1
24565,CN3808700000000,38,87,"Slope County, ND",Oct-19,409,401,8,2.0
24566,CN3808900000000,38,89,"Stark County, ND",Oct-19,18371,18090,281,1.5
24567,CN3809100000000,38,91,"Steele County, ND",Oct-19,979,967,12,1.2
24568,CN3809300000000,38,93,"Stutsman County, ND",Oct-19,10147,9987,160,1.6
24569,CN3809500000000,38,95,"Towner County, ND",Oct-19,1114,1090,24,2.2
24570,CN3809700000000,38,97,"Traill County, ND",Oct-19,4359,4295,64,1.5
24571,CN3809900000000,38,99,"Walsh County, ND",Oct-19,5093,4988,105,2.1
24572,CN3810100000000,38,101,"Ward County, ND",Oct-19,31303,30771,532,1.7
24573,CN3810300000000,38,103,"Wells County, ND",Oct-19,1893,1857,36,1.9
24574,CN3810500000000,38,105,"Williams County, ND",Oct-19,24554,24199,355,1.4
24575,CN3900100000000,39,1,"Adams County, OH",Oct-19,10648,10048,600,5.6
24576,CN3900300000000,39,3,"Allen County, OH",Oct-19,47673,45842,1831,3.8
24577,CN3900500000000,39,5,"Ashland County, OH",Oct-19,26973,25950,1023,3.8
24578,CN3900700000000,39,7,"Ashtabula County, OH",Oct-19,44465,42566,1899,4.3
24579,CN3900900000000,39,9,"Athens County, OH",Oct-19,29654,28288,1366,4.6
24580,CN3901100000000,39,11,"Auglaize County, OH",Oct-19,24932,24176,756,3.0
24581,CN3901300000000,39,13,"Belmont County, OH",Oct-19,30477,28808,1669,5.5
24582,CN3901500000000,39,15,"Brown County, OH",Oct-19,19644,18773,871,4.4
24583,CN3901700000000,39,17,"Butler County, OH",Oct-19,196219,189071,7148,3.6
24584,CN3901900000000,39,19,"Carroll County, OH",Oct-19,13051,12434,617,4.7
24585,CN3902100000000,39,21,"Champaign County, OH",Oct-19,20134,19220,914,4.5
24586,CN3902300000000,39,23,"Clark County, OH",Oct-19,64014,60915,3099,4.8
24587,CN3902500000000,39,25,"Clermont County, OH",Oct-19,107354,103666,3688,3.4
24588,CN3902700000000,39,27,"Clinton County, OH",Oct-19,17814,17050,764,4.3
24589,CN3902900000000,39,29,"Columbiana County, OH",Oct-19,47652,45505,2147,4.5
24590,CN3903100000000,39,31,"Coshocton County, OH",Oct-19,14358,13585,773,5.4
24591,CN3903300000000,39,33,"Crawford County, OH",Oct-19,18190,17386,804,4.4
24592,CN3903500000000,39,35,"Cuyahoga County, OH",Oct-19,612718,591180,21538,3.5
24593,CN3903700000000,39,37,"Darke County, OH",Oct-19,25805,24934,871,3.4
24594,CN3903900000000,39,39,"Defiance County, OH",Oct-19,18477,17660,817,4.4
24595,CN3904100000000,39,41,"Delaware County, OH",Oct-19,111550,108125,3425,3.1
24596,CN3904300000000,39,43,"Erie County, OH",Oct-19,37018,35504,1514,4.1
24597,CN3904500000000,39,45,"Fairfield County, OH",Oct-19,78598,75880,2718,3.5
24598,CN3904700000000,39,47,"Fayette County, OH",Oct-19,13892,13389,503,3.6
24599,CN3904900000000,39,49,"Franklin County, OH",Oct-19,704318,680640,23678,3.4
24600,CN3905100000000,39,51,"Fulton County, OH",Oct-19,22680,21825,855,3.8
24601,CN3905300000000,39,53,"Gallia County, OH",Oct-19,12228,11648,580,4.7
24602,CN3905500000000,39,55,"Geauga County, OH",Oct-19,49241,47863,1378,2.8
24603,CN3905700000000,39,57,"Greene County, OH",Oct-19,84114,81059,3055,3.6
24604,CN3905900000000,39,59,"Guernsey County, OH",Oct-19,18552,17643,909,4.9
24605,CN3906100000000,39,61,"Hamilton County, OH",Oct-19,418838,403575,15263,3.6
24606,CN3906300000000,39,63,"Hancock County, OH",Oct-19,41972,40733,1239,3.0
24607,CN3906500000000,39,65,"Hardin County, OH",Oct-19,13780,13227,553,4.0
24608,CN3906700000000,39,67,"Harrison County, OH",Oct-19,6739,6392,347,5.1
24609,CN3906900000000,39,69,"Henry County, OH",Oct-19,13411,12902,509,3.8
24610,CN3907100000000,39,71,"Highland County, OH",Oct-19,17056,16264,792,4.6
24611,CN3907300000000,39,73,"Hocking County, OH",Oct-19,13165,12636,529,4.0
24612,CN3907500000000,39,75,"Holmes County, OH",Oct-19,20836,20222,614,2.9
24613,CN3907700000000,39,77,"Huron County, OH",Oct-19,27742,26418,1324,4.8
24614,CN3907900000000,39,79,"Jackson County, OH",Oct-19,12569,11919,650,5.2
24615,CN3908100000000,39,81,"Jefferson County, OH",Oct-19,27914,26324,1590,5.7
24616,CN3908300000000,39,83,"Knox County, OH",Oct-19,31839,30735,1104,3.5
24617,CN3908500000000,39,85,"Lake County, OH",Oct-19,126133,122451,3682,2.9
24618,CN3908700000000,39,87,"Lawrence County, OH",Oct-19,23963,22790,1173,4.9
24619,CN3908900000000,39,89,"Licking County, OH",Oct-19,91327,88115,3212,3.5
24620,CN3909100000000,39,91,"Logan County, OH",Oct-19,22673,21873,800,3.5
24621,CN3909300000000,39,93,"Lorain County, OH",Oct-19,153390,148004,5386,3.5
24622,CN3909500000000,39,95,"Lucas County, OH",Oct-19,212691,203843,8848,4.2
24623,CN3909700000000,39,97,"Madison County, OH",Oct-19,20893,20239,654,3.1
24624,CN3909900000000,39,99,"Mahoning County, OH",Oct-19,102861,97536,5325,5.2
24625,CN3910100000000,39,101,"Marion County, OH",Oct-19,28216,27176,1040,3.7
24626,CN3910300000000,39,103,"Medina County, OH",Oct-19,97602,94826,2776,2.8
24627,CN3910500000000,39,105,"Meigs County, OH",Oct-19,9161,8636,525,5.7
24628,CN3910700000000,39,107,"Mercer County, OH",Oct-19,23206,22618,588,2.5
24629,CN3910900000000,39,109,"Miami County, OH",Oct-19,54575,52686,1889,3.5
24630,CN3911100000000,39,111,"Monroe County, OH",Oct-19,5305,4916,389,7.3
24631,CN3911300000000,39,113,"Montgomery County, OH",Oct-19,255615,244921,10694,4.2
24632,CN3911500000000,39,115,"Morgan County, OH",Oct-19,6638,6266,372,5.6
24633,CN3911700000000,39,117,"Morrow County, OH",Oct-19,16896,16303,593,3.5
24634,CN3911900000000,39,119,"Muskingum County, OH",Oct-19,39714,38062,1652,4.2
24635,CN3912100000000,39,121,"Noble County, OH",Oct-19,4670,4391,279,6.0
24636,CN3912300000000,39,123,"Ottawa County, OH",Oct-19,20925,20061,864,4.1
24637,CN3912500000000,39,125,"Paulding County, OH",Oct-19,8657,8333,324,3.7
24638,CN3912700000000,39,127,"Perry County, OH",Oct-19,15991,15230,761,4.8
24639,CN3912900000000,39,129,"Pickaway County, OH",Oct-19,26588,25646,942,3.5
24640,CN3913100000000,39,131,"Pike County, OH",Oct-19,10754,10166,588,5.5
24641,CN3913300000000,39,133,"Portage County, OH",Oct-19,87868,84495,3373,3.8
24642,CN3913500000000,39,135,"Preble County, OH",Oct-19,21243,20476,767,3.6
24643,CN3913700000000,39,137,"Putnam County, OH",Oct-19,18765,18242,523,2.8
24644,CN3913900000000,39,139,"Richland County, OH",Oct-19,51779,49620,2159,4.2
24645,CN3914100000000,39,141,"Ross County, OH",Oct-19,35340,34054,1286,3.6
24646,CN3914300000000,39,143,"Sandusky County, OH",Oct-19,30497,29126,1371,4.5
24647,CN3914500000000,39,145,"Scioto County, OH",Oct-19,29081,27460,1621,5.6
24648,CN3914700000000,39,147,"Seneca County, OH",Oct-19,27251,26212,1039,3.8
24649,CN3914900000000,39,149,"Shelby County, OH",Oct-19,24047,23240,807,3.4
24650,CN3915100000000,39,151,"Stark County, OH",Oct-19,186909,179200,7709,4.1
24651,CN3915300000000,39,153,"Summit County, OH",Oct-19,274119,263402,10717,3.9
24652,CN3915500000000,39,155,"Trumbull County, OH",Oct-19,86582,81788,4794,5.5
24653,CN3915700000000,39,157,"Tuscarawas County, OH",Oct-19,44916,43115,1801,4.0
24654,CN3915900000000,39,159,"Union County, OH",Oct-19,29224,28307,917,3.1
24655,CN3916100000000,39,161,"Van Wert County, OH",Oct-19,15021,14536,485,3.2
24656,CN3916300000000,39,163,"Vinton County, OH",Oct-19,5565,5303,262,4.7
24657,CN3916500000000,39,165,"Warren County, OH",Oct-19,119919,115876,4043,3.4
24658,CN3916700000000,39,167,"Washington County, OH",Oct-19,27554,26217,1337,4.9
24659,CN3916900000000,39,169,"Wayne County, OH",Oct-19,62254,60348,1906,3.1
24660,CN3917100000000,39,171,"Williams County, OH",Oct-19,19056,18431,625,3.3
24661,CN3917300000000,39,173,"Wood County, OH",Oct-19,72144,69676,2468,3.4
24662,CN3917500000000,39,175,"Wyandot County, OH",Oct-19,12848,12488,360,2.8
24663,CN4000100000000,40,1,"Adair County, OK",Oct-19,8196,7883,313,3.8
24664,CN4000300000000,40,3,"Alfalfa County, OK",Oct-19,2906,2840,66,2.3
24665,CN4000500000000,40,5,"Atoka County, OK",Oct-19,4942,4719,223,4.5
24666,CN4000700000000,40,7,"Beaver County, OK",Oct-19,2960,2914,46,1.6
24667,CN4000900000000,40,9,"Beckham County, OK",Oct-19,10209,9784,425,4.2
24668,CN4001100000000,40,11,"Blaine County, OK",Oct-19,4760,4669,91,1.9
24669,CN4001300000000,40,13,"Bryan County, OK",Oct-19,21306,20699,607,2.8
24670,CN4001500000000,40,15,"Caddo County, OK",Oct-19,11878,11420,458,3.9
24671,CN4001700000000,40,17,"Canadian County, OK",Oct-19,75173,72987,2186,2.9
24672,CN4001900000000,40,19,"Carter County, OK",Oct-19,21651,20909,742,3.4
24673,CN4002100000000,40,21,"Cherokee County, OK",Oct-19,18788,18088,700,3.7
24674,CN4002300000000,40,23,"Choctaw County, OK",Oct-19,5375,5120,255,4.7
24675,CN4002500000000,40,25,"Cimarron County, OK",Oct-19,1403,1380,23,1.6
24676,CN4002700000000,40,27,"Cleveland County, OK",Oct-19,143907,140067,3840,2.7
24677,CN4002900000000,40,29,"Coal County, OK",Oct-19,2416,2302,114,4.7
24678,CN4003100000000,40,31,"Comanche County, OK",Oct-19,48110,46328,1782,3.7
24679,CN4003300000000,40,33,"Cotton County, OK",Oct-19,2758,2655,103,3.7
24680,CN4003500000000,40,35,"Craig County, OK",Oct-19,5956,5733,223,3.7
24681,CN4003700000000,40,37,"Creek County, OK",Oct-19,31871,30596,1275,4.0
24682,CN4003900000000,40,39,"Custer County, OK",Oct-19,15677,15266,411,2.6
24683,CN4004100000000,40,41,"Delaware County, OK",Oct-19,18034,17368,666,3.7
24684,CN4004300000000,40,43,"Dewey County, OK",Oct-19,2934,2856,78,2.7
24685,CN4004500000000,40,45,"Ellis County, OK",Oct-19,2167,2114,53,2.4
24686,CN4004700000000,40,47,"Garfield County, OK",Oct-19,26944,26146,798,3.0
24687,CN4004900000000,40,49,"Garvin County, OK",Oct-19,12515,12102,413,3.3
24688,CN4005100000000,40,51,"Grady County, OK",Oct-19,26858,25989,869,3.2
24689,CN4005300000000,40,53,"Grant County, OK",Oct-19,2693,2647,46,1.7
24690,CN4005500000000,40,55,"Greer County, OK",Oct-19,1890,1812,78,4.1
24691,CN4005700000000,40,57,"Harmon County, OK",Oct-19,1183,1151,32,2.7
24692,CN4005900000000,40,59,"Harper County, OK",Oct-19,1831,1779,52,2.8
24693,CN4006100000000,40,61,"Haskell County, OK",Oct-19,4258,3995,263,6.2
24694,CN4006300000000,40,63,"Hughes County, OK",Oct-19,5429,5135,294,5.4
24695,CN4006500000000,40,65,"Jackson County, OK",Oct-19,10755,10452,303,2.8
24696,CN4006700000000,40,67,"Jefferson County, OK",Oct-19,2551,2474,77,3.0
24697,CN4006900000000,40,69,"Johnston County, OK",Oct-19,3705,3527,178,4.8
24698,CN4007100000000,40,71,"Kay County, OK",Oct-19,18423,17647,776,4.2
24699,CN4007300000000,40,73,"Kingfisher County, OK",Oct-19,9154,8987,167,1.8
24700,CN4007500000000,40,75,"Kiowa County, OK",Oct-19,3518,3370,148,4.2
24701,CN4007700000000,40,77,"Latimer County, OK",Oct-19,3174,2935,239,7.5
24702,CN4007900000000,40,79,"Le Flore County, OK",Oct-19,19081,18187,894,4.7
24703,CN4008100000000,40,81,"Lincoln County, OK",Oct-19,15924,15376,548,3.4
24704,CN4008300000000,40,83,"Logan County, OK",Oct-19,22294,21708,586,2.6
24705,CN4008500000000,40,85,"Love County, OK",Oct-19,6227,6085,142,2.3
24706,CN4008700000000,40,87,"McClain County, OK",Oct-19,19912,19342,570,2.9
24707,CN4008900000000,40,89,"McCurtain County, OK",Oct-19,14875,14013,862,5.8
24708,CN4009100000000,40,91,"McIntosh County, OK",Oct-19,7169,6742,427,6.0
24709,CN4009300000000,40,93,"Major County, OK",Oct-19,3855,3773,82,2.1
24710,CN4009500000000,40,95,"Marshall County, OK",Oct-19,6930,6711,219,3.2
24711,CN4009700000000,40,97,"Mayes County, OK",Oct-19,19525,18920,605,3.1
24712,CN4009900000000,40,99,"Murray County, OK",Oct-19,6338,6146,192,3.0
24713,CN4010100000000,40,101,"Muskogee County, OK",Oct-19,29881,28763,1118,3.7
24714,CN4010300000000,40,103,"Noble County, OK",Oct-19,5667,5523,144,2.5
24715,CN4010500000000,40,105,"Nowata County, OK",Oct-19,4650,4493,157,3.4
24716,CN4010700000000,40,107,"Okfuskee County, OK",Oct-19,4655,4427,228,4.9
24717,CN4010900000000,40,109,"Oklahoma County, OK",Oct-19,388081,375946,12135,3.1
24718,CN4011100000000,40,111,"Okmulgee County, OK",Oct-19,15854,15060,794,5.0
24719,CN4011300000000,40,113,"Osage County, OK",Oct-19,20874,20093,781,3.7
24720,CN4011500000000,40,115,"Ottawa County, OK",Oct-19,14091,13639,452,3.2
24721,CN4011700000000,40,117,"Pawnee County, OK",Oct-19,7412,7120,292,3.9
24722,CN4011900000000,40,119,"Payne County, OK",Oct-19,37863,36923,940,2.5
24723,CN4012100000000,40,121,"Pittsburg County, OK",Oct-19,17129,16310,819,4.8
24724,CN4012300000000,40,123,"Pontotoc County, OK",Oct-19,19643,18758,885,4.5
24725,CN4012500000000,40,125,"Pottawatomie County, OK",Oct-19,32647,31474,1173,3.6
24726,CN4012700000000,40,127,"Pushmataha County, OK",Oct-19,4326,4100,226,5.2
24727,CN4012900000000,40,129,"Roger Mills County, OK",Oct-19,1918,1845,73,3.8
24728,CN4013100000000,40,131,"Rogers County, OK",Oct-19,45489,44060,1429,3.1
24729,CN4013300000000,40,133,"Seminole County, OK",Oct-19,9601,9071,530,5.5
24730,CN4013500000000,40,135,"Sequoyah County, OK",Oct-19,16202,15513,689,4.3
24731,CN4013700000000,40,137,"Stephens County, OK",Oct-19,18453,17517,936,5.1
24732,CN4013900000000,40,139,"Texas County, OK",Oct-19,11459,11285,174,1.5
24733,CN4014100000000,40,141,"Tillman County, OK",Oct-19,3074,2930,144,4.7
24734,CN4014300000000,40,143,"Tulsa County, OK",Oct-19,325874,314516,11358,3.5
24735,CN4014500000000,40,145,"Wagoner County, OK",Oct-19,38287,36993,1294,3.4
24736,CN4014700000000,40,147,"Washington County, OK",Oct-19,22217,21478,739,3.3
24737,CN4014900000000,40,149,"Washita County, OK",Oct-19,5300,5074,226,4.3
24738,CN4015100000000,40,151,"Woods County, OK",Oct-19,4680,4600,80,1.7
24739,CN4015300000000,40,153,"Woodward County, OK",Oct-19,8940,8648,292,3.3
24740,CN4100100000000,41,1,"Baker County, OR",Oct-19,7256,7007,249,3.4
24741,CN4100300000000,41,3,"Benton County, OR",Oct-19,48875,47733,1142,2.3
24742,CN4100500000000,41,5,"Clackamas County, OR",Oct-19,219951,213713,6238,2.8
24743,CN4100700000000,41,7,"Clatsop County, OR",Oct-19,19446,18856,590,3.0
24744,CN4100900000000,41,9,"Columbia County, OR",Oct-19,24417,23480,937,3.8
24745,CN4101100000000,41,11,"Coos County, OR",Oct-19,25935,24936,999,3.9
24746,CN4101300000000,41,13,"Crook County, OR",Oct-19,9593,9210,383,4.0
24747,CN4101500000000,41,15,"Curry County, OR",Oct-19,8984,8634,350,3.9
24748,CN4101700000000,41,17,"Deschutes County, OR",Oct-19,96369,93551,2818,2.9
24749,CN4101900000000,41,19,"Douglas County, OR",Oct-19,46398,44551,1847,4.0
24750,CN4102100000000,41,21,"Gilliam County, OR",Oct-19,877,846,31,3.5
24751,CN4102300000000,41,23,"Grant County, OR",Oct-19,3181,3054,127,4.0
24752,CN4102500000000,41,25,"Harney County, OR",Oct-19,3584,3473,111,3.1
24753,CN4102700000000,41,27,"Hood River County, OR",Oct-19,14332,13991,341,2.4
24754,CN4102900000000,41,29,"Jackson County, OR",Oct-19,104139,100828,3311,3.2
24755,CN4103100000000,41,31,"Jefferson County, OR",Oct-19,10034,9675,359,3.6
24756,CN4103300000000,41,33,"Josephine County, OR",Oct-19,35818,34422,1396,3.9
24757,CN4103500000000,41,35,"Klamath County, OR",Oct-19,29345,27961,1384,4.7
24758,CN4103700000000,41,37,"Lake County, OR",Oct-19,3656,3533,123,3.4
24759,CN4103900000000,41,39,"Lane County, OR",Oct-19,181792,175810,5982,3.3
24760,CN4104100000000,41,41,"Lincoln County, OR",Oct-19,20621,19898,723,3.5
24761,CN4104300000000,41,43,"Linn County, OR",Oct-19,58943,56887,2056,3.5
24762,CN4104500000000,41,45,"Malheur County, OR",Oct-19,12478,12131,347,2.8
24763,CN4104700000000,41,47,"Marion County, OR",Oct-19,162210,157070,5140,3.2
24764,CN4104900000000,41,49,"Morrow County, OR",Oct-19,5774,5611,163,2.8
24765,CN4105100000000,41,51,"Multnomah County, OR",Oct-19,456073,443524,12549,2.8
24766,CN4105300000000,41,53,"Polk County, OR",Oct-19,40170,38839,1331,3.3
24767,CN4105500000000,41,55,"Sherman County, OR",Oct-19,945,920,25,2.6
24768,CN4105700000000,41,57,"Tillamook County, OR",Oct-19,11775,11401,374,3.2
24769,CN4105900000000,41,59,"Umatilla County, OR",Oct-19,36892,35669,1223,3.3
24770,CN4106100000000,41,61,"Union County, OR",Oct-19,11981,11574,407,3.4
24771,CN4106300000000,41,63,"Wallowa County, OR",Oct-19,3378,3254,124,3.7
24772,CN4106500000000,41,65,"Wasco County, OR",Oct-19,12541,12107,434,3.5
24773,CN4106700000000,41,67,"Washington County, OR",Oct-19,325734,317232,8502,2.6
24774,CN4106900000000,41,69,"Wheeler County, OR",Oct-19,737,711,26,3.5
24775,CN4107100000000,41,71,"Yamhill County, OR",Oct-19,54954,53426,1528,2.8
24776,CN4200100000000,42,1,"Adams County, PA",Oct-19,55545,53717,1828,3.3
24777,CN4200300000000,42,3,"Allegheny County, PA",Oct-19,655839,628425,27414,4.2
24778,CN4200500000000,42,5,"Armstrong County, PA",Oct-19,32430,30903,1527,4.7
24779,CN4200700000000,42,7,"Beaver County, PA",Oct-19,84817,81024,3793,4.5
24780,CN4200900000000,42,9,"Bedford County, PA",Oct-19,23593,22561,1032,4.4
24781,CN4201100000000,42,11,"Berks County, PA",Oct-19,217403,207765,9638,4.4
24782,CN4201300000000,42,13,"Blair County, PA",Oct-19,59553,56832,2721,4.6
24783,CN4201500000000,42,15,"Bradford County, PA",Oct-19,28871,27573,1298,4.5
24784,CN4201700000000,42,17,"Bucks County, PA",Oct-19,348291,334531,13760,4.0
24785,CN4201900000000,42,19,"Butler County, PA",Oct-19,100754,96868,3886,3.9
24786,CN4202100000000,42,21,"Cambria County, PA",Oct-19,58402,55491,2911,5.0
24787,CN4202300000000,42,23,"Cameron County, PA",Oct-19,2051,1875,176,8.6
24788,CN4202500000000,42,25,"Carbon County, PA",Oct-19,32601,30824,1777,5.5
24789,CN4202700000000,42,27,"Centre County, PA",Oct-19,82034,79219,2815,3.4
24790,CN4202900000000,42,29,"Chester County, PA",Oct-19,287859,278303,9556,3.3
24791,CN4203100000000,42,31,"Clarion County, PA",Oct-19,17349,16556,793,4.6
24792,CN4203300000000,42,33,"Clearfield County, PA",Oct-19,36070,34315,1755,4.9
24793,CN4203500000000,42,35,"Clinton County, PA",Oct-19,18338,17432,906,4.9
24794,CN4203700000000,42,37,"Columbia County, PA",Oct-19,34014,32537,1477,4.3
24795,CN4203900000000,42,39,"Crawford County, PA",Oct-19,38724,36978,1746,4.5
24796,CN4204100000000,42,41,"Cumberland County, PA",Oct-19,133601,128886,4715,3.5
24797,CN4204300000000,42,43,"Dauphin County, PA",Oct-19,146011,139832,6179,4.2
24798,CN4204500000000,42,45,"Delaware County, PA",Oct-19,303813,290893,12920,4.3
24799,CN4204700000000,42,47,"Elk County, PA",Oct-19,15481,14566,915,5.9
24800,CN4204900000000,42,49,"Erie County, PA",Oct-19,129331,123552,5779,4.5
24801,CN4205100000000,42,51,"Fayette County, PA",Oct-19,57546,54303,3243,5.6
24802,CN4205300000000,42,53,"Forest County, PA",Oct-19,1805,1690,115,6.4
24803,CN4205500000000,42,55,"Franklin County, PA",Oct-19,78205,75159,3046,3.9
24804,CN4205700000000,42,57,"Fulton County, PA",Oct-19,7828,7511,317,4.0
24805,CN4205900000000,42,59,"Greene County, PA",Oct-19,16755,15895,860,5.1
24806,CN4206100000000,42,61,"Huntingdon County, PA",Oct-19,20097,19001,1096,5.5
24807,CN4206300000000,42,63,"Indiana County, PA",Oct-19,39783,37942,1841,4.6
24808,CN4206500000000,42,65,"Jefferson County, PA",Oct-19,20556,19637,919,4.5
24809,CN4206700000000,42,67,"Juniata County, PA",Oct-19,12623,12093,530,4.2
24810,CN4206900000000,42,69,"Lackawanna County, PA",Oct-19,106426,101269,5157,4.8
24811,CN4207100000000,42,71,"Lancaster County, PA",Oct-19,286906,276812,10094,3.5
24812,CN4207300000000,42,73,"Lawrence County, PA",Oct-19,40923,38989,1934,4.7
24813,CN4207500000000,42,75,"Lebanon County, PA",Oct-19,73001,70103,2898,4.0
24814,CN4207700000000,42,77,"Lehigh County, PA",Oct-19,195512,186693,8819,4.5
24815,CN4207900000000,42,79,"Luzerne County, PA",Oct-19,159377,150535,8842,5.5
24816,CN4208100000000,42,81,"Lycoming County, PA",Oct-19,57148,54495,2653,4.6
24817,CN4208300000000,42,83,"McKean County, PA",Oct-19,17398,16448,950,5.5
24818,CN4208500000000,42,85,"Mercer County, PA",Oct-19,49298,46831,2467,5.0
24819,CN4208700000000,42,87,"Mifflin County, PA",Oct-19,21107,20168,939,4.4
24820,CN4208900000000,42,89,"Monroe County, PA",Oct-19,83516,78944,4572,5.5
24821,CN4209100000000,42,91,"Montgomery County, PA",Oct-19,460450,443608,16842,3.7
24822,CN4209300000000,42,93,"Montour County, PA",Oct-19,9271,8951,320,3.5
24823,CN4209500000000,42,95,"Northampton County, PA",Oct-19,163566,156329,7237,4.4
24824,CN4209700000000,42,97,"Northumberland County, PA",Oct-19,43347,41075,2272,5.2
24825,CN4209900000000,42,99,"Perry County, PA",Oct-19,24641,23747,894,3.6
24826,CN4210100000000,42,101,"Philadelphia County/city, PA",Oct-19,733323,691092,42231,5.8
24827,CN4210300000000,42,103,"Pike County, PA",Oct-19,25442,24019,1423,5.6
24828,CN4210500000000,42,105,"Potter County, PA",Oct-19,7165,6757,408,5.7
24829,CN4210700000000,42,107,"Schuylkill County, PA",Oct-19,66662,63033,3629,5.4
24830,CN4210900000000,42,109,"Snyder County, PA",Oct-19,20189,19165,1024,5.1
24831,CN4211100000000,42,111,"Somerset County, PA",Oct-19,33550,31913,1637,4.9
24832,CN4211300000000,42,113,"Sullivan County, PA",Oct-19,2675,2535,140,5.2
24833,CN4211500000000,42,115,"Susquehanna County, PA",Oct-19,20691,19846,845,4.1
24834,CN4211700000000,42,117,"Tioga County, PA",Oct-19,19385,18461,924,4.8
24835,CN4211900000000,42,119,"Union County, PA",Oct-19,20164,19397,767,3.8
24836,CN4212100000000,42,121,"Venango County, PA",Oct-19,22391,21284,1107,4.9
24837,CN4212300000000,42,123,"Warren County, PA",Oct-19,18932,18079,853,4.5
24838,CN4212500000000,42,125,"Washington County, PA",Oct-19,108323,103334,4989,4.6
24839,CN4212700000000,42,127,"Wayne County, PA",Oct-19,22145,21159,986,4.5
24840,CN4212900000000,42,129,"Westmoreland County, PA",Oct-19,182756,174852,7904,4.3
24841,CN4213100000000,42,131,"Wyoming County, PA",Oct-19,13726,13084,642,4.7
24842,CN4213300000000,42,133,"York County, PA",Oct-19,238249,228898,9351,3.9
24843,CN4400100000000,44,1,"Bristol County, RI",Oct-19,26122,25490,632,2.4
24844,CN4400300000000,44,3,"Kent County, RI",Oct-19,91178,88734,2444,2.7
24845,CN4400500000000,44,5,"Newport County, RI",Oct-19,44377,43353,1024,2.3
24846,CN4400700000000,44,7,"Providence County, RI",Oct-19,326784,316201,10583,3.2
24847,CN4400900000000,44,9,"Washington County, RI",Oct-19,69139,67419,1720,2.5
24848,CN4500100000000,45,1,"Abbeville County, SC",Oct-19,10067,9759,308,3.1
24849,CN4500300000000,45,3,"Aiken County, SC",Oct-19,75147,73318,1829,2.4
24850,CN4500500000000,45,5,"Allendale County, SC",Oct-19,2649,2521,128,4.8
24851,CN4500700000000,45,7,"Anderson County, SC",Oct-19,92178,90082,2096,2.3
24852,CN4500900000000,45,9,"Bamberg County, SC",Oct-19,4972,4695,277,5.6
24853,CN4501100000000,45,11,"Barnwell County, SC",Oct-19,8227,7920,307,3.7
24854,CN4501300000000,45,13,"Beaufort County, SC",Oct-19,78395,76680,1715,2.2
24855,CN4501500000000,45,15,"Berkeley County, SC",Oct-19,104588,102365,2223,2.1
24856,CN4501700000000,45,17,"Calhoun County, SC",Oct-19,6629,6415,214,3.2
24857,CN4501900000000,45,19,"Charleston County, SC",Oct-19,211921,207907,4014,1.9
24858,CN4502100000000,45,21,"Cherokee County, SC",Oct-19,25411,24744,667,2.6
24859,CN4502300000000,45,23,"Chester County, SC",Oct-19,13566,13097,469,3.5
24860,CN4502500000000,45,25,"Chesterfield County, SC",Oct-19,21990,21435,555,2.5
24861,CN4502700000000,45,27,"Clarendon County, SC",Oct-19,12700,12278,422,3.3
24862,CN4502900000000,45,29,"Colleton County, SC",Oct-19,16809,16348,461,2.7
24863,CN4503100000000,45,31,"Darlington County, SC",Oct-19,30503,29627,876,2.9
24864,CN4503300000000,45,33,"Dillon County, SC",Oct-19,13031,12575,456,3.5
24865,CN4503500000000,45,35,"Dorchester County, SC",Oct-19,78478,76878,1600,2.0
24866,CN4503700000000,45,37,"Edgefield County, SC",Oct-19,10705,10453,252,2.4
24867,CN4503900000000,45,39,"Fairfield County, SC",Oct-19,9629,9288,341,3.5
24868,CN4504100000000,45,41,"Florence County, SC",Oct-19,67067,65434,1633,2.4
24869,CN4504300000000,45,43,"Georgetown County, SC",Oct-19,25744,24961,783,3.0
24870,CN4504500000000,45,45,"Greenville County, SC",Oct-19,257803,252507,5296,2.1
24871,CN4504700000000,45,47,"Greenwood County, SC",Oct-19,31425,30596,829,2.6
24872,CN4504900000000,45,49,"Hampton County, SC",Oct-19,8414,8229,185,2.2
24873,CN4505100000000,45,51,"Horry County, SC",Oct-19,147647,143508,4139,2.8
24874,CN4505300000000,45,53,"Jasper County, SC",Oct-19,12630,12374,256,2.0
24875,CN4505500000000,45,55,"Kershaw County, SC",Oct-19,29469,28725,744,2.5
24876,CN4505700000000,45,57,"Lancaster County, SC",Oct-19,41776,40550,1226,2.9
24877,CN4505900000000,45,59,"Laurens County, SC",Oct-19,30467,29672,795,2.6
24878,CN4506100000000,45,61,"Lee County, SC",Oct-19,6668,6417,251,3.8
24879,CN4506300000000,45,63,"Lexington County, SC",Oct-19,151240,148277,2963,2.0
24880,CN4506500000000,45,65,"McCormick County, SC",Oct-19,3368,3278,90,2.7
24881,CN4506700000000,45,67,"Marion County, SC",Oct-19,12954,12497,457,3.5
24882,CN4506900000000,45,69,"Marlboro County, SC",Oct-19,9298,8923,375,4.0
24883,CN4507100000000,45,71,"Newberry County, SC",Oct-19,19124,18659,465,2.4
24884,CN4507300000000,45,73,"Oconee County, SC",Oct-19,35280,34481,799,2.3
24885,CN4507500000000,45,75,"Orangeburg County, SC",Oct-19,34398,32726,1672,4.9
24886,CN4507700000000,45,77,"Pickens County, SC",Oct-19,57956,56627,1329,2.3
24887,CN4507900000000,45,79,"Richland County, SC",Oct-19,200637,196081,4556,2.3
24888,CN4508100000000,45,81,"Saluda County, SC",Oct-19,8894,8692,202,2.3
24889,CN4508300000000,45,83,"Spartanburg County, SC",Oct-19,154757,151469,3288,2.1
24890,CN4508500000000,45,85,"Sumter County, SC",Oct-19,43854,42605,1249,2.8
24891,CN4508700000000,45,87,"Union County, SC",Oct-19,11755,11405,350,3.0
24892,CN4508900000000,45,89,"Williamsburg County, SC",Oct-19,11916,11445,471,4.0
24893,CN4509100000000,45,91,"York County, SC",Oct-19,141947,138675,3272,2.3
24894,CN4600300000000,46,3,"Aurora County, SD",Oct-19,1514,1471,43,2.8
24895,CN4600500000000,46,5,"Beadle County, SD",Oct-19,9439,9156,283,3.0
24896,CN4600700000000,46,7,"Bennett County, SD",Oct-19,1106,1046,60,5.4
24897,CN4600900000000,46,9,"Bon Homme County, SD",Oct-19,2870,2782,88,3.1
24898,CN4601100000000,46,11,"Brookings County, SD",Oct-19,19658,19033,625,3.2
24899,CN4601300000000,46,13,"Brown County, SD",Oct-19,20801,20185,616,3.0
24900,CN4601500000000,46,15,"Brule County, SD",Oct-19,2474,2394,80,3.2
24901,CN4601700000000,46,17,"Buffalo County, SD",Oct-19,677,631,46,6.8
24902,CN4601900000000,46,19,"Butte County, SD",Oct-19,5041,4875,166,3.3
24903,CN4602100000000,46,21,"Campbell County, SD",Oct-19,771,748,23,3.0
24904,CN4602300000000,46,23,"Charles Mix County, SD",Oct-19,3736,3600,136,3.6
24905,CN4602500000000,46,25,"Clark County, SD",Oct-19,1927,1867,60,3.1
24906,CN4602700000000,46,27,"Clay County, SD",Oct-19,7768,7513,255,3.3
24907,CN4602900000000,46,29,"Codington County, SD",Oct-19,15573,15144,429,2.8
24908,CN4603100000000,46,31,"Corson County, SD",Oct-19,1395,1315,80,5.7
24909,CN4603300000000,46,33,"Custer County, SD",Oct-19,3995,3846,149,3.7
24910,CN4603500000000,46,35,"Davison County, SD",Oct-19,11108,10811,297,2.7
24911,CN4603700000000,46,37,"Day County, SD",Oct-19,2767,2666,101,3.7
24912,CN4603900000000,46,39,"Deuel County, SD",Oct-19,2188,2113,75,3.4
24913,CN4604100000000,46,41,"Dewey County, SD",Oct-19,2223,2064,159,7.2
24914,CN4604300000000,46,43,"Douglas County, SD",Oct-19,1589,1548,41,2.6
24915,CN4604500000000,46,45,"Edmunds County, SD",Oct-19,2042,1984,58,2.8
24916,CN4604700000000,46,47,"Fall River County, SD",Oct-19,2926,2812,114,3.9
24917,CN4604900000000,46,49,"Faulk County, SD",Oct-19,1078,1043,35,3.2
24918,CN4605100000000,46,51,"Grant County, SD",Oct-19,4437,4324,113,2.5
24919,CN4605300000000,46,53,"Gregory County, SD",Oct-19,2115,2045,70,3.3
24920,CN4605500000000,46,55,"Haakon County, SD",Oct-19,1060,1032,28,2.6
24921,CN4605700000000,46,57,"Hamlin County, SD",Oct-19,3366,3280,86,2.6
24922,CN4605900000000,46,59,"Hand County, SD",Oct-19,1821,1773,48,2.6
24923,CN4606100000000,46,61,"Hanson County, SD",Oct-19,1735,1672,63,3.6
24924,CN4606300000000,46,63,"Harding County, SD",Oct-19,743,721,22,3.0
24925,CN4606500000000,46,65,"Hughes County, SD",Oct-19,10058,9811,247,2.5
24926,CN4606700000000,46,67,"Hutchinson County, SD",Oct-19,3621,3518,103,2.8
24927,CN4606900000000,46,69,"Hyde County, SD",Oct-19,685,662,23,3.4
24928,CN4607100000000,46,71,"Jackson County, SD",Oct-19,1257,1192,65,5.2
24929,CN4607300000000,46,73,"Jerauld County, SD",Oct-19,1123,1095,28,2.5
24930,CN4607500000000,46,75,"Jones County, SD",Oct-19,540,525,15,2.8
24931,CN4607700000000,46,77,"Kingsbury County, SD",Oct-19,2651,2580,71,2.7
24932,CN4607900000000,46,79,"Lake County, SD",Oct-19,6760,6535,225,3.3
24933,CN4608100000000,46,81,"Lawrence County, SD",Oct-19,13561,13137,424,3.1
24934,CN4608300000000,46,83,"Lincoln County, SD",Oct-19,34909,34054,855,2.4
24935,CN4608500000000,46,85,"Lyman County, SD",Oct-19,1724,1648,76,4.4
24936,CN4608700000000,46,87,"McCook County, SD",Oct-19,3096,3015,81,2.6
24937,CN4608900000000,46,89,"McPherson County, SD",Oct-19,1012,972,40,4.0
24938,CN4609100000000,46,91,"Marshall County, SD",Oct-19,2398,2322,76,3.2
24939,CN4609300000000,46,93,"Meade County, SD",Oct-19,14161,13702,459,3.2
24940,CN4609500000000,46,95,"Mellette County, SD",Oct-19,738,697,41,5.6
24941,CN4609700000000,46,97,"Miner County, SD",Oct-19,1199,1159,40,3.3
24942,CN4609900000000,46,99,"Minnehaha County, SD",Oct-19,113993,110995,2998,2.6
24943,CN4610100000000,46,101,"Moody County, SD",Oct-19,4064,3940,124,3.1
24944,CN4610200000000,46,102,"Oglala Lakota County, SD",Oct-19,3545,3219,326,9.2
24945,CN4610300000000,46,103,"Pennington County, SD",Oct-19,56999,55169,1830,3.2
24946,CN4610500000000,46,105,"Perkins County, SD",Oct-19,1422,1377,45,3.2
24947,CN4610700000000,46,107,"Potter County, SD",Oct-19,1044,1011,33,3.2
24948,CN4610900000000,46,109,"Roberts County, SD",Oct-19,5011,4854,157,3.1
24949,CN4611100000000,46,111,"Sanborn County, SD",Oct-19,1151,1116,35,3.0
24950,CN4611500000000,46,115,"Spink County, SD",Oct-19,3169,3065,104,3.3
24951,CN4611700000000,46,117,"Stanley County, SD",Oct-19,1850,1804,46,2.5
24952,CN4611900000000,46,119,"Sully County, SD",Oct-19,804,781,23,2.9
24953,CN4612100000000,46,121,"Todd County, SD",Oct-19,3136,2937,199,6.3
24954,CN4612300000000,46,123,"Tripp County, SD",Oct-19,3098,3012,86,2.8
24955,CN4612500000000,46,125,"Turner County, SD",Oct-19,4722,4589,133,2.8
24956,CN4612700000000,46,127,"Union County, SD",Oct-19,8566,8276,290,3.4
24957,CN4612900000000,46,129,"Walworth County, SD",Oct-19,2116,2018,98,4.6
24958,CN4613500000000,46,135,"Yankton County, SD",Oct-19,11896,11553,343,2.9
24959,CN4613700000000,46,137,"Ziebach County, SD",Oct-19,940,889,51,5.4
24960,CN4700100000000,47,1,"Anderson County, TN",Oct-19,35239,34026,1213,3.4
24961,CN4700300000000,47,3,"Bedford County, TN",Oct-19,21274,20506,768,3.6
24962,CN4700500000000,47,5,"Benton County, TN",Oct-19,6993,6677,316,4.5
24963,CN4700700000000,47,7,"Bledsoe County, TN",Oct-19,4456,4242,214,4.8
24964,CN4700900000000,47,9,"Blount County, TN",Oct-19,64663,62702,1961,3.0
24965,CN4701100000000,47,11,"Bradley County, TN",Oct-19,53609,51938,1671,3.1
24966,CN4701300000000,47,13,"Campbell County, TN",Oct-19,15097,14438,659,4.4
24967,CN4701500000000,47,15,"Cannon County, TN",Oct-19,6775,6576,199,2.9
24968,CN4701700000000,47,17,"Carroll County, TN",Oct-19,12191,11650,541,4.4
24969,CN4701900000000,47,19,"Carter County, TN",Oct-19,24305,23432,873,3.6
24970,CN4702100000000,47,21,"Cheatham County, TN",Oct-19,22458,21926,532,2.4
24971,CN4702300000000,47,23,"Chester County, TN",Oct-19,8660,8379,281,3.2
24972,CN4702500000000,47,25,"Claiborne County, TN",Oct-19,13242,12741,501,3.8
24973,CN4702700000000,47,27,"Clay County, TN",Oct-19,2816,2670,146,5.2
24974,CN4702900000000,47,29,"Cocke County, TN",Oct-19,15085,14497,588,3.9
24975,CN4703100000000,47,31,"Coffee County, TN",Oct-19,25780,24989,791,3.1
24976,CN4703300000000,47,33,"Crockett County, TN",Oct-19,7109,6883,226,3.2
24977,CN4703500000000,47,35,"Cumberland County, TN",Oct-19,23891,22993,898,3.8
24978,CN4703700000000,47,37,"Davidson County, TN",Oct-19,414469,404807,9662,2.3
24979,CN4703900000000,47,39,"Decatur County, TN",Oct-19,4701,4402,299,6.4
24980,CN4704100000000,47,41,"DeKalb County, TN",Oct-19,7928,7515,413,5.2
24981,CN4704300000000,47,43,"Dickson County, TN",Oct-19,27718,26958,760,2.7
24982,CN4704500000000,47,45,"Dyer County, TN",Oct-19,16636,15878,758,4.6
24983,CN4704700000000,47,47,"Fayette County, TN",Oct-19,19487,18770,717,3.7
24984,CN4704900000000,47,49,"Fentress County, TN",Oct-19,7637,7339,298,3.9
24985,CN4705100000000,47,51,"Franklin County, TN",Oct-19,20604,19939,665,3.2
24986,CN4705300000000,47,53,"Gibson County, TN",Oct-19,22410,21495,915,4.1
24987,CN4705500000000,47,55,"Giles County, TN",Oct-19,15272,14600,672,4.4
24988,CN4705700000000,47,57,"Grainger County, TN",Oct-19,9675,9334,341,3.5
24989,CN4705900000000,47,59,"Greene County, TN",Oct-19,29893,28550,1343,4.5
24990,CN4706100000000,47,61,"Grundy County, TN",Oct-19,5100,4888,212,4.2
24991,CN4706300000000,47,63,"Hamblen County, TN",Oct-19,28564,27509,1055,3.7
24992,CN4706500000000,47,65,"Hamilton County, TN",Oct-19,185845,180168,5677,3.1
24993,CN4706700000000,47,67,"Hancock County, TN",Oct-19,2149,2033,116,5.4
24994,CN4706900000000,47,69,"Hardeman County, TN",Oct-19,9635,9148,487,5.1
24995,CN4707100000000,47,71,"Hardin County, TN",Oct-19,10572,10155,417,3.9
24996,CN4707300000000,47,73,"Hawkins County, TN",Oct-19,24049,23025,1024,4.3
24997,CN4707500000000,47,75,"Haywood County, TN",Oct-19,7818,7477,341,4.4
24998,CN4707700000000,47,77,"Henderson County, TN",Oct-19,12510,11893,617,4.9
24999,CN4707900000000,47,79,"Henry County, TN",Oct-19,14306,13760,546,3.8
25000,CN4708100000000,47,81,"Hickman County, TN",Oct-19,11794,11414,380,3.2
25001,CN4708300000000,47,83,"Houston County, TN",Oct-19,3329,3197,132,4.0
25002,CN4708500000000,47,85,"Humphreys County, TN",Oct-19,9049,8743,306,3.4
25003,CN4708700000000,47,87,"Jackson County, TN",Oct-19,4723,4538,185,3.9
25004,CN4708900000000,47,89,"Jefferson County, TN",Oct-19,24903,24076,827,3.3
25005,CN4709100000000,47,91,"Johnson County, TN",Oct-19,7812,7575,237,3.0
25006,CN4709300000000,47,93,"Knox County, TN",Oct-19,247970,241347,6623,2.7
25007,CN4709500000000,47,95,"Lake County, TN",Oct-19,1774,1690,84,4.7
25008,CN4709700000000,47,97,"Lauderdale County, TN",Oct-19,9858,9355,503,5.1
25009,CN4709900000000,47,99,"Lawrence County, TN",Oct-19,19814,18916,898,4.5
25010,CN4710100000000,47,101,"Lewis County, TN",Oct-19,5434,5118,316,5.8
25011,CN4710300000000,47,103,"Lincoln County, TN",Oct-19,16763,16048,715,4.3
25012,CN4710500000000,47,105,"Loudon County, TN",Oct-19,23895,23161,734,3.1
25013,CN4710700000000,47,107,"McMinn County, TN",Oct-19,23955,23138,817,3.4
25014,CN4710900000000,47,109,"McNairy County, TN",Oct-19,8642,8246,396,4.6
25015,CN4711100000000,47,111,"Macon County, TN",Oct-19,11645,11285,360,3.1
25016,CN4711300000000,47,113,"Madison County, TN",Oct-19,49572,47852,1720,3.5
25017,CN4711500000000,47,115,"Marion County, TN",Oct-19,12632,12115,517,4.1
25018,CN4711700000000,47,117,"Marshall County, TN",Oct-19,16205,15381,824,5.1
25019,CN4711900000000,47,119,"Maury County, TN",Oct-19,52383,49244,3139,6.0
25020,CN4712100000000,47,121,"Meigs County, TN",Oct-19,5263,5058,205,3.9
25021,CN4712300000000,47,123,"Monroe County, TN",Oct-19,20394,19693,701,3.4
25022,CN4712500000000,47,125,"Montgomery County, TN",Oct-19,86761,83648,3113,3.6
25023,CN4712700000000,47,127,"Moore County, TN",Oct-19,3683,3582,101,2.7
25024,CN4712900000000,47,129,"Morgan County, TN",Oct-19,7989,7711,278,3.5
25025,CN4713100000000,47,131,"Obion County, TN",Oct-19,12550,12041,509,4.1
25026,CN4713300000000,47,133,"Overton County, TN",Oct-19,10181,9863,318,3.1
25027,CN4713500000000,47,135,"Perry County, TN",Oct-19,3112,2855,257,8.3
25028,CN4713700000000,47,137,"Pickett County, TN",Oct-19,2419,2323,96,4.0
25029,CN4713900000000,47,139,"Polk County, TN",Oct-19,7727,7463,264,3.4
25030,CN4714100000000,47,141,"Putnam County, TN",Oct-19,35799,34676,1123,3.1
25031,CN4714300000000,47,143,"Rhea County, TN",Oct-19,13639,13009,630,4.6
25032,CN4714500000000,47,145,"Roane County, TN",Oct-19,23740,22885,855,3.6
25033,CN4714700000000,47,147,"Robertson County, TN",Oct-19,39001,37999,1002,2.6
25034,CN4714900000000,47,149,"Rutherford County, TN",Oct-19,188770,184280,4490,2.4
25035,CN4715100000000,47,151,"Scott County, TN",Oct-19,8310,7970,340,4.1
25036,CN4715300000000,47,153,"Sequatchie County, TN",Oct-19,6289,6024,265,4.2
25037,CN4715500000000,47,155,"Sevier County, TN",Oct-19,55286,53966,1320,2.4
25038,CN4715700000000,47,157,"Shelby County, TN",Oct-19,449513,432775,16738,3.7
25039,CN4715900000000,47,159,"Smith County, TN",Oct-19,9712,9442,270,2.8
25040,CN4716100000000,47,161,"Stewart County, TN",Oct-19,5578,5366,212,3.8
25041,CN4716300000000,47,163,"Sullivan County, TN",Oct-19,70846,68429,2417,3.4
25042,CN4716500000000,47,165,"Sumner County, TN",Oct-19,105071,102417,2654,2.5
25043,CN4716700000000,47,167,"Tipton County, TN",Oct-19,28487,27443,1044,3.7
25044,CN4716900000000,47,169,"Trousdale County, TN",Oct-19,5562,5413,149,2.7
25045,CN4717100000000,47,171,"Unicoi County, TN",Oct-19,7189,6883,306,4.3
25046,CN4717300000000,47,173,"Union County, TN",Oct-19,7746,7470,276,3.6
25047,CN4717500000000,47,175,"Van Buren County, TN",Oct-19,2091,1999,92,4.4
25048,CN4717700000000,47,177,"Warren County, TN",Oct-19,16935,16166,769,4.5
25049,CN4717900000000,47,179,"Washington County, TN",Oct-19,61176,59239,1937,3.2
25050,CN4718100000000,47,181,"Wayne County, TN",Oct-19,6310,6015,295,4.7
25051,CN4718300000000,47,183,"Weakley County, TN",Oct-19,16331,15779,552,3.4
25052,CN4718500000000,47,185,"White County, TN",Oct-19,12415,11962,453,3.6
25053,CN4718700000000,47,187,"Williamson County, TN",Oct-19,131871,128851,3020,2.3
25054,CN4718900000000,47,189,"Wilson County, TN",Oct-19,78690,76680,2010,2.6
25055,CN4800100000000,48,1,"Anderson County, TX",Oct-19,24135,23470,665,2.8
25056,CN4800300000000,48,3,"Andrews County, TX",Oct-19,9879,9655,224,2.3
25057,CN4800500000000,48,5,"Angelina County, TX",Oct-19,36017,34638,1379,3.8
25058,CN4800700000000,48,7,"Aransas County, TX",Oct-19,9429,9061,368,3.9
25059,CN4800900000000,48,9,"Archer County, TX",Oct-19,4174,4063,111,2.7
25060,CN4801100000000,48,11,"Armstrong County, TX",Oct-19,941,917,24,2.6
25061,CN4801300000000,48,13,"Atascosa County, TX",Oct-19,21976,21229,747,3.4
25062,CN4801500000000,48,15,"Austin County, TX",Oct-19,14209,13747,462,3.3
25063,CN4801700000000,48,17,"Bailey County, TX",Oct-19,2525,2443,82,3.2
25064,CN4801900000000,48,19,"Bandera County, TX",Oct-19,10191,9864,327,3.2
25065,CN4802100000000,48,21,"Bastrop County, TX",Oct-19,43412,42168,1244,2.9
25066,CN4802300000000,48,23,"Baylor County, TX",Oct-19,1790,1753,37,2.1
25067,CN4802500000000,48,25,"Bee County, TX",Oct-19,9884,9461,423,4.3
25068,CN4802700000000,48,27,"Bell County, TX",Oct-19,145056,139793,5263,3.6
25069,CN4802900000000,48,29,"Bexar County, TX",Oct-19,961234,932364,28870,3.0
25070,CN4803100000000,48,31,"Blanco County, TX",Oct-19,6509,6361,148,2.3
25071,CN4803300000000,48,33,"Borden County, TX",Oct-19,424,415,9,2.1
25072,CN4803500000000,48,35,"Bosque County, TX",Oct-19,8374,8101,273,3.3
25073,CN4803700000000,48,37,"Bowie County, TX",Oct-19,40047,38380,1667,4.2
25074,CN4803900000000,48,39,"Brazoria County, TX",Oct-19,180965,173595,7370,4.1
25075,CN4804100000000,48,41,"Brazos County, TX",Oct-19,122689,119539,3150,2.6
25076,CN4804300000000,48,43,"Brewster County, TX",Oct-19,4182,4070,112,2.7
25077,CN4804500000000,48,45,"Briscoe County, TX",Oct-19,588,568,20,3.4
25078,CN4804700000000,48,47,"Brooks County, TX",Oct-19,2588,2459,129,5.0
25079,CN4804900000000,48,49,"Brown County, TX",Oct-19,15522,14938,584,3.8
25080,CN4805100000000,48,51,"Burleson County, TX",Oct-19,8608,8355,253,2.9
25081,CN4805300000000,48,53,"Burnet County, TX",Oct-19,23604,22983,621,2.6
25082,CN4805500000000,48,55,"Caldwell County, TX",Oct-19,19889,19267,622,3.1
25083,CN4805700000000,48,57,"Calhoun County, TX",Oct-19,12161,11793,368,3.0
25084,CN4805900000000,48,59,"Callahan County, TX",Oct-19,6182,6009,173,2.8
25085,CN4806100000000,48,61,"Cameron County, TX",Oct-19,166663,158120,8543,5.1
25086,CN4806300000000,48,63,"Camp County, TX",Oct-19,5004,4811,193,3.9
25087,CN4806500000000,48,65,"Carson County, TX",Oct-19,3046,2974,72,2.4
25088,CN4806700000000,48,67,"Cass County, TX",Oct-19,12473,11975,498,4.0
25089,CN4806900000000,48,69,"Castro County, TX",Oct-19,3504,3419,85,2.4
25090,CN4807100000000,48,71,"Chambers County, TX",Oct-19,19577,18766,811,4.1
25091,CN4807300000000,48,73,"Cherokee County, TX",Oct-19,20931,20156,775,3.7
25092,CN4807500000000,48,75,"Childress County, TX",Oct-19,2949,2860,89,3.0
25093,CN4807700000000,48,77,"Clay County, TX",Oct-19,4980,4838,142,2.9
25094,CN4807900000000,48,79,"Cochran County, TX",Oct-19,1149,1115,34,3.0
25095,CN4808100000000,48,81,"Coke County, TX",Oct-19,1483,1436,47,3.2
25096,CN4808300000000,48,83,"Coleman County, TX",Oct-19,2877,2768,109,3.8
25097,CN4808500000000,48,85,"Collin County, TX",Oct-19,569882,553156,16726,2.9
25098,CN4808700000000,48,87,"Collingsworth County, TX",Oct-19,1192,1154,38,3.2
25099,CN4808900000000,48,89,"Colorado County, TX",Oct-19,9879,9591,288,2.9
25100,CN4809100000000,48,91,"Comal County, TX",Oct-19,74073,71988,2085,2.8
25101,CN4809300000000,48,93,"Comanche County, TX",Oct-19,5685,5503,182,3.2
25102,CN4809500000000,48,95,"Concho County, TX",Oct-19,1389,1349,40,2.9
25103,CN4809700000000,48,97,"Cooke County, TX",Oct-19,19818,19278,540,2.7
25104,CN4809900000000,48,99,"Coryell County, TX",Oct-19,24308,23413,895,3.7
25105,CN4810100000000,48,101,"Cottle County, TX",Oct-19,562,539,23,4.1
25106,CN4810300000000,48,103,"Crane County, TX",Oct-19,1584,1520,64,4.0
25107,CN4810500000000,48,105,"Crockett County, TX",Oct-19,1625,1568,57,3.5
25108,CN4810700000000,48,107,"Crosby County, TX",Oct-19,2548,2456,92,3.6
25109,CN4810900000000,48,109,"Culberson County, TX",Oct-19,1062,1019,43,4.0
25110,CN4811100000000,48,111,"Dallam County, TX",Oct-19,3946,3872,74,1.9
25111,CN4811300000000,48,113,"Dallas County, TX",Oct-19,1378578,1333216,45362,3.3
25112,CN4811500000000,48,115,"Dawson County, TX",Oct-19,4641,4469,172,3.7
25113,CN4811700000000,48,117,"Deaf Smith County, TX",Oct-19,8662,8446,216,2.5
25114,CN4811900000000,48,119,"Delta County, TX",Oct-19,2466,2382,84,3.4
25115,CN4812100000000,48,121,"Denton County, TX",Oct-19,500290,486234,14056,2.8
25116,CN4812300000000,48,123,"DeWitt County, TX",Oct-19,9895,9639,256,2.6
25117,CN4812500000000,48,125,"Dickens County, TX",Oct-19,690,660,30,4.3
25118,CN4812700000000,48,127,"Dimmit County, TX",Oct-19,7405,7218,187,2.5
25119,CN4812900000000,48,129,"Donley County, TX",Oct-19,1429,1384,45,3.1
25120,CN4813100000000,48,131,"Duval County, TX",Oct-19,4944,4734,210,4.2
25121,CN4813300000000,48,133,"Eastland County, TX",Oct-19,8202,7939,263,3.2
25122,CN4813500000000,48,135,"Ector County, TX",Oct-19,88389,85963,2426,2.7
25123,CN4813700000000,48,137,"Edwards County, TX",Oct-19,1151,1130,21,1.8
25124,CN4813900000000,48,139,"Ellis County, TX",Oct-19,93666,90924,2742,2.9
25125,CN4814100000000,48,141,"El Paso County, TX",Oct-19,366624,353079,13545,3.7
25126,CN4814300000000,48,143,"Erath County, TX",Oct-19,21346,20674,672,3.1
25127,CN4814500000000,48,145,"Falls County, TX",Oct-19,6619,6413,206,3.1
25128,CN4814700000000,48,147,"Fannin County, TX",Oct-19,17510,17046,464,2.6
25129,CN4814900000000,48,149,"Fayette County, TX",Oct-19,12104,11799,305,2.5
25130,CN4815100000000,48,151,"Fisher County, TX",Oct-19,1650,1606,44,2.7
25131,CN4815300000000,48,153,"Floyd County, TX",Oct-19,2603,2508,95,3.6
25132,CN4815500000000,48,155,"Foard County, TX",Oct-19,599,582,17,2.8
25133,CN4815700000000,48,157,"Fort Bend County, TX",Oct-19,394963,381779,13184,3.3
25134,CN4815900000000,48,159,"Franklin County, TX",Oct-19,4642,4484,158,3.4
25135,CN4816100000000,48,161,"Freestone County, TX",Oct-19,6424,6119,305,4.7
25136,CN4816300000000,48,163,"Frio County, TX",Oct-19,10467,10213,254,2.4
25137,CN4816500000000,48,165,"Gaines County, TX",Oct-19,9885,9656,229,2.3
25138,CN4816700000000,48,167,"Galveston County, TX",Oct-19,166498,160169,6329,3.8
25139,CN4816900000000,48,169,"Garza County, TX",Oct-19,2161,2108,53,2.5
25140,CN4817100000000,48,171,"Gillespie County, TX",Oct-19,13491,13189,302,2.2
25141,CN4817300000000,48,173,"Glasscock County, TX",Oct-19,821,805,16,1.9
25142,CN4817500000000,48,175,"Goliad County, TX",Oct-19,3273,3169,104,3.2
25143,CN4817700000000,48,177,"Gonzales County, TX",Oct-19,9715,9462,253,2.6
25144,CN4817900000000,48,179,"Gray County, TX",Oct-19,8072,7806,266,3.3
25145,CN4818100000000,48,181,"Grayson County, TX",Oct-19,64281,62367,1914,3.0
25146,CN4818300000000,48,183,"Gregg County, TX",Oct-19,58750,56633,2117,3.6
25147,CN4818500000000,48,185,"Grimes County, TX",Oct-19,11508,11062,446,3.9
25148,CN4818700000000,48,187,"Guadalupe County, TX",Oct-19,82542,80253,2289,2.8
25149,CN4818900000000,48,189,"Hale County, TX",Oct-19,12173,11676,497,4.1
25150,CN4819100000000,48,191,"Hall County, TX",Oct-19,1074,1031,43,4.0
25151,CN4819300000000,48,193,"Hamilton County, TX",Oct-19,3656,3545,111,3.0
25152,CN4819500000000,48,195,"Hansford County, TX",Oct-19,2797,2736,61,2.2
25153,CN4819700000000,48,197,"Hardeman County, TX",Oct-19,1745,1695,50,2.9
25154,CN4819900000000,48,199,"Hardin County, TX",Oct-19,25441,24384,1057,4.2
25155,CN4820100000000,48,201,"Harris County, TX",Oct-19,2330581,2245695,84886,3.6
25156,CN4820300000000,48,203,"Harrison County, TX",Oct-19,29830,28654,1176,3.9
25157,CN4820500000000,48,205,"Hartley County, TX",Oct-19,2830,2785,45,1.6
25158,CN4820700000000,48,207,"Haskell County, TX",Oct-19,2344,2276,68,2.9
25159,CN4820900000000,48,209,"Hays County, TX",Oct-19,121348,118096,3252,2.7
25160,CN4821100000000,48,211,"Hemphill County, TX",Oct-19,1916,1862,54,2.8
25161,CN4821300000000,48,213,"Henderson County, TX",Oct-19,36681,35455,1226,3.3
25162,CN4821500000000,48,215,"Hidalgo County, TX",Oct-19,354494,334439,20055,5.7
25163,CN4821700000000,48,217,"Hill County, TX",Oct-19,16584,16064,520,3.1
25164,CN4821900000000,48,219,"Hockley County, TX",Oct-19,11322,11001,321,2.8
25165,CN4822100000000,48,221,"Hood County, TX",Oct-19,27756,26856,900,3.2
25166,CN4822300000000,48,223,"Hopkins County, TX",Oct-19,17695,17185,510,2.9
25167,CN4822500000000,48,225,"Houston County, TX",Oct-19,10514,10194,320,3.0
25168,CN4822700000000,48,227,"Howard County, TX",Oct-19,14117,13667,450,3.2
25169,CN4822900000000,48,229,"Hudspeth County, TX",Oct-19,1870,1790,80,4.3
25170,CN4823100000000,48,231,"Hunt County, TX",Oct-19,43879,42384,1495,3.4
25171,CN4823300000000,48,233,"Hutchinson County, TX",Oct-19,8734,8378,356,4.1
25172,CN4823500000000,48,235,"Irion County, TX",Oct-19,764,746,18,2.4
25173,CN4823700000000,48,237,"Jack County, TX",Oct-19,3425,3307,118,3.4
25174,CN4823900000000,48,239,"Jackson County, TX",Oct-19,7681,7464,217,2.8
25175,CN4824100000000,48,241,"Jasper County, TX",Oct-19,12789,12085,704,5.5
25176,CN4824300000000,48,243,"Jeff Davis County, TX",Oct-19,1023,995,28,2.7
25177,CN4824500000000,48,245,"Jefferson County, TX",Oct-19,107441,101653,5788,5.4
25178,CN4824700000000,48,247,"Jim Hogg County, TX",Oct-19,1864,1782,82,4.4
25179,CN4824900000000,48,249,"Jim Wells County, TX",Oct-19,16648,15868,780,4.7
25180,CN4825100000000,48,251,"Johnson County, TX",Oct-19,82930,80343,2587,3.1
25181,CN4825300000000,48,253,"Jones County, TX",Oct-19,5842,5613,229,3.9
25182,CN4825500000000,48,255,"Karnes County, TX",Oct-19,7351,7173,178,2.4
25183,CN4825700000000,48,257,"Kaufman County, TX",Oct-19,65371,63313,2058,3.1
25184,CN4825900000000,48,259,"Kendall County, TX",Oct-19,22382,21805,577,2.6
25185,CN4826100000000,48,261,"Kenedy County, TX",Oct-19,212,203,9,4.2
25186,CN4826300000000,48,263,"Kent County, TX",Oct-19,486,475,11,2.3
25187,CN4826500000000,48,265,"Kerr County, TX",Oct-19,22150,21507,643,2.9
25188,CN4826700000000,48,267,"Kimble County, TX",Oct-19,1863,1809,54,2.9
25189,CN4826900000000,48,269,"King County, TX",Oct-19,245,241,4,1.6
25190,CN4827100000000,48,271,"Kinney County, TX",Oct-19,1406,1361,45,3.2
25191,CN4827300000000,48,273,"Kleberg County, TX",Oct-19,13731,13157,574,4.2
25192,CN4827500000000,48,275,"Knox County, TX",Oct-19,1470,1427,43,2.9
25193,CN4827700000000,48,277,"Lamar County, TX",Oct-19,24378,23605,773,3.2
25194,CN4827900000000,48,279,"Lamb County, TX",Oct-19,5392,5192,200,3.7
25195,CN4828100000000,48,281,"Lampasas County, TX",Oct-19,9283,8998,285,3.1
25196,CN4828300000000,48,283,"La Salle County, TX",Oct-19,4332,4221,111,2.6
25197,CN4828500000000,48,285,"Lavaca County, TX",Oct-19,8538,8299,239,2.8
25198,CN4828700000000,48,287,"Lee County, TX",Oct-19,10110,9850,260,2.6
25199,CN4828900000000,48,289,"Leon County, TX",Oct-19,6400,6122,278,4.3
25200,CN4829100000000,48,291,"Liberty County, TX",Oct-19,33286,31715,1571,4.7
25201,CN4829300000000,48,293,"Limestone County, TX",Oct-19,8649,8331,318,3.7
25202,CN4829500000000,48,295,"Lipscomb County, TX",Oct-19,1636,1595,41,2.5
25203,CN4829700000000,48,297,"Live Oak County, TX",Oct-19,5670,5508,162,2.9
25204,CN4829900000000,48,299,"Llano County, TX",Oct-19,8731,8456,275,3.1
25205,CN4830100000000,48,301,"Loving County, TX",Oct-19,640,636,4,0.6
25206,CN4830300000000,48,303,"Lubbock County, TX",Oct-19,158917,154691,4226,2.7
25207,CN4830500000000,48,305,"Lynn County, TX",Oct-19,2826,2746,80,2.8
25208,CN4830700000000,48,307,"McCulloch County, TX",Oct-19,3387,3217,170,5.0
25209,CN4830900000000,48,309,"McLennan County, TX",Oct-19,119784,116007,3777,3.2
25210,CN4831100000000,48,311,"McMullen County, TX",Oct-19,898,884,14,1.6
25211,CN4831300000000,48,313,"Madison County, TX",Oct-19,4580,4397,183,4.0
25212,CN4831500000000,48,315,"Marion County, TX",Oct-19,4257,4084,173,4.1
25213,CN4831700000000,48,317,"Martin County, TX",Oct-19,2935,2850,85,2.9
25214,CN4831900000000,48,319,"Mason County, TX",Oct-19,1767,1716,51,2.9
25215,CN4832100000000,48,321,"Matagorda County, TX",Oct-19,16993,16111,882,5.2
25216,CN4832300000000,48,323,"Maverick County, TX",Oct-19,23629,22094,1535,6.5
25217,CN4832500000000,48,325,"Medina County, TX",Oct-19,22129,21471,658,3.0
25218,CN4832700000000,48,327,"Menard County, TX",Oct-19,881,853,28,3.2
25219,CN4832900000000,48,329,"Midland County, TX",Oct-19,108074,105850,2224,2.1
25220,CN4833100000000,48,331,"Milam County, TX",Oct-19,9799,9376,423,4.3
25221,CN4833300000000,48,333,"Mills County, TX",Oct-19,1938,1884,54,2.8
25222,CN4833500000000,48,335,"Mitchell County, TX",Oct-19,2349,2269,80,3.4
25223,CN4833700000000,48,337,"Montague County, TX",Oct-19,9429,9169,260,2.8
25224,CN4833900000000,48,339,"Montgomery County, TX",Oct-19,285848,276470,9378,3.3
25225,CN4834100000000,48,341,"Moore County, TX",Oct-19,10954,10714,240,2.2
25226,CN4834300000000,48,343,"Morris County, TX",Oct-19,4820,4574,246,5.1
25227,CN4834500000000,48,345,"Motley County, TX",Oct-19,490,476,14,2.9
25228,CN4834700000000,48,347,"Nacogdoches County, TX",Oct-19,28277,27262,1015,3.6
25229,CN4834900000000,48,349,"Navarro County, TX",Oct-19,24619,23903,716,2.9
25230,CN4835100000000,48,351,"Newton County, TX",Oct-19,5206,4912,294,5.6
25231,CN4835300000000,48,353,"Nolan County, TX",Oct-19,7279,7079,200,2.7
25232,CN4835500000000,48,355,"Nueces County, TX",Oct-19,167773,161388,6385,3.8
25233,CN4835700000000,48,357,"Ochiltree County, TX",Oct-19,4353,4242,111,2.5
25234,CN4835900000000,48,359,"Oldham County, TX",Oct-19,929,906,23,2.5
25235,CN4836100000000,48,361,"Orange County, TX",Oct-19,36536,34809,1727,4.7
25236,CN4836300000000,48,363,"Palo Pinto County, TX",Oct-19,13605,13209,396,2.9
25237,CN4836500000000,48,365,"Panola County, TX",Oct-19,10112,9712,400,4.0
25238,CN4836700000000,48,367,"Parker County, TX",Oct-19,67925,66018,1907,2.8
25239,CN4836900000000,48,369,"Parmer County, TX",Oct-19,4953,4849,104,2.1
25240,CN4837100000000,48,371,"Pecos County, TX",Oct-19,6361,6151,210,3.3
25241,CN4837300000000,48,373,"Polk County, TX",Oct-19,18141,17330,811,4.5
25242,CN4837500000000,48,375,"Potter County, TX",Oct-19,55466,54003,1463,2.6
25243,CN4837700000000,48,377,"Presidio County, TX",Oct-19,3141,2938,203,6.5
25244,CN4837900000000,48,379,"Rains County, TX",Oct-19,6032,5864,168,2.8
25245,CN4838100000000,48,381,"Randall County, TX",Oct-19,72607,70934,1673,2.3
25246,CN4838300000000,48,383,"Reagan County, TX",Oct-19,1945,1891,54,2.8
25247,CN4838500000000,48,385,"Real County, TX",Oct-19,1008,970,38,3.8
25248,CN4838700000000,48,387,"Red River County, TX",Oct-19,5154,4930,224,4.3
25249,CN4838900000000,48,389,"Reeves County, TX",Oct-19,12072,11882,190,1.6
25250,CN4839100000000,48,391,"Refugio County, TX",Oct-19,3164,3042,122,3.9
25251,CN4839300000000,48,393,"Roberts County, TX",Oct-19,428,417,11,2.6
25252,CN4839500000000,48,395,"Robertson County, TX",Oct-19,7889,7629,260,3.3
25253,CN4839700000000,48,397,"Rockwall County, TX",Oct-19,52629,51081,1548,2.9
25254,CN4839900000000,48,399,"Runnels County, TX",Oct-19,4673,4545,128,2.7
25255,CN4840100000000,48,401,"Rusk County, TX",Oct-19,23243,22436,807,3.5
25256,CN4840300000000,48,403,"Sabine County, TX",Oct-19,3670,3450,220,6.0
25257,CN4840500000000,48,405,"San Augustine County, TX",Oct-19,3406,3246,160,4.7
25258,CN4840700000000,48,407,"San Jacinto County, TX",Oct-19,11815,11301,514,4.4
25259,CN4840900000000,48,409,"San Patricio County, TX",Oct-19,30020,28492,1528,5.1
25260,CN4841100000000,48,411,"San Saba County, TX",Oct-19,2575,2498,77,3.0
25261,CN4841300000000,48,413,"Schleicher County, TX",Oct-19,1304,1264,40,3.1
25262,CN4841500000000,48,415,"Scurry County, TX",Oct-19,6724,6514,210,3.1
25263,CN4841700000000,48,417,"Shackelford County, TX",Oct-19,1895,1855,40,2.1
25264,CN4841900000000,48,419,"Shelby County, TX",Oct-19,11304,10888,416,3.7
25265,CN4842100000000,48,421,"Sherman County, TX",Oct-19,1416,1383,33,2.3
25266,CN4842300000000,48,423,"Smith County, TX",Oct-19,107593,104149,3444,3.2
25267,CN4842500000000,48,425,"Somervell County, TX",Oct-19,4392,4247,145,3.3
25268,CN4842700000000,48,427,"Starr County, TX",Oct-19,25044,22664,2380,9.5
25269,CN4842900000000,48,429,"Stephens County, TX",Oct-19,4069,3950,119,2.9
25270,CN4843100000000,48,431,"Sterling County, TX",Oct-19,597,579,18,3.0
25271,CN4843300000000,48,433,"Stonewall County, TX",Oct-19,583,567,16,2.7
25272,CN4843500000000,48,435,"Sutton County, TX",Oct-19,1286,1232,54,4.2
25273,CN4843700000000,48,437,"Swisher County, TX",Oct-19,2629,2537,92,3.5
25274,CN4843900000000,48,439,"Tarrant County, TX",Oct-19,1092588,1057072,35516,3.3
25275,CN4844100000000,48,441,"Taylor County, TX",Oct-19,67997,66138,1859,2.7
25276,CN4844300000000,48,443,"Terrell County, TX",Oct-19,375,362,13,3.5
25277,CN4844500000000,48,445,"Terry County, TX",Oct-19,5017,4847,170,3.4
25278,CN4844700000000,48,447,"Throckmorton County, TX",Oct-19,665,639,26,3.9
25279,CN4844900000000,48,449,"Titus County, TX",Oct-19,13105,12605,500,3.8
25280,CN4845100000000,48,451,"Tom Green County, TX",Oct-19,54691,53096,1595,2.9
25281,CN4845300000000,48,453,"Travis County, TX",Oct-19,749182,730820,18362,2.5
25282,CN4845500000000,48,455,"Trinity County, TX",Oct-19,5380,5124,256,4.8
25283,CN4845700000000,48,457,"Tyler County, TX",Oct-19,7168,6800,368,5.1
25284,CN4845900000000,48,459,"Upshur County, TX",Oct-19,18028,17395,633,3.5
25285,CN4846100000000,48,461,"Upton County, TX",Oct-19,1676,1638,38,2.3
25286,CN4846300000000,48,463,"Uvalde County, TX",Oct-19,11487,11081,406,3.5
25287,CN4846500000000,48,465,"Val Verde County, TX",Oct-19,23091,22350,741,3.2
25288,CN4846700000000,48,467,"Van Zandt County, TX",Oct-19,26058,25246,812,3.1
25289,CN4846900000000,48,469,"Victoria County, TX",Oct-19,42868,41435,1433,3.3
25290,CN4847100000000,48,471,"Walker County, TX",Oct-19,24443,23544,899,3.7
25291,CN4847300000000,48,473,"Waller County, TX",Oct-19,23704,22828,876,3.7
25292,CN4847500000000,48,475,"Ward County, TX",Oct-19,7510,7338,172,2.3
25293,CN4847700000000,48,477,"Washington County, TX",Oct-19,15396,14939,457,3.0
25294,CN4847900000000,48,479,"Webb County, TX",Oct-19,118980,114899,4081,3.4
25295,CN4848100000000,48,481,"Wharton County, TX",Oct-19,21985,21274,711,3.2
25296,CN4848300000000,48,483,"Wheeler County, TX",Oct-19,2286,2215,71,3.1
25297,CN4848500000000,48,485,"Wichita County, TX",Oct-19,56522,54842,1680,3.0
25298,CN4848700000000,48,487,"Wilbarger County, TX",Oct-19,4982,4826,156,3.1
25299,CN4848900000000,48,489,"Willacy County, TX",Oct-19,6730,6249,481,7.1
25300,CN4849100000000,48,491,"Williamson County, TX",Oct-19,317883,309323,8560,2.7
25301,CN4849300000000,48,493,"Wilson County, TX",Oct-19,25196,24513,683,2.7
25302,CN4849500000000,48,495,"Winkler County, TX",Oct-19,4036,3931,105,2.6
25303,CN4849700000000,48,497,"Wise County, TX",Oct-19,32150,31186,964,3.0
25304,CN4849900000000,48,499,"Wood County, TX",Oct-19,17828,17162,666,3.7
25305,CN4850100000000,48,501,"Yoakum County, TX",Oct-19,3699,3585,114,3.1
25306,CN4850300000000,48,503,"Young County, TX",Oct-19,8105,7878,227,2.8
25307,CN4850500000000,48,505,"Zapata County, TX",Oct-19,4789,4545,244,5.1
25308,CN4850700000000,48,507,"Zavala County, TX",Oct-19,3352,3078,274,8.2
25309,CN4900100000000,49,1,"Beaver County, UT",Oct-19,2860,2799,61,2.1
25310,CN4900300000000,49,3,"Box Elder County, UT",Oct-19,26129,25592,537,2.1
25311,CN4900500000000,49,5,"Cache County, UT",Oct-19,65179,64052,1127,1.7
25312,CN4900700000000,49,7,"Carbon County, UT",Oct-19,8645,8387,258,3.0
25313,CN4900900000000,49,9,"Daggett County, UT",Oct-19,401,387,14,3.5
25314,CN4901100000000,49,11,"Davis County, UT",Oct-19,175167,171737,3430,2.0
25315,CN4901300000000,49,13,"Duchesne County, UT",Oct-19,7802,7561,241,3.1
25316,CN4901500000000,49,15,"Emery County, UT",Oct-19,4266,4143,123,2.9
25317,CN4901700000000,49,17,"Garfield County, UT",Oct-19,2886,2806,80,2.8
25318,CN4901900000000,49,19,"Grand County, UT",Oct-19,6389,6266,123,1.9
25319,CN4902100000000,49,21,"Iron County, UT",Oct-19,24754,24187,567,2.3
25320,CN4902300000000,49,23,"Juab County, UT",Oct-19,5801,5699,102,1.8
25321,CN4902500000000,49,25,"Kane County, UT",Oct-19,3849,3770,79,2.1
25322,CN4902700000000,49,27,"Millard County, UT",Oct-19,6018,5886,132,2.2
25323,CN4902900000000,49,29,"Morgan County, UT",Oct-19,5603,5502,101,1.8
25324,CN4903100000000,49,31,"Piute County, UT",Oct-19,493,474,19,3.9
25325,CN4903300000000,49,33,"Rich County, UT",Oct-19,1120,1090,30,2.7
25326,CN4903500000000,49,35,"Salt Lake County, UT",Oct-19,640368,627077,13291,2.1
25327,CN4903700000000,49,37,"San Juan County, UT",Oct-19,5778,5567,211,3.7
25328,CN4903900000000,49,39,"Sanpete County, UT",Oct-19,12585,12270,315,2.5
25329,CN4904100000000,49,41,"Sevier County, UT",Oct-19,9751,9531,220,2.3
25330,CN4904300000000,49,43,"Summit County, UT",Oct-19,23854,23303,551,2.3
25331,CN4904500000000,49,45,"Tooele County, UT",Oct-19,34249,33443,806,2.4
25332,CN4904700000000,49,47,"Uintah County, UT",Oct-19,13634,13151,483,3.5
25333,CN4904900000000,49,49,"Utah County, UT",Oct-19,313159,307087,6072,1.9
25334,CN4905100000000,49,51,"Wasatch County, UT",Oct-19,16154,15778,376,2.3
25335,CN4905300000000,49,53,"Washington County, UT",Oct-19,77355,75516,1839,2.4
25336,CN4905500000000,49,55,"Wayne County, UT",Oct-19,1463,1422,41,2.8
25337,CN4905700000000,49,57,"Weber County, UT",Oct-19,128164,125332,2832,2.2
25338,CN5000100000000,50,1,"Addison County, VT",Oct-19,20436,20111,325,1.6
25339,CN5000300000000,50,3,"Bennington County, VT",Oct-19,17678,17294,384,2.2
25340,CN5000500000000,50,5,"Caledonia County, VT",Oct-19,14452,14159,293,2.0
25341,CN5000700000000,50,7,"Chittenden County, VT",Oct-19,96471,95136,1335,1.4
25342,CN5000900000000,50,9,"Essex County, VT",Oct-19,2648,2597,51,1.9
25343,CN5001100000000,50,11,"Franklin County, VT",Oct-19,27195,26748,447,1.6
25344,CN5001300000000,50,13,"Grand Isle County, VT",Oct-19,4020,3942,78,1.9
25345,CN5001500000000,50,15,"Lamoille County, VT",Oct-19,13814,13520,294,2.1
25346,CN5001700000000,50,17,"Orange County, VT",Oct-19,15781,15539,242,1.5
25347,CN5001900000000,50,19,"Orleans County, VT",Oct-19,13002,12636,366,2.8
25348,CN5002100000000,50,21,"Rutland County, VT",Oct-19,30019,29420,599,2.0
25349,CN5002300000000,50,23,"Washington County, VT",Oct-19,34066,33539,527,1.5
25350,CN5002500000000,50,25,"Windham County, VT",Oct-19,21545,21150,395,1.8
25351,CN5002700000000,50,27,"Windsor County, VT",Oct-19,28243,27782,461,1.6
25352,CN5100100000000,51,1,"Accomack County, VA",Oct-19,16747,16269,478,2.9
25353,CN5100300000000,51,3,"Albemarle County, VA",Oct-19,58209,56909,1300,2.2
25354,CN5100500000000,51,5,"Alleghany County, VA",Oct-19,6960,6750,210,3.0
25355,CN5100700000000,51,7,"Amelia County, VA",Oct-19,6369,6203,166,2.6
25356,CN5100900000000,51,9,"Amherst County, VA",Oct-19,15304,14862,442,2.9
25357,CN5101100000000,51,11,"Appomattox County, VA",Oct-19,7291,7071,220,3.0
25358,CN5101300000000,51,13,"Arlington County, VA",Oct-19,157251,154505,2746,1.7
25359,CN5101500000000,51,15,"Augusta County, VA",Oct-19,38235,37379,856,2.2
25360,CN5101700000000,51,17,"Bath County, VA",Oct-19,2552,2497,55,2.2
25361,CN5101900000000,51,19,"Bedford County, VA",Oct-19,39086,38069,1017,2.6
25362,CN5102100000000,51,21,"Bland County, VA",Oct-19,2856,2790,66,2.3
25363,CN5102300000000,51,23,"Botetourt County, VA",Oct-19,17601,17182,419,2.4
25364,CN5102500000000,51,25,"Brunswick County, VA",Oct-19,6073,5821,252,4.1
25365,CN5102700000000,51,27,"Buchanan County, VA",Oct-19,6686,6318,368,5.5
25366,CN5102900000000,51,29,"Buckingham County, VA",Oct-19,6487,6291,196,3.0
25367,CN5103100000000,51,31,"Campbell County, VA",Oct-19,26423,25680,743,2.8
25368,CN5103300000000,51,33,"Caroline County, VA",Oct-19,15469,15023,446,2.9
25369,CN5103500000000,51,35,"Carroll County, VA",Oct-19,13312,12885,427,3.2
25370,CN5103600000000,51,36,"Charles City County, VA",Oct-19,3726,3620,106,2.8
25371,CN5103700000000,51,37,"Charlotte County, VA",Oct-19,5378,5186,192,3.6
25372,CN5104100000000,51,41,"Chesterfield County, VA",Oct-19,190224,185445,4779,2.5
25373,CN5104300000000,51,43,"Clarke County, VA",Oct-19,7759,7590,169,2.2
25374,CN5104500000000,51,45,"Craig County, VA",Oct-19,2318,2254,64,2.8
25375,CN5104700000000,51,47,"Culpeper County, VA",Oct-19,25020,24439,581,2.3
25376,CN5104900000000,51,49,"Cumberland County, VA",Oct-19,4682,4556,126,2.7
25377,CN5105100000000,51,51,"Dickenson County, VA",Oct-19,4822,4603,219,4.5
25378,CN5105300000000,51,53,"Dinwiddie County, VA",Oct-19,13846,13442,404,2.9
25379,CN5105700000000,51,57,"Essex County, VA",Oct-19,5517,5345,172,3.1
25380,CN5105900000000,51,59,"Fairfax County, VA",Oct-19,646163,632820,13343,2.1
25381,CN5106100000000,51,61,"Fauquier County, VA",Oct-19,37992,37192,800,2.1
25382,CN5106300000000,51,63,"Floyd County, VA",Oct-19,8127,7941,186,2.3
25383,CN5106500000000,51,65,"Fluvanna County, VA",Oct-19,14133,13840,293,2.1
25384,CN5106700000000,51,67,"Franklin County, VA",Oct-19,26669,25943,726,2.7
25385,CN5106900000000,51,69,"Frederick County, VA",Oct-19,49145,48109,1036,2.1
25386,CN5107100000000,51,71,"Giles County, VA",Oct-19,7765,7546,219,2.8
25387,CN5107300000000,51,73,"Gloucester County, VA",Oct-19,19777,19313,464,2.3
25388,CN5107500000000,51,75,"Goochland County, VA",Oct-19,11358,11077,281,2.5
25389,CN5107700000000,51,77,"Grayson County, VA",Oct-19,8131,7924,207,2.5
25390,CN5107900000000,51,79,"Greene County, VA",Oct-19,10671,10442,229,2.1
25391,CN5108100000000,51,81,"Greensville County, VA",Oct-19,4303,4170,133,3.1
25392,CN5108300000000,51,83,"Halifax County, VA",Oct-19,15678,15096,582,3.7
25393,CN5108500000000,51,85,"Hanover County, VA",Oct-19,60163,58827,1336,2.2
25394,CN5108700000000,51,87,"Henrico County, VA",Oct-19,184705,179954,4751,2.6
25395,CN5108900000000,51,89,"Henry County, VA",Oct-19,23849,23124,725,3.0
25396,CN5109100000000,51,91,"Highland County, VA",Oct-19,1240,1210,30,2.4
25397,CN5109300000000,51,93,"Isle of Wight County, VA",Oct-19,19632,19130,502,2.6
25398,CN5109500000000,51,95,"James City County, VA",Oct-19,36892,36004,888,2.4
25399,CN5109700000000,51,97,"King and Queen County, VA",Oct-19,3868,3781,87,2.2
25400,CN5109900000000,51,99,"King George County, VA",Oct-19,13669,13341,328,2.4
25401,CN5110100000000,51,101,"King William County, VA",Oct-19,9288,9048,240,2.6
25402,CN5110300000000,51,103,"Lancaster County, VA",Oct-19,5469,5318,151,2.8
25403,CN5110500000000,51,105,"Lee County, VA",Oct-19,8302,7979,323,3.9
25404,CN5110700000000,51,107,"Loudoun County, VA",Oct-19,226780,222067,4713,2.1
25405,CN5110900000000,51,109,"Louisa County, VA",Oct-19,20307,19823,484,2.4
25406,CN5111100000000,51,111,"Lunenburg County, VA",Oct-19,5338,5185,153,2.9
25407,CN5111300000000,51,113,"Madison County, VA",Oct-19,7626,7475,151,2.0
25408,CN5111500000000,51,115,"Mathews County, VA",Oct-19,4176,4065,111,2.7
25409,CN5111700000000,51,117,"Mecklenburg County, VA",Oct-19,12504,12026,478,3.8
25410,CN5111900000000,51,119,"Middlesex County, VA",Oct-19,5351,5230,121,2.3
25411,CN5112100000000,51,121,"Montgomery County, VA",Oct-19,49344,48068,1276,2.6
25412,CN5112500000000,51,125,"Nelson County, VA",Oct-19,7552,7377,175,2.3
25413,CN5112700000000,51,127,"New Kent County, VA",Oct-19,12656,12389,267,2.1
25414,CN5113100000000,51,131,"Northampton County, VA",Oct-19,5551,5373,178,3.2
25415,CN5113300000000,51,133,"Northumberland County, VA",Oct-19,5696,5525,171,3.0
25416,CN5113500000000,51,135,"Nottoway County, VA",Oct-19,7358,7163,195,2.7
25417,CN5113700000000,51,137,"Orange County, VA",Oct-19,17717,17233,484,2.7
25418,CN5113900000000,51,139,"Page County, VA",Oct-19,12223,11885,338,2.8
25419,CN5114100000000,51,141,"Patrick County, VA",Oct-19,7276,7048,228,3.1
25420,CN5114300000000,51,143,"Pittsylvania County, VA",Oct-19,30458,29521,937,3.1
25421,CN5114500000000,51,145,"Powhatan County, VA",Oct-19,14332,14000,332,2.3
25422,CN5114700000000,51,147,"Prince Edward County, VA",Oct-19,10397,10063,334,3.2
25423,CN5114900000000,51,149,"Prince George County, VA",Oct-19,15332,14841,491,3.2
25424,CN5115300000000,51,153,"Prince William County, VA",Oct-19,250024,244346,5678,2.3
25425,CN5115500000000,51,155,"Pulaski County, VA",Oct-19,15780,15304,476,3.0
25426,CN5115700000000,51,157,"Rappahannock County, VA",Oct-19,3750,3668,82,2.2
25427,CN5115900000000,51,159,"Richmond County, VA",Oct-19,4119,4014,105,2.5
25428,CN5116100000000,51,161,"Roanoke County, VA",Oct-19,49804,48630,1174,2.4
25429,CN5116300000000,51,163,"Rockbridge County, VA",Oct-19,10983,10716,267,2.4
25430,CN5116500000000,51,165,"Rockingham County, VA",Oct-19,43157,42295,862,2.0
25431,CN5116700000000,51,167,"Russell County, VA",Oct-19,11329,10923,406,3.6
25432,CN5116900000000,51,169,"Scott County, VA",Oct-19,9205,8952,253,2.7
25433,CN5117100000000,51,171,"Shenandoah County, VA",Oct-19,22602,22099,503,2.2
25434,CN5117300000000,51,173,"Smyth County, VA",Oct-19,13935,13426,509,3.7
25435,CN5117500000000,51,175,"Southampton County, VA",Oct-19,9243,9008,235,2.5
25436,CN5117700000000,51,177,"Spotsylvania County, VA",Oct-19,68255,66472,1783,2.6
25437,CN5117900000000,51,179,"Stafford County, VA",Oct-19,73443,71594,1849,2.5
25438,CN5118100000000,51,181,"Surry County, VA",Oct-19,3756,3645,111,3.0
25439,CN5118300000000,51,183,"Sussex County, VA",Oct-19,3908,3751,157,4.0
25440,CN5118500000000,51,185,"Tazewell County, VA",Oct-19,15763,15128,635,4.0
25441,CN5118700000000,51,187,"Warren County, VA",Oct-19,20766,20246,520,2.5
25442,CN5119100000000,51,191,"Washington County, VA",Oct-19,26949,26164,785,2.9
25443,CN5119300000000,51,193,"Westmoreland County, VA",Oct-19,9621,9350,271,2.8
25444,CN5119500000000,51,195,"Wise County, VA",Oct-19,13515,12949,566,4.2
25445,CN5119700000000,51,197,"Wythe County, VA",Oct-19,13821,13366,455,3.3
25446,CN5119900000000,51,199,"York County, VA",Oct-19,33052,32260,792,2.4
25447,CN5151000000000,51,510,"Alexandria city, VA",Oct-19,103167,101198,1969,1.9
25448,CN5152000000000,51,520,"Bristol city, VA",Oct-19,7230,6981,249,3.4
25449,CN5153000000000,51,530,"Buena Vista city, VA",Oct-19,3653,3569,84,2.3
25450,CN5154000000000,51,540,"Charlottesville city, VA",Oct-19,26862,26313,549,2.0
25451,CN5155000000000,51,550,"Chesapeake city, VA",Oct-19,123888,120588,3300,2.7
25452,CN5157000000000,51,570,"Colonial Heights city, VA",Oct-19,8947,8667,280,3.1
25453,CN5158000000000,51,580,"Covington city, VA",Oct-19,2410,2322,88,3.7
25454,CN5159000000000,51,590,"Danville city, VA",Oct-19,19268,18406,862,4.5
25455,CN5159500000000,51,595,"Emporia city, VA",Oct-19,2283,2192,91,4.0
25456,CN5160000000000,51,600,"Fairfax city, VA",Oct-19,13681,13414,267,2.0
25457,CN5161000000000,51,610,"Falls Church city, VA",Oct-19,8744,8581,163,1.9
25458,CN5162000000000,51,620,"Franklin city, VA",Oct-19,3603,3464,139,3.9
25459,CN5163000000000,51,630,"Fredericksburg city, VA",Oct-19,14389,13964,425,3.0
25460,CN5164000000000,51,640,"Galax city, VA",Oct-19,2919,2838,81,2.8
25461,CN5165000000000,51,650,"Hampton city, VA",Oct-19,64892,62669,2223,3.4
25462,CN5166000000000,51,660,"Harrisonburg city, VA",Oct-19,25648,24955,693,2.7
25463,CN5167000000000,51,670,"Hopewell city, VA",Oct-19,9816,9434,382,3.9
25464,CN5167800000000,51,678,"Lexington city, VA",Oct-19,2129,2039,90,4.2
25465,CN5168000000000,51,680,"Lynchburg city, VA",Oct-19,36902,35715,1187,3.2
25466,CN5168300000000,51,683,"Manassas city, VA",Oct-19,22414,21929,485,2.2
25467,CN5168500000000,51,685,"Manassas Park city, VA",Oct-19,9524,9317,207,2.2
25468,CN5169000000000,51,690,"Martinsville city, VA",Oct-19,5506,5289,217,3.9
25469,CN5170000000000,51,700,"Newport News city, VA",Oct-19,89557,86745,2812,3.1
25470,CN5171000000000,51,710,"Norfolk city, VA",Oct-19,112518,109028,3490,3.1
25471,CN5172000000000,51,720,"Norton city, VA",Oct-19,1691,1637,54,3.2
25472,CN5173000000000,51,730,"Petersburg city, VA",Oct-19,13179,12510,669,5.1
25473,CN5173500000000,51,735,"Poquoson city, VA",Oct-19,6463,6316,147,2.3
25474,CN5174000000000,51,740,"Portsmouth city, VA",Oct-19,44631,43032,1599,3.6
25475,CN5175000000000,51,750,"Radford city, VA",Oct-19,8491,8229,262,3.1
25476,CN5176000000000,51,760,"Richmond city, VA",Oct-19,119924,116325,3599,3.0
25477,CN5177000000000,51,770,"Roanoke city, VA",Oct-19,49535,48167,1368,2.8
25478,CN5177500000000,51,775,"Salem city, VA",Oct-19,13085,12757,328,2.5
25479,CN5179000000000,51,790,"Staunton city, VA",Oct-19,12443,12139,304,2.4
25480,CN5180000000000,51,800,"Suffolk city, VA",Oct-19,45076,43817,1259,2.8
25481,CN5181000000000,51,810,"Virginia Beach city, VA",Oct-19,235102,229249,5853,2.5
25482,CN5182000000000,51,820,"Waynesboro city, VA",Oct-19,10870,10581,289,2.7
25483,CN5183000000000,51,830,"Williamsburg city, VA",Oct-19,6734,6499,235,3.5
25484,CN5184000000000,51,840,"Winchester city, VA",Oct-19,15122,14752,370,2.4
25485,CN5300100000000,53,1,"Adams County, WA",Oct-19,10414,10025,389,3.7
25486,CN5300300000000,53,3,"Asotin County, WA",Oct-19,10609,10250,359,3.4
25487,CN5300500000000,53,5,"Benton County, WA",Oct-19,104670,100330,4340,4.1
25488,CN5300700000000,53,7,"Chelan County, WA",Oct-19,45754,44107,1647,3.6
25489,CN5300900000000,53,9,"Clallam County, WA",Oct-19,29300,27703,1597,5.5
25490,CN5301100000000,53,11,"Clark County, WA",Oct-19,244960,234661,10299,4.2
25491,CN5301300000000,53,13,"Columbia County, WA",Oct-19,1883,1800,83,4.4
25492,CN5301500000000,53,15,"Cowlitz County, WA",Oct-19,48321,45832,2489,5.2
25493,CN5301700000000,53,17,"Douglas County, WA",Oct-19,22452,21534,918,4.1
25494,CN5301900000000,53,19,"Ferry County, WA",Oct-19,2413,2200,213,8.8
25495,CN5302100000000,53,21,"Franklin County, WA",Oct-19,43354,41360,1994,4.6
25496,CN5302300000000,53,23,"Garfield County, WA",Oct-19,945,902,43,4.6
25497,CN5302500000000,53,25,"Grant County, WA",Oct-19,47617,45227,2390,5.0
25498,CN5302700000000,53,27,"Grays Harbor County, WA",Oct-19,29248,27518,1730,5.9
25499,CN5302900000000,53,29,"Island County, WA",Oct-19,36951,35358,1593,4.3
25500,CN5303100000000,53,31,"Jefferson County, WA",Oct-19,13304,12681,623,4.7
25501,CN5303300000000,53,33,"King County, WA",Oct-19,1290236,1256592,33644,2.6
25502,CN5303500000000,53,35,"Kitsap County, WA",Oct-19,130423,125361,5062,3.9
25503,CN5303700000000,53,37,"Kittitas County, WA",Oct-19,24612,23542,1070,4.3
25504,CN5303900000000,53,39,"Klickitat County, WA",Oct-19,10417,9945,472,4.5
25505,CN5304100000000,53,41,"Lewis County, WA",Oct-19,35291,33470,1821,5.2
25506,CN5304300000000,53,43,"Lincoln County, WA",Oct-19,5022,4812,210,4.2
25507,CN5304500000000,53,45,"Mason County, WA",Oct-19,26530,25169,1361,5.1
25508,CN5304700000000,53,47,"Okanogan County, WA",Oct-19,20564,19604,960,4.7
25509,CN5304900000000,53,49,"Pacific County, WA",Oct-19,8636,8110,526,6.1
25510,CN5305100000000,53,51,"Pend Oreille County, WA",Oct-19,5144,4793,351,6.8
25511,CN5305300000000,53,53,"Pierce County, WA",Oct-19,448395,428436,19959,4.5
25512,CN5305500000000,53,55,"San Juan County, WA",Oct-19,8751,8471,280,3.2
25513,CN5305700000000,53,57,"Skagit County, WA",Oct-19,63801,60862,2939,4.6
25514,CN5305900000000,53,59,"Skamania County, WA",Oct-19,5602,5357,245,4.4
25515,CN5306100000000,53,61,"Snohomish County, WA",Oct-19,439529,426954,12575,2.9
25516,CN5306300000000,53,63,"Spokane County, WA",Oct-19,258979,248088,10891,4.2
25517,CN5306500000000,53,65,"Stevens County, WA",Oct-19,19167,18194,973,5.1
25518,CN5306700000000,53,67,"Thurston County, WA",Oct-19,145859,139729,6130,4.2
25519,CN5306900000000,53,69,"Wahkiakum County, WA",Oct-19,1389,1306,83,6.0
25520,CN5307100000000,53,71,"Walla Walla County, WA",Oct-19,31865,30626,1239,3.9
25521,CN5307300000000,53,73,"Whatcom County, WA",Oct-19,116357,111328,5029,4.3
25522,CN5307500000000,53,75,"Whitman County, WA",Oct-19,25031,24041,990,4.0
25523,CN5307700000000,53,77,"Yakima County, WA",Oct-19,137142,130792,6350,4.6
25524,CN5400100000000,54,1,"Barbour County, WV",Oct-19,7460,7055,405,5.4
25525,CN5400300000000,54,3,"Berkeley County, WV",Oct-19,59761,57853,1908,3.2
25526,CN5400500000000,54,5,"Boone County, WV",Oct-19,7514,7102,412,5.5
25527,CN5400700000000,54,7,"Braxton County, WV",Oct-19,5301,4944,357,6.7
25528,CN5400900000000,54,9,"Brooke County, WV",Oct-19,10155,9616,539,5.3
25529,CN5401100000000,54,11,"Cabell County, WV",Oct-19,42130,40513,1617,3.8
25530,CN5401300000000,54,13,"Calhoun County, WV",Oct-19,2566,2275,291,11.3
25531,CN5401500000000,54,15,"Clay County, WV",Oct-19,3162,2910,252,8.0
25532,CN5401700000000,54,17,"Doddridge County, WV",Oct-19,4071,3886,185,4.5
25533,CN5401900000000,54,19,"Fayette County, WV",Oct-19,16494,15632,862,5.2
25534,CN5402100000000,54,21,"Gilmer County, WV",Oct-19,2481,2325,156,6.3
25535,CN5402300000000,54,23,"Grant County, WV",Oct-19,5997,5717,280,4.7
25536,CN5402500000000,54,25,"Greenbrier County, WV",Oct-19,16282,15580,702,4.3
25537,CN5402700000000,54,27,"Hampshire County, WV",Oct-19,11007,10632,375,3.4
25538,CN5402900000000,54,29,"Hancock County, WV",Oct-19,13271,12577,694,5.2
25539,CN5403100000000,54,31,"Hardy County, WV",Oct-19,5840,5593,247,4.2
25540,CN5403300000000,54,33,"Harrison County, WV",Oct-19,34943,33462,1481,4.2
25541,CN5403500000000,54,35,"Jackson County, WV",Oct-19,13504,12881,623,4.6
25542,CN5403700000000,54,37,"Jefferson County, WV",Oct-19,30788,29916,872,2.8
25543,CN5403900000000,54,39,"Kanawha County, WV",Oct-19,82917,79391,3526,4.3
25544,CN5404100000000,54,41,"Lewis County, WV",Oct-19,6852,6390,462,6.7
25545,CN5404300000000,54,43,"Lincoln County, WV",Oct-19,7304,6862,442,6.1
25546,CN5404500000000,54,45,"Logan County, WV",Oct-19,11285,10628,657,5.8
25547,CN5404700000000,54,47,"McDowell County, WV",Oct-19,4442,4087,355,8.0
25548,CN5404900000000,54,49,"Marion County, WV",Oct-19,25938,24688,1250,4.8
25549,CN5405100000000,54,51,"Marshall County, WV",Oct-19,14459,13602,857,5.9
25550,CN5405300000000,54,53,"Mason County, WV",Oct-19,10435,9862,573,5.5
25551,CN5405500000000,54,55,"Mercer County, WV",Oct-19,21399,20277,1122,5.2
25552,CN5405700000000,54,57,"Mineral County, WV",Oct-19,12921,12173,748,5.8
25553,CN5405900000000,54,59,"Mingo County, WV",Oct-19,6994,6523,471,6.7
25554,CN5406100000000,54,61,"Monongalia County, WV",Oct-19,56170,54282,1888,3.4
25555,CN5406300000000,54,63,"Monroe County, WV",Oct-19,6064,5832,232,3.8
25556,CN5406500000000,54,65,"Morgan County, WV",Oct-19,8301,8015,286,3.4
25557,CN5406700000000,54,67,"Nicholas County, WV",Oct-19,9651,9078,573,5.9
25558,CN5406900000000,54,69,"Ohio County, WV",Oct-19,21762,20767,995,4.6
25559,CN5407100000000,54,71,"Pendleton County, WV",Oct-19,3783,3669,114,3.0
25560,CN5407300000000,54,73,"Pleasants County, WV",Oct-19,2962,2764,198,6.7
25561,CN5407500000000,54,75,"Pocahontas County, WV",Oct-19,3693,3505,188,5.1
25562,CN5407700000000,54,77,"Preston County, WV",Oct-19,15978,15357,621,3.9
25563,CN5407900000000,54,79,"Putnam County, WV",Oct-19,27084,26038,1046,3.9
25564,CN5408100000000,54,81,"Raleigh County, WV",Oct-19,30936,29598,1338,4.3
25565,CN5408300000000,54,83,"Randolph County, WV",Oct-19,12477,11823,654,5.2
25566,CN5408500000000,54,85,"Ritchie County, WV",Oct-19,4477,4218,259,5.8
25567,CN5408700000000,54,87,"Roane County, WV",Oct-19,5213,4758,455,8.7
25568,CN5408900000000,54,89,"Summers County, WV",Oct-19,4429,4217,212,4.8
25569,CN5409100000000,54,91,"Taylor County, WV",Oct-19,8023,7665,358,4.5
25570,CN5409300000000,54,93,"Tucker County, WV",Oct-19,3408,3257,151,4.4
25571,CN5409500000000,54,95,"Tyler County, WV",Oct-19,3144,2917,227,7.2
25572,CN5409700000000,54,97,"Upshur County, WV",Oct-19,9753,9204,549,5.6
25573,CN5409900000000,54,99,"Wayne County, WV",Oct-19,16003,15217,786,4.9
25574,CN5410100000000,54,101,"Webster County, WV",Oct-19,3399,3206,193,5.7
25575,CN5410300000000,54,103,"Wetzel County, WV",Oct-19,6724,6255,469,7.0
25576,CN5410500000000,54,105,"Wirt County, WV",Oct-19,2346,2163,183,7.8
25577,CN5410700000000,54,107,"Wood County, WV",Oct-19,37345,35588,1757,4.7
25578,CN5410900000000,54,109,"Wyoming County, WV",Oct-19,6713,6296,417,6.2
25579,CN5500100000000,55,1,"Adams County, WI",Oct-19,8086,7799,287,3.5
25580,CN5500300000000,55,3,"Ashland County, WI",Oct-19,8050,7755,295,3.7
25581,CN5500500000000,55,5,"Barron County, WI",Oct-19,24227,23520,707,2.9
25582,CN5500700000000,55,7,"Bayfield County, WI",Oct-19,7673,7402,271,3.5
25583,CN5500900000000,55,9,"Brown County, WI",Oct-19,141834,138098,3736,2.6
25584,CN5501100000000,55,11,"Buffalo County, WI",Oct-19,6411,6218,193,3.0
25585,CN5501300000000,55,13,"Burnett County, WI",Oct-19,7019,6757,262,3.7
25586,CN5501500000000,55,15,"Calumet County, WI",Oct-19,27400,26748,652,2.4
25587,CN5501700000000,55,17,"Chippewa County, WI",Oct-19,33154,32223,931,2.8
25588,CN5501900000000,55,19,"Clark County, WI",Oct-19,17477,17055,422,2.4
25589,CN5502100000000,55,21,"Columbia County, WI",Oct-19,31730,30939,791,2.5
25590,CN5502300000000,55,23,"Crawford County, WI",Oct-19,7572,7336,236,3.1
25591,CN5502500000000,55,25,"Dane County, WI",Oct-19,324865,317924,6941,2.1
25592,CN5502700000000,55,27,"Dodge County, WI",Oct-19,47373,46161,1212,2.6
25593,CN5502900000000,55,29,"Door County, WI",Oct-19,15866,15470,396,2.5
25594,CN5503100000000,55,31,"Douglas County, WI",Oct-19,23075,22335,740,3.2
25595,CN5503300000000,55,33,"Dunn County, WI",Oct-19,24454,23820,634,2.6
25596,CN5503500000000,55,35,"Eau Claire County, WI",Oct-19,59134,57668,1466,2.5
25597,CN5503700000000,55,37,"Florence County, WI",Oct-19,2213,2129,84,3.8
25598,CN5503900000000,55,39,"Fond du Lac County, WI",Oct-19,57161,55742,1419,2.5
25599,CN5504100000000,55,41,"Forest County, WI",Oct-19,3980,3838,142,3.6
25600,CN5504300000000,55,43,"Grant County, WI",Oct-19,28260,27542,718,2.5
25601,CN5504500000000,55,45,"Green County, WI",Oct-19,21117,20656,461,2.2
25602,CN5504700000000,55,47,"Green Lake County, WI",Oct-19,9334,9072,262,2.8
25603,CN5504900000000,55,49,"Iowa County, WI",Oct-19,13763,13474,289,2.1
25604,CN5505100000000,55,51,"Iron County, WI",Oct-19,2551,2432,119,4.7
25605,CN5505300000000,55,53,"Jackson County, WI",Oct-19,10177,9882,295,2.9
25606,CN5505500000000,55,55,"Jefferson County, WI",Oct-19,45674,44528,1146,2.5
25607,CN5505700000000,55,57,"Juneau County, WI",Oct-19,13356,13026,330,2.5
25608,CN5505900000000,55,59,"Kenosha County, WI",Oct-19,89197,86132,3065,3.4
25609,CN5506100000000,55,61,"Kewaunee County, WI",Oct-19,10971,10709,262,2.4
25610,CN5506300000000,55,63,"La Crosse County, WI",Oct-19,66525,64960,1565,2.4
25611,CN5506500000000,55,65,"Lafayette County, WI",Oct-19,10035,9836,199,2.0
25612,CN5506700000000,55,67,"Langlade County, WI",Oct-19,9146,8843,303,3.3
25613,CN5506900000000,55,69,"Lincoln County, WI",Oct-19,15030,14589,441,2.9
25614,CN5507100000000,55,71,"Manitowoc County, WI",Oct-19,40893,39739,1154,2.8
25615,CN5507300000000,55,73,"Marathon County, WI",Oct-19,73343,71555,1788,2.4
25616,CN5507500000000,55,75,"Marinette County, WI",Oct-19,19322,18571,751,3.9
25617,CN5507700000000,55,77,"Marquette County, WI",Oct-19,7715,7504,211,2.7
25618,CN5507800000000,55,78,"Menominee County, WI",Oct-19,1589,1482,107,6.7
25619,CN5507900000000,55,79,"Milwaukee County, WI",Oct-19,466945,450016,16929,3.6
25620,CN5508100000000,55,81,"Monroe County, WI",Oct-19,23271,22721,550,2.4
25621,CN5508300000000,55,83,"Oconto County, WI",Oct-19,20522,19952,570,2.8
25622,CN5508500000000,55,85,"Oneida County, WI",Oct-19,17469,16911,558,3.2
25623,CN5508700000000,55,87,"Outagamie County, WI",Oct-19,102440,99943,2497,2.4
25624,CN5508900000000,55,89,"Ozaukee County, WI",Oct-19,49204,47972,1232,2.5
25625,CN5509100000000,55,91,"Pepin County, WI",Oct-19,4173,4060,113,2.7
25626,CN5509300000000,55,93,"Pierce County, WI",Oct-19,25299,24686,613,2.4
25627,CN5509500000000,55,95,"Polk County, WI",Oct-19,24399,23729,670,2.7
25628,CN5509700000000,55,97,"Portage County, WI",Oct-19,38909,37935,974,2.5
25629,CN5509900000000,55,99,"Price County, WI",Oct-19,6604,6305,299,4.5
25630,CN5510100000000,55,101,"Racine County, WI",Oct-19,97840,94293,3547,3.6
25631,CN5510300000000,55,103,"Richland County, WI",Oct-19,9132,8878,254,2.8
25632,CN5510500000000,55,105,"Rock County, WI",Oct-19,84938,82178,2760,3.2
25633,CN5510700000000,55,107,"Rusk County, WI",Oct-19,6720,6474,246,3.7
25634,CN5510900000000,55,109,"St. Croix County, WI",Oct-19,50489,49183,1306,2.6
25635,CN5511100000000,55,111,"Sauk County, WI",Oct-19,35201,34354,847,2.4
25636,CN5511300000000,55,113,"Sawyer County, WI",Oct-19,8013,7740,273,3.4
25637,CN5511500000000,55,115,"Shawano County, WI",Oct-19,20790,20273,517,2.5
25638,CN5511700000000,55,117,"Sheboygan County, WI",Oct-19,61425,59912,1513,2.5
25639,CN5511900000000,55,119,"Taylor County, WI",Oct-19,10900,10633,267,2.4
25640,CN5512100000000,55,121,"Trempealeau County, WI",Oct-19,15848,15452,396,2.5
25641,CN5512300000000,55,123,"Vernon County, WI",Oct-19,15181,14785,396,2.6
25642,CN5512500000000,55,125,"Vilas County, WI",Oct-19,10132,9837,295,2.9
25643,CN5512700000000,55,127,"Walworth County, WI",Oct-19,58409,56861,1548,2.7
25644,CN5512900000000,55,129,"Washburn County, WI",Oct-19,7861,7619,242,3.1
25645,CN5513100000000,55,131,"Washington County, WI",Oct-19,77172,75220,1952,2.5
25646,CN5513300000000,55,133,"Waukesha County, WI",Oct-19,225034,219243,5791,2.6
25647,CN5513500000000,55,135,"Waupaca County, WI",Oct-19,25565,24866,699,2.7
25648,CN5513700000000,55,137,"Waushara County, WI",Oct-19,11252,10885,367,3.3
25649,CN5513900000000,55,139,"Winnebago County, WI",Oct-19,91238,88827,2411,2.6
25650,CN5514100000000,55,141,"Wood County, WI",Oct-19,35116,34091,1025,2.9
25651,CN5600100000000,56,1,"Albany County, WY",Oct-19,20899,20308,591,2.8
25652,CN5600300000000,56,3,"Big Horn County, WY",Oct-19,5429,5232,197,3.6
25653,CN5600500000000,56,5,"Campbell County, WY",Oct-19,23334,22517,817,3.5
25654,CN5600700000000,56,7,"Carbon County, WY",Oct-19,8158,7926,232,2.8
25655,CN5600900000000,56,9,"Converse County, WY",Oct-19,8968,8729,239,2.7
25656,CN5601100000000,56,11,"Crook County, WY",Oct-19,3719,3615,104,2.8
25657,CN5601300000000,56,13,"Fremont County, WY",Oct-19,18833,18080,753,4.0
25658,CN5601500000000,56,15,"Goshen County, WY",Oct-19,6646,6405,241,3.6
25659,CN5601700000000,56,17,"Hot Springs County, WY",Oct-19,2130,2055,75,3.5
25660,CN5601900000000,56,19,"Johnson County, WY",Oct-19,4183,4059,124,3.0
25661,CN5602100000000,56,21,"Laramie County, WY",Oct-19,48535,46903,1632,3.4
25662,CN5602300000000,56,23,"Lincoln County, WY",Oct-19,8912,8637,275,3.1
25663,CN5602500000000,56,25,"Natrona County, WY",Oct-19,39482,37994,1488,3.8
25664,CN5602700000000,56,27,"Niobrara County, WY",Oct-19,1235,1204,31,2.5
25665,CN5602900000000,56,29,"Park County, WY",Oct-19,15358,14809,549,3.6
25666,CN5603100000000,56,31,"Platte County, WY",Oct-19,4515,4375,140,3.1
25667,CN5603300000000,56,33,"Sheridan County, WY",Oct-19,15613,15157,456,2.9
25668,CN5603500000000,56,35,"Sublette County, WY",Oct-19,4211,4023,188,4.5
25669,CN5603700000000,56,37,"Sweetwater County, WY",Oct-19,21155,20417,738,3.5
25670,CN5603900000000,56,39,"Teton County, WY",Oct-19,15229,14808,421,2.8
25671,CN5604100000000,56,41,"Uinta County, WY",Oct-19,8985,8653,332,3.7
25672,CN5604300000000,56,43,"Washakie County, WY",Oct-19,3971,3832,139,3.5
25673,CN5604500000000,56,45,"Weston County, WY",Oct-19,3814,3719,95,2.5
25674,CN7200100000000,72,1,"Adjuntas Municipio, PR",Oct-19,4049,3451,598,14.8
25675,CN7200300000000,72,3,"Aguada Municipio, PR",Oct-19,11567,10331,1236,10.7
25676,CN7200500000000,72,5,"Aguadilla Municipio, PR",Oct-19,14181,12650,1531,10.8
25677,CN7200700000000,72,7,"Aguas Buenas Municipio, PR",Oct-19,6419,5774,645,10.0
25678,CN7200900000000,72,9,"Aibonito Municipio, PR",Oct-19,6389,5700,689,10.8
25679,CN7201100000000,72,11,"Anasco Municipio, PR",Oct-19,8568,7797,771,9.0
25680,CN7201300000000,72,13,"Arecibo Municipio, PR",Oct-19,23761,21279,2482,10.4
25681,CN7201500000000,72,15,"Arroyo Municipio, PR",Oct-19,4511,3879,632,14.0
25682,CN7201700000000,72,17,"Barceloneta Municipio, PR",Oct-19,5846,5118,728,12.5
25683,CN7201900000000,72,19,"Barranquitas Municipio, PR",Oct-19,7307,6610,697,9.5
25684,CN7202100000000,72,21,"Bayamon Municipio, PR",Oct-19,63473,59010,4463,7.0
25685,CN7202300000000,72,23,"Cabo Rojo Municipio, PR",Oct-19,13386,12154,1232,9.2
25686,CN7202500000000,72,25,"Caguas Municipio, PR",Oct-19,46519,43059,3460,7.4
25687,CN7202700000000,72,27,"Camuy Municipio, PR",Oct-19,9409,8526,883,9.4
25688,CN7202900000000,72,29,"Canovanas Municipio, PR",Oct-19,15688,14508,1180,7.5
25689,CN7203100000000,72,31,"Carolina Municipio, PR",Oct-19,59935,55925,4010,6.7
25690,CN7203300000000,72,33,"Catano Municipio, PR",Oct-19,7609,6988,621,8.2
25691,CN7203500000000,72,35,"Cayey Municipio, PR",Oct-19,15646,14440,1206,7.7
25692,CN7203700000000,72,37,"Ceiba Municipio, PR",Oct-19,3581,3206,375,10.5
25693,CN7203900000000,72,39,"Ciales Municipio, PR",Oct-19,3668,3220,448,12.2
25694,CN7204100000000,72,41,"Cidra Municipio, PR",Oct-19,15061,13978,1083,7.2
25695,CN7204300000000,72,43,"Coamo Municipio, PR",Oct-19,9812,8547,1265,12.9
25696,CN7204500000000,72,45,"Comerio Municipio, PR",Oct-19,4822,4333,489,10.1
25697,CN7204700000000,72,47,"Corozal Municipio, PR",Oct-19,8816,7941,875,9.9
25698,CN7204900000000,72,49,"Culebra Municipio, PR",Oct-19,859,829,30,3.5
25699,CN7205100000000,72,51,"Dorado Municipio, PR",Oct-19,12839,11992,847,6.6
25700,CN7205300000000,72,53,"Fajardo Municipio, PR",Oct-19,10631,9462,1169,11.0
25701,CN7205400000000,72,54,"Florida Municipio, PR",Oct-19,3264,2892,372,11.4
25702,CN7205500000000,72,55,"Guanica Municipio, PR",Oct-19,4074,3379,695,17.1
25703,CN7205700000000,72,57,"Guayama Municipio, PR",Oct-19,10777,9369,1408,13.1
25704,CN7205900000000,72,59,"Guayanilla Municipio, PR",Oct-19,4816,4106,710,14.7
25705,CN7206100000000,72,61,"Guaynabo Municipio, PR",Oct-19,36280,34546,1734,4.8
25706,CN7206300000000,72,63,"Gurabo Municipio, PR",Oct-19,17624,16511,1113,6.3
25707,CN7206500000000,72,65,"Hatillo Municipio, PR",Oct-19,13235,11732,1503,11.4
25708,CN7206700000000,72,67,"Hormigueros Municipio, PR",Oct-19,5220,4746,474,9.1
25709,CN7206900000000,72,69,"Humacao Municipio, PR",Oct-19,16712,14936,1776,10.6
25710,CN7207100000000,72,71,"Isabela Municipio, PR",Oct-19,12072,10955,1117,9.3
25711,CN7207300000000,72,73,"Jayuya Municipio, PR",Oct-19,4178,3598,580,13.9
25712,CN7207500000000,72,75,"Juana Diaz Municipio, PR",Oct-19,14764,13131,1633,11.1
25713,CN7207700000000,72,77,"Juncos Municipio, PR",Oct-19,12082,10967,1115,9.2
25714,CN7207900000000,72,79,"Lajas Municipio, PR",Oct-19,5190,4488,702,13.5
25715,CN7208100000000,72,81,"Lares Municipio, PR",Oct-19,7044,6070,974,13.8
25716,CN7208300000000,72,83,"Las Marias Municipio, PR",Oct-19,2532,2220,312,12.3
25717,CN7208500000000,72,85,"Las Piedras Municipio, PR",Oct-19,11072,9972,1100,9.9
25718,CN7208700000000,72,87,"Loiza Municipio, PR",Oct-19,8288,7554,734,8.9
25719,CN7208900000000,72,89,"Luquillo Municipio, PR",Oct-19,6029,5410,619,10.3
25720,CN7209100000000,72,91,"Manati Municipio, PR",Oct-19,11318,10315,1003,8.9
25721,CN7209300000000,72,93,"Maricao Municipio, PR",Oct-19,1883,1643,240,12.7
25722,CN7209500000000,72,95,"Maunabo Municipio, PR",Oct-19,2824,2428,396,14.0
25723,CN7209700000000,72,97,"Mayaguez Municipio, PR",Oct-19,21252,18874,2378,11.2
25724,CN7209900000000,72,99,"Moca Municipio, PR",Oct-19,10189,9089,1100,10.8
25725,CN7210100000000,72,101,"Morovis Municipio, PR",Oct-19,7876,7077,799,10.1
25726,CN7210300000000,72,103,"Naguabo Municipio, PR",Oct-19,7962,7180,782,9.8
25727,CN7210500000000,72,105,"Naranjito Municipio, PR",Oct-19,6988,6310,678,9.7
25728,CN7210700000000,72,107,"Orocovis Municipio, PR",Oct-19,4840,4322,518,10.7
25729,CN7210900000000,72,109,"Patillas Municipio, PR",Oct-19,4110,3519,591,14.4
25730,CN7211100000000,72,111,"Penuelas Municipio, PR",Oct-19,5808,4916,892,15.4
25731,CN7211300000000,72,113,"Ponce Municipio, PR",Oct-19,44405,39702,4703,10.6
25732,CN7211500000000,72,115,"Quebradillas Municipio, PR",Oct-19,5935,5212,723,12.2
25733,CN7211700000000,72,117,"Rincon Municipio, PR",Oct-19,4531,3957,574,12.7
25734,CN7211900000000,72,119,"Rio Grande Municipio, PR",Oct-19,16572,15236,1336,8.1
25735,CN7212100000000,72,121,"Sabana Grande Municipio, PR",Oct-19,6164,5335,829,13.4
25736,CN7212300000000,72,123,"Salinas Municipio, PR",Oct-19,7039,5902,1137,16.2
25737,CN7212500000000,72,125,"San German Municipio, PR",Oct-19,9581,8459,1122,11.7
25738,CN7212700000000,72,127,"San Juan Municipio, PR",Oct-19,129240,121050,8190,6.3
25739,CN7212900000000,72,129,"San Lorenzo Municipio, PR",Oct-19,11442,10377,1065,9.3
25740,CN7213100000000,72,131,"San Sebastian Municipio, PR",Oct-19,10118,8749,1369,13.5
25741,CN7213300000000,72,133,"Santa Isabel Municipio, PR",Oct-19,8757,7575,1182,13.5
25742,CN7213500000000,72,135,"Toa Alta Municipio, PR",Oct-19,26479,24738,1741,6.6
25743,CN7213700000000,72,137,"Toa Baja Municipio, PR",Oct-19,28514,26641,1873,6.6
25744,CN7213900000000,72,139,"Trujillo Alto Municipio, PR",Oct-19,26252,24834,1418,5.4
25745,CN7214100000000,72,141,"Utuado Municipio, PR",Oct-19,6603,5797,806,12.2
25746,CN7214300000000,72,143,"Vega Alta Municipio, PR",Oct-19,9570,8702,868,9.1
25747,CN7214500000000,72,145,"Vega Baja Municipio, PR",Oct-19,13113,11725,1388,10.6
25748,CN7214700000000,72,147,"Vieques Municipio, PR",Oct-19,2463,2281,182,7.4
25749,CN7214900000000,72,149,"Villalba Municipio, PR",Oct-19,7227,6105,1122,15.5
25750,CN7215100000000,72,151,"Yabucoa Municipio, PR",Oct-19,8673,7443,1230,14.2
25751,CN7215300000000,72,153,"Yauco Municipio, PR",Oct-19,9713,8312,1401,14.4
25752,CN0100100000000,01,1,"Autauga County, AL",Nov-19,26086,25500,586,2.2
25753,CN0100300000000,01,3,"Baldwin County, AL",Nov-19,96603,94405,2198,2.3
25754,CN0100500000000,01,5,"Barbour County, AL",Nov-19,8600,8323,277,3.2
25755,CN0100700000000,01,7,"Bibb County, AL",Nov-19,8720,8510,210,2.4
25756,CN0100900000000,01,9,"Blount County, AL",Nov-19,25411,24851,560,2.2
25757,CN0101100000000,01,11,"Bullock County, AL",Nov-19,4759,4592,167,3.5
25758,CN0101300000000,01,13,"Butler County, AL",Nov-19,9244,8945,299,3.2
25759,CN0101500000000,01,15,"Calhoun County, AL",Nov-19,46408,45076,1332,2.9
25760,CN0101700000000,01,17,"Chambers County, AL",Nov-19,15873,15492,381,2.4
25761,CN0101900000000,01,19,"Cherokee County, AL",Nov-19,11487,11218,269,2.3
25762,CN0102100000000,01,21,"Chilton County, AL",Nov-19,19898,19447,451,2.3
25763,CN0102300000000,01,23,"Choctaw County, AL",Nov-19,4525,4343,182,4.0
25764,CN0102500000000,01,25,"Clarke County, AL",Nov-19,7409,7058,351,4.7
25765,CN0102700000000,01,27,"Clay County, AL",Nov-19,6110,5962,148,2.4
25766,CN0102900000000,01,29,"Cleburne County, AL",Nov-19,5757,5615,142,2.5
25767,CN0103100000000,01,31,"Coffee County, AL",Nov-19,21161,20663,498,2.4
25768,CN0103300000000,01,33,"Colbert County, AL",Nov-19,23719,23015,704,3.0
25769,CN0103500000000,01,35,"Conecuh County, AL",Nov-19,4462,4316,146,3.3
25770,CN0103700000000,01,37,"Coosa County, AL",Nov-19,4516,4412,104,2.3
25771,CN0103900000000,01,39,"Covington County, AL",Nov-19,15528,15115,413,2.7
25772,CN0104100000000,01,41,"Crenshaw County, AL",Nov-19,6388,6240,148,2.3
25773,CN0104300000000,01,43,"Cullman County, AL",Nov-19,38779,37959,820,2.1
25774,CN0104500000000,01,45,"Dale County, AL",Nov-19,20668,20158,510,2.5
25775,CN0104700000000,01,47,"Dallas County, AL",Nov-19,14524,13913,611,4.2
25776,CN0104900000000,01,49,"DeKalb County, AL",Nov-19,30847,30156,691,2.2
25777,CN0105100000000,01,51,"Elmore County, AL",Nov-19,37508,36673,835,2.2
25778,CN0105300000000,01,53,"Escambia County, AL",Nov-19,14802,14379,423,2.9
25779,CN0105500000000,01,55,"Etowah County, AL",Nov-19,42785,41622,1163,2.7
25780,CN0105700000000,01,57,"Fayette County, AL",Nov-19,6570,6402,168,2.6
25781,CN0105900000000,01,59,"Franklin County, AL",Nov-19,14752,14423,329,2.2
25782,CN0106100000000,01,61,"Geneva County, AL",Nov-19,10979,10722,257,2.3
25783,CN0106300000000,01,63,"Greene County, AL",Nov-19,2866,2735,131,4.6
25784,CN0106500000000,01,65,"Hale County, AL",Nov-19,6141,5953,188,3.1
25785,CN0106700000000,01,67,"Henry County, AL",Nov-19,6915,6719,196,2.8
25786,CN0106900000000,01,69,"Houston County, AL",Nov-19,46336,45207,1129,2.4
25787,CN0107100000000,01,71,"Jackson County, AL",Nov-19,23221,22583,638,2.7
25788,CN0107300000000,01,73,"Jefferson County, AL",Nov-19,320792,313419,7373,2.3
25789,CN0107500000000,01,75,"Lamar County, AL",Nov-19,5842,5697,145,2.5
25790,CN0107700000000,01,77,"Lauderdale County, AL",Nov-19,42668,41570,1098,2.6
25791,CN0107900000000,01,79,"Lawrence County, AL",Nov-19,14359,13998,361,2.5
25792,CN0108100000000,01,81,"Lee County, AL",Nov-19,78204,76498,1706,2.2
25793,CN0108300000000,01,83,"Limestone County, AL",Nov-19,44197,43261,936,2.1
25794,CN0108500000000,01,85,"Lowndes County, AL",Nov-19,3549,3384,165,4.6
25795,CN0108700000000,01,87,"Macon County, AL",Nov-19,7915,7647,268,3.4
25796,CN0108900000000,01,89,"Madison County, AL",Nov-19,186938,183118,3820,2.0
25797,CN0109100000000,01,91,"Marengo County, AL",Nov-19,7606,7381,225,3.0
25798,CN0109300000000,01,93,"Marion County, AL",Nov-19,12815,12459,356,2.8
25799,CN0109500000000,01,95,"Marshall County, AL",Nov-19,43957,43067,890,2.0
25800,CN0109700000000,01,97,"Mobile County, AL",Nov-19,189712,184022,5690,3.0
25801,CN0109900000000,01,99,"Monroe County, AL",Nov-19,7306,6999,307,4.2
25802,CN0110100000000,01,101,"Montgomery County, AL",Nov-19,105553,102883,2670,2.5
25803,CN0110300000000,01,103,"Morgan County, AL",Nov-19,58756,57506,1250,2.1
25804,CN0110500000000,01,105,"Perry County, AL",Nov-19,3381,3247,134,4.0
25805,CN0110700000000,01,107,"Pickens County, AL",Nov-19,8002,7787,215,2.7
25806,CN0110900000000,01,109,"Pike County, AL",Nov-19,15572,15146,426,2.7
25807,CN0111100000000,01,111,"Randolph County, AL",Nov-19,9658,9414,244,2.5
25808,CN0111300000000,01,113,"Russell County, AL",Nov-19,24006,23421,585,2.4
25809,CN0111500000000,01,115,"St. Clair County, AL",Nov-19,40749,39869,880,2.2
25810,CN0111700000000,01,117,"Shelby County, AL",Nov-19,116853,114752,2101,1.8
25811,CN0111900000000,01,119,"Sumter County, AL",Nov-19,4866,4676,190,3.9
25812,CN0112100000000,01,121,"Talladega County, AL",Nov-19,35651,34669,982,2.8
25813,CN0112300000000,01,123,"Tallapoosa County, AL",Nov-19,18546,18095,451,2.4
25814,CN0112500000000,01,125,"Tuscaloosa County, AL",Nov-19,106921,104576,2345,2.2
25815,CN0112700000000,01,127,"Walker County, AL",Nov-19,25446,24751,695,2.7
25816,CN0112900000000,01,129,"Washington County, AL",Nov-19,6777,6534,243,3.6
25817,CN0113100000000,01,131,"Wilcox County, AL",Nov-19,2717,2551,166,6.1
25818,CN0113300000000,01,133,"Winston County, AL",Nov-19,10100,9813,287,2.8
25819,CN0201300000000,02,13,"Aleutians East Borough, AK",Nov-19,1401,1329,72,5.1
25820,CN0201600000000,02,16,"Aleutians West Census Area, AK",Nov-19,2848,2701,147,5.2
25821,CN0202000000000,02,20,"Anchorage Borough/municipality, AK",Nov-19,148116,140837,7279,4.9
25822,CN0205000000000,02,50,"Bethel Census Area, AK",Nov-19,7179,6368,811,11.3
25823,CN0206000000000,02,60,"Bristol Bay Borough, AK",Nov-19,247,217,30,12.1
25824,CN0206800000000,02,68,"Denali Borough, AK",Nov-19,584,488,96,16.4
25825,CN0207000000000,02,70,"Dillingham Census Area, AK",Nov-19,1690,1556,134,7.9
25826,CN0209000000000,02,90,"Fairbanks North Star Borough, AK",Nov-19,44677,42301,2376,5.3
25827,CN0210000000000,02,100,"Haines Borough, AK",Nov-19,970,839,131,13.5
25828,CN0210500000000,02,105,"Hoonah-Angoon Census Area, AK",Nov-19,991,850,141,14.2
25829,CN0211000000000,02,110,"Juneau Borough/city, AK",Nov-19,16521,15788,733,4.4
25830,CN0212200000000,02,122,"Kenai Peninsula Borough, AK",Nov-19,25292,23470,1822,7.2
25831,CN0213000000000,02,130,"Ketchikan Gateway Borough, AK",Nov-19,6476,6028,448,6.9
25832,CN0215000000000,02,150,"Kodiak Island Borough, AK",Nov-19,5809,5477,332,5.7
25833,CN0215800000000,02,158,"Kusilvak Census Area, AK",Nov-19,2676,2244,432,16.1
25834,CN0216400000000,02,164,"Lake and Peninsula Borough, AK",Nov-19,605,551,54,8.9
25835,CN0217000000000,02,170,"Matanuska-Susitna Borough, AK",Nov-19,47112,44023,3089,6.6
25836,CN0218000000000,02,180,"Nome Census Area, AK",Nov-19,4123,3737,386,9.4
25837,CN0218500000000,02,185,"North Slope Borough, AK",Nov-19,3475,3253,222,6.4
25838,CN0218800000000,02,188,"Northwest Arctic Borough, AK",Nov-19,3147,2715,432,13.7
25839,CN0219500000000,02,195,"Petersburg Borough, AK",Nov-19,1287,1170,117,9.1
25840,CN0219800000000,02,198,"Prince of Wales-Hyder Census Area, AK",Nov-19,2828,2577,251,8.9
25841,CN0222000000000,02,220,"Sitka Borough/city, AK",Nov-19,4017,3833,184,4.6
25842,CN0223000000000,02,230,"Skagway Municipality, AK",Nov-19,618,498,120,19.4
25843,CN0224000000000,02,240,"Southeast Fairbanks Census Area, AK",Nov-19,2865,2626,239,8.3
25844,CN0226100000000,02,261,"Valdez-Cordova Census Area, AK",Nov-19,4267,3835,432,10.1
25845,CN0227500000000,02,275,"Wrangell Borough/city, AK",Nov-19,988,909,79,8.0
25846,CN0228200000000,02,282,"Yakutat Borough/city, AK",Nov-19,229,211,18,7.9
25847,CN0229000000000,02,290,"Yukon-Koyukuk Census Area, AK",Nov-19,2444,2143,301,12.3
25848,CN0400100000000,04,1,"Apache County, AZ",Nov-19,20279,18471,1808,8.9
25849,CN0400300000000,04,3,"Cochise County, AZ",Nov-19,51708,48998,2710,5.2
25850,CN0400500000000,04,5,"Coconino County, AZ",Nov-19,78173,74463,3710,4.7
25851,CN0400700000000,04,7,"Gila County, AZ",Nov-19,21765,20573,1192,5.5
25852,CN0400900000000,04,9,"Graham County, AZ",Nov-19,15666,14998,668,4.3
25853,CN0401100000000,04,11,"Greenlee County, AZ",Nov-19,4549,4389,160,3.5
25854,CN0401200000000,04,12,"La Paz County, AZ",Nov-19,9709,9218,491,5.1
25855,CN0401300000000,04,13,"Maricopa County, AZ",Nov-19,2356073,2270551,85522,3.6
25856,CN0401500000000,04,15,"Mohave County, AZ",Nov-19,88701,84012,4689,5.3
25857,CN0401700000000,04,17,"Navajo County, AZ",Nov-19,41114,38458,2656,6.5
25858,CN0401900000000,04,19,"Pima County, AZ",Nov-19,504426,483933,20493,4.1
25859,CN0402100000000,04,21,"Pinal County, AZ",Nov-19,192465,183669,8796,4.6
25860,CN0402300000000,04,23,"Santa Cruz County, AZ",Nov-19,19882,18276,1606,8.1
25861,CN0402500000000,04,25,"Yavapai County, AZ",Nov-19,108301,103823,4478,4.1
25862,CN0402700000000,04,27,"Yuma County, AZ",Nov-19,102376,86784,15592,15.2
25863,CN0500100000000,05,1,"Arkansas County, AR",Nov-19,9385,9129,256,2.7
25864,CN0500300000000,05,3,"Ashley County, AR",Nov-19,7566,7196,370,4.9
25865,CN0500500000000,05,5,"Baxter County, AR",Nov-19,16191,15639,552,3.4
25866,CN0500700000000,05,7,"Benton County, AR",Nov-19,138707,135615,3092,2.2
25867,CN0500900000000,05,9,"Boone County, AR",Nov-19,16031,15588,443,2.8
25868,CN0501100000000,05,11,"Bradley County, AR",Nov-19,4453,4307,146,3.3
25869,CN0501300000000,05,13,"Calhoun County, AR",Nov-19,2443,2352,91,3.7
25870,CN0501500000000,05,15,"Carroll County, AR",Nov-19,12720,12402,318,2.5
25871,CN0501700000000,05,17,"Chicot County, AR",Nov-19,3239,3053,186,5.7
25872,CN0501900000000,05,19,"Clark County, AR",Nov-19,9803,9483,320,3.3
25873,CN0502100000000,05,21,"Clay County, AR",Nov-19,5613,5368,245,4.4
25874,CN0502300000000,05,23,"Cleburne County, AR",Nov-19,9092,8709,383,4.2
25875,CN0502500000000,05,25,"Cleveland County, AR",Nov-19,3213,3098,115,3.6
25876,CN0502700000000,05,27,"Columbia County, AR",Nov-19,9224,8868,356,3.9
25877,CN0502900000000,05,29,"Conway County, AR",Nov-19,8289,7991,298,3.6
25878,CN0503100000000,05,31,"Craighead County, AR",Nov-19,56299,55005,1294,2.3
25879,CN0503300000000,05,33,"Crawford County, AR",Nov-19,26895,26153,742,2.8
25880,CN0503500000000,05,35,"Crittenden County, AR",Nov-19,21511,20765,746,3.5
25881,CN0503700000000,05,37,"Cross County, AR",Nov-19,7394,7120,274,3.7
25882,CN0503900000000,05,39,"Dallas County, AR",Nov-19,2831,2714,117,4.1
25883,CN0504100000000,05,41,"Desha County, AR",Nov-19,5410,5200,210,3.9
25884,CN0504300000000,05,43,"Drew County, AR",Nov-19,7935,7572,363,4.6
25885,CN0504500000000,05,45,"Faulkner County, AR",Nov-19,62075,60443,1632,2.6
25886,CN0504700000000,05,47,"Franklin County, AR",Nov-19,7457,7239,218,2.9
25887,CN0504900000000,05,49,"Fulton County, AR",Nov-19,4925,4770,155,3.1
25888,CN0505100000000,05,51,"Garland County, AR",Nov-19,40659,39335,1324,3.3
25889,CN0505300000000,05,53,"Grant County, AR",Nov-19,8379,8134,245,2.9
25890,CN0505500000000,05,55,"Greene County, AR",Nov-19,20052,19444,608,3.0
25891,CN0505700000000,05,57,"Hempstead County, AR",Nov-19,9869,9544,325,3.3
25892,CN0505900000000,05,59,"Hot Spring County, AR",Nov-19,13983,13549,434,3.1
25893,CN0506100000000,05,61,"Howard County, AR",Nov-19,5698,5537,161,2.8
25894,CN0506300000000,05,63,"Independence County, AR",Nov-19,16553,15952,601,3.6
25895,CN0506500000000,05,65,"Izard County, AR",Nov-19,4862,4620,242,5.0
25896,CN0506700000000,05,67,"Jackson County, AR",Nov-19,5830,5484,346,5.9
25897,CN0506900000000,05,69,"Jefferson County, AR",Nov-19,27654,26303,1351,4.9
25898,CN0507100000000,05,71,"Johnson County, AR",Nov-19,10263,9900,363,3.5
25899,CN0507300000000,05,73,"Lafayette County, AR",Nov-19,2450,2350,100,4.1
25900,CN0507500000000,05,75,"Lawrence County, AR",Nov-19,6868,6617,251,3.7
25901,CN0507700000000,05,77,"Lee County, AR",Nov-19,2820,2701,119,4.2
25902,CN0507900000000,05,79,"Lincoln County, AR",Nov-19,3927,3782,145,3.7
25903,CN0508100000000,05,81,"Little River County, AR",Nov-19,5541,5329,212,3.8
25904,CN0508300000000,05,83,"Logan County, AR",Nov-19,8532,8196,336,3.9
25905,CN0508500000000,05,85,"Lonoke County, AR",Nov-19,34303,33315,988,2.9
25906,CN0508700000000,05,87,"Madison County, AR",Nov-19,7490,7329,161,2.1
25907,CN0508900000000,05,89,"Marion County, AR",Nov-19,6573,6354,219,3.3
25908,CN0509100000000,05,91,"Miller County, AR",Nov-19,19772,19082,690,3.5
25909,CN0509300000000,05,93,"Mississippi County, AR",Nov-19,17233,16530,703,4.1
25910,CN0509500000000,05,95,"Monroe County, AR",Nov-19,2718,2611,107,3.9
25911,CN0509700000000,05,97,"Montgomery County, AR",Nov-19,2891,2766,125,4.3
25912,CN0509900000000,05,99,"Nevada County, AR",Nov-19,3625,3504,121,3.3
25913,CN0510100000000,05,101,"Newton County, AR",Nov-19,3323,3224,99,3.0
25914,CN0510300000000,05,103,"Ouachita County, AR",Nov-19,9787,9355,432,4.4
25915,CN0510500000000,05,105,"Perry County, AR",Nov-19,4221,4087,134,3.2
25916,CN0510700000000,05,107,"Phillips County, AR",Nov-19,6306,5961,345,5.5
25917,CN0510900000000,05,109,"Pike County, AR",Nov-19,4204,4059,145,3.4
25918,CN0511100000000,05,111,"Poinsett County, AR",Nov-19,10391,10089,302,2.9
25919,CN0511300000000,05,113,"Polk County, AR",Nov-19,8151,7823,328,4.0
25920,CN0511500000000,05,115,"Pope County, AR",Nov-19,28922,27905,1017,3.5
25921,CN0511700000000,05,117,"Prairie County, AR",Nov-19,3576,3443,133,3.7
25922,CN0511900000000,05,119,"Pulaski County, AR",Nov-19,189276,183501,5775,3.1
25923,CN0512100000000,05,121,"Randolph County, AR",Nov-19,7345,7106,239,3.3
25924,CN0512300000000,05,123,"St. Francis County, AR",Nov-19,8111,7766,345,4.3
25925,CN0512500000000,05,125,"Saline County, AR",Nov-19,58825,57355,1470,2.5
25926,CN0512700000000,05,127,"Scott County, AR",Nov-19,4307,4175,132,3.1
25927,CN0512900000000,05,129,"Searcy County, AR",Nov-19,2814,2698,116,4.1
25928,CN0513100000000,05,131,"Sebastian County, AR",Nov-19,56702,55087,1615,2.8
25929,CN0513300000000,05,133,"Sevier County, AR",Nov-19,5498,5275,223,4.1
25930,CN0513500000000,05,135,"Sharp County, AR",Nov-19,5681,5428,253,4.5
25931,CN0513700000000,05,137,"Stone County, AR",Nov-19,4623,4433,190,4.1
25932,CN0513900000000,05,139,"Union County, AR",Nov-19,15776,15011,765,4.8
25933,CN0514100000000,05,141,"Van Buren County, AR",Nov-19,5662,5415,247,4.4
25934,CN0514300000000,05,143,"Washington County, AR",Nov-19,126299,123692,2607,2.1
25935,CN0514500000000,05,145,"White County, AR",Nov-19,33758,32436,1322,3.9
25936,CN0514700000000,05,147,"Woodruff County, AR",Nov-19,2753,2625,128,4.6
25937,CN0514900000000,05,149,"Yell County, AR",Nov-19,8415,8160,255,3.0
25938,CN0600100000000,06,1,"Alameda County, CA",Nov-19,846991,824242,22749,2.7
25939,CN0600300000000,06,3,"Alpine County, CA",Nov-19,500,475,25,5.0
25940,CN0600500000000,06,5,"Amador County, CA",Nov-19,14937,14423,514,3.4
25941,CN0600700000000,06,7,"Butte County, CA",Nov-19,99254,95082,4172,4.2
25942,CN0600900000000,06,9,"Calaveras County, CA",Nov-19,21596,20875,721,3.3
25943,CN0601100000000,06,11,"Colusa County, CA",Nov-19,10587,9456,1131,10.7
25944,CN0601300000000,06,13,"Contra Costa County, CA",Nov-19,563394,547608,15786,2.8
25945,CN0601500000000,06,15,"Del Norte County, CA",Nov-19,9613,9084,529,5.5
25946,CN0601700000000,06,17,"El Dorado County, CA",Nov-19,92397,89507,2890,3.1
25947,CN0601900000000,06,19,"Fresno County, CA",Nov-19,448416,418471,29945,6.7
25948,CN0602100000000,06,21,"Glenn County, CA",Nov-19,12946,12329,617,4.8
25949,CN0602300000000,06,23,"Humboldt County, CA",Nov-19,63086,61123,1963,3.1
25950,CN0602500000000,06,25,"Imperial County, CA",Nov-19,72396,58890,13506,18.7
25951,CN0602700000000,06,27,"Inyo County, CA",Nov-19,8774,8503,271,3.1
25952,CN0602900000000,06,29,"Kern County, CA",Nov-19,395137,369899,25238,6.4
25953,CN0603100000000,06,31,"Kings County, CA",Nov-19,57402,53245,4157,7.2
25954,CN0603300000000,06,33,"Lake County, CA",Nov-19,28793,27417,1376,4.8
25955,CN0603500000000,06,35,"Lassen County, CA",Nov-19,10318,9957,361,3.5
25956,CN0603700000000,06,37,"Los Angeles County, CA",Nov-19,5177117,4963388,213729,4.1
25957,CN0603900000000,06,39,"Madera County, CA",Nov-19,60686,56929,3757,6.2
25958,CN0604100000000,06,41,"Marin County, CA",Nov-19,140995,138064,2931,2.1
25959,CN0604300000000,06,43,"Mariposa County, CA",Nov-19,7321,7023,298,4.1
25960,CN0604500000000,06,45,"Mendocino County, CA",Nov-19,38558,37219,1339,3.5
25961,CN0604700000000,06,47,"Merced County, CA",Nov-19,115475,107741,7734,6.7
25962,CN0604900000000,06,49,"Modoc County, CA",Nov-19,3110,2934,176,5.7
25963,CN0605100000000,06,51,"Mono County, CA",Nov-19,7915,7601,314,4.0
25964,CN0605300000000,06,53,"Monterey County, CA",Nov-19,219427,209156,10271,4.7
25965,CN0605500000000,06,55,"Napa County, CA",Nov-19,73640,71720,1920,2.6
25966,CN0605700000000,06,57,"Nevada County, CA",Nov-19,48473,47039,1434,3.0
25967,CN0605900000000,06,59,"Orange County, CA",Nov-19,1630097,1588311,41786,2.6
25968,CN0606100000000,06,61,"Placer County, CA",Nov-19,188849,183568,5281,2.8
25969,CN0606300000000,06,63,"Plumas County, CA",Nov-19,7576,7113,463,6.1
25970,CN0606500000000,06,65,"Riverside County, CA",Nov-19,1116161,1073080,43081,3.9
25971,CN0606700000000,06,67,"Sacramento County, CA",Nov-19,715263,691610,23653,3.3
25972,CN0606900000000,06,69,"San Benito County, CA",Nov-19,31388,30015,1373,4.4
25973,CN0607100000000,06,71,"San Bernardino County, CA",Nov-19,978931,944748,34183,3.5
25974,CN0607300000000,06,73,"San Diego County, CA",Nov-19,1600077,1553350,46727,2.9
25975,CN0607500000000,06,75,"San Francisco County/city, CA",Nov-19,589758,578050,11708,2.0
25976,CN0607700000000,06,77,"San Joaquin County, CA",Nov-19,325674,308123,17551,5.4
25977,CN0607900000000,06,79,"San Luis Obispo County, CA",Nov-19,142044,138410,3634,2.6
25978,CN0608100000000,06,81,"San Mateo County, CA",Nov-19,465463,456745,8718,1.9
25979,CN0608300000000,06,83,"Santa Barbara County, CA",Nov-19,218458,211469,6989,3.2
25980,CN0608500000000,06,85,"Santa Clara County, CA",Nov-19,1059219,1034732,24487,2.3
25981,CN0608700000000,06,87,"Santa Cruz County, CA",Nov-19,141792,136149,5643,4.0
25982,CN0608900000000,06,89,"Shasta County, CA",Nov-19,74708,71735,2973,4.0
25983,CN0609100000000,06,91,"Sierra County, CA",Nov-19,1331,1278,53,4.0
25984,CN0609300000000,06,93,"Siskiyou County, CA",Nov-19,17105,16237,868,5.1
25985,CN0609500000000,06,95,"Solano County, CA",Nov-19,210399,203373,7026,3.3
25986,CN0609700000000,06,97,"Sonoma County, CA",Nov-19,260583,254278,6305,2.4
25987,CN0609900000000,06,99,"Stanislaus County, CA",Nov-19,243932,231079,12853,5.3
25988,CN0610100000000,06,101,"Sutter County, CA",Nov-19,46099,43323,2776,6.0
25989,CN0610300000000,06,103,"Tehama County, CA",Nov-19,25804,24637,1167,4.5
25990,CN0610500000000,06,105,"Trinity County, CA",Nov-19,4562,4334,228,5.0
25991,CN0610700000000,06,107,"Tulare County, CA",Nov-19,203387,185782,17605,8.7
25992,CN0610900000000,06,109,"Tuolumne County, CA",Nov-19,21484,20671,813,3.8
25993,CN0611100000000,06,111,"Ventura County, CA",Nov-19,425979,411300,14679,3.4
25994,CN0611300000000,06,113,"Yolo County, CA",Nov-19,108509,104533,3976,3.7
25995,CN0611500000000,06,115,"Yuba County, CA",Nov-19,30724,29143,1581,5.1
25996,CN0800100000000,08,1,"Adams County, CO",Nov-19,277792,270957,6835,2.5
25997,CN0800300000000,08,3,"Alamosa County, CO",Nov-19,9008,8739,269,3.0
25998,CN0800500000000,08,5,"Arapahoe County, CO",Nov-19,371176,362520,8656,2.3
25999,CN0800700000000,08,7,"Archuleta County, CO",Nov-19,6984,6799,185,2.6
26000,CN0800900000000,08,9,"Baca County, CO",Nov-19,2259,2228,31,1.4
26001,CN0801100000000,08,11,"Bent County, CO",Nov-19,2029,1987,42,2.1
26002,CN0801300000000,08,13,"Boulder County, CO",Nov-19,198526,194571,3955,2.0
26003,CN0801400000000,08,14,"Broomfield County/city, CO",Nov-19,40908,40035,873,2.1
26004,CN0801500000000,08,15,"Chaffee County, CO",Nov-19,9730,9522,208,2.1
26005,CN0801700000000,08,17,"Cheyenne County, CO",Nov-19,1266,1251,15,1.2
26006,CN0801900000000,08,19,"Clear Creek County, CO",Nov-19,6149,6025,124,2.0
26007,CN0802100000000,08,21,"Conejos County, CO",Nov-19,4324,4210,114,2.6
26008,CN0802300000000,08,23,"Costilla County, CO",Nov-19,1943,1885,58,3.0
26009,CN0802500000000,08,25,"Crowley County, CO",Nov-19,1580,1527,53,3.4
26010,CN0802700000000,08,27,"Custer County, CO",Nov-19,2150,2094,56,2.6
26011,CN0802900000000,08,29,"Delta County, CO",Nov-19,14898,14506,392,2.6
26012,CN0803100000000,08,31,"Denver County/city, CO",Nov-19,424326,414573,9753,2.3
26013,CN0803300000000,08,33,"Dolores County, CO",Nov-19,1216,1177,39,3.2
26014,CN0803500000000,08,35,"Douglas County, CO",Nov-19,197886,193833,4053,2.0
26015,CN0803700000000,08,37,"Eagle County, CO",Nov-19,35923,35036,887,2.5
26016,CN0803900000000,08,39,"Elbert County, CO",Nov-19,15582,15292,290,1.9
26017,CN0804100000000,08,41,"El Paso County, CO",Nov-19,346325,336623,9702,2.8
26018,CN0804300000000,08,43,"Fremont County, CO",Nov-19,15228,14643,585,3.8
26019,CN0804500000000,08,45,"Garfield County, CO",Nov-19,31995,31235,760,2.4
26020,CN0804700000000,08,47,"Gilpin County, CO",Nov-19,3842,3766,76,2.0
26021,CN0804900000000,08,49,"Grand County, CO",Nov-19,9687,9500,187,1.9
26022,CN0805100000000,08,51,"Gunnison County, CO",Nov-19,11278,11043,235,2.1
26023,CN0805300000000,08,53,"Hinsdale County, CO",Nov-19,362,345,17,4.7
26024,CN0805500000000,08,55,"Huerfano County, CO",Nov-19,2534,2420,114,4.5
26025,CN0805700000000,08,57,"Jackson County, CO",Nov-19,1063,1046,17,1.6
26026,CN0805900000000,08,59,"Jefferson County, CO",Nov-19,341063,333677,7386,2.2
26027,CN0806100000000,08,61,"Kiowa County, CO",Nov-19,1042,1030,12,1.2
26028,CN0806300000000,08,63,"Kit Carson County, CO",Nov-19,4526,4459,67,1.5
26029,CN0806500000000,08,65,"Lake County, CO",Nov-19,4930,4831,99,2.0
26030,CN0806700000000,08,67,"La Plata County, CO",Nov-19,32522,31851,671,2.1
26031,CN0806900000000,08,69,"Larimer County, CO",Nov-19,211387,207242,4145,2.0
26032,CN0807100000000,08,71,"Las Animas County, CO",Nov-19,6778,6570,208,3.1
26033,CN0807300000000,08,73,"Lincoln County, CO",Nov-19,2469,2422,47,1.9
26034,CN0807500000000,08,75,"Logan County, CO",Nov-19,11396,11188,208,1.8
26035,CN0807700000000,08,77,"Mesa County, CO",Nov-19,76804,74643,2161,2.8
26036,CN0807900000000,08,79,"Mineral County, CO",Nov-19,515,504,11,2.1
26037,CN0808100000000,08,81,"Moffat County, CO",Nov-19,7442,7242,200,2.7
26038,CN0808300000000,08,83,"Montezuma County, CO",Nov-19,13145,12677,468,3.6
26039,CN0808500000000,08,85,"Montrose County, CO",Nov-19,22504,21947,557,2.5
26040,CN0808700000000,08,87,"Morgan County, CO",Nov-19,17182,16804,378,2.2
26041,CN0808900000000,08,89,"Otero County, CO",Nov-19,8836,8553,283,3.2
26042,CN0809100000000,08,91,"Ouray County, CO",Nov-19,2378,2311,67,2.8
26043,CN0809300000000,08,93,"Park County, CO",Nov-19,11320,11094,226,2.0
26044,CN0809500000000,08,95,"Phillips County, CO",Nov-19,2742,2707,35,1.3
26045,CN0809700000000,08,97,"Pitkin County, CO",Nov-19,11284,10712,572,5.1
26046,CN0809900000000,08,99,"Prowers County, CO",Nov-19,6700,6560,140,2.1
26047,CN0810100000000,08,101,"Pueblo County, CO",Nov-19,77322,74621,2701,3.5
26048,CN0810300000000,08,103,"Rio Blanco County, CO",Nov-19,3078,2988,90,2.9
26049,CN0810500000000,08,105,"Rio Grande County, CO",Nov-19,5757,5556,201,3.5
26050,CN0810700000000,08,107,"Routt County, CO",Nov-19,16397,16061,336,2.0
26051,CN0810900000000,08,109,"Saguache County, CO",Nov-19,3823,3694,129,3.4
26052,CN0811100000000,08,111,"San Juan County, CO",Nov-19,456,439,17,3.7
26053,CN0811300000000,08,113,"San Miguel County, CO",Nov-19,5639,5334,305,5.4
26054,CN0811500000000,08,115,"Sedgwick County, CO",Nov-19,1305,1286,19,1.5
26055,CN0811700000000,08,117,"Summit County, CO",Nov-19,23589,23211,378,1.6
26056,CN0811900000000,08,119,"Teller County, CO",Nov-19,12885,12549,336,2.6
26057,CN0812100000000,08,121,"Washington County, CO",Nov-19,3066,3013,53,1.7
26058,CN0812300000000,08,123,"Weld County, CO",Nov-19,173704,169903,3801,2.2
26059,CN0812500000000,08,125,"Yuma County, CO",Nov-19,6408,6323,85,1.3
26060,CN0900100000000,09,1,"Fairfield County, CT",Nov-19,484305,468798,15507,3.2
26061,CN0900300000000,09,3,"Hartford County, CT",Nov-19,487079,470584,16495,3.4
26062,CN0900500000000,09,5,"Litchfield County, CT",Nov-19,105592,102517,3075,2.9
26063,CN0900700000000,09,7,"Middlesex County, CT",Nov-19,94673,92004,2669,2.8
26064,CN0900900000000,09,9,"New Haven County, CT",Nov-19,466275,450233,16042,3.4
26065,CN0901100000000,09,11,"New London County, CT",Nov-19,137708,133325,4383,3.2
26066,CN0901300000000,09,13,"Tolland County, CT",Nov-19,87716,85293,2423,2.8
26067,CN0901500000000,09,15,"Windham County, CT",Nov-19,64587,62404,2183,3.4
26068,CN1000100000000,10,1,"Kent County, DE",Nov-19,80546,77516,3030,3.8
26069,CN1000300000000,10,3,"New Castle County, DE",Nov-19,301843,291497,10346,3.4
26070,CN1000500000000,10,5,"Sussex County, DE",Nov-19,106019,102105,3914,3.7
26071,CN1100100000000,11,1,District of Columbia,Nov-19,412346,391565,20781,5.0
26072,CN1200100000000,12,1,"Alachua County, FL",Nov-19,141612,137984,3628,2.6
26073,CN1200300000000,12,3,"Baker County, FL",Nov-19,12016,11696,320,2.7
26074,CN1200500000000,12,5,"Bay County, FL",Nov-19,82497,80002,2495,3.0
26075,CN1200700000000,12,7,"Bradford County, FL",Nov-19,11274,10960,314,2.8
26076,CN1200900000000,12,9,"Brevard County, FL",Nov-19,287508,279290,8218,2.9
26077,CN1201100000000,12,11,"Broward County, FL",Nov-19,1045634,1016914,28720,2.7
26078,CN1201300000000,12,13,"Calhoun County, FL",Nov-19,4792,4623,169,3.5
26079,CN1201500000000,12,15,"Charlotte County, FL",Nov-19,72707,70295,2412,3.3
26080,CN1201700000000,12,17,"Citrus County, FL",Nov-19,47355,45311,2044,4.3
26081,CN1201900000000,12,19,"Clay County, FL",Nov-19,109361,106411,2950,2.7
26082,CN1202100000000,12,21,"Collier County, FL",Nov-19,183572,178439,5133,2.8
26083,CN1202300000000,12,23,"Columbia County, FL",Nov-19,30344,29506,838,2.8
26084,CN1202700000000,12,27,"DeSoto County, FL",Nov-19,14077,13614,463,3.3
26085,CN1202900000000,12,29,"Dixie County, FL",Nov-19,5885,5687,198,3.4
26086,CN1203100000000,12,31,"Duval County, FL",Nov-19,498839,484540,14299,2.9
26087,CN1203300000000,12,33,"Escambia County, FL",Nov-19,146791,142567,4224,2.9
26088,CN1203500000000,12,35,"Flagler County, FL",Nov-19,47140,45506,1634,3.5
26089,CN1203700000000,12,37,"Franklin County, FL",Nov-19,4539,4409,130,2.9
26090,CN1203900000000,12,39,"Gadsden County, FL",Nov-19,19040,18340,700,3.7
26091,CN1204100000000,12,41,"Gilchrist County, FL",Nov-19,7261,7040,221,3.0
26092,CN1204300000000,12,43,"Glades County, FL",Nov-19,5445,5253,192,3.5
26093,CN1204500000000,12,45,"Gulf County, FL",Nov-19,5633,5430,203,3.6
26094,CN1204700000000,12,47,"Hamilton County, FL",Nov-19,4303,4144,159,3.7
26095,CN1204900000000,12,49,"Hardee County, FL",Nov-19,8590,8223,367,4.3
26096,CN1205100000000,12,51,"Hendry County, FL",Nov-19,15757,14932,825,5.2
26097,CN1205300000000,12,53,"Hernando County, FL",Nov-19,72587,69855,2732,3.8
26098,CN1205500000000,12,55,"Highlands County, FL",Nov-19,36302,34829,1473,4.1
26099,CN1205700000000,12,57,"Hillsborough County, FL",Nov-19,758798,738009,20789,2.7
26100,CN1205900000000,12,59,"Holmes County, FL",Nov-19,7019,6801,218,3.1
26101,CN1206100000000,12,61,"Indian River County, FL",Nov-19,66003,63762,2241,3.4
26102,CN1206300000000,12,63,"Jackson County, FL",Nov-19,17154,16619,535,3.1
26103,CN1206500000000,12,65,"Jefferson County, FL",Nov-19,5698,5532,166,2.9
26104,CN1206700000000,12,67,"Lafayette County, FL",Nov-19,2848,2773,75,2.6
26105,CN1206900000000,12,69,"Lake County, FL",Nov-19,160461,155798,4663,2.9
26106,CN1207100000000,12,71,"Lee County, FL",Nov-19,352406,342558,9848,2.8
26107,CN1207300000000,12,73,"Leon County, FL",Nov-19,157670,153458,4212,2.7
26108,CN1207500000000,12,75,"Levy County, FL",Nov-19,16826,16286,540,3.2
26109,CN1207700000000,12,77,"Liberty County, FL",Nov-19,2651,2567,84,3.2
26110,CN1207900000000,12,79,"Madison County, FL",Nov-19,7558,7302,256,3.4
26111,CN1208100000000,12,81,"Manatee County, FL",Nov-19,181260,176130,5130,2.8
26112,CN1208300000000,12,83,"Marion County, FL",Nov-19,138518,133766,4752,3.4
26113,CN1208500000000,12,85,"Martin County, FL",Nov-19,74608,72532,2076,2.8
26114,CN1208600000000,12,86,"Miami-Dade County, FL",Nov-19,1384486,1360307,24179,1.7
26115,CN1208700000000,12,87,"Monroe County, FL",Nov-19,47312,46455,857,1.8
26116,CN1208900000000,12,89,"Nassau County, FL",Nov-19,41812,40711,1101,2.6
26117,CN1209100000000,12,91,"Okaloosa County, FL",Nov-19,96354,94012,2342,2.4
26118,CN1209300000000,12,93,"Okeechobee County, FL",Nov-19,18084,17552,532,2.9
26119,CN1209500000000,12,95,"Orange County, FL",Nov-19,769251,749379,19872,2.6
26120,CN1209700000000,12,97,"Osceola County, FL",Nov-19,185845,180369,5476,2.9
26121,CN1209900000000,12,99,"Palm Beach County, FL",Nov-19,735547,713976,21571,2.9
26122,CN1210100000000,12,101,"Pasco County, FL",Nov-19,240277,232699,7578,3.2
26123,CN1210300000000,12,103,"Pinellas County, FL",Nov-19,499256,485870,13386,2.7
26124,CN1210500000000,12,105,"Polk County, FL",Nov-19,309867,299722,10145,3.3
26125,CN1210700000000,12,107,"Putnam County, FL",Nov-19,26528,25481,1047,3.9
26126,CN1210900000000,12,109,"St. Johns County, FL",Nov-19,134295,131178,3117,2.3
26127,CN1211100000000,12,111,"St. Lucie County, FL",Nov-19,145879,140731,5148,3.5
26128,CN1211300000000,12,113,"Santa Rosa County, FL",Nov-19,83474,81262,2212,2.6
26129,CN1211500000000,12,115,"Sarasota County, FL",Nov-19,189959,184684,5275,2.8
26130,CN1211700000000,12,117,"Seminole County, FL",Nov-19,257685,250970,6715,2.6
26131,CN1211900000000,12,119,"Sumter County, FL",Nov-19,32923,31536,1387,4.2
26132,CN1212100000000,12,121,"Suwannee County, FL",Nov-19,18093,17538,555,3.1
26133,CN1212300000000,12,123,"Taylor County, FL",Nov-19,8260,7999,261,3.2
26134,CN1212500000000,12,125,"Union County, FL",Nov-19,4685,4560,125,2.7
26135,CN1212700000000,12,127,"Volusia County, FL",Nov-19,255129,247097,8032,3.1
26136,CN1212900000000,12,129,"Wakulla County, FL",Nov-19,15140,14753,387,2.6
26137,CN1213100000000,12,131,"Walton County, FL",Nov-19,31401,30593,808,2.6
26138,CN1213300000000,12,133,"Washington County, FL",Nov-19,9618,9331,287,3.0
26139,CN1300100000000,13,1,"Appling County, GA",Nov-19,9446,9179,267,2.8
26140,CN1300300000000,13,3,"Atkinson County, GA",Nov-19,4659,4561,98,2.1
26141,CN1300500000000,13,5,"Bacon County, GA",Nov-19,4904,4744,160,3.3
26142,CN1300700000000,13,7,"Baker County, GA",Nov-19,1175,1125,50,4.3
26143,CN1300900000000,13,9,"Baldwin County, GA",Nov-19,17498,16829,669,3.8
26144,CN1301100000000,13,11,"Banks County, GA",Nov-19,9810,9585,225,2.3
26145,CN1301300000000,13,13,"Barrow County, GA",Nov-19,40722,39817,905,2.2
26146,CN1301500000000,13,15,"Bartow County, GA",Nov-19,50944,49598,1346,2.6
26147,CN1301700000000,13,17,"Ben Hill County, GA",Nov-19,5309,5048,261,4.9
26148,CN1301900000000,13,19,"Berrien County, GA",Nov-19,7578,7249,329,4.3
26149,CN1302100000000,13,21,"Bibb County, GA",Nov-19,67773,65678,2095,3.1
26150,CN1302300000000,13,23,"Bleckley County, GA",Nov-19,4488,4306,182,4.1
26151,CN1302500000000,13,25,"Brantley County, GA",Nov-19,7221,6986,235,3.3
26152,CN1302700000000,13,27,"Brooks County, GA",Nov-19,6973,6766,207,3.0
26153,CN1302900000000,13,29,"Bryan County, GA",Nov-19,18254,17814,440,2.4
26154,CN1303100000000,13,31,"Bulloch County, GA",Nov-19,36610,35546,1064,2.9
26155,CN1303300000000,13,33,"Burke County, GA",Nov-19,9120,8750,370,4.1
26156,CN1303500000000,13,35,"Butts County, GA",Nov-19,10805,10530,275,2.5
26157,CN1303700000000,13,37,"Calhoun County, GA",Nov-19,2298,2233,65,2.8
26158,CN1303900000000,13,39,"Camden County, GA",Nov-19,20785,20193,592,2.8
26159,CN1304300000000,13,43,"Candler County, GA",Nov-19,5596,5475,121,2.2
26160,CN1304500000000,13,45,"Carroll County, GA",Nov-19,55619,54095,1524,2.7
26161,CN1304700000000,13,47,"Catoosa County, GA",Nov-19,33711,32928,783,2.3
26162,CN1304900000000,13,49,"Charlton County, GA",Nov-19,4803,4662,141,2.9
26163,CN1305100000000,13,51,"Chatham County, GA",Nov-19,139356,135608,3748,2.7
26164,CN1305300000000,13,53,"Chattahoochee County, GA",Nov-19,1986,1920,66,3.3
26165,CN1305500000000,13,55,"Chattooga County, GA",Nov-19,10126,9789,337,3.3
26166,CN1305700000000,13,57,"Cherokee County, GA",Nov-19,136973,134008,2965,2.2
26167,CN1305900000000,13,59,"Clarke County, GA",Nov-19,59528,57894,1634,2.7
26168,CN1306100000000,13,61,"Clay County, GA",Nov-19,885,829,56,6.3
26169,CN1306300000000,13,63,"Clayton County, GA",Nov-19,138659,133901,4758,3.4
26170,CN1306500000000,13,65,"Clinch County, GA",Nov-19,2516,2432,84,3.3
26171,CN1306700000000,13,67,"Cobb County, GA",Nov-19,428712,418510,10202,2.4
26172,CN1306900000000,13,69,"Coffee County, GA",Nov-19,18866,18293,573,3.0
26173,CN1307100000000,13,71,"Colquitt County, GA",Nov-19,21313,20784,529,2.5
26174,CN1307300000000,13,73,"Columbia County, GA",Nov-19,75101,73290,1811,2.4
26175,CN1307500000000,13,75,"Cook County, GA",Nov-19,8062,7815,247,3.1
26176,CN1307700000000,13,77,"Coweta County, GA",Nov-19,75185,73460,1725,2.3
26177,CN1307900000000,13,79,"Crawford County, GA",Nov-19,5603,5443,160,2.9
26178,CN1308100000000,13,81,"Crisp County, GA",Nov-19,9394,9098,296,3.2
26179,CN1308300000000,13,83,"Dade County, GA",Nov-19,8247,8036,211,2.6
26180,CN1308500000000,13,85,"Dawson County, GA",Nov-19,12407,12141,266,2.1
26181,CN1308700000000,13,87,"Decatur County, GA",Nov-19,11545,11185,360,3.1
26182,CN1308900000000,13,89,"DeKalb County, GA",Nov-19,402308,391250,11058,2.7
26183,CN1309100000000,13,91,"Dodge County, GA",Nov-19,7008,6690,318,4.5
26184,CN1309300000000,13,93,"Dooly County, GA",Nov-19,5095,4940,155,3.0
26185,CN1309500000000,13,95,"Dougherty County, GA",Nov-19,38413,36889,1524,4.0
26186,CN1309700000000,13,97,"Douglas County, GA",Nov-19,73794,71656,2138,2.9
26187,CN1309900000000,13,99,"Early County, GA",Nov-19,4452,4299,153,3.4
26188,CN1310100000000,13,101,"Echols County, GA",Nov-19,1931,1887,44,2.3
26189,CN1310300000000,13,103,"Effingham County, GA",Nov-19,30848,30127,721,2.3
26190,CN1310500000000,13,105,"Elbert County, GA",Nov-19,7649,7388,261,3.4
26191,CN1310700000000,13,107,"Emanuel County, GA",Nov-19,8249,7901,348,4.2
26192,CN1310900000000,13,109,"Evans County, GA",Nov-19,4896,4764,132,2.7
26193,CN1311100000000,13,111,"Fannin County, GA",Nov-19,11480,11172,308,2.7
26194,CN1311300000000,13,113,"Fayette County, GA",Nov-19,58444,57070,1374,2.4
26195,CN1311500000000,13,115,"Floyd County, GA",Nov-19,44454,43050,1404,3.2
26196,CN1311700000000,13,117,"Forsyth County, GA",Nov-19,123107,120452,2655,2.2
26197,CN1311900000000,13,119,"Franklin County, GA",Nov-19,9845,9558,287,2.9
26198,CN1312100000000,13,121,"Fulton County, GA",Nov-19,561031,545359,15672,2.8
26199,CN1312300000000,13,123,"Gilmer County, GA",Nov-19,11882,11549,333,2.8
26200,CN1312500000000,13,125,"Glascock County, GA",Nov-19,1276,1237,39,3.1
26201,CN1312700000000,13,127,"Glynn County, GA",Nov-19,39134,38099,1035,2.6
26202,CN1312900000000,13,129,"Gordon County, GA",Nov-19,27929,27149,780,2.8
26203,CN1313100000000,13,131,"Grady County, GA",Nov-19,10388,10091,297,2.9
26204,CN1313300000000,13,133,"Greene County, GA",Nov-19,6893,6678,215,3.1
26205,CN1313500000000,13,135,"Gwinnett County, GA",Nov-19,493509,481670,11839,2.4
26206,CN1313700000000,13,137,"Habersham County, GA",Nov-19,19110,18476,634,3.3
26207,CN1313900000000,13,139,"Hall County, GA",Nov-19,102867,100620,2247,2.2
26208,CN1314100000000,13,141,"Hancock County, GA",Nov-19,2474,2339,135,5.5
26209,CN1314300000000,13,143,"Haralson County, GA",Nov-19,12664,12314,350,2.8
26210,CN1314500000000,13,145,"Harris County, GA",Nov-19,16638,16240,398,2.4
26211,CN1314700000000,13,147,"Hart County, GA",Nov-19,10955,10628,327,3.0
26212,CN1314900000000,13,149,"Heard County, GA",Nov-19,5293,5147,146,2.8
26213,CN1315100000000,13,151,"Henry County, GA",Nov-19,116305,113041,3264,2.8
26214,CN1315300000000,13,153,"Houston County, GA",Nov-19,70316,68448,1868,2.7
26215,CN1315500000000,13,155,"Irwin County, GA",Nov-19,3344,3222,122,3.6
26216,CN1315700000000,13,157,"Jackson County, GA",Nov-19,37669,36909,760,2.0
26217,CN1315900000000,13,159,"Jasper County, GA",Nov-19,6997,6824,173,2.5
26218,CN1316100000000,13,161,"Jeff Davis County, GA",Nov-19,5941,5719,222,3.7
26219,CN1316300000000,13,163,"Jefferson County, GA",Nov-19,6603,6346,257,3.9
26220,CN1316500000000,13,165,"Jenkins County, GA",Nov-19,3106,2993,113,3.6
26221,CN1316700000000,13,167,"Johnson County, GA",Nov-19,3978,3861,117,2.9
26222,CN1316900000000,13,169,"Jones County, GA",Nov-19,13722,13355,367,2.7
26223,CN1317100000000,13,171,"Lamar County, GA",Nov-19,8280,8025,255,3.1
26224,CN1317300000000,13,173,"Lanier County, GA",Nov-19,3773,3648,125,3.3
26225,CN1317500000000,13,175,"Laurens County, GA",Nov-19,18874,18118,756,4.0
26226,CN1317700000000,13,177,"Lee County, GA",Nov-19,14804,14418,386,2.6
26227,CN1317900000000,13,179,"Liberty County, GA",Nov-19,26246,25429,817,3.1
26228,CN1318100000000,13,181,"Lincoln County, GA",Nov-19,3556,3444,112,3.1
26229,CN1318300000000,13,183,"Long County, GA",Nov-19,8176,7942,234,2.9
26230,CN1318500000000,13,185,"Lowndes County, GA",Nov-19,51538,50015,1523,3.0
26231,CN1318700000000,13,187,"Lumpkin County, GA",Nov-19,16881,16481,400,2.4
26232,CN1318900000000,13,189,"McDuffie County, GA",Nov-19,8844,8453,391,4.4
26233,CN1319100000000,13,191,"McIntosh County, GA",Nov-19,6133,5968,165,2.7
26234,CN1319300000000,13,193,"Macon County, GA",Nov-19,4678,4510,168,3.6
26235,CN1319500000000,13,195,"Madison County, GA",Nov-19,13406,13077,329,2.5
26236,CN1319700000000,13,197,"Marion County, GA",Nov-19,3294,3186,108,3.3
26237,CN1319900000000,13,199,"Meriwether County, GA",Nov-19,8961,8634,327,3.6
26238,CN1320100000000,13,201,"Miller County, GA",Nov-19,2763,2685,78,2.8
26239,CN1320500000000,13,205,"Mitchell County, GA",Nov-19,8587,8218,369,4.3
26240,CN1320700000000,13,207,"Monroe County, GA",Nov-19,13000,12661,339,2.6
26241,CN1320900000000,13,209,"Montgomery County, GA",Nov-19,3764,3615,149,4.0
26242,CN1321100000000,13,211,"Morgan County, GA",Nov-19,9314,9084,230,2.5
26243,CN1321300000000,13,213,"Murray County, GA",Nov-19,15363,14678,685,4.5
26244,CN1321500000000,13,215,"Muscogee County, GA",Nov-19,77219,74413,2806,3.6
26245,CN1321700000000,13,217,"Newton County, GA",Nov-19,52531,50917,1614,3.1
26246,CN1321900000000,13,219,"Oconee County, GA",Nov-19,19691,19308,383,1.9
26247,CN1322100000000,13,221,"Oglethorpe County, GA",Nov-19,6992,6815,177,2.5
26248,CN1322300000000,13,223,"Paulding County, GA",Nov-19,86643,84611,2032,2.3
26249,CN1322500000000,13,225,"Peach County, GA",Nov-19,11803,11428,375,3.2
26250,CN1322700000000,13,227,"Pickens County, GA",Nov-19,15394,15031,363,2.4
26251,CN1322900000000,13,229,"Pierce County, GA",Nov-19,8679,8446,233,2.7
26252,CN1323100000000,13,231,"Pike County, GA",Nov-19,8971,8755,216,2.4
26253,CN1323300000000,13,233,"Polk County, GA",Nov-19,18499,17954,545,2.9
26254,CN1323500000000,13,235,"Pulaski County, GA",Nov-19,4040,3926,114,2.8
26255,CN1323700000000,13,237,"Putnam County, GA",Nov-19,8191,7920,271,3.3
26256,CN1323900000000,13,239,"Quitman County, GA",Nov-19,795,759,36,4.5
26257,CN1324100000000,13,241,"Rabun County, GA",Nov-19,7121,6901,220,3.1
26258,CN1324300000000,13,243,"Randolph County, GA",Nov-19,2536,2432,104,4.1
26259,CN1324500000000,13,245,"Richmond County, GA",Nov-19,84814,81721,3093,3.6
26260,CN1324700000000,13,247,"Rockdale County, GA",Nov-19,45036,43682,1354,3.0
26261,CN1324900000000,13,249,"Schley County, GA",Nov-19,2228,2159,69,3.1
26262,CN1325100000000,13,251,"Screven County, GA",Nov-19,5034,4831,203,4.0
26263,CN1325300000000,13,253,"Seminole County, GA",Nov-19,3008,2906,102,3.4
26264,CN1325500000000,13,255,"Spalding County, GA",Nov-19,28840,27929,911,3.2
26265,CN1325700000000,13,257,"Stephens County, GA",Nov-19,10620,10279,341,3.2
26266,CN1325900000000,13,259,"Stewart County, GA",Nov-19,2422,2344,78,3.2
26267,CN1326100000000,13,261,"Sumter County, GA",Nov-19,12840,12333,507,3.9
26268,CN1326300000000,13,263,"Talbot County, GA",Nov-19,2797,2700,97,3.5
26269,CN1326500000000,13,265,"Taliaferro County, GA",Nov-19,566,535,31,5.5
26270,CN1326700000000,13,267,"Tattnall County, GA",Nov-19,9535,9250,285,3.0
26271,CN1326900000000,13,269,"Taylor County, GA",Nov-19,3160,3055,105,3.3
26272,CN1327100000000,13,271,"Telfair County, GA",Nov-19,3854,3498,356,9.2
26273,CN1327300000000,13,273,"Terrell County, GA",Nov-19,3492,3369,123,3.5
26274,CN1327500000000,13,275,"Thomas County, GA",Nov-19,16345,15774,571,3.5
26275,CN1327700000000,13,277,"Tift County, GA",Nov-19,19937,19390,547,2.7
26276,CN1327900000000,13,279,"Toombs County, GA",Nov-19,11525,11101,424,3.7
26277,CN1328100000000,13,281,"Towns County, GA",Nov-19,3885,3729,156,4.0
26278,CN1328300000000,13,283,"Treutlen County, GA",Nov-19,2546,2444,102,4.0
26279,CN1328500000000,13,285,"Troup County, GA",Nov-19,37302,36307,995,2.7
26280,CN1328700000000,13,287,"Turner County, GA",Nov-19,3135,3033,102,3.3
26281,CN1328900000000,13,289,"Twiggs County, GA",Nov-19,2867,2741,126,4.4
26282,CN1329100000000,13,291,"Union County, GA",Nov-19,10276,10028,248,2.4
26283,CN1329300000000,13,293,"Upson County, GA",Nov-19,11357,11010,347,3.1
26284,CN1329500000000,13,295,"Walker County, GA",Nov-19,31449,30629,820,2.6
26285,CN1329700000000,13,297,"Walton County, GA",Nov-19,46375,45249,1126,2.4
26286,CN1329900000000,13,299,"Ware County, GA",Nov-19,15525,15060,465,3.0
26287,CN1330100000000,13,301,"Warren County, GA",Nov-19,2849,2741,108,3.8
26288,CN1330300000000,13,303,"Washington County, GA",Nov-19,7030,6786,244,3.5
26289,CN1330500000000,13,305,"Wayne County, GA",Nov-19,11241,10884,357,3.2
26290,CN1330700000000,13,307,"Webster County, GA",Nov-19,1022,988,34,3.3
26291,CN1330900000000,13,309,"Wheeler County, GA",Nov-19,1590,1485,105,6.6
26292,CN1331100000000,13,311,"White County, GA",Nov-19,16456,16115,341,2.1
26293,CN1331300000000,13,313,"Whitfield County, GA",Nov-19,43015,41486,1529,3.6
26294,CN1331500000000,13,315,"Wilcox County, GA",Nov-19,2673,2581,92,3.4
26295,CN1331700000000,13,317,"Wilkes County, GA",Nov-19,3789,3625,164,4.3
26296,CN1331900000000,13,319,"Wilkinson County, GA",Nov-19,3950,3818,132,3.3
26297,CN1332100000000,13,321,"Worth County, GA",Nov-19,8927,8649,278,3.1
26298,CN1500100000000,15,1,"Hawaii County, HI",Nov-19,92013,88991,3022,3.3
26299,CN1500300000000,15,3,"Honolulu County/city, HI",Nov-19,452986,441863,11123,2.5
26300,CN1500700000000,15,7,"Kauai County, HI",Nov-19,36536,35504,1032,2.8
26301,CN1500900000000,15,9,"Maui County, HI",Nov-19,86322,84155,2167,2.5
26302,CN1600100000000,16,1,"Ada County, ID",Nov-19,257391,251026,6365,2.5
26303,CN1600300000000,16,3,"Adams County, ID",Nov-19,1669,1569,100,6.0
26304,CN1600500000000,16,5,"Bannock County, ID",Nov-19,43372,42250,1122,2.6
26305,CN1600700000000,16,7,"Bear Lake County, ID",Nov-19,2919,2833,86,2.9
26306,CN1600900000000,16,9,"Benewah County, ID",Nov-19,4082,3911,171,4.2
26307,CN1601100000000,16,11,"Bingham County, ID",Nov-19,23669,23076,593,2.5
26308,CN1601300000000,16,13,"Blaine County, ID",Nov-19,11886,11565,321,2.7
26309,CN1601500000000,16,15,"Boise County, ID",Nov-19,3551,3407,144,4.1
26310,CN1601700000000,16,17,"Bonner County, ID",Nov-19,19949,19196,753,3.8
26311,CN1601900000000,16,19,"Bonneville County, ID",Nov-19,57933,56644,1289,2.2
26312,CN1602100000000,16,21,"Boundary County, ID",Nov-19,5307,5110,197,3.7
26313,CN1602300000000,16,23,"Butte County, ID",Nov-19,1406,1371,35,2.5
26314,CN1602500000000,16,25,"Camas County, ID",Nov-19,684,662,22,3.2
26315,CN1602700000000,16,27,"Canyon County, ID",Nov-19,104900,101744,3156,3.0
26316,CN1602900000000,16,29,"Caribou County, ID",Nov-19,4144,4026,118,2.8
26317,CN1603100000000,16,31,"Cassia County, ID",Nov-19,12330,12041,289,2.3
26318,CN1603300000000,16,33,"Clark County, ID",Nov-19,379,364,15,4.0
26319,CN1603500000000,16,35,"Clearwater County, ID",Nov-19,2866,2719,147,5.1
26320,CN1603700000000,16,37,"Custer County, ID",Nov-19,2093,2008,85,4.1
26321,CN1603900000000,16,39,"Elmore County, ID",Nov-19,11533,11193,340,2.9
26322,CN1604100000000,16,41,"Franklin County, ID",Nov-19,7107,6946,161,2.3
26323,CN1604300000000,16,43,"Fremont County, ID",Nov-19,8027,7852,175,2.2
26324,CN1604500000000,16,45,"Gem County, ID",Nov-19,8405,8147,258,3.1
26325,CN1604700000000,16,47,"Gooding County, ID",Nov-19,8279,8076,203,2.5
26326,CN1604900000000,16,49,"Idaho County, ID",Nov-19,6449,6202,247,3.8
26327,CN1605100000000,16,51,"Jefferson County, ID",Nov-19,14214,13899,315,2.2
26328,CN1605300000000,16,53,"Jerome County, ID",Nov-19,12275,11971,304,2.5
26329,CN1605500000000,16,55,"Kootenai County, ID",Nov-19,80122,77439,2683,3.3
26330,CN1605700000000,16,57,"Latah County, ID",Nov-19,21192,20673,519,2.4
26331,CN1605900000000,16,59,"Lemhi County, ID",Nov-19,3477,3326,151,4.3
26332,CN1606100000000,16,61,"Lewis County, ID",Nov-19,1620,1534,86,5.3
26333,CN1606300000000,16,63,"Lincoln County, ID",Nov-19,2601,2533,68,2.6
26334,CN1606500000000,16,65,"Madison County, ID",Nov-19,22491,22101,390,1.7
26335,CN1606700000000,16,67,"Minidoka County, ID",Nov-19,11623,11348,275,2.4
26336,CN1606900000000,16,69,"Nez Perce County, ID",Nov-19,21368,20801,567,2.7
26337,CN1607100000000,16,71,"Oneida County, ID",Nov-19,2294,2253,41,1.8
26338,CN1607300000000,16,73,"Owyhee County, ID",Nov-19,5233,5072,161,3.1
26339,CN1607500000000,16,75,"Payette County, ID",Nov-19,11725,11344,381,3.2
26340,CN1607700000000,16,77,"Power County, ID",Nov-19,4012,3906,106,2.6
26341,CN1607900000000,16,79,"Shoshone County, ID",Nov-19,5019,4721,298,5.9
26342,CN1608100000000,16,81,"Teton County, ID",Nov-19,6271,6082,189,3.0
26343,CN1608300000000,16,83,"Twin Falls County, ID",Nov-19,41828,40703,1125,2.7
26344,CN1608500000000,16,85,"Valley County, ID",Nov-19,5224,5007,217,4.2
26345,CN1608700000000,16,87,"Washington County, ID",Nov-19,4689,4523,166,3.5
26346,CN1700100000000,17,1,"Adams County, IL",Nov-19,32039,31072,967,3.0
26347,CN1700300000000,17,3,"Alexander County, IL",Nov-19,2065,1943,122,5.9
26348,CN1700500000000,17,5,"Bond County, IL",Nov-19,7796,7550,246,3.2
26349,CN1700700000000,17,7,"Boone County, IL",Nov-19,26061,24757,1304,5.0
26350,CN1700900000000,17,9,"Brown County, IL",Nov-19,2989,2923,66,2.2
26351,CN1701100000000,17,11,"Bureau County, IL",Nov-19,17185,16458,727,4.2
26352,CN1701300000000,17,13,"Calhoun County, IL",Nov-19,2338,2233,105,4.5
26353,CN1701500000000,17,15,"Carroll County, IL",Nov-19,7314,7052,262,3.6
26354,CN1701700000000,17,17,"Cass County, IL",Nov-19,6034,5821,213,3.5
26355,CN1701900000000,17,19,"Champaign County, IL",Nov-19,113026,109466,3560,3.1
26356,CN1702100000000,17,21,"Christian County, IL",Nov-19,14300,13686,614,4.3
26357,CN1702300000000,17,23,"Clark County, IL",Nov-19,7635,7337,298,3.9
26358,CN1702500000000,17,25,"Clay County, IL",Nov-19,6397,6151,246,3.8
26359,CN1702700000000,17,27,"Clinton County, IL",Nov-19,20521,20000,521,2.5
26360,CN1702900000000,17,29,"Coles County, IL",Nov-19,24330,23508,822,3.4
26361,CN1703100000000,17,31,"Cook County, IL",Nov-19,2576961,2496373,80588,3.1
26362,CN1703300000000,17,33,"Crawford County, IL",Nov-19,8706,8394,312,3.6
26363,CN1703500000000,17,35,"Cumberland County, IL",Nov-19,6123,5958,165,2.7
26364,CN1703700000000,17,37,"DeKalb County, IL",Nov-19,55403,53393,2010,3.6
26365,CN1703900000000,17,39,"De Witt County, IL",Nov-19,7492,7232,260,3.5
26366,CN1704100000000,17,41,"Douglas County, IL",Nov-19,10365,10054,311,3.0
26367,CN1704300000000,17,43,"DuPage County, IL",Nov-19,504769,492940,11829,2.3
26368,CN1704500000000,17,45,"Edgar County, IL",Nov-19,8850,8512,338,3.8
26369,CN1704700000000,17,47,"Edwards County, IL",Nov-19,2672,2567,105,3.9
26370,CN1704900000000,17,49,"Effingham County, IL",Nov-19,19265,18742,523,2.7
26371,CN1705100000000,17,51,"Fayette County, IL",Nov-19,9783,9410,373,3.8
26372,CN1705300000000,17,53,"Ford County, IL",Nov-19,6644,6389,255,3.8
26373,CN1705500000000,17,55,"Franklin County, IL",Nov-19,16375,15576,799,4.9
26374,CN1705700000000,17,57,"Fulton County, IL",Nov-19,15111,14392,719,4.8
26375,CN1705900000000,17,59,"Gallatin County, IL",Nov-19,2316,2214,102,4.4
26376,CN1706100000000,17,61,"Greene County, IL",Nov-19,5992,5772,220,3.7
26377,CN1706300000000,17,63,"Grundy County, IL",Nov-19,25107,24276,831,3.3
26378,CN1706500000000,17,65,"Hamilton County, IL",Nov-19,4427,4282,145,3.3
26379,CN1706700000000,17,67,"Hancock County, IL",Nov-19,8455,8117,338,4.0
26380,CN1706900000000,17,69,"Hardin County, IL",Nov-19,1328,1255,73,5.5
26381,CN1707100000000,17,71,"Henderson County, IL",Nov-19,3571,3461,110,3.1
26382,CN1707300000000,17,73,"Henry County, IL",Nov-19,25101,23979,1122,4.5
26383,CN1707500000000,17,75,"Iroquois County, IL",Nov-19,14469,13925,544,3.8
26384,CN1707700000000,17,77,"Jackson County, IL",Nov-19,28480,27531,949,3.3
26385,CN1707900000000,17,79,"Jasper County, IL",Nov-19,4586,4432,154,3.4
26386,CN1708100000000,17,81,"Jefferson County, IL",Nov-19,17485,16759,726,4.2
26387,CN1708300000000,17,83,"Jersey County, IL",Nov-19,11044,10623,421,3.8
26388,CN1708500000000,17,85,"Jo Daviess County, IL",Nov-19,10582,10209,373,3.5
26389,CN1708700000000,17,87,"Johnson County, IL",Nov-19,4142,3939,203,4.9
26390,CN1708900000000,17,89,"Kane County, IL",Nov-19,274058,263806,10252,3.7
26391,CN1709100000000,17,91,"Kankakee County, IL",Nov-19,56735,53996,2739,4.8
26392,CN1709300000000,17,93,"Kendall County, IL",Nov-19,68124,66320,1804,2.6
26393,CN1709500000000,17,95,"Knox County, IL",Nov-19,21605,20666,939,4.3
26394,CN1709700000000,17,97,"Lake County, IL",Nov-19,376268,363081,13187,3.5
26395,CN1709900000000,17,99,"LaSalle County, IL",Nov-19,54650,52214,2436,4.5
26396,CN1710100000000,17,101,"Lawrence County, IL",Nov-19,5818,5545,273,4.7
26397,CN1710300000000,17,103,"Lee County, IL",Nov-19,17776,17155,621,3.5
26398,CN1710500000000,17,105,"Livingston County, IL",Nov-19,16632,16036,596,3.6
26399,CN1710700000000,17,107,"Logan County, IL",Nov-19,12540,12077,463,3.7
26400,CN1710900000000,17,109,"McDonough County, IL",Nov-19,13778,13289,489,3.5
26401,CN1711100000000,17,111,"McHenry County, IL",Nov-19,164203,159970,4233,2.6
26402,CN1711300000000,17,113,"McLean County, IL",Nov-19,89195,86343,2852,3.2
26403,CN1711500000000,17,115,"Macon County, IL",Nov-19,48435,46099,2336,4.8
26404,CN1711700000000,17,117,"Macoupin County, IL",Nov-19,23117,22241,876,3.8
26405,CN1711900000000,17,119,"Madison County, IL",Nov-19,135385,130758,4627,3.4
26406,CN1712100000000,17,121,"Marion County, IL",Nov-19,17561,16829,732,4.2
26407,CN1712300000000,17,123,"Marshall County, IL",Nov-19,5292,5054,238,4.5
26408,CN1712500000000,17,125,"Mason County, IL",Nov-19,6254,5978,276,4.4
26409,CN1712700000000,17,127,"Massac County, IL",Nov-19,5647,5390,257,4.6
26410,CN1712900000000,17,129,"Menard County, IL",Nov-19,6472,6271,201,3.1
26411,CN1713100000000,17,131,"Mercer County, IL",Nov-19,8076,7731,345,4.3
26412,CN1713300000000,17,133,"Monroe County, IL",Nov-19,18968,18447,521,2.7
26413,CN1713500000000,17,135,"Montgomery County, IL",Nov-19,11653,11105,548,4.7
26414,CN1713700000000,17,137,"Morgan County, IL",Nov-19,16460,15877,583,3.5
26415,CN1713900000000,17,139,"Moultrie County, IL",Nov-19,7573,7357,216,2.9
26416,CN1714100000000,17,141,"Ogle County, IL",Nov-19,24887,23835,1052,4.2
26417,CN1714300000000,17,143,"Peoria County, IL",Nov-19,84556,80670,3886,4.6
26418,CN1714500000000,17,145,"Perry County, IL",Nov-19,8353,7988,365,4.4
26419,CN1714700000000,17,147,"Piatt County, IL",Nov-19,8872,8615,257,2.9
26420,CN1714900000000,17,149,"Pike County, IL",Nov-19,6871,6607,264,3.8
26421,CN1715100000000,17,151,"Pope County, IL",Nov-19,1659,1579,80,4.8
26422,CN1715300000000,17,153,"Pulaski County, IL",Nov-19,2035,1922,113,5.6
26423,CN1715500000000,17,155,"Putnam County, IL",Nov-19,3065,2935,130,4.2
26424,CN1715700000000,17,157,"Randolph County, IL",Nov-19,14295,13819,476,3.3
26425,CN1715900000000,17,159,"Richland County, IL",Nov-19,7265,7006,259,3.6
26426,CN1716100000000,17,161,"Rock Island County, IL",Nov-19,71841,68524,3317,4.6
26427,CN1716300000000,17,163,"St. Clair County, IL",Nov-19,127688,122707,4981,3.9
26428,CN1716500000000,17,165,"Saline County, IL",Nov-19,9713,9261,452,4.7
26429,CN1716700000000,17,167,"Sangamon County, IL",Nov-19,100960,97437,3523,3.5
26430,CN1716900000000,17,169,"Schuyler County, IL",Nov-19,3137,3014,123,3.9
26431,CN1717100000000,17,171,"Scott County, IL",Nov-19,2512,2426,86,3.4
26432,CN1717300000000,17,173,"Shelby County, IL",Nov-19,10614,10241,373,3.5
26433,CN1717500000000,17,175,"Stark County, IL",Nov-19,2506,2375,131,5.2
26434,CN1717700000000,17,177,"Stephenson County, IL",Nov-19,21592,20745,847,3.9
26435,CN1717900000000,17,179,"Tazewell County, IL",Nov-19,63438,60967,2471,3.9
26436,CN1718100000000,17,181,"Union County, IL",Nov-19,7498,7134,364,4.9
26437,CN1718300000000,17,183,"Vermilion County, IL",Nov-19,33357,31792,1565,4.7
26438,CN1718500000000,17,185,"Wabash County, IL",Nov-19,5967,5784,183,3.1
26439,CN1718700000000,17,187,"Warren County, IL",Nov-19,8429,8140,289,3.4
26440,CN1718900000000,17,189,"Washington County, IL",Nov-19,10129,9918,211,2.1
26441,CN1719100000000,17,191,"Wayne County, IL",Nov-19,7014,6722,292,4.2
26442,CN1719300000000,17,193,"White County, IL",Nov-19,6595,6371,224,3.4
26443,CN1719500000000,17,195,"Whiteside County, IL",Nov-19,28838,27680,1158,4.0
26444,CN1719700000000,17,197,"Will County, IL",Nov-19,354250,343491,10759,3.0
26445,CN1719900000000,17,199,"Williamson County, IL",Nov-19,32601,31384,1217,3.7
26446,CN1720100000000,17,201,"Winnebago County, IL",Nov-19,139275,131747,7528,5.4
26447,CN1720300000000,17,203,"Woodford County, IL",Nov-19,18615,18033,582,3.1
26448,CN1800100000000,18,1,"Adams County, IN",Nov-19,17066,16591,475,2.8
26449,CN1800300000000,18,3,"Allen County, IN",Nov-19,187277,181339,5938,3.2
26450,CN1800500000000,18,5,"Bartholomew County, IN",Nov-19,44983,43946,1037,2.3
26451,CN1800700000000,18,7,"Benton County, IN",Nov-19,4638,4509,129,2.8
26452,CN1800900000000,18,9,"Blackford County, IN",Nov-19,4874,4687,187,3.8
26453,CN1801100000000,18,11,"Boone County, IN",Nov-19,36484,35637,847,2.3
26454,CN1801300000000,18,13,"Brown County, IN",Nov-19,7754,7551,203,2.6
26455,CN1801500000000,18,15,"Carroll County, IN",Nov-19,10449,10172,277,2.7
26456,CN1801700000000,18,17,"Cass County, IN",Nov-19,17733,17188,545,3.1
26457,CN1801900000000,18,19,"Clark County, IN",Nov-19,61781,59870,1911,3.1
26458,CN1802100000000,18,21,"Clay County, IN",Nov-19,12166,11765,401,3.3
26459,CN1802300000000,18,23,"Clinton County, IN",Nov-19,17210,16777,433,2.5
26460,CN1802500000000,18,25,"Crawford County, IN",Nov-19,4800,4634,166,3.5
26461,CN1802700000000,18,27,"Daviess County, IN",Nov-19,16661,16254,407,2.4
26462,CN1802900000000,18,29,"Dearborn County, IN",Nov-19,25841,25000,841,3.3
26463,CN1803100000000,18,31,"Decatur County, IN",Nov-19,14616,14228,388,2.7
26464,CN1803300000000,18,33,"DeKalb County, IN",Nov-19,22655,22026,629,2.8
26465,CN1803500000000,18,35,"Delaware County, IN",Nov-19,54732,52734,1998,3.7
26466,CN1803700000000,18,37,"Dubois County, IN",Nov-19,22852,22336,516,2.3
26467,CN1803900000000,18,39,"Elkhart County, IN",Nov-19,111351,108118,3233,2.9
26468,CN1804100000000,18,41,"Fayette County, IN",Nov-19,8631,8232,399,4.6
26469,CN1804300000000,18,43,"Floyd County, IN",Nov-19,41733,40493,1240,3.0
26470,CN1804500000000,18,45,"Fountain County, IN",Nov-19,8026,7754,272,3.4
26471,CN1804700000000,18,47,"Franklin County, IN",Nov-19,11364,10989,375,3.3
26472,CN1804900000000,18,49,"Fulton County, IN",Nov-19,9791,9503,288,2.9
26473,CN1805100000000,18,51,"Gibson County, IN",Nov-19,19584,19107,477,2.4
26474,CN1805300000000,18,53,"Grant County, IN",Nov-19,32316,31218,1098,3.4
26475,CN1805500000000,18,55,"Greene County, IN",Nov-19,13757,13256,501,3.6
26476,CN1805700000000,18,57,"Hamilton County, IN",Nov-19,184782,180430,4352,2.4
26477,CN1805900000000,18,59,"Hancock County, IN",Nov-19,40423,39403,1020,2.5
26478,CN1806100000000,18,61,"Harrison County, IN",Nov-19,20313,19738,575,2.8
26479,CN1806300000000,18,63,"Hendricks County, IN",Nov-19,90458,88155,2303,2.5
26480,CN1806500000000,18,65,"Henry County, IN",Nov-19,22108,21439,669,3.0
26481,CN1806700000000,18,67,"Howard County, IN",Nov-19,36993,35754,1239,3.3
26482,CN1806900000000,18,69,"Huntington County, IN",Nov-19,18266,17735,531,2.9
26483,CN1807100000000,18,71,"Jackson County, IN",Nov-19,22960,22413,547,2.4
26484,CN1807300000000,18,73,"Jasper County, IN",Nov-19,16349,15828,521,3.2
26485,CN1807500000000,18,75,"Jay County, IN",Nov-19,9375,9118,257,2.7
26486,CN1807700000000,18,77,"Jefferson County, IN",Nov-19,14965,14468,497,3.3
26487,CN1807900000000,18,79,"Jennings County, IN",Nov-19,13615,13225,390,2.9
26488,CN1808100000000,18,81,"Johnson County, IN",Nov-19,83414,81299,2115,2.5
26489,CN1808300000000,18,83,"Knox County, IN",Nov-19,18600,18068,532,2.9
26490,CN1808500000000,18,85,"Kosciusko County, IN",Nov-19,42077,40887,1190,2.8
26491,CN1808700000000,18,87,"LaGrange County, IN",Nov-19,19988,19489,499,2.5
26492,CN1808900000000,18,89,"Lake County, IN",Nov-19,231837,221635,10202,4.4
26493,CN1809100000000,18,91,"LaPorte County, IN",Nov-19,47785,45996,1789,3.7
26494,CN1809300000000,18,93,"Lawrence County, IN",Nov-19,21425,20673,752,3.5
26495,CN1809500000000,18,95,"Madison County, IN",Nov-19,59372,57377,1995,3.4
26496,CN1809700000000,18,97,"Marion County, IN",Nov-19,493184,478099,15085,3.1
26497,CN1809900000000,18,99,"Marshall County, IN",Nov-19,22915,22240,675,2.9
26498,CN1810100000000,18,101,"Martin County, IN",Nov-19,5347,5223,124,2.3
26499,CN1810300000000,18,103,"Miami County, IN",Nov-19,15205,14673,532,3.5
26500,CN1810500000000,18,105,"Monroe County, IN",Nov-19,72249,70073,2176,3.0
26501,CN1810700000000,18,107,"Montgomery County, IN",Nov-19,18865,18312,553,2.9
26502,CN1810900000000,18,109,"Morgan County, IN",Nov-19,36520,35500,1020,2.8
26503,CN1811100000000,18,111,"Newton County, IN",Nov-19,6988,6750,238,3.4
26504,CN1811300000000,18,113,"Noble County, IN",Nov-19,23417,22737,680,2.9
26505,CN1811500000000,18,115,"Ohio County, IN",Nov-19,3196,3089,107,3.3
26506,CN1811700000000,18,117,"Orange County, IN",Nov-19,8502,8214,288,3.4
26507,CN1811900000000,18,119,"Owen County, IN",Nov-19,9634,9299,335,3.5
26508,CN1812100000000,18,121,"Parke County, IN",Nov-19,7044,6783,261,3.7
26509,CN1812300000000,18,123,"Perry County, IN",Nov-19,9176,8904,272,3.0
26510,CN1812500000000,18,125,"Pike County, IN",Nov-19,6108,5940,168,2.8
26511,CN1812700000000,18,127,"Porter County, IN",Nov-19,87455,84514,2941,3.4
26512,CN1812900000000,18,129,"Posey County, IN",Nov-19,13669,13314,355,2.6
26513,CN1813100000000,18,131,"Pulaski County, IN",Nov-19,6450,6252,198,3.1
26514,CN1813300000000,18,133,"Putnam County, IN",Nov-19,16847,16316,531,3.2
26515,CN1813500000000,18,135,"Randolph County, IN",Nov-19,11207,10800,407,3.6
26516,CN1813700000000,18,137,"Ripley County, IN",Nov-19,14171,13742,429,3.0
26517,CN1813900000000,18,139,"Rush County, IN",Nov-19,8873,8657,216,2.4
26518,CN1814100000000,18,141,"St. Joseph County, IN",Nov-19,136131,131458,4673,3.4
26519,CN1814300000000,18,143,"Scott County, IN",Nov-19,10558,10223,335,3.2
26520,CN1814500000000,18,145,"Shelby County, IN",Nov-19,23269,22646,623,2.7
26521,CN1814700000000,18,147,"Spencer County, IN",Nov-19,10189,9886,303,3.0
26522,CN1814900000000,18,149,"Starke County, IN",Nov-19,9846,9458,388,3.9
26523,CN1815100000000,18,151,"Steuben County, IN",Nov-19,20965,20446,519,2.5
26524,CN1815300000000,18,153,"Sullivan County, IN",Nov-19,8423,8118,305,3.6
26525,CN1815500000000,18,155,"Switzerland County, IN",Nov-19,4993,4832,161,3.2
26526,CN1815700000000,18,157,"Tippecanoe County, IN",Nov-19,101422,98649,2773,2.7
26527,CN1815900000000,18,159,"Tipton County, IN",Nov-19,9174,8982,192,2.1
26528,CN1816100000000,18,161,"Union County, IN",Nov-19,3554,3449,105,3.0
26529,CN1816300000000,18,163,"Vanderburgh County, IN",Nov-19,94885,92153,2732,2.9
26530,CN1816500000000,18,165,"Vermillion County, IN",Nov-19,7029,6709,320,4.6
26531,CN1816700000000,18,167,"Vigo County, IN",Nov-19,48638,46727,1911,3.9
26532,CN1816900000000,18,169,"Wabash County, IN",Nov-19,15249,14800,449,2.9
26533,CN1817100000000,18,171,"Warren County, IN",Nov-19,4222,4102,120,2.8
26534,CN1817300000000,18,173,"Warrick County, IN",Nov-19,33211,32296,915,2.8
26535,CN1817500000000,18,175,"Washington County, IN",Nov-19,13708,13299,409,3.0
26536,CN1817700000000,18,177,"Wayne County, IN",Nov-19,30629,29607,1022,3.3
26537,CN1817900000000,18,179,"Wells County, IN",Nov-19,14496,14132,364,2.5
26538,CN1818100000000,18,181,"White County, IN",Nov-19,13366,13039,327,2.4
26539,CN1818300000000,18,183,"Whitley County, IN",Nov-19,17848,17375,473,2.7
26540,CN1900100000000,19,1,"Adair County, IA",Nov-19,4359,4278,81,1.9
26541,CN1900300000000,19,3,"Adams County, IA",Nov-19,2212,2179,33,1.5
26542,CN1900500000000,19,5,"Allamakee County, IA",Nov-19,7596,7410,186,2.4
26543,CN1900700000000,19,7,"Appanoose County, IA",Nov-19,6047,5857,190,3.1
26544,CN1900900000000,19,9,"Audubon County, IA",Nov-19,3186,3124,62,1.9
26545,CN1901100000000,19,11,"Benton County, IA",Nov-19,13918,13542,376,2.7
26546,CN1901300000000,19,13,"Black Hawk County, IA",Nov-19,70338,68235,2103,3.0
26547,CN1901500000000,19,15,"Boone County, IA",Nov-19,15278,14967,311,2.0
26548,CN1901700000000,19,17,"Bremer County, IA",Nov-19,14208,13901,307,2.2
26549,CN1901900000000,19,19,"Buchanan County, IA",Nov-19,11486,11216,270,2.4
26550,CN1902100000000,19,21,"Buena Vista County, IA",Nov-19,12405,12183,222,1.8
26551,CN1902300000000,19,23,"Butler County, IA",Nov-19,8138,7929,209,2.6
26552,CN1902500000000,19,25,"Calhoun County, IA",Nov-19,4356,4269,87,2.0
26553,CN1902700000000,19,27,"Carroll County, IA",Nov-19,11224,11024,200,1.8
26554,CN1902900000000,19,29,"Cass County, IA",Nov-19,6994,6851,143,2.0
26555,CN1903100000000,19,31,"Cedar County, IA",Nov-19,11122,10885,237,2.1
26556,CN1903300000000,19,33,"Cerro Gordo County, IA",Nov-19,23946,23375,571,2.4
26557,CN1903500000000,19,35,"Cherokee County, IA",Nov-19,6304,6179,125,2.0
26558,CN1903700000000,19,37,"Chickasaw County, IA",Nov-19,6752,6587,165,2.4
26559,CN1903900000000,19,39,"Clarke County, IA",Nov-19,4949,4833,116,2.3
26560,CN1904100000000,19,41,"Clay County, IA",Nov-19,8677,8463,214,2.5
26561,CN1904300000000,19,43,"Clayton County, IA",Nov-19,10316,10019,297,2.9
26562,CN1904500000000,19,45,"Clinton County, IA",Nov-19,23390,22522,868,3.7
26563,CN1904700000000,19,47,"Crawford County, IA",Nov-19,8395,8156,239,2.8
26564,CN1904900000000,19,49,"Dallas County, IA",Nov-19,50648,49790,858,1.7
26565,CN1905100000000,19,51,"Davis County, IA",Nov-19,4313,4209,104,2.4
26566,CN1905300000000,19,53,"Decatur County, IA",Nov-19,4527,4449,78,1.7
26567,CN1905500000000,19,55,"Delaware County, IA",Nov-19,10914,10685,229,2.1
26568,CN1905700000000,19,57,"Des Moines County, IA",Nov-19,19291,18567,724,3.8
26569,CN1905900000000,19,59,"Dickinson County, IA",Nov-19,9913,9693,220,2.2
26570,CN1906100000000,19,61,"Dubuque County, IA",Nov-19,57378,56040,1338,2.3
26571,CN1906300000000,19,63,"Emmet County, IA",Nov-19,5349,5258,91,1.7
26572,CN1906500000000,19,65,"Fayette County, IA",Nov-19,11010,10683,327,3.0
26573,CN1906700000000,19,67,"Floyd County, IA",Nov-19,8870,8480,390,4.4
26574,CN1906900000000,19,69,"Franklin County, IA",Nov-19,5795,5696,99,1.7
26575,CN1907100000000,19,71,"Fremont County, IA",Nov-19,3790,3715,75,2.0
26576,CN1907300000000,19,73,"Greene County, IA",Nov-19,5591,5497,94,1.7
26577,CN1907500000000,19,75,"Grundy County, IA",Nov-19,6695,6549,146,2.2
26578,CN1907700000000,19,77,"Guthrie County, IA",Nov-19,5782,5646,136,2.4
26579,CN1907900000000,19,79,"Hamilton County, IA",Nov-19,7113,6936,177,2.5
26580,CN1908100000000,19,81,"Hancock County, IA",Nov-19,6072,5930,142,2.3
26581,CN1908300000000,19,83,"Hardin County, IA",Nov-19,8220,8010,210,2.6
26582,CN1908500000000,19,85,"Harrison County, IA",Nov-19,7590,7439,151,2.0
26583,CN1908700000000,19,87,"Henry County, IA",Nov-19,10034,9778,256,2.6
26584,CN1908900000000,19,89,"Howard County, IA",Nov-19,5310,5204,106,2.0
26585,CN1909100000000,19,91,"Humboldt County, IA",Nov-19,5262,5140,122,2.3
26586,CN1909300000000,19,93,"Ida County, IA",Nov-19,4232,4164,68,1.6
26587,CN1909500000000,19,95,"Iowa County, IA",Nov-19,10838,10661,177,1.6
26588,CN1909700000000,19,97,"Jackson County, IA",Nov-19,11147,10850,297,2.7
26589,CN1909900000000,19,99,"Jasper County, IA",Nov-19,20307,19770,537,2.6
26590,CN1910100000000,19,101,"Jefferson County, IA",Nov-19,10426,10199,227,2.2
26591,CN1910300000000,19,103,"Johnson County, IA",Nov-19,88502,86863,1639,1.9
26592,CN1910500000000,19,105,"Jones County, IA",Nov-19,11007,10723,284,2.6
26593,CN1910700000000,19,107,"Keokuk County, IA",Nov-19,5360,5222,138,2.6
26594,CN1910900000000,19,109,"Kossuth County, IA",Nov-19,8617,8459,158,1.8
26595,CN1911100000000,19,111,"Lee County, IA",Nov-19,16497,15909,588,3.6
26596,CN1911300000000,19,113,"Linn County, IA",Nov-19,125166,121714,3452,2.8
26597,CN1911500000000,19,115,"Louisa County, IA",Nov-19,6206,6034,172,2.8
26598,CN1911700000000,19,117,"Lucas County, IA",Nov-19,4668,4581,87,1.9
26599,CN1911900000000,19,119,"Lyon County, IA",Nov-19,7237,7128,109,1.5
26600,CN1912100000000,19,121,"Madison County, IA",Nov-19,8757,8503,254,2.9
26601,CN1912300000000,19,123,"Mahaska County, IA",Nov-19,12152,11885,267,2.2
26602,CN1912500000000,19,125,"Marion County, IA",Nov-19,18760,18416,344,1.8
26603,CN1912700000000,19,127,"Marshall County, IA",Nov-19,18029,17437,592,3.3
26604,CN1912900000000,19,129,"Mills County, IA",Nov-19,7609,7453,156,2.1
26605,CN1913100000000,19,131,"Mitchell County, IA",Nov-19,7304,7206,98,1.3
26606,CN1913300000000,19,133,"Monona County, IA",Nov-19,4520,4406,114,2.5
26607,CN1913500000000,19,135,"Monroe County, IA",Nov-19,4117,4006,111,2.7
26608,CN1913700000000,19,137,"Montgomery County, IA",Nov-19,5102,4977,125,2.5
26609,CN1913900000000,19,139,"Muscatine County, IA",Nov-19,22143,21576,567,2.6
26610,CN1914100000000,19,141,"O'Brien County, IA",Nov-19,8469,8318,151,1.8
26611,CN1914300000000,19,143,"Osceola County, IA",Nov-19,3616,3555,61,1.7
26612,CN1914500000000,19,145,"Page County, IA",Nov-19,6481,6321,160,2.5
26613,CN1914700000000,19,147,"Palo Alto County, IA",Nov-19,4915,4821,94,1.9
26614,CN1914900000000,19,149,"Plymouth County, IA",Nov-19,15310,14961,349,2.3
26615,CN1915100000000,19,151,"Pocahontas County, IA",Nov-19,4928,4853,75,1.5
26616,CN1915300000000,19,153,"Polk County, IA",Nov-19,274608,267633,6975,2.5
26617,CN1915500000000,19,155,"Pottawattamie County, IA",Nov-19,49658,48648,1010,2.0
26618,CN1915700000000,19,157,"Poweshiek County, IA",Nov-19,10904,10667,237,2.2
26619,CN1915900000000,19,159,"Ringgold County, IA",Nov-19,2538,2480,58,2.3
26620,CN1916100000000,19,161,"Sac County, IA",Nov-19,5427,5336,91,1.7
26621,CN1916300000000,19,163,"Scott County, IA",Nov-19,90745,87681,3064,3.4
26622,CN1916500000000,19,165,"Shelby County, IA",Nov-19,6823,6705,118,1.7
26623,CN1916700000000,19,167,"Sioux County, IA",Nov-19,21804,21510,294,1.3
26624,CN1916900000000,19,169,"Story County, IA",Nov-19,61308,60271,1037,1.7
26625,CN1917100000000,19,171,"Tama County, IA",Nov-19,9561,9334,227,2.4
26626,CN1917300000000,19,173,"Taylor County, IA",Nov-19,3286,3225,61,1.9
26627,CN1917500000000,19,175,"Union County, IA",Nov-19,6482,6302,180,2.8
26628,CN1917700000000,19,177,"Van Buren County, IA",Nov-19,3771,3687,84,2.2
26629,CN1917900000000,19,179,"Wapello County, IA",Nov-19,18050,17482,568,3.1
26630,CN1918100000000,19,181,"Warren County, IA",Nov-19,28875,28253,622,2.2
26631,CN1918300000000,19,183,"Washington County, IA",Nov-19,12382,12132,250,2.0
26632,CN1918500000000,19,185,"Wayne County, IA",Nov-19,2893,2833,60,2.1
26633,CN1918700000000,19,187,"Webster County, IA",Nov-19,20028,19521,507,2.5
26634,CN1918900000000,19,189,"Winnebago County, IA",Nov-19,5269,5140,129,2.4
26635,CN1919100000000,19,191,"Winneshiek County, IA",Nov-19,12615,12375,240,1.9
26636,CN1919300000000,19,193,"Woodbury County, IA",Nov-19,56964,55534,1430,2.5
26637,CN1919500000000,19,195,"Worth County, IA",Nov-19,4332,4223,109,2.5
26638,CN1919700000000,19,197,"Wright County, IA",Nov-19,7180,7014,166,2.3
26639,CN2000100000000,20,1,"Allen County, KS",Nov-19,6400,6206,194,3.0
26640,CN2000300000000,20,3,"Anderson County, KS",Nov-19,4214,4101,113,2.7
26641,CN2000500000000,20,5,"Atchison County, KS",Nov-19,7041,6678,363,5.2
26642,CN2000700000000,20,7,"Barber County, KS",Nov-19,2369,2300,69,2.9
26643,CN2000900000000,20,9,"Barton County, KS",Nov-19,13385,13010,375,2.8
26644,CN2001100000000,20,11,"Bourbon County, KS",Nov-19,6635,6397,238,3.6
26645,CN2001300000000,20,13,"Brown County, KS",Nov-19,5355,5202,153,2.9
26646,CN2001500000000,20,15,"Butler County, KS",Nov-19,32651,31674,977,3.0
26647,CN2001700000000,20,17,"Chase County, KS",Nov-19,1510,1477,33,2.2
26648,CN2001900000000,20,19,"Chautauqua County, KS",Nov-19,1462,1409,53,3.6
26649,CN2002100000000,20,21,"Cherokee County, KS",Nov-19,10205,9904,301,2.9
26650,CN2002300000000,20,23,"Cheyenne County, KS",Nov-19,1349,1319,30,2.2
26651,CN2002500000000,20,25,"Clark County, KS",Nov-19,1118,1093,25,2.2
26652,CN2002700000000,20,27,"Clay County, KS",Nov-19,3824,3724,100,2.6
26653,CN2002900000000,20,29,"Cloud County, KS",Nov-19,3822,3713,109,2.9
26654,CN2003100000000,20,31,"Coffey County, KS",Nov-19,4171,4004,167,4.0
26655,CN2003300000000,20,33,"Comanche County, KS",Nov-19,890,865,25,2.8
26656,CN2003500000000,20,35,"Cowley County, KS",Nov-19,16388,15871,517,3.2
26657,CN2003700000000,20,37,"Crawford County, KS",Nov-19,18851,18159,692,3.7
26658,CN2003900000000,20,39,"Decatur County, KS",Nov-19,1277,1238,39,3.1
26659,CN2004100000000,20,41,"Dickinson County, KS",Nov-19,8870,8604,266,3.0
26660,CN2004300000000,20,43,"Doniphan County, KS",Nov-19,4167,4039,128,3.1
26661,CN2004500000000,20,45,"Douglas County, KS",Nov-19,67073,65294,1779,2.7
26662,CN2004700000000,20,47,"Edwards County, KS",Nov-19,1589,1554,35,2.2
26663,CN2004900000000,20,49,"Elk County, KS",Nov-19,1197,1160,37,3.1
26664,CN2005100000000,20,51,"Ellis County, KS",Nov-19,17301,16951,350,2.0
26665,CN2005300000000,20,53,"Ellsworth County, KS",Nov-19,2740,2675,65,2.4
26666,CN2005500000000,20,55,"Finney County, KS",Nov-19,20803,20356,447,2.1
26667,CN2005700000000,20,57,"Ford County, KS",Nov-19,17204,16812,392,2.3
26668,CN2005900000000,20,59,"Franklin County, KS",Nov-19,14189,13786,403,2.8
26669,CN2006100000000,20,61,"Geary County, KS",Nov-19,11449,11000,449,3.9
26670,CN2006300000000,20,63,"Gove County, KS",Nov-19,1496,1466,30,2.0
26671,CN2006500000000,20,65,"Graham County, KS",Nov-19,1133,1100,33,2.9
26672,CN2006700000000,20,67,"Grant County, KS",Nov-19,3259,3169,90,2.8
26673,CN2006900000000,20,69,"Gray County, KS",Nov-19,3348,3281,67,2.0
26674,CN2007100000000,20,71,"Greeley County, KS",Nov-19,798,782,16,2.0
26675,CN2007300000000,20,73,"Greenwood County, KS",Nov-19,3352,3262,90,2.7
26676,CN2007500000000,20,75,"Hamilton County, KS",Nov-19,1673,1645,28,1.7
26677,CN2007700000000,20,77,"Harper County, KS",Nov-19,2862,2790,72,2.5
26678,CN2007900000000,20,79,"Harvey County, KS",Nov-19,17096,16628,468,2.7
26679,CN2008100000000,20,81,"Haskell County, KS",Nov-19,2218,2176,42,1.9
26680,CN2008300000000,20,83,"Hodgeman County, KS",Nov-19,1027,1002,25,2.4
26681,CN2008500000000,20,85,"Jackson County, KS",Nov-19,7123,6949,174,2.4
26682,CN2008700000000,20,87,"Jefferson County, KS",Nov-19,10060,9782,278,2.8
26683,CN2008900000000,20,89,"Jewell County, KS",Nov-19,1282,1247,35,2.7
26684,CN2009100000000,20,91,"Johnson County, KS",Nov-19,341329,332762,8567,2.5
26685,CN2009300000000,20,93,"Kearny County, KS",Nov-19,2095,2051,44,2.1
26686,CN2009500000000,20,95,"Kingman County, KS",Nov-19,3477,3373,104,3.0
26687,CN2009700000000,20,97,"Kiowa County, KS",Nov-19,1339,1311,28,2.1
26688,CN2009900000000,20,99,"Labette County, KS",Nov-19,9974,9622,352,3.5
26689,CN2010100000000,20,101,"Lane County, KS",Nov-19,796,777,19,2.4
26690,CN2010300000000,20,103,"Leavenworth County, KS",Nov-19,36715,35589,1126,3.1
26691,CN2010500000000,20,105,"Lincoln County, KS",Nov-19,1763,1733,30,1.7
26692,CN2010700000000,20,107,"Linn County, KS",Nov-19,4459,4232,227,5.1
26693,CN2010900000000,20,109,"Logan County, KS",Nov-19,1661,1633,28,1.7
26694,CN2011100000000,20,111,"Lyon County, KS",Nov-19,16768,16268,500,3.0
26695,CN2011300000000,20,113,"McPherson County, KS",Nov-19,17171,16823,348,2.0
26696,CN2011500000000,20,115,"Marion County, KS",Nov-19,6085,5920,165,2.7
26697,CN2011700000000,20,117,"Marshall County, KS",Nov-19,5537,5405,132,2.4
26698,CN2011900000000,20,119,"Meade County, KS",Nov-19,2149,2103,46,2.1
26699,CN2012100000000,20,121,"Miami County, KS",Nov-19,17575,17075,500,2.8
26700,CN2012300000000,20,123,"Mitchell County, KS",Nov-19,3297,3228,69,2.1
26701,CN2012500000000,20,125,"Montgomery County, KS",Nov-19,14809,14207,602,4.1
26702,CN2012700000000,20,127,"Morris County, KS",Nov-19,3064,2974,90,2.9
26703,CN2012900000000,20,129,"Morton County, KS",Nov-19,1168,1140,28,2.4
26704,CN2013100000000,20,131,"Nemaha County, KS",Nov-19,5406,5263,143,2.6
26705,CN2013300000000,20,133,"Neosho County, KS",Nov-19,6210,5944,266,4.3
26706,CN2013500000000,20,135,"Ness County, KS",Nov-19,1361,1328,33,2.4
26707,CN2013700000000,20,137,"Norton County, KS",Nov-19,2717,2666,51,1.9
26708,CN2013900000000,20,139,"Osage County, KS",Nov-19,7947,7688,259,3.3
26709,CN2014100000000,20,141,"Osborne County, KS",Nov-19,2100,2063,37,1.8
26710,CN2014300000000,20,143,"Ottawa County, KS",Nov-19,3037,2961,76,2.5
26711,CN2014500000000,20,145,"Pawnee County, KS",Nov-19,2895,2821,74,2.6
26712,CN2014700000000,20,147,"Phillips County, KS",Nov-19,2656,2593,63,2.4
26713,CN2014900000000,20,149,"Pottawatomie County, KS",Nov-19,12840,12530,310,2.4
26714,CN2015100000000,20,151,"Pratt County, KS",Nov-19,4964,4853,111,2.2
26715,CN2015300000000,20,153,"Rawlins County, KS",Nov-19,1532,1499,33,2.2
26716,CN2015500000000,20,155,"Reno County, KS",Nov-19,29738,28860,878,3.0
26717,CN2015700000000,20,157,"Republic County, KS",Nov-19,2304,2246,58,2.5
26718,CN2015900000000,20,159,"Rice County, KS",Nov-19,5195,5065,130,2.5
26719,CN2016100000000,20,161,"Riley County, KS",Nov-19,36289,35370,919,2.5
26720,CN2016300000000,20,163,"Rooks County, KS",Nov-19,2583,2509,74,2.9
26721,CN2016500000000,20,165,"Rush County, KS",Nov-19,1641,1604,37,2.3
26722,CN2016700000000,20,167,"Russell County, KS",Nov-19,3294,3208,86,2.6
26723,CN2016900000000,20,169,"Saline County, KS",Nov-19,30212,29380,832,2.8
26724,CN2017100000000,20,171,"Scott County, KS",Nov-19,2897,2848,49,1.7
26725,CN2017300000000,20,173,"Sedgwick County, KS",Nov-19,252101,244039,8062,3.2
26726,CN2017500000000,20,175,"Seward County, KS",Nov-19,9458,9190,268,2.8
26727,CN2017700000000,20,177,"Shawnee County, KS",Nov-19,89887,87094,2793,3.1
26728,CN2017900000000,20,179,"Sheridan County, KS",Nov-19,1437,1407,30,2.1
26729,CN2018100000000,20,181,"Sherman County, KS",Nov-19,2835,2754,81,2.9
26730,CN2018300000000,20,183,"Smith County, KS",Nov-19,1995,1949,46,2.3
26731,CN2018500000000,20,185,"Stafford County, KS",Nov-19,2088,2032,56,2.7
26732,CN2018700000000,20,187,"Stanton County, KS",Nov-19,1005,980,25,2.5
26733,CN2018900000000,20,189,"Stevens County, KS",Nov-19,2576,2511,65,2.5
26734,CN2019100000000,20,191,"Sumner County, KS",Nov-19,10962,10638,324,3.0
26735,CN2019300000000,20,193,"Thomas County, KS",Nov-19,4363,4271,92,2.1
26736,CN2019500000000,20,195,"Trego County, KS",Nov-19,1457,1420,37,2.5
26737,CN2019700000000,20,197,"Wabaunsee County, KS",Nov-19,3654,3543,111,3.0
26738,CN2019900000000,20,199,"Wallace County, KS",Nov-19,815,794,21,2.6
26739,CN2020100000000,20,201,"Washington County, KS",Nov-19,2966,2910,56,1.9
26740,CN2020300000000,20,203,"Wichita County, KS",Nov-19,1251,1225,26,2.1
26741,CN2020500000000,20,205,"Wilson County, KS",Nov-19,3999,3846,153,3.8
26742,CN2020700000000,20,207,"Woodson County, KS",Nov-19,1576,1516,60,3.8
26743,CN2020900000000,20,209,"Wyandotte County, KS",Nov-19,77574,74665,2909,3.7
26744,CN2100100000000,21,1,"Adair County, KY",Nov-19,7174,6834,340,4.7
26745,CN2100300000000,21,3,"Allen County, KY",Nov-19,9175,8848,327,3.6
26746,CN2100500000000,21,5,"Anderson County, KY",Nov-19,12415,11994,421,3.4
26747,CN2100700000000,21,7,"Ballard County, KY",Nov-19,3532,3369,163,4.6
26748,CN2100900000000,21,9,"Barren County, KY",Nov-19,18757,18016,741,4.0
26749,CN2101100000000,21,11,"Bath County, KY",Nov-19,4648,4401,247,5.3
26750,CN2101300000000,21,13,"Bell County, KY",Nov-19,8471,7923,548,6.5
26751,CN2101500000000,21,15,"Boone County, KY",Nov-19,71447,69247,2200,3.1
26752,CN2101700000000,21,17,"Bourbon County, KY",Nov-19,9980,9639,341,3.4
26753,CN2101900000000,21,19,"Boyd County, KY",Nov-19,17835,16957,878,4.9
26754,CN2102100000000,21,21,"Boyle County, KY",Nov-19,12464,11960,504,4.0
26755,CN2102300000000,21,23,"Bracken County, KY",Nov-19,3819,3671,148,3.9
26756,CN2102500000000,21,25,"Breathitt County, KY",Nov-19,3427,3175,252,7.4
26757,CN2102700000000,21,27,"Breckinridge County, KY",Nov-19,7877,7508,369,4.7
26758,CN2102900000000,21,29,"Bullitt County, KY",Nov-19,43042,41498,1544,3.6
26759,CN2103100000000,21,31,"Butler County, KY",Nov-19,5157,4938,219,4.2
26760,CN2103300000000,21,33,"Caldwell County, KY",Nov-19,5510,5271,239,4.3
26761,CN2103500000000,21,35,"Calloway County, KY",Nov-19,18668,17992,676,3.6
26762,CN2103700000000,21,37,"Campbell County, KY",Nov-19,51055,49469,1586,3.1
26763,CN2103900000000,21,39,"Carlisle County, KY",Nov-19,2281,2196,85,3.7
26764,CN2104100000000,21,41,"Carroll County, KY",Nov-19,5396,5222,174,3.2
26765,CN2104300000000,21,43,"Carter County, KY",Nov-19,9732,9106,626,6.4
26766,CN2104500000000,21,45,"Casey County, KY",Nov-19,6697,6458,239,3.6
26767,CN2104700000000,21,47,"Christian County, KY",Nov-19,25284,24057,1227,4.9
26768,CN2104900000000,21,49,"Clark County, KY",Nov-19,17338,16746,592,3.4
26769,CN2105100000000,21,51,"Clay County, KY",Nov-19,5203,4863,340,6.5
26770,CN2105300000000,21,53,"Clinton County, KY",Nov-19,3961,3764,197,5.0
26771,CN2105500000000,21,55,"Crittenden County, KY",Nov-19,3816,3673,143,3.7
26772,CN2105700000000,21,57,"Cumberland County, KY",Nov-19,3181,3072,109,3.4
26773,CN2105900000000,21,59,"Daviess County, KY",Nov-19,47437,45857,1580,3.3
26774,CN2106100000000,21,61,"Edmonson County, KY",Nov-19,4874,4676,198,4.1
26775,CN2106300000000,21,63,"Elliott County, KY",Nov-19,2045,1899,146,7.1
26776,CN2106500000000,21,65,"Estill County, KY",Nov-19,5467,5213,254,4.6
26777,CN2106700000000,21,67,"Fayette County, KY",Nov-19,177029,171926,5103,2.9
26778,CN2106900000000,21,69,"Fleming County, KY",Nov-19,6129,5849,280,4.6
26779,CN2107100000000,21,71,"Floyd County, KY",Nov-19,11070,10399,671,6.1
26780,CN2107300000000,21,73,"Franklin County, KY",Nov-19,25934,25115,819,3.2
26781,CN2107500000000,21,75,"Fulton County, KY",Nov-19,2068,1972,96,4.6
26782,CN2107700000000,21,77,"Gallatin County, KY",Nov-19,4112,3971,141,3.4
26783,CN2107900000000,21,79,"Garrard County, KY",Nov-19,7736,7422,314,4.1
26784,CN2108100000000,21,81,"Grant County, KY",Nov-19,11774,11355,419,3.6
26785,CN2108300000000,21,83,"Graves County, KY",Nov-19,15896,15256,640,4.0
26786,CN2108500000000,21,85,"Grayson County, KY",Nov-19,11079,10603,476,4.3
26787,CN2108700000000,21,87,"Green County, KY",Nov-19,5209,5009,200,3.8
26788,CN2108900000000,21,89,"Greenup County, KY",Nov-19,13399,12637,762,5.7
26789,CN2109100000000,21,91,"Hancock County, KY",Nov-19,3987,3854,133,3.3
26790,CN2109300000000,21,93,"Hardin County, KY",Nov-19,48942,47161,1781,3.6
26791,CN2109500000000,21,95,"Harlan County, KY",Nov-19,6658,5927,731,11.0
26792,CN2109700000000,21,97,"Harrison County, KY",Nov-19,8901,8573,328,3.7
26793,CN2109900000000,21,99,"Hart County, KY",Nov-19,7921,7471,450,5.7
26794,CN2110100000000,21,101,"Henderson County, KY",Nov-19,22204,21403,801,3.6
26795,CN2110300000000,21,103,"Henry County, KY",Nov-19,8281,8029,252,3.0
26796,CN2110500000000,21,105,"Hickman County, KY",Nov-19,1773,1692,81,4.6
26797,CN2110700000000,21,107,"Hopkins County, KY",Nov-19,18521,17801,720,3.9
26798,CN2110900000000,21,109,"Jackson County, KY",Nov-19,4174,3930,244,5.8
26799,CN2111100000000,21,111,"Jefferson County, KY",Nov-19,401806,387931,13875,3.5
26800,CN2111300000000,21,113,"Jessamine County, KY",Nov-19,26776,25933,843,3.1
26801,CN2111500000000,21,115,"Johnson County, KY",Nov-19,6765,6362,403,6.0
26802,CN2111700000000,21,117,"Kenton County, KY",Nov-19,88393,85539,2854,3.2
26803,CN2111900000000,21,119,"Knott County, KY",Nov-19,4512,4215,297,6.6
26804,CN2112100000000,21,121,"Knox County, KY",Nov-19,9992,9451,541,5.4
26805,CN2112300000000,21,123,"Larue County, KY",Nov-19,5940,5711,229,3.9
26806,CN2112500000000,21,125,"Laurel County, KY",Nov-19,24793,23732,1061,4.3
26807,CN2112700000000,21,127,"Lawrence County, KY",Nov-19,5289,4956,333,6.3
26808,CN2112900000000,21,129,"Lee County, KY",Nov-19,2039,1935,104,5.1
26809,CN2113100000000,21,131,"Leslie County, KY",Nov-19,2750,2493,257,9.3
26810,CN2113300000000,21,133,"Letcher County, KY",Nov-19,6469,5947,522,8.1
26811,CN2113500000000,21,135,"Lewis County, KY",Nov-19,4624,4247,377,8.2
26812,CN2113700000000,21,137,"Lincoln County, KY",Nov-19,9243,8858,385,4.2
26813,CN2113900000000,21,139,"Livingston County, KY",Nov-19,3675,3512,163,4.4
26814,CN2114100000000,21,141,"Logan County, KY",Nov-19,12655,12180,475,3.8
26815,CN2114300000000,21,143,"Lyon County, KY",Nov-19,3018,2898,120,4.0
26816,CN2114500000000,21,145,"McCracken County, KY",Nov-19,29394,28169,1225,4.2
26817,CN2114700000000,21,147,"McCreary County, KY",Nov-19,4689,4437,252,5.4
26818,CN2114900000000,21,149,"McLean County, KY",Nov-19,4240,4074,166,3.9
26819,CN2115100000000,21,151,"Madison County, KY",Nov-19,48517,46907,1610,3.3
26820,CN2115300000000,21,153,"Magoffin County, KY",Nov-19,3258,2900,358,11.0
26821,CN2115500000000,21,155,"Marion County, KY",Nov-19,9691,9374,317,3.3
26822,CN2115700000000,21,157,"Marshall County, KY",Nov-19,15107,14535,572,3.8
26823,CN2115900000000,21,159,"Martin County, KY",Nov-19,2739,2554,185,6.8
26824,CN2116100000000,21,161,"Mason County, KY",Nov-19,7105,6751,354,5.0
26825,CN2116300000000,21,163,"Meade County, KY",Nov-19,12276,11762,514,4.2
26826,CN2116500000000,21,165,"Menifee County, KY",Nov-19,2319,2194,125,5.4
26827,CN2116700000000,21,167,"Mercer County, KY",Nov-19,10075,9635,440,4.4
26828,CN2116900000000,21,169,"Metcalfe County, KY",Nov-19,4122,3919,203,4.9
26829,CN2117100000000,21,171,"Monroe County, KY",Nov-19,4743,4590,153,3.2
26830,CN2117300000000,21,173,"Montgomery County, KY",Nov-19,11743,11216,527,4.5
26831,CN2117500000000,21,175,"Morgan County, KY",Nov-19,4584,4373,211,4.6
26832,CN2117700000000,21,177,"Muhlenberg County, KY",Nov-19,10395,9805,590,5.7
26833,CN2117900000000,21,179,"Nelson County, KY",Nov-19,23293,22425,868,3.7
26834,CN2118100000000,21,181,"Nicholas County, KY",Nov-19,3348,3211,137,4.1
26835,CN2118300000000,21,183,"Ohio County, KY",Nov-19,9781,9337,444,4.5
26836,CN2118500000000,21,185,"Oldham County, KY",Nov-19,33503,32552,951,2.8
26837,CN2118700000000,21,187,"Owen County, KY",Nov-19,5126,4942,184,3.6
26838,CN2118900000000,21,189,"Owsley County, KY",Nov-19,1127,1057,70,6.2
26839,CN2119100000000,21,191,"Pendleton County, KY",Nov-19,6991,6772,219,3.1
26840,CN2119300000000,21,193,"Perry County, KY",Nov-19,8344,7824,520,6.2
26841,CN2119500000000,21,195,"Pike County, KY",Nov-19,20281,19153,1128,5.6
26842,CN2119700000000,21,197,"Powell County, KY",Nov-19,5061,4816,245,4.8
26843,CN2119900000000,21,199,"Pulaski County, KY",Nov-19,26954,25818,1136,4.2
26844,CN2120100000000,21,201,"Robertson County, KY",Nov-19,845,801,44,5.2
26845,CN2120300000000,21,203,"Rockcastle County, KY",Nov-19,6838,6560,278,4.1
26846,CN2120500000000,21,205,"Rowan County, KY",Nov-19,10578,10064,514,4.9
26847,CN2120700000000,21,207,"Russell County, KY",Nov-19,6207,5885,322,5.2
26848,CN2120900000000,21,209,"Scott County, KY",Nov-19,29517,28584,933,3.2
26849,CN2121100000000,21,211,"Shelby County, KY",Nov-19,25683,24945,738,2.9
26850,CN2121300000000,21,213,"Simpson County, KY",Nov-19,8949,8570,379,4.2
26851,CN2121500000000,21,215,"Spencer County, KY",Nov-19,10264,9942,322,3.1
26852,CN2121700000000,21,217,"Taylor County, KY",Nov-19,13288,12815,473,3.6
26853,CN2121900000000,21,219,"Todd County, KY",Nov-19,5537,5332,205,3.7
26854,CN2122100000000,21,221,"Trigg County, KY",Nov-19,6081,5850,231,3.8
26855,CN2122300000000,21,223,"Trimble County, KY",Nov-19,3907,3757,150,3.8
26856,CN2122500000000,21,225,"Union County, KY",Nov-19,6214,5954,260,4.2
26857,CN2122700000000,21,227,"Warren County, KY",Nov-19,66082,63870,2212,3.3
26858,CN2122900000000,21,229,"Washington County, KY",Nov-19,6322,6107,215,3.4
26859,CN2123100000000,21,231,"Wayne County, KY",Nov-19,7480,7109,371,5.0
26860,CN2123300000000,21,233,"Webster County, KY",Nov-19,5693,5478,215,3.8
26861,CN2123500000000,21,235,"Whitley County, KY",Nov-19,13854,13188,666,4.8
26862,CN2123700000000,21,237,"Wolfe County, KY",Nov-19,1988,1863,125,6.3
26863,CN2123900000000,21,239,"Woodford County, KY",Nov-19,15203,14745,458,3.0
26864,CN2200100000000,22,1,"Acadia Parish, LA",Nov-19,23813,22505,1308,5.5
26865,CN2200300000000,22,3,"Allen Parish, LA",Nov-19,8948,8424,524,5.9
26866,CN2200500000000,22,5,"Ascension Parish, LA",Nov-19,64467,61697,2770,4.3
26867,CN2200700000000,22,7,"Assumption Parish, LA",Nov-19,8909,8369,540,6.1
26868,CN2200900000000,22,9,"Avoyelles Parish, LA",Nov-19,15037,14120,917,6.1
26869,CN2201100000000,22,11,"Beauregard Parish, LA",Nov-19,14784,14008,776,5.2
26870,CN2201300000000,22,13,"Bienville Parish, LA",Nov-19,5497,5158,339,6.2
26871,CN2201500000000,22,15,"Bossier Parish, LA",Nov-19,57966,55358,2608,4.5
26872,CN2201700000000,22,17,"Caddo Parish, LA",Nov-19,104107,98300,5807,5.6
26873,CN2201900000000,22,19,"Calcasieu Parish, LA",Nov-19,105412,100846,4566,4.3
26874,CN2202100000000,22,21,"Caldwell Parish, LA",Nov-19,3777,3509,268,7.1
26875,CN2202300000000,22,23,"Cameron Parish, LA",Nov-19,3896,3748,148,3.8
26876,CN2202500000000,22,25,"Catahoula Parish, LA",Nov-19,3367,3153,214,6.4
26877,CN2202700000000,22,27,"Claiborne Parish, LA",Nov-19,5884,5482,402,6.8
26878,CN2202900000000,22,29,"Concordia Parish, LA",Nov-19,7108,6654,454,6.4
26879,CN2203100000000,22,31,"De Soto Parish, LA",Nov-19,10930,10228,702,6.4
26880,CN2203300000000,22,33,"East Baton Rouge Parish, LA",Nov-19,232303,221726,10577,4.6
26881,CN2203500000000,22,35,"East Carroll Parish, LA",Nov-19,1875,1671,204,10.9
26882,CN2203700000000,22,37,"East Feliciana Parish, LA",Nov-19,8006,7633,373,4.7
26883,CN2203900000000,22,39,"Evangeline Parish, LA",Nov-19,11842,11116,726,6.1
26884,CN2204100000000,22,41,"Franklin Parish, LA",Nov-19,7285,6764,521,7.2
26885,CN2204300000000,22,43,"Grant Parish, LA",Nov-19,8206,7691,515,6.3
26886,CN2204500000000,22,45,"Iberia Parish, LA",Nov-19,28098,26502,1596,5.7
26887,CN2204700000000,22,47,"Iberville Parish, LA",Nov-19,14121,13251,870,6.2
26888,CN2204900000000,22,49,"Jackson Parish, LA",Nov-19,6853,6516,337,4.9
26889,CN2205100000000,22,51,"Jefferson Parish, LA",Nov-19,216130,207079,9051,4.2
26890,CN2205300000000,22,53,"Jefferson Davis Parish, LA",Nov-19,13250,12602,648,4.9
26891,CN2205500000000,22,55,"Lafayette Parish, LA",Nov-19,114106,108971,5135,4.5
26892,CN2205700000000,22,57,"Lafourche Parish, LA",Nov-19,42270,40373,1897,4.5
26893,CN2205900000000,22,59,"LaSalle Parish, LA",Nov-19,6805,6508,297,4.4
26894,CN2206100000000,22,61,"Lincoln Parish, LA",Nov-19,22548,21327,1221,5.4
26895,CN2206300000000,22,63,"Livingston Parish, LA",Nov-19,69083,66219,2864,4.1
26896,CN2206500000000,22,65,"Madison Parish, LA",Nov-19,3465,3173,292,8.4
26897,CN2206700000000,22,67,"Morehouse Parish, LA",Nov-19,10042,9152,890,8.9
26898,CN2206900000000,22,69,"Natchitoches Parish, LA",Nov-19,16534,15543,991,6.0
26899,CN2207100000000,22,71,"Orleans Parish, LA",Nov-19,180866,171945,8921,4.9
26900,CN2207300000000,22,73,"Ouachita Parish, LA",Nov-19,70609,66679,3930,5.6
26901,CN2207500000000,22,75,"Plaquemines Parish, LA",Nov-19,10105,9658,447,4.4
26902,CN2207700000000,22,77,"Pointe Coupee Parish, LA",Nov-19,9838,9317,521,5.3
26903,CN2207900000000,22,79,"Rapides Parish, LA",Nov-19,55182,52323,2859,5.2
26904,CN2208100000000,22,81,"Red River Parish, LA",Nov-19,3714,3510,204,5.5
26905,CN2208300000000,22,83,"Richland Parish, LA",Nov-19,8145,7601,544,6.7
26906,CN2208500000000,22,85,"Sabine Parish, LA",Nov-19,9107,8606,501,5.5
26907,CN2208700000000,22,87,"St. Bernard Parish, LA",Nov-19,20039,19029,1010,5.0
26908,CN2208900000000,22,89,"St. Charles Parish, LA",Nov-19,25467,24320,1147,4.5
26909,CN2209100000000,22,91,"St. Helena Parish, LA",Nov-19,4285,4024,261,6.1
26910,CN2209300000000,22,93,"St. James Parish, LA",Nov-19,9335,8768,567,6.1
26911,CN2209500000000,22,95,"St. John the Baptist Parish, LA",Nov-19,19961,18776,1185,5.9
26912,CN2209700000000,22,97,"St. Landry Parish, LA",Nov-19,31977,29906,2071,6.5
26913,CN2209900000000,22,99,"St. Martin Parish, LA",Nov-19,22265,21091,1174,5.3
26914,CN2210100000000,22,101,"St. Mary Parish, LA",Nov-19,19975,18743,1232,6.2
26915,CN2210300000000,22,103,"St. Tammany Parish, LA",Nov-19,120597,115474,5123,4.2
26916,CN2210500000000,22,105,"Tangipahoa Parish, LA",Nov-19,55370,52297,3073,5.5
26917,CN2210700000000,22,107,"Tensas Parish, LA",Nov-19,1348,1226,122,9.1
26918,CN2210900000000,22,109,"Terrebonne Parish, LA",Nov-19,46605,44373,2232,4.8
26919,CN2211100000000,22,111,"Union Parish, LA",Nov-19,9100,8547,553,6.1
26920,CN2211300000000,22,113,"Vermilion Parish, LA",Nov-19,24029,22815,1214,5.1
26921,CN2211500000000,22,115,"Vernon Parish, LA",Nov-19,16038,15064,974,6.1
26922,CN2211700000000,22,117,"Washington Parish, LA",Nov-19,16793,15811,982,5.8
26923,CN2211900000000,22,119,"Webster Parish, LA",Nov-19,14593,13662,931,6.4
26924,CN2212100000000,22,121,"West Baton Rouge Parish, LA",Nov-19,13739,13119,620,4.5
26925,CN2212300000000,22,123,"West Carroll Parish, LA",Nov-19,3588,3188,400,11.1
26926,CN2212500000000,22,125,"West Feliciana Parish, LA",Nov-19,5410,5167,243,4.5
26927,CN2212700000000,22,127,"Winn Parish, LA",Nov-19,4822,4496,326,6.8
26928,CN2300100000000,23,1,"Androscoggin County, ME",Nov-19,55674,54140,1534,2.8
26929,CN2300300000000,23,3,"Aroostook County, ME",Nov-19,29922,28676,1246,4.2
26930,CN2300500000000,23,5,"Cumberland County, ME",Nov-19,164997,161219,3778,2.3
26931,CN2300700000000,23,7,"Franklin County, ME",Nov-19,14152,13657,495,3.5
26932,CN2300900000000,23,9,"Hancock County, ME",Nov-19,27747,26856,891,3.2
26933,CN2301100000000,23,11,"Kennebec County, ME",Nov-19,61717,60021,1696,2.7
26934,CN2301300000000,23,13,"Knox County, ME",Nov-19,19543,19009,534,2.7
26935,CN2301500000000,23,15,"Lincoln County, ME",Nov-19,16329,15872,457,2.8
26936,CN2301700000000,23,17,"Oxford County, ME",Nov-19,25679,24806,873,3.4
26937,CN2301900000000,23,19,"Penobscot County, ME",Nov-19,77726,75427,2299,3.0
26938,CN2302100000000,23,21,"Piscataquis County, ME",Nov-19,7175,6913,262,3.7
26939,CN2302300000000,23,23,"Sagadahoc County, ME",Nov-19,19304,18883,421,2.2
26940,CN2302500000000,23,25,"Somerset County, ME",Nov-19,22013,21094,919,4.2
26941,CN2302700000000,23,27,"Waldo County, ME",Nov-19,20441,19852,589,2.9
26942,CN2302900000000,23,29,"Washington County, ME",Nov-19,13857,13319,538,3.9
26943,CN2303100000000,23,31,"York County, ME",Nov-19,113383,110394,2989,2.6
26944,CN2400100000000,24,1,"Allegany County, MD",Nov-19,32409,30906,1503,4.6
26945,CN2400300000000,24,3,"Anne Arundel County, MD",Nov-19,318901,310287,8614,2.7
26946,CN2400500000000,24,5,"Baltimore County, MD",Nov-19,459033,443909,15124,3.3
26947,CN2400900000000,24,9,"Calvert County, MD",Nov-19,50909,49546,1363,2.7
26948,CN2401100000000,24,11,"Caroline County, MD",Nov-19,18013,17429,584,3.2
26949,CN2401300000000,24,13,"Carroll County, MD",Nov-19,96278,93853,2425,2.5
26950,CN2401500000000,24,15,"Cecil County, MD",Nov-19,53266,51425,1841,3.5
26951,CN2401700000000,24,17,"Charles County, MD",Nov-19,88828,85958,2870,3.2
26952,CN2401900000000,24,19,"Dorchester County, MD",Nov-19,15246,14605,641,4.2
26953,CN2402100000000,24,21,"Frederick County, MD",Nov-19,135685,131900,3785,2.8
26954,CN2402300000000,24,23,"Garrett County, MD",Nov-19,15078,14448,630,4.2
26955,CN2402500000000,24,25,"Harford County, MD",Nov-19,142173,138057,4116,2.9
26956,CN2402700000000,24,27,"Howard County, MD",Nov-19,189939,185399,4540,2.4
26957,CN2402900000000,24,29,"Kent County, MD",Nov-19,9654,9328,326,3.4
26958,CN2403100000000,24,31,"Montgomery County, MD",Nov-19,569674,554911,14763,2.6
26959,CN2403300000000,24,33,"Prince George's County, MD",Nov-19,518677,501124,17553,3.4
26960,CN2403500000000,24,35,"Queen Anne's County, MD",Nov-19,27847,27090,757,2.7
26961,CN2403700000000,24,37,"St. Mary's County, MD",Nov-19,57429,55816,1613,2.8
26962,CN2403900000000,24,39,"Somerset County, MD",Nov-19,8734,8256,478,5.5
26963,CN2404100000000,24,41,"Talbot County, MD",Nov-19,19320,18755,565,2.9
26964,CN2404300000000,24,43,"Washington County, MD",Nov-19,76577,74055,2522,3.3
26965,CN2404500000000,24,45,"Wicomico County, MD",Nov-19,50225,48031,2194,4.4
26966,CN2404700000000,24,47,"Worcester County, MD",Nov-19,25404,23255,2149,8.5
26967,CN2451000000000,24,510,"Baltimore city, MD",Nov-19,291299,277897,13402,4.6
26968,CN2500100000000,25,1,"Barnstable County, MA",Nov-19,110574,106945,3629,3.3
26969,CN2500300000000,25,3,"Berkshire County, MA",Nov-19,64189,62416,1773,2.8
26970,CN2500500000000,25,5,"Bristol County, MA",Nov-19,305287,296490,8797,2.9
26971,CN2500700000000,25,7,"Dukes County, MA",Nov-19,8563,8229,334,3.9
26972,CN2500900000000,25,9,"Essex County, MA",Nov-19,430547,420382,10165,2.4
26973,CN2501100000000,25,11,"Franklin County, MA",Nov-19,41480,40615,865,2.1
26974,CN2501300000000,25,13,"Hampden County, MA",Nov-19,231841,224473,7368,3.2
26975,CN2501500000000,25,15,"Hampshire County, MA",Nov-19,91756,89953,1803,2.0
26976,CN2501700000000,25,17,"Middlesex County, MA",Nov-19,932770,915739,17031,1.8
26977,CN2501900000000,25,19,"Nantucket County/town, MA",Nov-19,6688,6440,248,3.7
26978,CN2502100000000,25,21,"Norfolk County, MA",Nov-19,397748,389692,8056,2.0
26979,CN2502300000000,25,23,"Plymouth County, MA",Nov-19,287417,280603,6814,2.4
26980,CN2502500000000,25,25,"Suffolk County, MA",Nov-19,463731,453962,9769,2.1
26981,CN2502700000000,25,27,"Worcester County, MA",Nov-19,452930,441783,11147,2.5
26982,CN2600100000000,26,1,"Alcona County, MI",Nov-19,3791,3602,189,5.0
26983,CN2600300000000,26,3,"Alger County, MI",Nov-19,3030,2820,210,6.9
26984,CN2600500000000,26,5,"Allegan County, MI",Nov-19,61980,60513,1467,2.4
26985,CN2600700000000,26,7,"Alpena County, MI",Nov-19,13263,12813,450,3.4
26986,CN2600900000000,26,9,"Antrim County, MI",Nov-19,9813,9425,388,4.0
26987,CN2601100000000,26,11,"Arenac County, MI",Nov-19,5928,5629,299,5.0
26988,CN2601300000000,26,13,"Baraga County, MI",Nov-19,3177,3019,158,5.0
26989,CN2601500000000,26,15,"Barry County, MI",Nov-19,31527,30752,775,2.5
26990,CN2601700000000,26,17,"Bay County, MI",Nov-19,49855,48058,1797,3.6
26991,CN2601900000000,26,19,"Benzie County, MI",Nov-19,8724,8402,322,3.7
26992,CN2602100000000,26,21,"Berrien County, MI",Nov-19,72846,70581,2265,3.1
26993,CN2602300000000,26,23,"Branch County, MI",Nov-19,19388,18774,614,3.2
26994,CN2602500000000,26,25,"Calhoun County, MI",Nov-19,62723,60732,1991,3.2
26995,CN2602700000000,26,27,"Cass County, MI",Nov-19,24393,23603,790,3.2
26996,CN2602900000000,26,29,"Charlevoix County, MI",Nov-19,12184,11740,444,3.6
26997,CN2603100000000,26,31,"Cheboygan County, MI",Nov-19,9786,9076,710,7.3
26998,CN2603300000000,26,33,"Chippewa County, MI",Nov-19,15769,15035,734,4.7
26999,CN2603500000000,26,35,"Clare County, MI",Nov-19,11539,10994,545,4.7
27000,CN2603700000000,26,37,"Clinton County, MI",Nov-19,41710,40770,940,2.3
27001,CN2603900000000,26,39,"Crawford County, MI",Nov-19,5501,5226,275,5.0
27002,CN2604100000000,26,41,"Delta County, MI",Nov-19,16921,16214,707,4.2
27003,CN2604300000000,26,43,"Dickinson County, MI",Nov-19,12184,11755,429,3.5
27004,CN2604500000000,26,45,"Eaton County, MI",Nov-19,58086,56610,1476,2.5
27005,CN2604700000000,26,47,"Emmet County, MI",Nov-19,17036,16323,713,4.2
27006,CN2604900000000,26,49,"Genesee County, MI",Nov-19,183897,177003,6894,3.7
27007,CN2605100000000,26,51,"Gladwin County, MI",Nov-19,9746,9280,466,4.8
27008,CN2605300000000,26,53,"Gogebic County, MI",Nov-19,5914,5675,239,4.0
27009,CN2605500000000,26,55,"Grand Traverse County, MI",Nov-19,49225,47961,1264,2.6
27010,CN2605700000000,26,57,"Gratiot County, MI",Nov-19,18138,17556,582,3.2
27011,CN2605900000000,26,59,"Hillsdale County, MI",Nov-19,20428,19748,680,3.3
27012,CN2606100000000,26,61,"Houghton County, MI",Nov-19,16530,15946,584,3.5
27013,CN2606300000000,26,63,"Huron County, MI",Nov-19,15146,14697,449,3.0
27014,CN2606500000000,26,65,"Ingham County, MI",Nov-19,153357,149407,3950,2.6
27015,CN2606700000000,26,67,"Ionia County, MI",Nov-19,30360,29592,768,2.5
27016,CN2606900000000,26,69,"Iosco County, MI",Nov-19,10175,9697,478,4.7
27017,CN2607100000000,26,71,"Iron County, MI",Nov-19,5055,4865,190,3.8
27018,CN2607300000000,26,73,"Isabella County, MI",Nov-19,34737,33756,981,2.8
27019,CN2607500000000,26,75,"Jackson County, MI",Nov-19,74151,71956,2195,3.0
27020,CN2607700000000,26,77,"Kalamazoo County, MI",Nov-19,134891,131372,3519,2.6
27021,CN2607900000000,26,79,"Kalkaska County, MI",Nov-19,7816,7461,355,4.5
27022,CN2608100000000,26,81,"Kent County, MI",Nov-19,359449,351206,8243,2.3
27023,CN2608300000000,26,83,"Keweenaw County, MI",Nov-19,905,850,55,6.1
27024,CN2608500000000,26,85,"Lake County, MI",Nov-19,3824,3626,198,5.2
27025,CN2608700000000,26,87,"Lapeer County, MI",Nov-19,41036,39393,1643,4.0
27026,CN2608900000000,26,89,"Leelanau County, MI",Nov-19,10364,10090,274,2.6
27027,CN2609100000000,26,91,"Lenawee County, MI",Nov-19,46753,45380,1373,2.9
27028,CN2609300000000,26,93,"Livingston County, MI",Nov-19,104014,101199,2815,2.7
27029,CN2609500000000,26,95,"Luce County, MI",Nov-19,2257,2127,130,5.8
27030,CN2609700000000,26,97,"Mackinac County, MI",Nov-19,4221,3821,400,9.5
27031,CN2609900000000,26,99,"Macomb County, MI",Nov-19,449612,433993,15619,3.5
27032,CN2610100000000,26,101,"Manistee County, MI",Nov-19,10235,9792,443,4.3
27033,CN2610300000000,26,103,"Marquette County, MI",Nov-19,32953,31811,1142,3.5
27034,CN2610500000000,26,105,"Mason County, MI",Nov-19,13297,12731,566,4.3
27035,CN2610700000000,26,107,"Mecosta County, MI",Nov-19,18522,17900,622,3.4
27036,CN2610900000000,26,109,"Menominee County, MI",Nov-19,10939,10613,326,3.0
27037,CN2611100000000,26,111,"Midland County, MI",Nov-19,40076,38878,1198,3.0
27038,CN2611300000000,26,113,"Missaukee County, MI",Nov-19,6810,6580,230,3.4
27039,CN2611500000000,26,115,"Monroe County, MI",Nov-19,75770,73615,2155,2.8
27040,CN2611700000000,26,117,"Montcalm County, MI",Nov-19,28089,27259,830,3.0
27041,CN2611900000000,26,119,"Montmorency County, MI",Nov-19,2979,2733,246,8.3
27042,CN2612100000000,26,121,"Muskegon County, MI",Nov-19,77174,74406,2768,3.6
27043,CN2612300000000,26,123,"Newaygo County, MI",Nov-19,23281,22531,750,3.2
27044,CN2612500000000,26,125,"Oakland County, MI",Nov-19,679379,660200,19179,2.8
27045,CN2612700000000,26,127,"Oceana County, MI",Nov-19,11583,11070,513,4.4
27046,CN2612900000000,26,129,"Ogemaw County, MI",Nov-19,7842,7451,391,5.0
27047,CN2613100000000,26,131,"Ontonagon County, MI",Nov-19,2062,1937,125,6.1
27048,CN2613300000000,26,133,"Osceola County, MI",Nov-19,11217,10894,323,2.9
27049,CN2613500000000,26,135,"Oscoda County, MI",Nov-19,2976,2795,181,6.1
27050,CN2613700000000,26,137,"Otsego County, MI",Nov-19,11349,10873,476,4.2
27051,CN2613900000000,26,139,"Ottawa County, MI",Nov-19,160667,157205,3462,2.2
27052,CN2614100000000,26,141,"Presque Isle County, MI",Nov-19,4784,4509,275,5.7
27053,CN2614300000000,26,143,"Roscommon County, MI",Nov-19,7474,7046,428,5.7
27054,CN2614500000000,26,145,"Saginaw County, MI",Nov-19,86708,83397,3311,3.8
27055,CN2614700000000,26,147,"St. Clair County, MI",Nov-19,75789,72845,2944,3.9
27056,CN2614900000000,26,149,"St. Joseph County, MI",Nov-19,27653,26714,939,3.4
27057,CN2615100000000,26,151,"Sanilac County, MI",Nov-19,19280,18639,641,3.3
27058,CN2615300000000,26,153,"Schoolcraft County, MI",Nov-19,3268,3106,162,5.0
27059,CN2615500000000,26,155,"Shiawassee County, MI",Nov-19,33549,32527,1022,3.0
27060,CN2615700000000,26,157,"Tuscola County, MI",Nov-19,23727,22863,864,3.6
27061,CN2615900000000,26,159,"Van Buren County, MI",Nov-19,35100,33888,1212,3.5
27062,CN2616100000000,26,161,"Washtenaw County, MI",Nov-19,202006,197622,4384,2.2
27063,CN2616300000000,26,163,"Wayne County, MI",Nov-19,806697,772995,33702,4.2
27064,CN2616500000000,26,165,"Wexford County, MI",Nov-19,14718,14200,518,3.5
27065,CN2700100000000,27,1,"Aitkin County, MN",Nov-19,7284,6861,423,5.8
27066,CN2700300000000,27,3,"Anoka County, MN",Nov-19,200387,194997,5390,2.7
27067,CN2700500000000,27,5,"Becker County, MN",Nov-19,18834,18183,651,3.5
27068,CN2700700000000,27,7,"Beltrami County, MN",Nov-19,24835,23830,1005,4.0
27069,CN2700900000000,27,9,"Benton County, MN",Nov-19,22333,21593,740,3.3
27070,CN2701100000000,27,11,"Big Stone County, MN",Nov-19,2490,2406,84,3.4
27071,CN2701300000000,27,13,"Blue Earth County, MN",Nov-19,41894,41023,871,2.1
27072,CN2701500000000,27,15,"Brown County, MN",Nov-19,14398,13987,411,2.9
27073,CN2701700000000,27,17,"Carlton County, MN",Nov-19,18016,17283,733,4.1
27074,CN2701900000000,27,19,"Carver County, MN",Nov-19,59364,57975,1389,2.3
27075,CN2702100000000,27,21,"Cass County, MN",Nov-19,14205,13401,804,5.7
27076,CN2702300000000,27,23,"Chippewa County, MN",Nov-19,7015,6806,209,3.0
27077,CN2702500000000,27,25,"Chisago County, MN",Nov-19,30345,29371,974,3.2
27078,CN2702700000000,27,27,"Clay County, MN",Nov-19,36683,35867,816,2.2
27079,CN2702900000000,27,29,"Clearwater County, MN",Nov-19,4528,4223,305,6.7
27080,CN2703100000000,27,31,"Cook County, MN",Nov-19,3007,2877,130,4.3
27081,CN2703300000000,27,33,"Cottonwood County, MN",Nov-19,6050,5897,153,2.5
27082,CN2703500000000,27,35,"Crow Wing County, MN",Nov-19,32083,30689,1394,4.3
27083,CN2703700000000,27,37,"Dakota County, MN",Nov-19,245003,238851,6152,2.5
27084,CN2703900000000,27,39,"Dodge County, MN",Nov-19,11942,11622,320,2.7
27085,CN2704100000000,27,41,"Douglas County, MN",Nov-19,20924,20369,555,2.7
27086,CN2704300000000,27,43,"Faribault County, MN",Nov-19,7068,6781,287,4.1
27087,CN2704500000000,27,45,"Fillmore County, MN",Nov-19,11610,11320,290,2.5
27088,CN2704700000000,27,47,"Freeborn County, MN",Nov-19,16317,15798,519,3.2
27089,CN2704900000000,27,49,"Goodhue County, MN",Nov-19,27315,26639,676,2.5
27090,CN2705100000000,27,51,"Grant County, MN",Nov-19,3315,3199,116,3.5
27091,CN2705300000000,27,53,"Hennepin County, MN",Nov-19,717092,699188,17904,2.5
27092,CN2705500000000,27,55,"Houston County, MN",Nov-19,10556,10303,253,2.4
27093,CN2705700000000,27,57,"Hubbard County, MN",Nov-19,9890,9354,536,5.4
27094,CN2705900000000,27,59,"Isanti County, MN",Nov-19,21540,20812,728,3.4
27095,CN2706100000000,27,61,"Itasca County, MN",Nov-19,21871,20565,1306,6.0
27096,CN2706300000000,27,63,"Jackson County, MN",Nov-19,5737,5612,125,2.2
27097,CN2706500000000,27,65,"Kanabec County, MN",Nov-19,9163,8669,494,5.4
27098,CN2706700000000,27,67,"Kandiyohi County, MN",Nov-19,24419,23782,637,2.6
27099,CN2706900000000,27,69,"Kittson County, MN",Nov-19,2389,2323,66,2.8
27100,CN2707100000000,27,71,"Koochiching County, MN",Nov-19,5854,5451,403,6.9
27101,CN2707300000000,27,73,"Lac qui Parle County, MN",Nov-19,3624,3528,96,2.6
27102,CN2707500000000,27,75,"Lake County, MN",Nov-19,5421,5200,221,4.1
27103,CN2707700000000,27,77,"Lake of the Woods County, MN",Nov-19,2403,2280,123,5.1
27104,CN2707900000000,27,79,"Le Sueur County, MN",Nov-19,16281,15710,571,3.5
27105,CN2708100000000,27,81,"Lincoln County, MN",Nov-19,3294,3188,106,3.2
27106,CN2708300000000,27,83,"Lyon County, MN",Nov-19,14611,14254,357,2.4
27107,CN2708500000000,27,85,"McLeod County, MN",Nov-19,19312,18732,580,3.0
27108,CN2708700000000,27,87,"Mahnomen County, MN",Nov-19,2291,2178,113,4.9
27109,CN2708900000000,27,89,"Marshall County, MN",Nov-19,5469,5208,261,4.8
27110,CN2709100000000,27,91,"Martin County, MN",Nov-19,10045,9770,275,2.7
27111,CN2709300000000,27,93,"Meeker County, MN",Nov-19,13428,13013,415,3.1
27112,CN2709500000000,27,95,"Mille Lacs County, MN",Nov-19,13062,12457,605,4.6
27113,CN2709700000000,27,97,"Morrison County, MN",Nov-19,17635,16764,871,4.9
27114,CN2709900000000,27,99,"Mower County, MN",Nov-19,20541,20002,539,2.6
27115,CN2710100000000,27,101,"Murray County, MN",Nov-19,4801,4675,126,2.6
27116,CN2710300000000,27,103,"Nicollet County, MN",Nov-19,21622,21214,408,1.9
27117,CN2710500000000,27,105,"Nobles County, MN",Nov-19,11388,11096,292,2.6
27118,CN2710700000000,27,107,"Norman County, MN",Nov-19,3225,3109,116,3.6
27119,CN2710900000000,27,109,"Olmsted County, MN",Nov-19,89243,87337,1906,2.1
27120,CN2711100000000,27,111,"Otter Tail County, MN",Nov-19,31355,30249,1106,3.5
27121,CN2711300000000,27,113,"Pennington County, MN",Nov-19,8683,8405,278,3.2
27122,CN2711500000000,27,115,"Pine County, MN",Nov-19,15146,14465,681,4.5
27123,CN2711700000000,27,117,"Pipestone County, MN",Nov-19,4960,4842,118,2.4
27124,CN2711900000000,27,119,"Polk County, MN",Nov-19,16798,16306,492,2.9
27125,CN2712100000000,27,121,"Pope County, MN",Nov-19,6618,6434,184,2.8
27126,CN2712300000000,27,123,"Ramsey County, MN",Nov-19,293841,285973,7868,2.7
27127,CN2712500000000,27,125,"Red Lake County, MN",Nov-19,2226,2142,84,3.8
27128,CN2712700000000,27,127,"Redwood County, MN",Nov-19,7662,7434,228,3.0
27129,CN2712900000000,27,129,"Renville County, MN",Nov-19,8774,8484,290,3.3
27130,CN2713100000000,27,131,"Rice County, MN",Nov-19,37403,36505,898,2.4
27131,CN2713300000000,27,133,"Rock County, MN",Nov-19,5684,5568,116,2.0
27132,CN2713500000000,27,135,"Roseau County, MN",Nov-19,7821,7602,219,2.8
27133,CN2713700000000,27,137,"St. Louis County, MN",Nov-19,103145,99191,3954,3.8
27134,CN2713900000000,27,139,"Scott County, MN",Nov-19,84747,82689,2058,2.4
27135,CN2714100000000,27,141,"Sherburne County, MN",Nov-19,53064,51503,1561,2.9
27136,CN2714300000000,27,143,"Sibley County, MN",Nov-19,8658,8388,270,3.1
27137,CN2714500000000,27,145,"Stearns County, MN",Nov-19,91894,89509,2385,2.6
27138,CN2714700000000,27,147,"Steele County, MN",Nov-19,21535,20986,549,2.5
27139,CN2714900000000,27,149,"Stevens County, MN",Nov-19,5482,5359,123,2.2
27140,CN2715100000000,27,151,"Swift County, MN",Nov-19,5056,4798,258,5.1
27141,CN2715300000000,27,153,"Todd County, MN",Nov-19,13777,13199,578,4.2
27142,CN2715500000000,27,155,"Traverse County, MN",Nov-19,1765,1713,52,2.9
27143,CN2715700000000,27,157,"Wabasha County, MN",Nov-19,12471,12066,405,3.2
27144,CN2715900000000,27,159,"Wadena County, MN",Nov-19,6045,5726,319,5.3
27145,CN2716100000000,27,161,"Waseca County, MN",Nov-19,9062,8742,320,3.5
27146,CN2716300000000,27,163,"Washington County, MN",Nov-19,145306,141766,3540,2.4
27147,CN2716500000000,27,165,"Watonwan County, MN",Nov-19,6512,6284,228,3.5
27148,CN2716700000000,27,167,"Wilkin County, MN",Nov-19,3474,3395,79,2.3
27149,CN2716900000000,27,169,"Winona County, MN",Nov-19,29076,28343,733,2.5
27150,CN2717100000000,27,171,"Wright County, MN",Nov-19,76717,74543,2174,2.8
27151,CN2717300000000,27,173,"Yellow Medicine County, MN",Nov-19,5449,5296,153,2.8
27152,CN2800100000000,28,1,"Adams County, MS",Nov-19,11344,10592,752,6.6
27153,CN2800300000000,28,3,"Alcorn County, MS",Nov-19,15831,15106,725,4.6
27154,CN2800500000000,28,5,"Amite County, MS",Nov-19,4338,4046,292,6.7
27155,CN2800700000000,28,7,"Attala County, MS",Nov-19,6936,6521,415,6.0
27156,CN2800900000000,28,9,"Benton County, MS",Nov-19,3106,2916,190,6.1
27157,CN2801100000000,28,11,"Bolivar County, MS",Nov-19,11944,11135,809,6.8
27158,CN2801300000000,28,13,"Calhoun County, MS",Nov-19,5511,5199,312,5.7
27159,CN2801500000000,28,15,"Carroll County, MS",Nov-19,3447,3238,209,6.1
27160,CN2801700000000,28,17,"Chickasaw County, MS",Nov-19,6808,6447,361,5.3
27161,CN2801900000000,28,19,"Choctaw County, MS",Nov-19,3683,3488,195,5.3
27162,CN2802100000000,28,21,"Claiborne County, MS",Nov-19,2994,2699,295,9.9
27163,CN2802300000000,28,23,"Clarke County, MS",Nov-19,5817,5461,356,6.1
27164,CN2802500000000,28,25,"Clay County, MS",Nov-19,7776,7145,631,8.1
27165,CN2802700000000,28,27,"Coahoma County, MS",Nov-19,8176,7614,562,6.9
27166,CN2802900000000,28,29,"Copiah County, MS",Nov-19,11200,10524,676,6.0
27167,CN2803100000000,28,31,"Covington County, MS",Nov-19,8185,7811,374,4.6
27168,CN2803300000000,28,33,"DeSoto County, MS",Nov-19,92721,88857,3864,4.2
27169,CN2803500000000,28,35,"Forrest County, MS",Nov-19,33963,32389,1574,4.6
27170,CN2803700000000,28,37,"Franklin County, MS",Nov-19,2736,2546,190,6.9
27171,CN2803900000000,28,39,"George County, MS",Nov-19,8718,8125,593,6.8
27172,CN2804100000000,28,41,"Greene County, MS",Nov-19,4304,4001,303,7.0
27173,CN2804300000000,28,43,"Grenada County, MS",Nov-19,9301,8846,455,4.9
27174,CN2804500000000,28,45,"Hancock County, MS",Nov-19,18779,17772,1007,5.4
27175,CN2804700000000,28,47,"Harrison County, MS",Nov-19,87010,82660,4350,5.0
27176,CN2804900000000,28,49,"Hinds County, MS",Nov-19,107844,102520,5324,4.9
27177,CN2805100000000,28,51,"Holmes County, MS",Nov-19,5650,5123,527,9.3
27178,CN2805300000000,28,53,"Humphreys County, MS",Nov-19,2137,1928,209,9.8
27179,CN2805500000000,28,55,"Issaquena County, MS",Nov-19,363,330,33,9.1
27180,CN2805700000000,28,57,"Itawamba County, MS",Nov-19,10565,10092,473,4.5
27181,CN2805900000000,28,59,"Jackson County, MS",Nov-19,58926,55591,3335,5.7
27182,CN2806100000000,28,61,"Jasper County, MS",Nov-19,6124,5718,406,6.6
27183,CN2806300000000,28,63,"Jefferson County, MS",Nov-19,2006,1714,292,14.6
27184,CN2806500000000,28,65,"Jefferson Davis County, MS",Nov-19,4129,3875,254,6.2
27185,CN2806700000000,28,67,"Jones County, MS",Nov-19,26099,24734,1365,5.2
27186,CN2806900000000,28,69,"Kemper County, MS",Nov-19,3494,3196,298,8.5
27187,CN2807100000000,28,71,"Lafayette County, MS",Nov-19,29832,28634,1198,4.0
27188,CN2807300000000,28,73,"Lamar County, MS",Nov-19,31475,30244,1231,3.9
27189,CN2807500000000,28,75,"Lauderdale County, MS",Nov-19,30226,28601,1625,5.4
27190,CN2807700000000,28,77,"Lawrence County, MS",Nov-19,4573,4285,288,6.3
27191,CN2807900000000,28,79,"Leake County, MS",Nov-19,7771,7342,429,5.5
27192,CN2808100000000,28,81,"Lee County, MS",Nov-19,41562,39831,1731,4.2
27193,CN2808300000000,28,83,"Leflore County, MS",Nov-19,9958,9280,678,6.8
27194,CN2808500000000,28,85,"Lincoln County, MS",Nov-19,14600,13814,786,5.4
27195,CN2808700000000,28,87,"Lowndes County, MS",Nov-19,25772,24481,1291,5.0
27196,CN2808900000000,28,89,"Madison County, MS",Nov-19,53640,51446,2194,4.1
27197,CN2809100000000,28,91,"Marion County, MS",Nov-19,9932,9411,521,5.2
27198,CN2809300000000,28,93,"Marshall County, MS",Nov-19,14669,13853,816,5.6
27199,CN2809500000000,28,95,"Monroe County, MS",Nov-19,15684,14878,806,5.1
27200,CN2809700000000,28,97,"Montgomery County, MS",Nov-19,3875,3651,224,5.8
27201,CN2809900000000,28,99,"Neshoba County, MS",Nov-19,9980,9392,588,5.9
27202,CN2810100000000,28,101,"Newton County, MS",Nov-19,8838,8368,470,5.3
27203,CN2810300000000,28,103,"Noxubee County, MS",Nov-19,3719,3444,275,7.4
27204,CN2810500000000,28,105,"Oktibbeha County, MS",Nov-19,23173,21961,1212,5.2
27205,CN2810700000000,28,107,"Panola County, MS",Nov-19,12562,11791,771,6.1
27206,CN2810900000000,28,109,"Pearl River County, MS",Nov-19,23876,22679,1197,5.0
27207,CN2811100000000,28,111,"Perry County, MS",Nov-19,4349,4089,260,6.0
27208,CN2811300000000,28,113,"Pike County, MS",Nov-19,14389,13497,892,6.2
27209,CN2811500000000,28,115,"Pontotoc County, MS",Nov-19,14845,14207,638,4.3
27210,CN2811700000000,28,117,"Prentiss County, MS",Nov-19,11302,10779,523,4.6
27211,CN2811900000000,28,119,"Quitman County, MS",Nov-19,2287,2109,178,7.8
27212,CN2812100000000,28,121,"Rankin County, MS",Nov-19,76872,73943,2929,3.8
27213,CN2812300000000,28,123,"Scott County, MS",Nov-19,12461,11922,539,4.3
27214,CN2812500000000,28,125,"Sharkey County, MS",Nov-19,1572,1445,127,8.1
27215,CN2812700000000,28,127,"Simpson County, MS",Nov-19,10764,10248,516,4.8
27216,CN2812900000000,28,129,"Smith County, MS",Nov-19,6707,6354,353,5.3
27217,CN2813100000000,28,131,"Stone County, MS",Nov-19,6928,6501,427,6.2
27218,CN2813300000000,28,133,"Sunflower County, MS",Nov-19,7566,6874,692,9.1
27219,CN2813500000000,28,135,"Tallahatchie County, MS",Nov-19,5089,4824,265,5.2
27220,CN2813700000000,28,137,"Tate County, MS",Nov-19,12495,11814,681,5.5
27221,CN2813900000000,28,139,"Tippah County, MS",Nov-19,9394,8954,440,4.7
27222,CN2814100000000,28,141,"Tishomingo County, MS",Nov-19,8493,8056,437,5.1
27223,CN2814300000000,28,143,"Tunica County, MS",Nov-19,4452,4208,244,5.5
27224,CN2814500000000,28,145,"Union County, MS",Nov-19,14378,13783,595,4.1
27225,CN2814700000000,28,147,"Walthall County, MS",Nov-19,4850,4507,343,7.1
27226,CN2814900000000,28,149,"Warren County, MS",Nov-19,20310,19168,1142,5.6
27227,CN2815100000000,28,151,"Washington County, MS",Nov-19,16821,15614,1207,7.2
27228,CN2815300000000,28,153,"Wayne County, MS",Nov-19,7289,6841,448,6.1
27229,CN2815500000000,28,155,"Webster County, MS",Nov-19,3967,3758,209,5.3
27230,CN2815700000000,28,157,"Wilkinson County, MS",Nov-19,2825,2556,269,9.5
27231,CN2815900000000,28,159,"Winston County, MS",Nov-19,7391,6979,412,5.6
27232,CN2816100000000,28,161,"Yalobusha County, MS",Nov-19,5037,4783,254,5.0
27233,CN2816300000000,28,163,"Yazoo County, MS",Nov-19,9322,8773,549,5.9
27234,CN2900100000000,29,1,"Adair County, MO",Nov-19,10433,10105,328,3.1
27235,CN2900300000000,29,3,"Andrew County, MO",Nov-19,9764,9540,224,2.3
27236,CN2900500000000,29,5,"Atchison County, MO",Nov-19,2677,2596,81,3.0
27237,CN2900700000000,29,7,"Audrain County, MO",Nov-19,10678,10351,327,3.1
27238,CN2900900000000,29,9,"Barry County, MO",Nov-19,15536,14984,552,3.6
27239,CN2901100000000,29,11,"Barton County, MO",Nov-19,5193,5031,162,3.1
27240,CN2901300000000,29,13,"Bates County, MO",Nov-19,7887,7630,257,3.3
27241,CN2901500000000,29,15,"Benton County, MO",Nov-19,7210,6878,332,4.6
27242,CN2901700000000,29,17,"Bollinger County, MO",Nov-19,5525,5311,214,3.9
27243,CN2901900000000,29,19,"Boone County, MO",Nov-19,99976,97734,2242,2.2
27244,CN2902100000000,29,21,"Buchanan County, MO",Nov-19,44757,43534,1223,2.7
27245,CN2902300000000,29,23,"Butler County, MO",Nov-19,18002,17313,689,3.8
27246,CN2902500000000,29,25,"Caldwell County, MO",Nov-19,4381,4249,132,3.0
27247,CN2902700000000,29,27,"Callaway County, MO",Nov-19,21355,20778,577,2.7
27248,CN2902900000000,29,29,"Camden County, MO",Nov-19,18275,17406,869,4.8
27249,CN2903100000000,29,31,"Cape Girardeau County, MO",Nov-19,41300,40080,1220,3.0
27250,CN2903300000000,29,33,"Carroll County, MO",Nov-19,4741,4573,168,3.5
27251,CN2903500000000,29,35,"Carter County, MO",Nov-19,2514,2413,101,4.0
27252,CN2903700000000,29,37,"Cass County, MO",Nov-19,55217,53720,1497,2.7
27253,CN2903900000000,29,39,"Cedar County, MO",Nov-19,5770,5559,211,3.7
27254,CN2904100000000,29,41,"Chariton County, MO",Nov-19,3766,3659,107,2.8
27255,CN2904300000000,29,43,"Christian County, MO",Nov-19,45464,44270,1194,2.6
27256,CN2904500000000,29,45,"Clark County, MO",Nov-19,3199,3096,103,3.2
27257,CN2904700000000,29,47,"Clay County, MO",Nov-19,137536,133935,3601,2.6
27258,CN2904900000000,29,49,"Clinton County, MO",Nov-19,10746,10480,266,2.5
27259,CN2905100000000,29,51,"Cole County, MO",Nov-19,39092,38118,974,2.5
27260,CN2905300000000,29,53,"Cooper County, MO",Nov-19,7556,7318,238,3.1
27261,CN2905500000000,29,55,"Crawford County, MO",Nov-19,10985,10559,426,3.9
27262,CN2905700000000,29,57,"Dade County, MO",Nov-19,3553,3450,103,2.9
27263,CN2905900000000,29,59,"Dallas County, MO",Nov-19,7170,6807,363,5.1
27264,CN2906100000000,29,61,"Daviess County, MO",Nov-19,4098,3975,123,3.0
27265,CN2906300000000,29,63,"DeKalb County, MO",Nov-19,4814,4691,123,2.6
27266,CN2906500000000,29,65,"Dent County, MO",Nov-19,6301,6080,221,3.5
27267,CN2906700000000,29,67,"Douglas County, MO",Nov-19,5078,4834,244,4.8
27268,CN2906900000000,29,69,"Dunklin County, MO",Nov-19,11408,10867,541,4.7
27269,CN2907100000000,29,71,"Franklin County, MO",Nov-19,53505,51881,1624,3.0
27270,CN2907300000000,29,73,"Gasconade County, MO",Nov-19,7733,7493,240,3.1
27271,CN2907500000000,29,75,"Gentry County, MO",Nov-19,3464,3370,94,2.7
27272,CN2907700000000,29,77,"Greene County, MO",Nov-19,153203,149009,4194,2.7
27273,CN2907900000000,29,79,"Grundy County, MO",Nov-19,4417,4252,165,3.7
27274,CN2908100000000,29,81,"Harrison County, MO",Nov-19,3780,3672,108,2.9
27275,CN2908300000000,29,83,"Henry County, MO",Nov-19,9702,9378,324,3.3
27276,CN2908500000000,29,85,"Hickory County, MO",Nov-19,3806,3657,149,3.9
27277,CN2908700000000,29,87,"Holt County, MO",Nov-19,2545,2486,59,2.3
27278,CN2908900000000,29,89,"Howard County, MO",Nov-19,4928,4788,140,2.8
27279,CN2909100000000,29,91,"Howell County, MO",Nov-19,16755,16031,724,4.3
27280,CN2909300000000,29,93,"Iron County, MO",Nov-19,3499,3349,150,4.3
27281,CN2909500000000,29,95,"Jackson County, MO",Nov-19,365901,353495,12406,3.4
27282,CN2909700000000,29,97,"Jasper County, MO",Nov-19,57883,56188,1695,2.9
27283,CN2909900000000,29,99,"Jefferson County, MO",Nov-19,118964,115469,3495,2.9
27284,CN2910100000000,29,101,"Johnson County, MO",Nov-19,23430,22618,812,3.5
27285,CN2910300000000,29,103,"Knox County, MO",Nov-19,1764,1721,43,2.4
27286,CN2910500000000,29,105,"Laclede County, MO",Nov-19,17589,16017,1572,8.9
27287,CN2910700000000,29,107,"Lafayette County, MO",Nov-19,16908,16422,486,2.9
27288,CN2910900000000,29,109,"Lawrence County, MO",Nov-19,18122,17496,626,3.5
27289,CN2911100000000,29,111,"Lewis County, MO",Nov-19,4984,4838,146,2.9
27290,CN2911300000000,29,113,"Lincoln County, MO",Nov-19,28521,27673,848,3.0
27291,CN2911500000000,29,115,"Linn County, MO",Nov-19,5182,4951,231,4.5
27292,CN2911700000000,29,117,"Livingston County, MO",Nov-19,7283,7095,188,2.6
27293,CN2911900000000,29,119,"McDonald County, MO",Nov-19,10849,10489,360,3.3
27294,CN2912100000000,29,121,"Macon County, MO",Nov-19,7537,7314,223,3.0
27295,CN2912300000000,29,123,"Madison County, MO",Nov-19,5480,5301,179,3.3
27296,CN2912500000000,29,125,"Maries County, MO",Nov-19,3901,3771,130,3.3
27297,CN2912700000000,29,127,"Marion County, MO",Nov-19,14828,14393,435,2.9
27298,CN2912900000000,29,129,"Mercer County, MO",Nov-19,1859,1808,51,2.7
27299,CN2913100000000,29,131,"Miller County, MO",Nov-19,12291,11829,462,3.8
27300,CN2913300000000,29,133,"Mississippi County, MO",Nov-19,5760,5540,220,3.8
27301,CN2913500000000,29,135,"Moniteau County, MO",Nov-19,7269,7071,198,2.7
27302,CN2913700000000,29,137,"Monroe County, MO",Nov-19,3922,3763,159,4.1
27303,CN2913900000000,29,139,"Montgomery County, MO",Nov-19,5740,5582,158,2.8
27304,CN2914100000000,29,141,"Morgan County, MO",Nov-19,8045,7698,347,4.3
27305,CN2914300000000,29,143,"New Madrid County, MO",Nov-19,8211,7873,338,4.1
27306,CN2914500000000,29,145,"Newton County, MO",Nov-19,27597,26743,854,3.1
27307,CN2914700000000,29,147,"Nodaway County, MO",Nov-19,10983,10697,286,2.6
27308,CN2914900000000,29,149,"Oregon County, MO",Nov-19,4020,3870,150,3.7
27309,CN2915100000000,29,151,"Osage County, MO",Nov-19,7094,6931,163,2.3
27310,CN2915300000000,29,153,"Ozark County, MO",Nov-19,3365,3174,191,5.7
27311,CN2915500000000,29,155,"Pemiscot County, MO",Nov-19,6318,6033,285,4.5
27312,CN2915700000000,29,157,"Perry County, MO",Nov-19,10014,9748,266,2.7
27313,CN2915900000000,29,159,"Pettis County, MO",Nov-19,21276,20400,876,4.1
27314,CN2916100000000,29,161,"Phelps County, MO",Nov-19,19915,19289,626,3.1
27315,CN2916300000000,29,163,"Pike County, MO",Nov-19,7483,7227,256,3.4
27316,CN2916500000000,29,165,"Platte County, MO",Nov-19,59208,57757,1451,2.5
27317,CN2916700000000,29,167,"Polk County, MO",Nov-19,14665,14220,445,3.0
27318,CN2916900000000,29,169,"Pulaski County, MO",Nov-19,14780,14151,629,4.3
27319,CN2917100000000,29,171,"Putnam County, MO",Nov-19,2237,2172,65,2.9
27320,CN2917300000000,29,173,"Ralls County, MO",Nov-19,5745,5583,162,2.8
27321,CN2917500000000,29,175,"Randolph County, MO",Nov-19,10513,10117,396,3.8
27322,CN2917700000000,29,177,"Ray County, MO",Nov-19,11067,10720,347,3.1
27323,CN2917900000000,29,179,"Reynolds County, MO",Nov-19,2992,2882,110,3.7
27324,CN2918100000000,29,181,"Ripley County, MO",Nov-19,4990,4780,210,4.2
27325,CN2918300000000,29,183,"St. Charles County, MO",Nov-19,228381,222847,5534,2.4
27326,CN2918500000000,29,185,"St. Clair County, MO",Nov-19,3711,3566,145,3.9
27327,CN2918600000000,29,186,"Ste. Genevieve County, MO",Nov-19,9178,8938,240,2.6
27328,CN2918700000000,29,187,"St. Francois County, MO",Nov-19,26717,25766,951,3.6
27329,CN2918900000000,29,189,"St. Louis County, MO",Nov-19,536436,520839,15597,2.9
27330,CN2919500000000,29,195,"Saline County, MO",Nov-19,10595,10260,335,3.2
27331,CN2919700000000,29,197,"Schuyler County, MO",Nov-19,1943,1875,68,3.5
27332,CN2919900000000,29,199,"Scotland County, MO",Nov-19,2386,2325,61,2.6
27333,CN2920100000000,29,201,"Scott County, MO",Nov-19,19960,19274,686,3.4
27334,CN2920300000000,29,203,"Shannon County, MO",Nov-19,3197,3016,181,5.7
27335,CN2920500000000,29,205,"Shelby County, MO",Nov-19,3060,2983,77,2.5
27336,CN2920700000000,29,207,"Stoddard County, MO",Nov-19,13009,12481,528,4.1
27337,CN2920900000000,29,209,"Stone County, MO",Nov-19,13924,13379,545,3.9
27338,CN2921100000000,29,211,"Sullivan County, MO",Nov-19,2640,2558,82,3.1
27339,CN2921300000000,29,213,"Taney County, MO",Nov-19,27038,26112,926,3.4
27340,CN2921500000000,29,215,"Texas County, MO",Nov-19,9064,8671,393,4.3
27341,CN2921700000000,29,217,"Vernon County, MO",Nov-19,9407,9095,312,3.3
27342,CN2921900000000,29,219,"Warren County, MO",Nov-19,18056,17563,493,2.7
27343,CN2922100000000,29,221,"Washington County, MO",Nov-19,10236,9807,429,4.2
27344,CN2922300000000,29,223,"Wayne County, MO",Nov-19,5259,5044,215,4.1
27345,CN2922500000000,29,225,"Webster County, MO",Nov-19,17452,16828,624,3.6
27346,CN2922700000000,29,227,"Worth County, MO",Nov-19,1166,1139,27,2.3
27347,CN2922900000000,29,229,"Wright County, MO",Nov-19,7565,7147,418,5.5
27348,CN2951000000000,29,510,"St. Louis city, MO",Nov-19,153834,148255,5579,3.6
27349,CN3000100000000,30,1,"Beaverhead County, MT",Nov-19,5080,4925,155,3.1
27350,CN3000300000000,30,3,"Big Horn County, MT",Nov-19,4833,4512,321,6.6
27351,CN3000500000000,30,5,"Blaine County, MT",Nov-19,2540,2450,90,3.5
27352,CN3000700000000,30,7,"Broadwater County, MT",Nov-19,2599,2494,105,4.0
27353,CN3000900000000,30,9,"Carbon County, MT",Nov-19,5520,5329,191,3.5
27354,CN3001100000000,30,11,"Carter County, MT",Nov-19,681,667,14,2.1
27355,CN3001300000000,30,13,"Cascade County, MT",Nov-19,38082,36867,1215,3.2
27356,CN3001500000000,30,15,"Chouteau County, MT",Nov-19,2526,2465,61,2.4
27357,CN3001700000000,30,17,"Custer County, MT",Nov-19,6149,5987,162,2.6
27358,CN3001900000000,30,19,"Daniels County, MT",Nov-19,912,892,20,2.2
27359,CN3002100000000,30,21,"Dawson County, MT",Nov-19,4600,4483,117,2.5
27360,CN3002300000000,30,23,"Deer Lodge County, MT",Nov-19,4951,4804,147,3.0
27361,CN3002500000000,30,25,"Fallon County, MT",Nov-19,1718,1681,37,2.2
27362,CN3002700000000,30,27,"Fergus County, MT",Nov-19,6107,5931,176,2.9
27363,CN3002900000000,30,29,"Flathead County, MT",Nov-19,47350,45110,2240,4.7
27364,CN3003100000000,30,31,"Gallatin County, MT",Nov-19,69227,67352,1875,2.7
27365,CN3003300000000,30,33,"Garfield County, MT",Nov-19,750,732,18,2.4
27366,CN3003500000000,30,35,"Glacier County, MT",Nov-19,5531,5124,407,7.4
27367,CN3003700000000,30,37,"Golden Valley County, MT",Nov-19,372,356,16,4.3
27368,CN3003900000000,30,39,"Granite County, MT",Nov-19,1598,1501,97,6.1
27369,CN3004100000000,30,41,"Hill County, MT",Nov-19,7715,7445,270,3.5
27370,CN3004300000000,30,43,"Jefferson County, MT",Nov-19,5704,5516,188,3.3
27371,CN3004500000000,30,45,"Judith Basin County, MT",Nov-19,1023,996,27,2.6
27372,CN3004700000000,30,47,"Lake County, MT",Nov-19,13246,12717,529,4.0
27373,CN3004900000000,30,49,"Lewis and Clark County, MT",Nov-19,35722,34728,994,2.8
27374,CN3005100000000,30,51,"Liberty County, MT",Nov-19,986,958,28,2.8
27375,CN3005300000000,30,53,"Lincoln County, MT",Nov-19,8117,7544,573,7.1
27376,CN3005500000000,30,55,"McCone County, MT",Nov-19,971,953,18,1.9
27377,CN3005700000000,30,57,"Madison County, MT",Nov-19,4429,4241,188,4.2
27378,CN3005900000000,30,59,"Meagher County, MT",Nov-19,978,947,31,3.2
27379,CN3006100000000,30,61,"Mineral County, MT",Nov-19,1714,1624,90,5.3
27380,CN3006300000000,30,63,"Missoula County, MT",Nov-19,64012,62028,1984,3.1
27381,CN3006500000000,30,65,"Musselshell County, MT",Nov-19,2301,2211,90,3.9
27382,CN3006700000000,30,67,"Park County, MT",Nov-19,8811,8484,327,3.7
27383,CN3006900000000,30,69,"Petroleum County, MT",Nov-19,288,277,11,3.8
27384,CN3007100000000,30,71,"Phillips County, MT",Nov-19,1919,1855,64,3.3
27385,CN3007300000000,30,73,"Pondera County, MT",Nov-19,2671,2590,81,3.0
27386,CN3007500000000,30,75,"Powder River County, MT",Nov-19,1000,976,24,2.4
27387,CN3007700000000,30,77,"Powell County, MT",Nov-19,3037,2930,107,3.5
27388,CN3007900000000,30,79,"Prairie County, MT",Nov-19,495,478,17,3.4
27389,CN3008100000000,30,81,"Ravalli County, MT",Nov-19,20408,19677,731,3.6
27390,CN3008300000000,30,83,"Richland County, MT",Nov-19,5971,5827,144,2.4
27391,CN3008500000000,30,85,"Roosevelt County, MT",Nov-19,4505,4343,162,3.6
27392,CN3008700000000,30,87,"Rosebud County, MT",Nov-19,3848,3676,172,4.5
27393,CN3008900000000,30,89,"Sanders County, MT",Nov-19,4849,4616,233,4.8
27394,CN3009100000000,30,91,"Sheridan County, MT",Nov-19,1758,1718,40,2.3
27395,CN3009300000000,30,93,"Silver Bow County, MT",Nov-19,17202,16570,632,3.7
27396,CN3009500000000,30,95,"Stillwater County, MT",Nov-19,5352,5201,151,2.8
27397,CN3009700000000,30,97,"Sweet Grass County, MT",Nov-19,1837,1790,47,2.6
27398,CN3009900000000,30,99,"Teton County, MT",Nov-19,2779,2689,90,3.2
27399,CN3010100000000,30,101,"Toole County, MT",Nov-19,2115,2054,61,2.9
27400,CN3010300000000,30,103,"Treasure County, MT",Nov-19,348,341,7,2.0
27401,CN3010500000000,30,105,"Valley County, MT",Nov-19,4115,3977,138,3.4
27402,CN3010700000000,30,107,"Wheatland County, MT",Nov-19,819,791,28,3.4
27403,CN3010900000000,30,109,"Wibaux County, MT",Nov-19,461,447,14,3.0
27404,CN3011100000000,30,111,"Yellowstone County, MT",Nov-19,81685,79231,2454,3.0
27405,CN3100100000000,31,1,"Adams County, NE",Nov-19,16798,16351,447,2.7
27406,CN3100300000000,31,3,"Antelope County, NE",Nov-19,3604,3528,76,2.1
27407,CN3100500000000,31,5,"Arthur County, NE",Nov-19,234,220,14,6.0
27408,CN3100700000000,31,7,"Banner County, NE",Nov-19,393,377,16,4.1
27409,CN3100900000000,31,9,"Blaine County, NE",Nov-19,270,258,12,4.4
27410,CN3101100000000,31,11,"Boone County, NE",Nov-19,2990,2922,68,2.3
27411,CN3101300000000,31,13,"Box Butte County, NE",Nov-19,5402,5256,146,2.7
27412,CN3101500000000,31,15,"Boyd County, NE",Nov-19,1091,1065,26,2.4
27413,CN3101700000000,31,17,"Brown County, NE",Nov-19,1410,1368,42,3.0
27414,CN3101900000000,31,19,"Buffalo County, NE",Nov-19,27858,27216,642,2.3
27415,CN3102100000000,31,21,"Burt County, NE",Nov-19,3484,3378,106,3.0
27416,CN3102300000000,31,23,"Butler County, NE",Nov-19,4499,4389,110,2.4
27417,CN3102500000000,31,25,"Cass County, NE",Nov-19,13600,13237,363,2.7
27418,CN3102700000000,31,27,"Cedar County, NE",Nov-19,4512,4410,102,2.3
27419,CN3102900000000,31,29,"Chase County, NE",Nov-19,2304,2256,48,2.1
27420,CN3103100000000,31,31,"Cherry County, NE",Nov-19,3425,3361,64,1.9
27421,CN3103300000000,31,33,"Cheyenne County, NE",Nov-19,4358,4202,156,3.6
27422,CN3103500000000,31,35,"Clay County, NE",Nov-19,3308,3232,76,2.3
27423,CN3103700000000,31,37,"Colfax County, NE",Nov-19,5578,5436,142,2.5
27424,CN3103900000000,31,39,"Cuming County, NE",Nov-19,4676,4560,116,2.5
27425,CN3104100000000,31,41,"Custer County, NE",Nov-19,6435,6297,138,2.1
27426,CN3104300000000,31,43,"Dakota County, NE",Nov-19,10780,10433,347,3.2
27427,CN3104500000000,31,45,"Dawes County, NE",Nov-19,4972,4842,130,2.6
27428,CN3104700000000,31,47,"Dawson County, NE",Nov-19,13008,12691,317,2.4
27429,CN3104900000000,31,49,"Deuel County, NE",Nov-19,965,941,24,2.5
27430,CN3105100000000,31,51,"Dixon County, NE",Nov-19,3078,2996,82,2.7
27431,CN3105300000000,31,53,"Dodge County, NE",Nov-19,19524,19037,487,2.5
27432,CN3105500000000,31,55,"Douglas County, NE",Nov-19,299929,291619,8310,2.8
27433,CN3105700000000,31,57,"Dundy County, NE",Nov-19,1200,1170,30,2.5
27434,CN3105900000000,31,59,"Fillmore County, NE",Nov-19,3149,3087,62,2.0
27435,CN3106100000000,31,61,"Franklin County, NE",Nov-19,1456,1412,44,3.0
27436,CN3106300000000,31,63,"Frontier County, NE",Nov-19,1643,1599,44,2.7
27437,CN3106500000000,31,65,"Furnas County, NE",Nov-19,2572,2508,64,2.5
27438,CN3106700000000,31,67,"Gage County, NE",Nov-19,10912,10609,303,2.8
27439,CN3106900000000,31,69,"Garden County, NE",Nov-19,1096,1062,34,3.1
27440,CN3107100000000,31,71,"Garfield County, NE",Nov-19,1189,1161,28,2.4
27441,CN3107300000000,31,73,"Gosper County, NE",Nov-19,1111,1085,26,2.3
27442,CN3107500000000,31,75,"Grant County, NE",Nov-19,443,431,12,2.7
27443,CN3107700000000,31,77,"Greeley County, NE",Nov-19,1219,1191,28,2.3
27444,CN3107900000000,31,79,"Hall County, NE",Nov-19,31535,30655,880,2.8
27445,CN3108100000000,31,81,"Hamilton County, NE",Nov-19,4776,4646,130,2.7
27446,CN3108300000000,31,83,"Harlan County, NE",Nov-19,1781,1737,44,2.5
27447,CN3108500000000,31,85,"Hayes County, NE",Nov-19,648,630,18,2.8
27448,CN3108700000000,31,87,"Hitchcock County, NE",Nov-19,1252,1218,34,2.7
27449,CN3108900000000,31,89,"Holt County, NE",Nov-19,5825,5691,134,2.3
27450,CN3109100000000,31,91,"Hooker County, NE",Nov-19,441,429,12,2.7
27451,CN3109300000000,31,93,"Howard County, NE",Nov-19,3345,3257,88,2.6
27452,CN3109500000000,31,95,"Jefferson County, NE",Nov-19,4140,4048,92,2.2
27453,CN3109700000000,31,97,"Johnson County, NE",Nov-19,2052,1996,56,2.7
27454,CN3109900000000,31,99,"Kearney County, NE",Nov-19,3820,3744,76,2.0
27455,CN3110100000000,31,101,"Keith County, NE",Nov-19,4545,4401,144,3.2
27456,CN3110300000000,31,103,"Keya Paha County, NE",Nov-19,614,600,14,2.3
27457,CN3110500000000,31,105,"Kimball County, NE",Nov-19,2019,1965,54,2.7
27458,CN3110700000000,31,107,"Knox County, NE",Nov-19,4627,4521,106,2.3
27459,CN3110900000000,31,109,"Lancaster County, NE",Nov-19,178736,174345,4391,2.5
27460,CN3111100000000,31,111,"Lincoln County, NE",Nov-19,18267,17698,569,3.1
27461,CN3111300000000,31,113,"Logan County, NE",Nov-19,490,474,16,3.3
27462,CN3111500000000,31,115,"Loup County, NE",Nov-19,425,403,22,5.2
27463,CN3111700000000,31,117,"McPherson County, NE",Nov-19,451,441,10,2.2
27464,CN3111900000000,31,119,"Madison County, NE",Nov-19,19730,19265,465,2.4
27465,CN3112100000000,31,121,"Merrick County, NE",Nov-19,4006,3902,104,2.6
27466,CN3112300000000,31,123,"Morrill County, NE",Nov-19,2632,2558,74,2.8
27467,CN3112500000000,31,125,"Nance County, NE",Nov-19,1974,1924,50,2.5
27468,CN3112700000000,31,127,"Nemaha County, NE",Nov-19,3626,3518,108,3.0
27469,CN3112900000000,31,129,"Nuckolls County, NE",Nov-19,2428,2372,56,2.3
27470,CN3113100000000,31,131,"Otoe County, NE",Nov-19,8448,8245,203,2.4
27471,CN3113300000000,31,133,"Pawnee County, NE",Nov-19,1481,1447,34,2.3
27472,CN3113500000000,31,135,"Perkins County, NE",Nov-19,1844,1804,40,2.2
27473,CN3113700000000,31,137,"Phelps County, NE",Nov-19,5002,4884,118,2.4
27474,CN3113900000000,31,139,"Pierce County, NE",Nov-19,4096,4004,92,2.2
27475,CN3114100000000,31,141,"Platte County, NE",Nov-19,17652,17223,429,2.4
27476,CN3114300000000,31,143,"Polk County, NE",Nov-19,2972,2898,74,2.5
27477,CN3114500000000,31,145,"Red Willow County, NE",Nov-19,5871,5729,142,2.4
27478,CN3114700000000,31,147,"Richardson County, NE",Nov-19,4184,4080,104,2.5
27479,CN3114900000000,31,149,"Rock County, NE",Nov-19,897,877,20,2.2
27480,CN3115100000000,31,151,"Saline County, NE",Nov-19,7344,7143,201,2.7
27481,CN3115300000000,31,153,"Sarpy County, NE",Nov-19,96840,94360,2480,2.6
27482,CN3115500000000,31,155,"Saunders County, NE",Nov-19,11266,10989,277,2.5
27483,CN3115700000000,31,157,"Scotts Bluff County, NE",Nov-19,18330,17754,576,3.1
27484,CN3115900000000,31,159,"Seward County, NE",Nov-19,9081,8836,245,2.7
27485,CN3116100000000,31,161,"Sheridan County, NE",Nov-19,2701,2639,62,2.3
27486,CN3116300000000,31,163,"Sherman County, NE",Nov-19,1699,1653,46,2.7
27487,CN3116500000000,31,165,"Sioux County, NE",Nov-19,751,729,22,2.9
27488,CN3116700000000,31,167,"Stanton County, NE",Nov-19,3515,3441,74,2.1
27489,CN3116900000000,31,169,"Thayer County, NE",Nov-19,2762,2696,66,2.4
27490,CN3117100000000,31,171,"Thomas County, NE",Nov-19,438,422,16,3.7
27491,CN3117300000000,31,173,"Thurston County, NE",Nov-19,3100,2972,128,4.1
27492,CN3117500000000,31,175,"Valley County, NE",Nov-19,2116,2064,52,2.5
27493,CN3117700000000,31,177,"Washington County, NE",Nov-19,11332,11053,279,2.5
27494,CN3117900000000,31,179,"Wayne County, NE",Nov-19,5871,5727,144,2.5
27495,CN3118100000000,31,181,"Webster County, NE",Nov-19,1701,1649,52,3.1
27496,CN3118300000000,31,183,"Wheeler County, NE",Nov-19,588,574,14,2.4
27497,CN3118500000000,31,185,"York County, NE",Nov-19,7209,7043,166,2.3
27498,CN3200100000000,32,1,"Churchill County, NV",Nov-19,11202,10865,337,3.0
27499,CN3200300000000,32,3,"Clark County, NV",Nov-19,1139511,1098734,40777,3.6
27500,CN3200500000000,32,5,"Douglas County, NV",Nov-19,23070,22281,789,3.4
27501,CN3200700000000,32,7,"Elko County, NV",Nov-19,26857,26159,698,2.6
27502,CN3200900000000,32,9,"Esmeralda County, NV",Nov-19,464,450,14,3.0
27503,CN3201100000000,32,11,"Eureka County, NV",Nov-19,1125,1104,21,1.9
27504,CN3201300000000,32,13,"Humboldt County, NV",Nov-19,8344,8116,228,2.7
27505,CN3201500000000,32,15,"Lander County, NV",Nov-19,3196,3104,92,2.9
27506,CN3201700000000,32,17,"Lincoln County, NV",Nov-19,2157,2089,68,3.2
27507,CN3201900000000,32,19,"Lyon County, NV",Nov-19,23368,22444,924,4.0
27508,CN3202100000000,32,21,"Mineral County, NV",Nov-19,1991,1926,65,3.3
27509,CN3202300000000,32,23,"Nye County, NV",Nov-19,17591,16814,777,4.4
27510,CN3202700000000,32,27,"Pershing County, NV",Nov-19,2584,2492,92,3.6
27511,CN3202900000000,32,29,"Storey County, NV",Nov-19,2072,2007,65,3.1
27512,CN3203100000000,32,31,"Washoe County, NV",Nov-19,260090,253047,7043,2.7
27513,CN3203300000000,32,33,"White Pine County, NV",Nov-19,4664,4549,115,2.5
27514,CN3251000000000,32,510,"Carson City, NV",Nov-19,26314,25443,871,3.3
27515,CN3300100000000,33,1,"Belknap County, NH",Nov-19,31041,30337,704,2.3
27516,CN3300300000000,33,3,"Carroll County, NH",Nov-19,22928,22399,529,2.3
27517,CN3300500000000,33,5,"Cheshire County, NH",Nov-19,41362,40416,946,2.3
27518,CN3300700000000,33,7,"Coos County, NH",Nov-19,14464,14077,387,2.7
27519,CN3300900000000,33,9,"Grafton County, NH",Nov-19,49826,48824,1002,2.0
27520,CN3301100000000,33,11,"Hillsborough County, NH",Nov-19,243591,237725,5866,2.4
27521,CN3301300000000,33,13,"Merrimack County, NH",Nov-19,84025,82321,1704,2.0
27522,CN3301500000000,33,15,"Rockingham County, NH",Nov-19,188306,183633,4673,2.5
27523,CN3301700000000,33,17,"Strafford County, NH",Nov-19,74873,73276,1597,2.1
27524,CN3301900000000,33,19,"Sullivan County, NH",Nov-19,23029,22551,478,2.1
27525,CN3400100000000,34,1,"Atlantic County, NJ",Nov-19,120041,114037,6004,5.0
27526,CN3400300000000,34,3,"Bergen County, NJ",Nov-19,489572,475909,13663,2.8
27527,CN3400500000000,34,5,"Burlington County, NJ",Nov-19,232663,225271,7392,3.2
27528,CN3400700000000,34,7,"Camden County, NJ",Nov-19,255265,245085,10180,4.0
27529,CN3400900000000,34,9,"Cape May County, NJ",Nov-19,43106,39343,3763,8.7
27530,CN3401100000000,34,11,"Cumberland County, NJ",Nov-19,65723,62244,3479,5.3
27531,CN3401300000000,34,13,"Essex County, NJ",Nov-19,371879,355565,16314,4.4
27532,CN3401500000000,34,15,"Gloucester County, NJ",Nov-19,151019,145590,5429,3.6
27533,CN3401700000000,34,17,"Hudson County, NJ",Nov-19,366921,355070,11851,3.2
27534,CN3401900000000,34,19,"Hunterdon County, NJ",Nov-19,65123,63441,1682,2.6
27535,CN3402100000000,34,21,"Mercer County, NJ",Nov-19,206167,199965,6202,3.0
27536,CN3402300000000,34,23,"Middlesex County, NJ",Nov-19,441938,428540,13398,3.0
27537,CN3402500000000,34,25,"Monmouth County, NJ",Nov-19,331470,321235,10235,3.1
27538,CN3402700000000,34,27,"Morris County, NJ",Nov-19,258765,251804,6961,2.7
27539,CN3402900000000,34,29,"Ocean County, NJ",Nov-19,277419,267366,10053,3.6
27540,CN3403100000000,34,31,"Passaic County, NJ",Nov-19,245597,235549,10048,4.1
27541,CN3403300000000,34,33,"Salem County, NJ",Nov-19,29501,28104,1397,4.7
27542,CN3403500000000,34,35,"Somerset County, NJ",Nov-19,172728,167718,5010,2.9
27543,CN3403700000000,34,37,"Sussex County, NJ",Nov-19,74596,72187,2409,3.2
27544,CN3403900000000,34,39,"Union County, NJ",Nov-19,278298,268452,9846,3.5
27545,CN3404100000000,34,41,"Warren County, NJ",Nov-19,56988,55213,1775,3.1
27546,CN3500100000000,35,1,"Bernalillo County, NM",Nov-19,338926,324718,14208,4.2
27547,CN3500300000000,35,3,"Catron County, NM",Nov-19,1179,1101,78,6.6
27548,CN3500500000000,35,5,"Chaves County, NM",Nov-19,27300,25961,1339,4.9
27549,CN3500600000000,35,6,"Cibola County, NM",Nov-19,9043,8491,552,6.1
27550,CN3500700000000,35,7,"Colfax County, NM",Nov-19,5062,4820,242,4.8
27551,CN3500900000000,35,9,"Curry County, NM",Nov-19,21718,20864,854,3.9
27552,CN3501100000000,35,11,"De Baca County, NM",Nov-19,804,773,31,3.9
27553,CN3501300000000,35,13,"Dona Ana County, NM",Nov-19,99237,93970,5267,5.3
27554,CN3501500000000,35,15,"Eddy County, NM",Nov-19,35578,34506,1072,3.0
27555,CN3501700000000,35,17,"Grant County, NM",Nov-19,12528,11955,573,4.6
27556,CN3501900000000,35,19,"Guadalupe County, NM",Nov-19,1533,1465,68,4.4
27557,CN3502100000000,35,21,"Harding County, NM",Nov-19,282,269,13,4.6
27558,CN3502300000000,35,23,"Hidalgo County, NM",Nov-19,2027,1939,88,4.3
27559,CN3502500000000,35,25,"Lea County, NM",Nov-19,32436,31198,1238,3.8
27560,CN3502700000000,35,27,"Lincoln County, NM",Nov-19,8873,8464,409,4.6
27561,CN3502800000000,35,28,"Los Alamos County, NM",Nov-19,9418,9134,284,3.0
27562,CN3502900000000,35,29,"Luna County, NM",Nov-19,9787,8485,1302,13.3
27563,CN3503100000000,35,31,"McKinley County, NM",Nov-19,24344,22751,1593,6.5
27564,CN3503300000000,35,33,"Mora County, NM",Nov-19,2200,2069,131,6.0
27565,CN3503500000000,35,35,"Otero County, NM",Nov-19,24952,23766,1186,4.8
27566,CN3503700000000,35,37,"Quay County, NM",Nov-19,3210,3062,148,4.6
27567,CN3503900000000,35,39,"Rio Arriba County, NM",Nov-19,16822,15978,844,5.0
27568,CN3504100000000,35,41,"Roosevelt County, NM",Nov-19,8042,7698,344,4.3
27569,CN3504300000000,35,43,"Sandoval County, NM",Nov-19,67442,64377,3065,4.5
27570,CN3504500000000,35,45,"San Juan County, NM",Nov-19,52437,49496,2941,5.6
27571,CN3504700000000,35,47,"San Miguel County, NM",Nov-19,11062,10453,609,5.5
27572,CN3504900000000,35,49,"Santa Fe County, NM",Nov-19,76493,73747,2746,3.6
27573,CN3505100000000,35,51,"Sierra County, NM",Nov-19,3935,3720,215,5.5
27574,CN3505300000000,35,53,"Socorro County, NM",Nov-19,6457,6106,351,5.4
27575,CN3505500000000,35,55,"Taos County, NM",Nov-19,15303,14422,881,5.8
27576,CN3505700000000,35,57,"Torrance County, NM",Nov-19,5863,5484,379,6.5
27577,CN3505900000000,35,59,"Union County, NM",Nov-19,1793,1722,71,4.0
27578,CN3506100000000,35,61,"Valencia County, NM",Nov-19,31115,29548,1567,5.0
27579,CN3600100000000,36,1,"Albany County, NY",Nov-19,158717,153352,5365,3.4
27580,CN3600300000000,36,3,"Allegany County, NY",Nov-19,19846,18823,1023,5.2
27581,CN3600500000000,36,5,"Bronx County, NY",Nov-19,592846,565253,27593,4.7
27582,CN3600700000000,36,7,"Broome County, NY",Nov-19,83101,79476,3625,4.4
27583,CN3600900000000,36,9,"Cattaraugus County, NY",Nov-19,34014,32368,1646,4.8
27584,CN3601100000000,36,11,"Cayuga County, NY",Nov-19,35611,34211,1400,3.9
27585,CN3601300000000,36,13,"Chautauqua County, NY",Nov-19,53613,51212,2401,4.5
27586,CN3601500000000,36,15,"Chemung County, NY",Nov-19,34987,33640,1347,3.9
27587,CN3601700000000,36,17,"Chenango County, NY",Nov-19,21840,20942,898,4.1
27588,CN3601900000000,36,19,"Clinton County, NY",Nov-19,36545,35082,1463,4.0
27589,CN3602100000000,36,21,"Columbia County, NY",Nov-19,30966,30060,906,2.9
27590,CN3602300000000,36,23,"Cortland County, NY",Nov-19,22974,21925,1049,4.6
27591,CN3602500000000,36,25,"Delaware County, NY",Nov-19,19012,18189,823,4.3
27592,CN3602700000000,36,27,"Dutchess County, NY",Nov-19,144472,139508,4964,3.4
27593,CN3602900000000,36,29,"Erie County, NY",Nov-19,441202,423233,17969,4.1
27594,CN3603100000000,36,31,"Essex County, NY",Nov-19,16183,15437,746,4.6
27595,CN3603300000000,36,33,"Franklin County, NY",Nov-19,19466,18564,902,4.6
27596,CN3603500000000,36,35,"Fulton County, NY",Nov-19,22650,21586,1064,4.7
27597,CN3603700000000,36,37,"Genesee County, NY",Nov-19,29515,28403,1112,3.8
27598,CN3603900000000,36,39,"Greene County, NY",Nov-19,19930,19073,857,4.3
27599,CN3604100000000,36,41,"Hamilton County, NY",Nov-19,2098,1946,152,7.2
27600,CN3604300000000,36,43,"Herkimer County, NY",Nov-19,27710,26460,1250,4.5
27601,CN3604500000000,36,45,"Jefferson County, NY",Nov-19,43582,41017,2565,5.9
27602,CN3604700000000,36,47,"Kings County, NY",Nov-19,1189795,1148557,41238,3.5
27603,CN3604900000000,36,49,"Lewis County, NY",Nov-19,11628,11065,563,4.8
27604,CN3605100000000,36,51,"Livingston County, NY",Nov-19,30673,29505,1168,3.8
27605,CN3605300000000,36,53,"Madison County, NY",Nov-19,32692,31417,1275,3.9
27606,CN3605500000000,36,55,"Monroe County, NY",Nov-19,361419,346865,14554,4.0
27607,CN3605700000000,36,57,"Montgomery County, NY",Nov-19,22449,21392,1057,4.7
27608,CN3605900000000,36,59,"Nassau County, NY",Nov-19,709026,685255,23771,3.4
27609,CN3606100000000,36,61,"New York County, NY",Nov-19,906015,878954,27061,3.0
27610,CN3606300000000,36,63,"Niagara County, NY",Nov-19,98686,94064,4622,4.7
27611,CN3606500000000,36,65,"Oneida County, NY",Nov-19,100473,96429,4044,4.0
27612,CN3606700000000,36,67,"Onondaga County, NY",Nov-19,220786,212563,8223,3.7
27613,CN3606900000000,36,69,"Ontario County, NY",Nov-19,55307,53333,1974,3.6
27614,CN3607100000000,36,71,"Orange County, NY",Nov-19,185012,178197,6815,3.7
27615,CN3607300000000,36,73,"Orleans County, NY",Nov-19,17574,16792,782,4.4
27616,CN3607500000000,36,75,"Oswego County, NY",Nov-19,52937,50252,2685,5.1
27617,CN3607700000000,36,77,"Otsego County, NY",Nov-19,27941,26857,1084,3.9
27618,CN3607900000000,36,79,"Putnam County, NY",Nov-19,51413,49566,1847,3.6
27619,CN3608100000000,36,81,"Queens County, NY",Nov-19,1132200,1099168,33032,2.9
27620,CN3608300000000,36,83,"Rensselaer County, NY",Nov-19,81709,78878,2831,3.5
27621,CN3608500000000,36,85,"Richmond County, NY",Nov-19,220678,213599,7079,3.2
27622,CN3608700000000,36,87,"Rockland County, NY",Nov-19,155142,149876,5266,3.4
27623,CN3608900000000,36,89,"St. Lawrence County, NY",Nov-19,43781,41597,2184,5.0
27624,CN3609100000000,36,91,"Saratoga County, NY",Nov-19,119920,116147,3773,3.1
27625,CN3609300000000,36,93,"Schenectady County, NY",Nov-19,76648,73902,2746,3.6
27626,CN3609500000000,36,95,"Schoharie County, NY",Nov-19,14674,14111,563,3.8
27627,CN3609700000000,36,97,"Schuyler County, NY",Nov-19,7955,7605,350,4.4
27628,CN3609900000000,36,99,"Seneca County, NY",Nov-19,16101,15523,578,3.6
27629,CN3610100000000,36,101,"Steuben County, NY",Nov-19,42357,40532,1825,4.3
27630,CN3610300000000,36,103,"Suffolk County, NY",Nov-19,778538,751074,27464,3.5
27631,CN3610500000000,36,105,"Sullivan County, NY",Nov-19,36499,35063,1436,3.9
27632,CN3610700000000,36,107,"Tioga County, NY",Nov-19,22597,21747,850,3.8
27633,CN3610900000000,36,109,"Tompkins County, NY",Nov-19,49795,48154,1641,3.3
27634,CN3611100000000,36,111,"Ulster County, NY",Nov-19,87788,84741,3047,3.5
27635,CN3611300000000,36,113,"Warren County, NY",Nov-19,30909,29472,1437,4.6
27636,CN3611500000000,36,115,"Washington County, NY",Nov-19,27424,26386,1038,3.8
27637,CN3611700000000,36,117,"Wayne County, NY",Nov-19,43819,42186,1633,3.7
27638,CN3611900000000,36,119,"Westchester County, NY",Nov-19,484262,466686,17576,3.6
27639,CN3612100000000,36,121,"Wyoming County, NY",Nov-19,17853,17137,716,4.0
27640,CN3612300000000,36,123,"Yates County, NY",Nov-19,11880,11452,428,3.6
27641,CN3700100000000,37,1,"Alamance County, NC",Nov-19,82915,80149,2766,3.3
27642,CN3700300000000,37,3,"Alexander County, NC",Nov-19,18187,17666,521,2.9
27643,CN3700500000000,37,5,"Alleghany County, NC",Nov-19,4470,4282,188,4.2
27644,CN3700700000000,37,7,"Anson County, NC",Nov-19,10942,10511,431,3.9
27645,CN3700900000000,37,9,"Ashe County, NC",Nov-19,13178,12787,391,3.0
27646,CN3701100000000,37,11,"Avery County, NC",Nov-19,7274,7037,237,3.3
27647,CN3701300000000,37,13,"Beaufort County, NC",Nov-19,19591,18772,819,4.2
27648,CN3701500000000,37,15,"Bertie County, NC",Nov-19,7824,7487,337,4.3
27649,CN3701700000000,37,17,"Bladen County, NC",Nov-19,14565,13931,634,4.4
27650,CN3701900000000,37,19,"Brunswick County, NC",Nov-19,53737,51202,2535,4.7
27651,CN3702100000000,37,21,"Buncombe County, NC",Nov-19,143075,139326,3749,2.6
27652,CN3702300000000,37,23,"Burke County, NC",Nov-19,41520,40116,1404,3.4
27653,CN3702500000000,37,25,"Cabarrus County, NC",Nov-19,110546,106940,3606,3.3
27654,CN3702700000000,37,27,"Caldwell County, NC",Nov-19,36989,35672,1317,3.6
27655,CN3702900000000,37,29,"Camden County, NC",Nov-19,4656,4487,169,3.6
27656,CN3703100000000,37,31,"Carteret County, NC",Nov-19,31993,30892,1101,3.4
27657,CN3703300000000,37,33,"Caswell County, NC",Nov-19,10034,9616,418,4.2
27658,CN3703500000000,37,35,"Catawba County, NC",Nov-19,79794,77186,2608,3.3
27659,CN3703700000000,37,37,"Chatham County, NC",Nov-19,36302,35216,1086,3.0
27660,CN3703900000000,37,39,"Cherokee County, NC",Nov-19,11280,10828,452,4.0
27661,CN3704100000000,37,41,"Chowan County, NC",Nov-19,5565,5339,226,4.1
27662,CN3704300000000,37,43,"Clay County, NC",Nov-19,4207,4049,158,3.8
27663,CN3704500000000,37,45,"Cleveland County, NC",Nov-19,49167,47278,1889,3.8
27664,CN3704700000000,37,47,"Columbus County, NC",Nov-19,23159,22128,1031,4.5
27665,CN3704900000000,37,49,"Craven County, NC",Nov-19,42109,40589,1520,3.6
27666,CN3705100000000,37,51,"Cumberland County, NC",Nov-19,128764,122722,6042,4.7
27667,CN3705300000000,37,53,"Currituck County, NC",Nov-19,14102,13656,446,3.2
27668,CN3705500000000,37,55,"Dare County, NC",Nov-19,18789,18065,724,3.9
27669,CN3705700000000,37,57,"Davidson County, NC",Nov-19,81744,78942,2802,3.4
27670,CN3705900000000,37,59,"Davie County, NC",Nov-19,20833,20193,640,3.1
27671,CN3706100000000,37,61,"Duplin County, NC",Nov-19,25538,24623,915,3.6
27672,CN3706300000000,37,63,"Durham County, NC",Nov-19,173168,167907,5261,3.0
27673,CN3706500000000,37,65,"Edgecombe County, NC",Nov-19,21538,20400,1138,5.3
27674,CN3706700000000,37,67,"Forsyth County, NC",Nov-19,189341,182990,6351,3.4
27675,CN3706900000000,37,69,"Franklin County, NC",Nov-19,31688,30574,1114,3.5
27676,CN3707100000000,37,71,"Gaston County, NC",Nov-19,112797,108584,4213,3.7
27677,CN3707300000000,37,73,"Gates County, NC",Nov-19,5339,5145,194,3.6
27678,CN3707500000000,37,75,"Graham County, NC",Nov-19,3181,3029,152,4.8
27679,CN3707700000000,37,77,"Granville County, NC",Nov-19,30052,29128,924,3.1
27680,CN3707900000000,37,79,"Greene County, NC",Nov-19,9584,9260,324,3.4
27681,CN3708100000000,37,81,"Guilford County, NC",Nov-19,266867,257121,9746,3.7
27682,CN3708300000000,37,83,"Halifax County, NC",Nov-19,20476,19317,1159,5.7
27683,CN3708500000000,37,85,"Harnett County, NC",Nov-19,54175,52020,2155,4.0
27684,CN3708700000000,37,87,"Haywood County, NC",Nov-19,30458,29564,894,2.9
27685,CN3708900000000,37,89,"Henderson County, NC",Nov-19,56053,54452,1601,2.9
27686,CN3709100000000,37,91,"Hertford County, NC",Nov-19,9202,8790,412,4.5
27687,CN3709300000000,37,93,"Hoke County, NC",Nov-19,20321,19393,928,4.6
27688,CN3709500000000,37,95,"Hyde County, NC",Nov-19,1944,1737,207,10.6
27689,CN3709700000000,37,97,"Iredell County, NC",Nov-19,90819,87772,3047,3.4
27690,CN3709900000000,37,99,"Jackson County, NC",Nov-19,20193,19512,681,3.4
27691,CN3710100000000,37,101,"Johnston County, NC",Nov-19,100524,97208,3316,3.3
27692,CN3710300000000,37,103,"Jones County, NC",Nov-19,4420,4275,145,3.3
27693,CN3710500000000,37,105,"Lee County, NC",Nov-19,26137,25079,1058,4.0
27694,CN3710700000000,37,107,"Lenoir County, NC",Nov-19,28003,26972,1031,3.7
27695,CN3710900000000,37,109,"Lincoln County, NC",Nov-19,44221,42761,1460,3.3
27696,CN3711100000000,37,111,"McDowell County, NC",Nov-19,20606,19859,747,3.6
27697,CN3711300000000,37,113,"Macon County, NC",Nov-19,15701,15180,521,3.3
27698,CN3711500000000,37,115,"Madison County, NC",Nov-19,10331,10013,318,3.1
27699,CN3711700000000,37,117,"Martin County, NC",Nov-19,9130,8727,403,4.4
27700,CN3711900000000,37,119,"Mecklenburg County, NC",Nov-19,630869,609814,21055,3.3
27701,CN3712100000000,37,121,"Mitchell County, NC",Nov-19,6090,5853,237,3.9
27702,CN3712300000000,37,123,"Montgomery County, NC",Nov-19,11595,11177,418,3.6
27703,CN3712500000000,37,125,"Moore County, NC",Nov-19,42718,41269,1449,3.4
27704,CN3712700000000,37,127,"Nash County, NC",Nov-19,43906,42019,1887,4.3
27705,CN3712900000000,37,129,"New Hanover County, NC",Nov-19,126424,122534,3890,3.1
27706,CN3713100000000,37,131,"Northampton County, NC",Nov-19,7769,7389,380,4.9
27707,CN3713300000000,37,133,"Onslow County, NC",Nov-19,65882,63180,2702,4.1
27708,CN3713500000000,37,135,"Orange County, NC",Nov-19,79901,77682,2219,2.8
27709,CN3713700000000,37,137,"Pamlico County, NC",Nov-19,5374,5199,175,3.3
27710,CN3713900000000,37,139,"Pasquotank County, NC",Nov-19,16759,16055,704,4.2
27711,CN3714100000000,37,141,"Pender County, NC",Nov-19,29460,28416,1044,3.5
27712,CN3714300000000,37,143,"Perquimans County, NC",Nov-19,4995,4769,226,4.5
27713,CN3714500000000,37,145,"Person County, NC",Nov-19,18619,17932,687,3.7
27714,CN3714700000000,37,147,"Pitt County, NC",Nov-19,91146,87680,3466,3.8
27715,CN3714900000000,37,149,"Polk County, NC",Nov-19,9050,8749,301,3.3
27716,CN3715100000000,37,151,"Randolph County, NC",Nov-19,67365,65109,2256,3.3
27717,CN3715300000000,37,153,"Richmond County, NC",Nov-19,16774,15940,834,5.0
27718,CN3715500000000,37,155,"Robeson County, NC",Nov-19,50655,48148,2507,4.9
27719,CN3715700000000,37,157,"Rockingham County, NC",Nov-19,40877,39217,1660,4.1
27720,CN3715900000000,37,159,"Rowan County, NC",Nov-19,67378,64745,2633,3.9
27721,CN3716100000000,37,161,"Rutherford County, NC",Nov-19,25486,24361,1125,4.4
27722,CN3716300000000,37,163,"Sampson County, NC",Nov-19,29755,28737,1018,3.4
27723,CN3716500000000,37,165,"Scotland County, NC",Nov-19,11654,10933,721,6.2
27724,CN3716700000000,37,167,"Stanly County, NC",Nov-19,30597,29553,1044,3.4
27725,CN3716900000000,37,169,"Stokes County, NC",Nov-19,21959,21244,715,3.3
27726,CN3717100000000,37,171,"Surry County, NC",Nov-19,34232,33071,1161,3.4
27727,CN3717300000000,37,173,"Swain County, NC",Nov-19,6905,6675,230,3.3
27728,CN3717500000000,37,175,"Transylvania County, NC",Nov-19,14651,14186,465,3.2
27729,CN3717700000000,37,177,"Tyrrell County, NC",Nov-19,1394,1315,79,5.7
27730,CN3717900000000,37,179,"Union County, NC",Nov-19,125666,121822,3844,3.1
27731,CN3718100000000,37,181,"Vance County, NC",Nov-19,17435,16481,954,5.5
27732,CN3718300000000,37,183,"Wake County, NC",Nov-19,603895,585916,17979,3.0
27733,CN3718500000000,37,185,"Warren County, NC",Nov-19,6720,6366,354,5.3
27734,CN3718700000000,37,187,"Washington County, NC",Nov-19,4436,4203,233,5.3
27735,CN3718900000000,37,189,"Watauga County, NC",Nov-19,30137,29294,843,2.8
27736,CN3719100000000,37,191,"Wayne County, NC",Nov-19,52152,50214,1938,3.7
27737,CN3719300000000,37,193,"Wilkes County, NC",Nov-19,29577,28529,1048,3.5
27738,CN3719500000000,37,195,"Wilson County, NC",Nov-19,34946,33100,1846,5.3
27739,CN3719700000000,37,197,"Yadkin County, NC",Nov-19,17883,17326,557,3.1
27740,CN3719900000000,37,199,"Yancey County, NC",Nov-19,8566,8282,284,3.3
27741,CN3800100000000,38,1,"Adams County, ND",Nov-19,1027,1001,26,2.5
27742,CN3800300000000,38,3,"Barnes County, ND",Nov-19,5085,4975,110,2.2
27743,CN3800500000000,38,5,"Benson County, ND",Nov-19,2263,2185,78,3.4
27744,CN3800700000000,38,7,"Billings County, ND",Nov-19,355,345,10,2.8
27745,CN3800900000000,38,9,"Bottineau County, ND",Nov-19,2855,2786,69,2.4
27746,CN3801100000000,38,11,"Bowman County, ND",Nov-19,1689,1656,33,2.0
27747,CN3801300000000,38,13,"Burke County, ND",Nov-19,1017,998,19,1.9
27748,CN3801500000000,38,15,"Burleigh County, ND",Nov-19,48917,47933,984,2.0
27749,CN3801700000000,38,17,"Cass County, ND",Nov-19,102607,100878,1729,1.7
27750,CN3801900000000,38,19,"Cavalier County, ND",Nov-19,1849,1810,39,2.1
27751,CN3802100000000,38,21,"Dickey County, ND",Nov-19,2202,2166,36,1.6
27752,CN3802300000000,38,23,"Divide County, ND",Nov-19,1369,1347,22,1.6
27753,CN3802500000000,38,25,"Dunn County, ND",Nov-19,3112,3069,43,1.4
27754,CN3802700000000,38,27,"Eddy County, ND",Nov-19,1177,1140,37,3.1
27755,CN3802900000000,38,29,"Emmons County, ND",Nov-19,1387,1344,43,3.1
27756,CN3803100000000,38,31,"Foster County, ND",Nov-19,1423,1394,29,2.0
27757,CN3803300000000,38,33,"Golden Valley County, ND",Nov-19,795,783,12,1.5
27758,CN3803500000000,38,35,"Grand Forks County, ND",Nov-19,37199,36565,634,1.7
27759,CN3803700000000,38,37,"Grant County, ND",Nov-19,1134,1113,21,1.9
27760,CN3803900000000,38,39,"Griggs County, ND",Nov-19,978,950,28,2.9
27761,CN3804100000000,38,41,"Hettinger County, ND",Nov-19,1331,1306,25,1.9
27762,CN3804300000000,38,43,"Kidder County, ND",Nov-19,1181,1152,29,2.5
27763,CN3804500000000,38,45,"LaMoure County, ND",Nov-19,1985,1954,31,1.6
27764,CN3804700000000,38,47,"Logan County, ND",Nov-19,851,833,18,2.1
27765,CN3804900000000,38,49,"McHenry County, ND",Nov-19,2950,2875,75,2.5
27766,CN3805100000000,38,51,"McIntosh County, ND",Nov-19,1063,1038,25,2.4
27767,CN3805300000000,38,53,"McKenzie County, ND",Nov-19,10277,10110,167,1.6
27768,CN3805500000000,38,55,"McLean County, ND",Nov-19,4510,4385,125,2.8
27769,CN3805700000000,38,57,"Mercer County, ND",Nov-19,3376,3237,139,4.1
27770,CN3805900000000,38,59,"Morton County, ND",Nov-19,16009,15607,402,2.5
27771,CN3806100000000,38,61,"Mountrail County, ND",Nov-19,7386,7282,104,1.4
27772,CN3806300000000,38,63,"Nelson County, ND",Nov-19,1323,1292,31,2.3
27773,CN3806500000000,38,65,"Oliver County, ND",Nov-19,842,816,26,3.1
27774,CN3806700000000,38,67,"Pembina County, ND",Nov-19,3191,3112,79,2.5
27775,CN3806900000000,38,69,"Pierce County, ND",Nov-19,1637,1598,39,2.4
27776,CN3807100000000,38,71,"Ramsey County, ND",Nov-19,5390,5258,132,2.4
27777,CN3807300000000,38,73,"Ransom County, ND",Nov-19,2750,2708,42,1.5
27778,CN3807500000000,38,75,"Renville County, ND",Nov-19,1192,1164,28,2.3
27779,CN3807700000000,38,77,"Richland County, ND",Nov-19,8347,8189,158,1.9
27780,CN3807900000000,38,79,"Rolette County, ND",Nov-19,4466,4180,286,6.4
27781,CN3808100000000,38,81,"Sargent County, ND",Nov-19,2585,2545,40,1.5
27782,CN3808300000000,38,83,"Sheridan County, ND",Nov-19,647,616,31,4.8
27783,CN3808500000000,38,85,"Sioux County, ND",Nov-19,1215,1178,37,3.0
27784,CN3808700000000,38,87,"Slope County, ND",Nov-19,384,374,10,2.6
27785,CN3808900000000,38,89,"Stark County, ND",Nov-19,18168,17825,343,1.9
27786,CN3809100000000,38,91,"Steele County, ND",Nov-19,937,923,14,1.5
27787,CN3809300000000,38,93,"Stutsman County, ND",Nov-19,10005,9804,201,2.0
27788,CN3809500000000,38,95,"Towner County, ND",Nov-19,1047,1021,26,2.5
27789,CN3809700000000,38,97,"Traill County, ND",Nov-19,4289,4211,78,1.8
27790,CN3809900000000,38,99,"Walsh County, ND",Nov-19,4924,4802,122,2.5
27791,CN3810100000000,38,101,"Ward County, ND",Nov-19,31058,30420,638,2.1
27792,CN3810300000000,38,103,"Wells County, ND",Nov-19,1800,1757,43,2.4
27793,CN3810500000000,38,105,"Williams County, ND",Nov-19,24290,23869,421,1.7
27794,CN3900100000000,39,1,"Adams County, OH",Nov-19,10576,9946,630,6.0
27795,CN3900300000000,39,3,"Allen County, OH",Nov-19,47691,45916,1775,3.7
27796,CN3900500000000,39,5,"Ashland County, OH",Nov-19,26645,25631,1014,3.8
27797,CN3900700000000,39,7,"Ashtabula County, OH",Nov-19,44147,42236,1911,4.3
27798,CN3900900000000,39,9,"Athens County, OH",Nov-19,29411,28122,1289,4.4
27799,CN3901100000000,39,11,"Auglaize County, OH",Nov-19,24785,24112,673,2.7
27800,CN3901300000000,39,13,"Belmont County, OH",Nov-19,30513,28759,1754,5.7
27801,CN3901500000000,39,15,"Brown County, OH",Nov-19,19561,18681,880,4.5
27802,CN3901700000000,39,17,"Butler County, OH",Nov-19,195670,188945,6725,3.4
27803,CN3901900000000,39,19,"Carroll County, OH",Nov-19,12972,12340,632,4.9
27804,CN3902100000000,39,21,"Champaign County, OH",Nov-19,20143,19445,698,3.5
27805,CN3902300000000,39,23,"Clark County, OH",Nov-19,63271,60614,2657,4.2
27806,CN3902500000000,39,25,"Clermont County, OH",Nov-19,107016,103469,3547,3.3
27807,CN3902700000000,39,27,"Clinton County, OH",Nov-19,17752,17004,748,4.2
27808,CN3902900000000,39,29,"Columbiana County, OH",Nov-19,47252,45214,2038,4.3
27809,CN3903100000000,39,31,"Coshocton County, OH",Nov-19,14081,13297,784,5.6
27810,CN3903300000000,39,33,"Crawford County, OH",Nov-19,18144,17352,792,4.4
27811,CN3903500000000,39,35,"Cuyahoga County, OH",Nov-19,612496,591283,21213,3.5
27812,CN3903700000000,39,37,"Darke County, OH",Nov-19,25584,24720,864,3.4
27813,CN3903900000000,39,39,"Defiance County, OH",Nov-19,18037,17327,710,3.9
27814,CN3904100000000,39,41,"Delaware County, OH",Nov-19,111602,108363,3239,2.9
27815,CN3904300000000,39,43,"Erie County, OH",Nov-19,35567,33836,1731,4.9
27816,CN3904500000000,39,45,"Fairfield County, OH",Nov-19,78740,76076,2664,3.4
27817,CN3904700000000,39,47,"Fayette County, OH",Nov-19,13929,13456,473,3.4
27818,CN3904900000000,39,49,"Franklin County, OH",Nov-19,705714,682946,22768,3.2
27819,CN3905100000000,39,51,"Fulton County, OH",Nov-19,22407,21618,789,3.5
27820,CN3905300000000,39,53,"Gallia County, OH",Nov-19,12113,11534,579,4.8
27821,CN3905500000000,39,55,"Geauga County, OH",Nov-19,48973,47637,1336,2.7
27822,CN3905700000000,39,57,"Greene County, OH",Nov-19,83500,80676,2824,3.4
27823,CN3905900000000,39,59,"Guernsey County, OH",Nov-19,18401,17430,971,5.3
27824,CN3906100000000,39,61,"Hamilton County, OH",Nov-19,417324,403046,14278,3.4
27825,CN3906300000000,39,63,"Hancock County, OH",Nov-19,41904,40666,1238,3.0
27826,CN3906500000000,39,65,"Hardin County, OH",Nov-19,13669,13156,513,3.8
27827,CN3906700000000,39,67,"Harrison County, OH",Nov-19,6699,6320,379,5.7
27828,CN3906900000000,39,69,"Henry County, OH",Nov-19,13243,12758,485,3.7
27829,CN3907100000000,39,71,"Highland County, OH",Nov-19,16973,16136,837,4.9
27830,CN3907300000000,39,73,"Hocking County, OH",Nov-19,13172,12659,513,3.9
27831,CN3907500000000,39,75,"Holmes County, OH",Nov-19,20450,19901,549,2.7
27832,CN3907700000000,39,77,"Huron County, OH",Nov-19,27405,25971,1434,5.2
27833,CN3907900000000,39,79,"Jackson County, OH",Nov-19,12538,11803,735,5.9
27834,CN3908100000000,39,81,"Jefferson County, OH",Nov-19,27658,26154,1504,5.4
27835,CN3908300000000,39,83,"Knox County, OH",Nov-19,31503,30419,1084,3.4
27836,CN3908500000000,39,85,"Lake County, OH",Nov-19,126159,122461,3698,2.9
27837,CN3908700000000,39,87,"Lawrence County, OH",Nov-19,23846,22751,1095,4.6
27838,CN3908900000000,39,89,"Licking County, OH",Nov-19,91325,88246,3079,3.4
27839,CN3909100000000,39,91,"Logan County, OH",Nov-19,22640,21864,776,3.4
27840,CN3909300000000,39,93,"Lorain County, OH",Nov-19,153505,148017,5488,3.6
27841,CN3909500000000,39,95,"Lucas County, OH",Nov-19,210971,202313,8658,4.1
27842,CN3909700000000,39,97,"Madison County, OH",Nov-19,20897,20267,630,3.0
27843,CN3909900000000,39,99,"Mahoning County, OH",Nov-19,102263,96889,5374,5.3
27844,CN3910100000000,39,101,"Marion County, OH",Nov-19,28161,27170,991,3.5
27845,CN3910300000000,39,103,"Medina County, OH",Nov-19,97482,94769,2713,2.8
27846,CN3910500000000,39,105,"Meigs County, OH",Nov-19,9080,8531,549,6.0
27847,CN3910700000000,39,107,"Mercer County, OH",Nov-19,22982,22438,544,2.4
27848,CN3910900000000,39,109,"Miami County, OH",Nov-19,54297,52477,1820,3.4
27849,CN3911100000000,39,111,"Monroe County, OH",Nov-19,5299,4864,435,8.2
27850,CN3911300000000,39,113,"Montgomery County, OH",Nov-19,253625,243925,9700,3.8
27851,CN3911500000000,39,115,"Morgan County, OH",Nov-19,6625,6220,405,6.1
27852,CN3911700000000,39,117,"Morrow County, OH",Nov-19,16940,16313,627,3.7
27853,CN3911900000000,39,119,"Muskingum County, OH",Nov-19,39895,38141,1754,4.4
27854,CN3912100000000,39,121,"Noble County, OH",Nov-19,4635,4337,298,6.4
27855,CN3912300000000,39,123,"Ottawa County, OH",Nov-19,20238,19040,1198,5.9
27856,CN3912500000000,39,125,"Paulding County, OH",Nov-19,8559,8217,342,4.0
27857,CN3912700000000,39,127,"Perry County, OH",Nov-19,16050,15269,781,4.9
27858,CN3912900000000,39,129,"Pickaway County, OH",Nov-19,26628,25687,941,3.5
27859,CN3913100000000,39,131,"Pike County, OH",Nov-19,10690,10065,625,5.8
27860,CN3913300000000,39,133,"Portage County, OH",Nov-19,87685,84283,3402,3.9
27861,CN3913500000000,39,135,"Preble County, OH",Nov-19,21100,20395,705,3.3
27862,CN3913700000000,39,137,"Putnam County, OH",Nov-19,18601,18082,519,2.8
27863,CN3913900000000,39,139,"Richland County, OH",Nov-19,52036,49776,2260,4.3
27864,CN3914100000000,39,141,"Ross County, OH",Nov-19,35462,33999,1463,4.1
27865,CN3914300000000,39,143,"Sandusky County, OH",Nov-19,30147,28913,1234,4.1
27866,CN3914500000000,39,145,"Scioto County, OH",Nov-19,28964,27349,1615,5.6
27867,CN3914700000000,39,147,"Seneca County, OH",Nov-19,27129,26110,1019,3.8
27868,CN3914900000000,39,149,"Shelby County, OH",Nov-19,23838,23093,745,3.1
27869,CN3915100000000,39,151,"Stark County, OH",Nov-19,186121,178234,7887,4.2
27870,CN3915300000000,39,153,"Summit County, OH",Nov-19,273367,262926,10441,3.8
27871,CN3915500000000,39,155,"Trumbull County, OH",Nov-19,86139,81205,4934,5.7
27872,CN3915700000000,39,157,"Tuscarawas County, OH",Nov-19,44630,42827,1803,4.0
27873,CN3915900000000,39,159,"Union County, OH",Nov-19,29164,28294,870,3.0
27874,CN3916100000000,39,161,"Van Wert County, OH",Nov-19,14897,14399,498,3.3
27875,CN3916300000000,39,163,"Vinton County, OH",Nov-19,5525,5217,308,5.6
27876,CN3916500000000,39,165,"Warren County, OH",Nov-19,119510,115715,3795,3.2
27877,CN3916700000000,39,167,"Washington County, OH",Nov-19,27404,26013,1391,5.1
27878,CN3916900000000,39,169,"Wayne County, OH",Nov-19,61802,59961,1841,3.0
27879,CN3917100000000,39,171,"Williams County, OH",Nov-19,18876,18297,579,3.1
27880,CN3917300000000,39,173,"Wood County, OH",Nov-19,71443,69137,2306,3.2
27881,CN3917500000000,39,175,"Wyandot County, OH",Nov-19,12797,12431,366,2.9
27882,CN4000100000000,40,1,"Adair County, OK",Nov-19,8174,7846,328,4.0
27883,CN4000300000000,40,3,"Alfalfa County, OK",Nov-19,2859,2797,62,2.2
27884,CN4000500000000,40,5,"Atoka County, OK",Nov-19,4963,4740,223,4.5
27885,CN4000700000000,40,7,"Beaver County, OK",Nov-19,2936,2882,54,1.8
27886,CN4000900000000,40,9,"Beckham County, OK",Nov-19,10053,9647,406,4.0
27887,CN4001100000000,40,11,"Blaine County, OK",Nov-19,4739,4637,102,2.2
27888,CN4001300000000,40,13,"Bryan County, OK",Nov-19,21354,20744,610,2.9
27889,CN4001500000000,40,15,"Caddo County, OK",Nov-19,11918,11473,445,3.7
27890,CN4001700000000,40,17,"Canadian County, OK",Nov-19,75151,72962,2189,2.9
27891,CN4001900000000,40,19,"Carter County, OK",Nov-19,21594,20848,746,3.5
27892,CN4002100000000,40,21,"Cherokee County, OK",Nov-19,18747,18062,685,3.7
27893,CN4002300000000,40,23,"Choctaw County, OK",Nov-19,5377,5120,257,4.8
27894,CN4002500000000,40,25,"Cimarron County, OK",Nov-19,1367,1345,22,1.6
27895,CN4002700000000,40,27,"Cleveland County, OK",Nov-19,143943,140173,3770,2.6
27896,CN4002900000000,40,29,"Coal County, OK",Nov-19,2425,2313,112,4.6
27897,CN4003100000000,40,31,"Comanche County, OK",Nov-19,48424,46733,1691,3.5
27898,CN4003300000000,40,33,"Cotton County, OK",Nov-19,2759,2665,94,3.4
27899,CN4003500000000,40,35,"Craig County, OK",Nov-19,5919,5709,210,3.5
27900,CN4003700000000,40,37,"Creek County, OK",Nov-19,31809,30641,1168,3.7
27901,CN4003900000000,40,39,"Custer County, OK",Nov-19,15746,15311,435,2.8
27902,CN4004100000000,40,41,"Delaware County, OK",Nov-19,17984,17343,641,3.6
27903,CN4004300000000,40,43,"Dewey County, OK",Nov-19,2920,2839,81,2.8
27904,CN4004500000000,40,45,"Ellis County, OK",Nov-19,2136,2075,61,2.9
27905,CN4004700000000,40,47,"Garfield County, OK",Nov-19,26875,26067,808,3.0
27906,CN4004900000000,40,49,"Garvin County, OK",Nov-19,12572,12153,419,3.3
27907,CN4005100000000,40,51,"Grady County, OK",Nov-19,26847,25967,880,3.3
27908,CN4005300000000,40,53,"Grant County, OK",Nov-19,2650,2604,46,1.7
27909,CN4005500000000,40,55,"Greer County, OK",Nov-19,1863,1785,78,4.2
27910,CN4005700000000,40,57,"Harmon County, OK",Nov-19,1183,1151,32,2.7
27911,CN4005900000000,40,59,"Harper County, OK",Nov-19,1795,1738,57,3.2
27912,CN4006100000000,40,61,"Haskell County, OK",Nov-19,4242,3976,266,6.3
27913,CN4006300000000,40,63,"Hughes County, OK",Nov-19,5368,5107,261,4.9
27914,CN4006500000000,40,65,"Jackson County, OK",Nov-19,10777,10468,309,2.9
27915,CN4006700000000,40,67,"Jefferson County, OK",Nov-19,2526,2451,75,3.0
27916,CN4006900000000,40,69,"Johnston County, OK",Nov-19,3712,3534,178,4.8
27917,CN4007100000000,40,71,"Kay County, OK",Nov-19,18313,17561,752,4.1
27918,CN4007300000000,40,73,"Kingfisher County, OK",Nov-19,9167,8989,178,1.9
27919,CN4007500000000,40,75,"Kiowa County, OK",Nov-19,3468,3345,123,3.5
27920,CN4007700000000,40,77,"Latimer County, OK",Nov-19,3158,2930,228,7.2
27921,CN4007900000000,40,79,"Le Flore County, OK",Nov-19,19154,18260,894,4.7
27922,CN4008100000000,40,81,"Lincoln County, OK",Nov-19,15926,15379,547,3.4
27923,CN4008300000000,40,83,"Logan County, OK",Nov-19,22288,21697,591,2.7
27924,CN4008500000000,40,85,"Love County, OK",Nov-19,6207,6065,142,2.3
27925,CN4008700000000,40,87,"McClain County, OK",Nov-19,19882,19323,559,2.8
27926,CN4008900000000,40,89,"McCurtain County, OK",Nov-19,14618,13778,840,5.7
27927,CN4009100000000,40,91,"McIntosh County, OK",Nov-19,7170,6735,435,6.1
27928,CN4009300000000,40,93,"Major County, OK",Nov-19,3842,3764,78,2.0
27929,CN4009500000000,40,95,"Marshall County, OK",Nov-19,6873,6648,225,3.3
27930,CN4009700000000,40,97,"Mayes County, OK",Nov-19,19463,18904,559,2.9
27931,CN4009900000000,40,99,"Murray County, OK",Nov-19,6338,6140,198,3.1
27932,CN4010100000000,40,101,"Muskogee County, OK",Nov-19,29837,28765,1072,3.6
27933,CN4010300000000,40,103,"Noble County, OK",Nov-19,5656,5516,140,2.5
27934,CN4010500000000,40,105,"Nowata County, OK",Nov-19,4615,4476,139,3.0
27935,CN4010700000000,40,107,"Okfuskee County, OK",Nov-19,4614,4386,228,4.9
27936,CN4010900000000,40,109,"Oklahoma County, OK",Nov-19,387919,376283,11636,3.0
27937,CN4011100000000,40,111,"Okmulgee County, OK",Nov-19,15842,15061,781,4.9
27938,CN4011300000000,40,113,"Osage County, OK",Nov-19,20835,20088,747,3.6
27939,CN4011500000000,40,115,"Ottawa County, OK",Nov-19,14057,13622,435,3.1
27940,CN4011700000000,40,117,"Pawnee County, OK",Nov-19,7412,7124,288,3.9
27941,CN4011900000000,40,119,"Payne County, OK",Nov-19,37990,36988,1002,2.6
27942,CN4012100000000,40,121,"Pittsburg County, OK",Nov-19,17094,16301,793,4.6
27943,CN4012300000000,40,123,"Pontotoc County, OK",Nov-19,19355,18823,532,2.7
27944,CN4012500000000,40,125,"Pottawatomie County, OK",Nov-19,32734,31553,1181,3.6
27945,CN4012700000000,40,127,"Pushmataha County, OK",Nov-19,4302,4084,218,5.1
27946,CN4012900000000,40,129,"Roger Mills County, OK",Nov-19,1895,1830,65,3.4
27947,CN4013100000000,40,131,"Rogers County, OK",Nov-19,45417,44080,1337,2.9
27948,CN4013300000000,40,133,"Seminole County, OK",Nov-19,9560,9090,470,4.9
27949,CN4013500000000,40,135,"Sequoyah County, OK",Nov-19,16283,15587,696,4.3
27950,CN4013700000000,40,137,"Stephens County, OK",Nov-19,18461,17566,895,4.8
27951,CN4013900000000,40,139,"Texas County, OK",Nov-19,11356,11158,198,1.7
27952,CN4014100000000,40,141,"Tillman County, OK",Nov-19,3012,2904,108,3.6
27953,CN4014300000000,40,143,"Tulsa County, OK",Nov-19,325137,315066,10071,3.1
27954,CN4014500000000,40,145,"Wagoner County, OK",Nov-19,38243,37035,1208,3.2
27955,CN4014700000000,40,147,"Washington County, OK",Nov-19,22177,21463,714,3.2
27956,CN4014900000000,40,149,"Washita County, OK",Nov-19,5272,5060,212,4.0
27957,CN4015100000000,40,151,"Woods County, OK",Nov-19,4660,4579,81,1.7
27958,CN4015300000000,40,153,"Woodward County, OK",Nov-19,8946,8619,327,3.7
27959,CN4100100000000,41,1,"Baker County, OR",Nov-19,7170,6898,272,3.8
27960,CN4100300000000,41,3,"Benton County, OR",Nov-19,49105,48079,1026,2.1
27961,CN4100500000000,41,5,"Clackamas County, OR",Nov-19,220206,214357,5849,2.7
27962,CN4100700000000,41,7,"Clatsop County, OR",Nov-19,19154,18556,598,3.1
27963,CN4100900000000,41,9,"Columbia County, OR",Nov-19,24464,23567,897,3.7
27964,CN4101100000000,41,11,"Coos County, OR",Nov-19,25951,24988,963,3.7
27965,CN4101300000000,41,13,"Crook County, OR",Nov-19,9494,9078,416,4.4
27966,CN4101500000000,41,15,"Curry County, OR",Nov-19,8732,8347,385,4.4
27967,CN4101700000000,41,17,"Deschutes County, OR",Nov-19,95449,92618,2831,3.0
27968,CN4101900000000,41,19,"Douglas County, OR",Nov-19,46139,44373,1766,3.8
27969,CN4102100000000,41,21,"Gilliam County, OR",Nov-19,860,832,28,3.3
27970,CN4102300000000,41,23,"Grant County, OR",Nov-19,3109,2942,167,5.4
27971,CN4102500000000,41,25,"Harney County, OR",Nov-19,3534,3417,117,3.3
27972,CN4102700000000,41,27,"Hood River County, OR",Nov-19,13745,13416,329,2.4
27973,CN4102900000000,41,29,"Jackson County, OR",Nov-19,103552,100344,3208,3.1
27974,CN4103100000000,41,31,"Jefferson County, OR",Nov-19,9892,9516,376,3.8
27975,CN4103300000000,41,33,"Josephine County, OR",Nov-19,35590,34207,1383,3.9
27976,CN4103500000000,41,35,"Klamath County, OR",Nov-19,28736,27303,1433,5.0
27977,CN4103700000000,41,37,"Lake County, OR",Nov-19,3566,3441,125,3.5
27978,CN4103900000000,41,39,"Lane County, OR",Nov-19,181668,175938,5730,3.2
27979,CN4104100000000,41,41,"Lincoln County, OR",Nov-19,20362,19601,761,3.7
27980,CN4104300000000,41,43,"Linn County, OR",Nov-19,58829,56836,1993,3.4
27981,CN4104500000000,41,45,"Malheur County, OR",Nov-19,12360,11997,363,2.9
27982,CN4104700000000,41,47,"Marion County, OR",Nov-19,161709,156807,4902,3.0
27983,CN4104900000000,41,49,"Morrow County, OR",Nov-19,5592,5413,179,3.2
27984,CN4105100000000,41,51,"Multnomah County, OR",Nov-19,456657,444753,11904,2.6
27985,CN4105300000000,41,53,"Polk County, OR",Nov-19,40068,38821,1247,3.1
27986,CN4105500000000,41,55,"Sherman County, OR",Nov-19,919,888,31,3.4
27987,CN4105700000000,41,57,"Tillamook County, OR",Nov-19,11586,11231,355,3.1
27988,CN4105900000000,41,59,"Umatilla County, OR",Nov-19,36003,34726,1277,3.5
27989,CN4106100000000,41,61,"Union County, OR",Nov-19,11758,11348,410,3.5
27990,CN4106300000000,41,63,"Wallowa County, OR",Nov-19,3268,3131,137,4.2
27991,CN4106500000000,41,65,"Wasco County, OR",Nov-19,12552,12124,428,3.4
27992,CN4106700000000,41,67,"Washington County, OR",Nov-19,326588,318684,7904,2.4
27993,CN4106900000000,41,69,"Wheeler County, OR",Nov-19,719,694,25,3.5
27994,CN4107100000000,41,71,"Yamhill County, OR",Nov-19,54687,53222,1465,2.7
27995,CN4200100000000,42,1,"Adams County, PA",Nov-19,55091,53335,1756,3.2
27996,CN4200300000000,42,3,"Allegheny County, PA",Nov-19,654502,627714,26788,4.1
27997,CN4200500000000,42,5,"Armstrong County, PA",Nov-19,32557,30842,1715,5.3
27998,CN4200700000000,42,7,"Beaver County, PA",Nov-19,84788,80923,3865,4.6
27999,CN4200900000000,42,9,"Bedford County, PA",Nov-19,23433,22358,1075,4.6
28000,CN4201100000000,42,11,"Berks County, PA",Nov-19,217344,207931,9413,4.3
28001,CN4201300000000,42,13,"Blair County, PA",Nov-19,59482,56762,2720,4.6
28002,CN4201500000000,42,15,"Bradford County, PA",Nov-19,28757,27477,1280,4.5
28003,CN4201700000000,42,17,"Bucks County, PA",Nov-19,346722,333495,13227,3.8
28004,CN4201900000000,42,19,"Butler County, PA",Nov-19,100589,96713,3876,3.9
28005,CN4202100000000,42,21,"Cambria County, PA",Nov-19,58468,55391,3077,5.3
28006,CN4202300000000,42,23,"Cameron County, PA",Nov-19,2054,1923,131,6.4
28007,CN4202500000000,42,25,"Carbon County, PA",Nov-19,32625,30914,1711,5.2
28008,CN4202700000000,42,27,"Centre County, PA",Nov-19,82187,79502,2685,3.3
28009,CN4202900000000,42,29,"Chester County, PA",Nov-19,286184,277109,9075,3.2
28010,CN4203100000000,42,31,"Clarion County, PA",Nov-19,17307,16458,849,4.9
28011,CN4203300000000,42,33,"Clearfield County, PA",Nov-19,36198,34314,1884,5.2
28012,CN4203500000000,42,35,"Clinton County, PA",Nov-19,18308,17338,970,5.3
28013,CN4203700000000,42,37,"Columbia County, PA",Nov-19,33913,32437,1476,4.4
28014,CN4203900000000,42,39,"Crawford County, PA",Nov-19,38604,36708,1896,4.9
28015,CN4204100000000,42,41,"Cumberland County, PA",Nov-19,133740,129291,4449,3.3
28016,CN4204300000000,42,43,"Dauphin County, PA",Nov-19,146182,140351,5831,4.0
28017,CN4204500000000,42,45,"Delaware County, PA",Nov-19,303962,291669,12293,4.0
28018,CN4204700000000,42,47,"Elk County, PA",Nov-19,15421,14466,955,6.2
28019,CN4204900000000,42,49,"Erie County, PA",Nov-19,129217,123269,5948,4.6
28020,CN4205100000000,42,51,"Fayette County, PA",Nov-19,57706,54216,3490,6.0
28021,CN4205300000000,42,53,"Forest County, PA",Nov-19,1788,1669,119,6.7
28022,CN4205500000000,42,55,"Franklin County, PA",Nov-19,78498,75533,2965,3.8
28023,CN4205700000000,42,57,"Fulton County, PA",Nov-19,7857,7532,325,4.1
28024,CN4205900000000,42,59,"Greene County, PA",Nov-19,16809,15900,909,5.4
28025,CN4206100000000,42,61,"Huntingdon County, PA",Nov-19,20060,18867,1193,5.9
28026,CN4206300000000,42,63,"Indiana County, PA",Nov-19,39734,37733,2001,5.0
28027,CN4206500000000,42,65,"Jefferson County, PA",Nov-19,20490,19479,1011,4.9
28028,CN4206700000000,42,67,"Juniata County, PA",Nov-19,12493,11993,500,4.0
28029,CN4206900000000,42,69,"Lackawanna County, PA",Nov-19,106306,101152,5154,4.8
28030,CN4207100000000,42,71,"Lancaster County, PA",Nov-19,286594,276970,9624,3.4
28031,CN4207300000000,42,73,"Lawrence County, PA",Nov-19,40777,38709,2068,5.1
28032,CN4207500000000,42,75,"Lebanon County, PA",Nov-19,72858,70039,2819,3.9
28033,CN4207700000000,42,77,"Lehigh County, PA",Nov-19,195668,187255,8413,4.3
28034,CN4207900000000,42,79,"Luzerne County, PA",Nov-19,159300,150351,8949,5.6
28035,CN4208100000000,42,81,"Lycoming County, PA",Nov-19,57158,54444,2714,4.7
28036,CN4208300000000,42,83,"McKean County, PA",Nov-19,17388,16365,1023,5.9
28037,CN4208500000000,42,85,"Mercer County, PA",Nov-19,49103,46591,2512,5.1
28038,CN4208700000000,42,87,"Mifflin County, PA",Nov-19,21064,20086,978,4.6
28039,CN4208900000000,42,89,"Monroe County, PA",Nov-19,83705,79119,4586,5.5
28040,CN4209100000000,42,91,"Montgomery County, PA",Nov-19,458352,442325,16027,3.5
28041,CN4209300000000,42,93,"Montour County, PA",Nov-19,9235,8925,310,3.4
28042,CN4209500000000,42,95,"Northampton County, PA",Nov-19,163805,156802,7003,4.3
28043,CN4209700000000,42,97,"Northumberland County, PA",Nov-19,42750,40293,2457,5.7
28044,CN4209900000000,42,99,"Perry County, PA",Nov-19,24698,23788,910,3.7
28045,CN4210100000000,42,101,"Philadelphia County/city, PA",Nov-19,733292,692512,40780,5.6
28046,CN4210300000000,42,103,"Pike County, PA",Nov-19,25465,24031,1434,5.6
28047,CN4210500000000,42,105,"Potter County, PA",Nov-19,7118,6681,437,6.1
28048,CN4210700000000,42,107,"Schuylkill County, PA",Nov-19,66547,62923,3624,5.4
28049,CN4210900000000,42,109,"Snyder County, PA",Nov-19,20192,19213,979,4.8
28050,CN4211100000000,42,111,"Somerset County, PA",Nov-19,33529,31702,1827,5.4
28051,CN4211300000000,42,113,"Sullivan County, PA",Nov-19,2658,2497,161,6.1
28052,CN4211500000000,42,115,"Susquehanna County, PA",Nov-19,20478,19601,877,4.3
28053,CN4211700000000,42,117,"Tioga County, PA",Nov-19,19277,18266,1011,5.2
28054,CN4211900000000,42,119,"Union County, PA",Nov-19,20015,19261,754,3.8
28055,CN4212100000000,42,121,"Venango County, PA",Nov-19,22311,21158,1153,5.2
28056,CN4212300000000,42,123,"Warren County, PA",Nov-19,18859,17996,863,4.6
28057,CN4212500000000,42,125,"Washington County, PA",Nov-19,108144,103183,4961,4.6
28058,CN4212700000000,42,127,"Wayne County, PA",Nov-19,21984,20982,1002,4.6
28059,CN4212900000000,42,129,"Westmoreland County, PA",Nov-19,182665,174577,8088,4.4
28060,CN4213100000000,42,131,"Wyoming County, PA",Nov-19,13721,13049,672,4.9
28061,CN4213300000000,42,133,"York County, PA",Nov-19,238331,229333,8998,3.8
28062,CN4400100000000,44,1,"Bristol County, RI",Nov-19,26301,25547,754,2.9
28063,CN4400300000000,44,3,"Kent County, RI",Nov-19,91638,88933,2705,3.0
28064,CN4400500000000,44,5,"Newport County, RI",Nov-19,44690,43451,1239,2.8
28065,CN4400700000000,44,7,"Providence County, RI",Nov-19,328354,316914,11440,3.5
28066,CN4400900000000,44,9,"Washington County, RI",Nov-19,69503,67409,2094,3.0
28067,CN4500100000000,45,1,"Abbeville County, SC",Nov-19,10104,9802,302,3.0
28068,CN4500300000000,45,3,"Aiken County, SC",Nov-19,74754,73038,1716,2.3
28069,CN4500500000000,45,5,"Allendale County, SC",Nov-19,2644,2527,117,4.4
28070,CN4500700000000,45,7,"Anderson County, SC",Nov-19,91561,89578,1983,2.2
28071,CN4500900000000,45,9,"Bamberg County, SC",Nov-19,4933,4704,229,4.6
28072,CN4501100000000,45,11,"Barnwell County, SC",Nov-19,8157,7876,281,3.4
28073,CN4501300000000,45,13,"Beaufort County, SC",Nov-19,77607,76027,1580,2.0
28074,CN4501500000000,45,15,"Berkeley County, SC",Nov-19,104458,102325,2133,2.0
28075,CN4501700000000,45,17,"Calhoun County, SC",Nov-19,6600,6418,182,2.8
28076,CN4501900000000,45,19,"Charleston County, SC",Nov-19,211899,208118,3781,1.8
28077,CN4502100000000,45,21,"Cherokee County, SC",Nov-19,25289,24654,635,2.5
28078,CN4502300000000,45,23,"Chester County, SC",Nov-19,13478,13019,459,3.4
28079,CN4502500000000,45,25,"Chesterfield County, SC",Nov-19,21903,21401,502,2.3
28080,CN4502700000000,45,27,"Clarendon County, SC",Nov-19,12641,12235,406,3.2
28081,CN4502900000000,45,29,"Colleton County, SC",Nov-19,16694,16269,425,2.5
28082,CN4503100000000,45,31,"Darlington County, SC",Nov-19,30439,29616,823,2.7
28083,CN4503300000000,45,33,"Dillon County, SC",Nov-19,12969,12535,434,3.3
28084,CN4503500000000,45,35,"Dorchester County, SC",Nov-19,78389,76867,1522,1.9
28085,CN4503700000000,45,37,"Edgefield County, SC",Nov-19,10671,10433,238,2.2
28086,CN4503900000000,45,39,"Fairfield County, SC",Nov-19,9626,9281,345,3.6
28087,CN4504100000000,45,41,"Florence County, SC",Nov-19,66991,65446,1545,2.3
28088,CN4504300000000,45,43,"Georgetown County, SC",Nov-19,25458,24714,744,2.9
28089,CN4504500000000,45,45,"Greenville County, SC",Nov-19,256029,251056,4973,1.9
28090,CN4504700000000,45,47,"Greenwood County, SC",Nov-19,31514,30708,806,2.6
28091,CN4504900000000,45,49,"Hampton County, SC",Nov-19,8356,8180,176,2.1
28092,CN4505100000000,45,51,"Horry County, SC",Nov-19,145239,141181,4058,2.8
28093,CN4505300000000,45,53,"Jasper County, SC",Nov-19,12562,12327,235,1.9
28094,CN4505500000000,45,55,"Kershaw County, SC",Nov-19,29398,28702,696,2.4
28095,CN4505700000000,45,57,"Lancaster County, SC",Nov-19,41483,40332,1151,2.8
28096,CN4505900000000,45,59,"Laurens County, SC",Nov-19,30280,29529,751,2.5
28097,CN4506100000000,45,61,"Lee County, SC",Nov-19,6632,6394,238,3.6
28098,CN4506300000000,45,63,"Lexington County, SC",Nov-19,150943,148155,2788,1.8
28099,CN4506500000000,45,65,"McCormick County, SC",Nov-19,3357,3274,83,2.5
28100,CN4506700000000,45,67,"Marion County, SC",Nov-19,12812,12383,429,3.3
28101,CN4506900000000,45,69,"Marlboro County, SC",Nov-19,9185,8851,334,3.6
28102,CN4507100000000,45,71,"Newberry County, SC",Nov-19,19111,18673,438,2.3
28103,CN4507300000000,45,73,"Oconee County, SC",Nov-19,35230,34478,752,2.1
28104,CN4507500000000,45,75,"Orangeburg County, SC",Nov-19,34763,33373,1390,4.0
28105,CN4507700000000,45,77,"Pickens County, SC",Nov-19,57671,56334,1337,2.3
28106,CN4507900000000,45,79,"Richland County, SC",Nov-19,200123,195721,4402,2.2
28107,CN4508100000000,45,81,"Saluda County, SC",Nov-19,8910,8711,199,2.2
28108,CN4508300000000,45,83,"Spartanburg County, SC",Nov-19,153532,150364,3168,2.1
28109,CN4508500000000,45,85,"Sumter County, SC",Nov-19,43661,42451,1210,2.8
28110,CN4508700000000,45,87,"Union County, SC",Nov-19,11649,11326,323,2.8
28111,CN4508900000000,45,89,"Williamsburg County, SC",Nov-19,11815,11367,448,3.8
28112,CN4509100000000,45,91,"York County, SC",Nov-19,141067,137920,3147,2.2
28113,CN4600300000000,46,3,"Aurora County, SD",Nov-19,1500,1458,42,2.8
28114,CN4600500000000,46,5,"Beadle County, SD",Nov-19,9548,9249,299,3.1
28115,CN4600700000000,46,7,"Bennett County, SD",Nov-19,1105,1041,64,5.8
28116,CN4600900000000,46,9,"Bon Homme County, SD",Nov-19,2850,2752,98,3.4
28117,CN4601100000000,46,11,"Brookings County, SD",Nov-19,19770,19071,699,3.5
28118,CN4601300000000,46,13,"Brown County, SD",Nov-19,20878,20243,635,3.0
28119,CN4601500000000,46,15,"Brule County, SD",Nov-19,2450,2377,73,3.0
28120,CN4601700000000,46,17,"Buffalo County, SD",Nov-19,685,627,58,8.5
28121,CN4601900000000,46,19,"Butte County, SD",Nov-19,5043,4861,182,3.6
28122,CN4602100000000,46,21,"Campbell County, SD",Nov-19,765,738,27,3.5
28123,CN4602300000000,46,23,"Charles Mix County, SD",Nov-19,3725,3569,156,4.2
28124,CN4602500000000,46,25,"Clark County, SD",Nov-19,1900,1838,62,3.3
28125,CN4602700000000,46,27,"Clay County, SD",Nov-19,7851,7561,290,3.7
28126,CN4602900000000,46,29,"Codington County, SD",Nov-19,15631,15179,452,2.9
28127,CN4603100000000,46,31,"Corson County, SD",Nov-19,1388,1305,83,6.0
28128,CN4603300000000,46,33,"Custer County, SD",Nov-19,3971,3797,174,4.4
28129,CN4603500000000,46,35,"Davison County, SD",Nov-19,11116,10797,319,2.9
28130,CN4603700000000,46,37,"Day County, SD",Nov-19,2757,2647,110,4.0
28131,CN4603900000000,46,39,"Deuel County, SD",Nov-19,2141,2064,77,3.6
28132,CN4604100000000,46,41,"Dewey County, SD",Nov-19,2232,2066,166,7.4
28133,CN4604300000000,46,43,"Douglas County, SD",Nov-19,1572,1531,41,2.6
28134,CN4604500000000,46,45,"Edmunds County, SD",Nov-19,2031,1975,56,2.8
28135,CN4604700000000,46,47,"Fall River County, SD",Nov-19,2893,2769,124,4.3
28136,CN4604900000000,46,49,"Faulk County, SD",Nov-19,1060,1023,37,3.5
28137,CN4605100000000,46,51,"Grant County, SD",Nov-19,4413,4289,124,2.8
28138,CN4605300000000,46,53,"Gregory County, SD",Nov-19,2107,2039,68,3.2
28139,CN4605500000000,46,55,"Haakon County, SD",Nov-19,1057,1024,33,3.1
28140,CN4605700000000,46,57,"Hamlin County, SD",Nov-19,3374,3279,95,2.8
28141,CN4605900000000,46,59,"Hand County, SD",Nov-19,1805,1753,52,2.9
28142,CN4606100000000,46,61,"Hanson County, SD",Nov-19,1741,1658,83,4.8
28143,CN4606300000000,46,63,"Harding County, SD",Nov-19,727,706,21,2.9
28144,CN4606500000000,46,65,"Hughes County, SD",Nov-19,10052,9789,263,2.6
28145,CN4606700000000,46,67,"Hutchinson County, SD",Nov-19,3577,3473,104,2.9
28146,CN4606900000000,46,69,"Hyde County, SD",Nov-19,677,656,21,3.1
28147,CN4607100000000,46,71,"Jackson County, SD",Nov-19,1198,1121,77,6.4
28148,CN4607300000000,46,73,"Jerauld County, SD",Nov-19,1117,1086,31,2.8
28149,CN4607500000000,46,75,"Jones County, SD",Nov-19,527,512,15,2.8
28150,CN4607700000000,46,77,"Kingsbury County, SD",Nov-19,2627,2552,75,2.9
28151,CN4607900000000,46,79,"Lake County, SD",Nov-19,6782,6543,239,3.5
28152,CN4608100000000,46,81,"Lawrence County, SD",Nov-19,13426,12976,450,3.4
28153,CN4608300000000,46,83,"Lincoln County, SD",Nov-19,34961,34075,886,2.5
28154,CN4608500000000,46,85,"Lyman County, SD",Nov-19,1695,1622,73,4.3
28155,CN4608700000000,46,87,"McCook County, SD",Nov-19,3088,3003,85,2.8
28156,CN4608900000000,46,89,"McPherson County, SD",Nov-19,1009,963,46,4.6
28157,CN4609100000000,46,91,"Marshall County, SD",Nov-19,2365,2280,85,3.6
28158,CN4609300000000,46,93,"Meade County, SD",Nov-19,14051,13566,485,3.5
28159,CN4609500000000,46,95,"Mellette County, SD",Nov-19,741,689,52,7.0
28160,CN4609700000000,46,97,"Miner County, SD",Nov-19,1189,1150,39,3.3
28161,CN4609900000000,46,99,"Minnehaha County, SD",Nov-19,114338,111092,3246,2.8
28162,CN4610100000000,46,101,"Moody County, SD",Nov-19,4029,3902,127,3.2
28163,CN4610200000000,46,102,"Oglala Lakota County, SD",Nov-19,3625,3243,382,10.5
28164,CN4610300000000,46,103,"Pennington County, SD",Nov-19,56602,54604,1998,3.5
28165,CN4610500000000,46,105,"Perkins County, SD",Nov-19,1410,1364,46,3.3
28166,CN4610700000000,46,107,"Potter County, SD",Nov-19,1036,1001,35,3.4
28167,CN4610900000000,46,109,"Roberts County, SD",Nov-19,4948,4751,197,4.0
28168,CN4611100000000,46,111,"Sanborn County, SD",Nov-19,1144,1109,35,3.1
28169,CN4611500000000,46,115,"Spink County, SD",Nov-19,3133,3035,98,3.1
28170,CN4611700000000,46,117,"Stanley County, SD",Nov-19,1838,1790,48,2.6
28171,CN4611900000000,46,119,"Sully County, SD",Nov-19,790,769,21,2.7
28172,CN4612100000000,46,121,"Todd County, SD",Nov-19,3164,2950,214,6.8
28173,CN4612300000000,46,123,"Tripp County, SD",Nov-19,3070,2985,85,2.8
28174,CN4612500000000,46,125,"Turner County, SD",Nov-19,4714,4577,137,2.9
28175,CN4612700000000,46,127,"Union County, SD",Nov-19,8644,8331,313,3.6
28176,CN4612900000000,46,129,"Walworth County, SD",Nov-19,2106,2006,100,4.7
28177,CN4613500000000,46,135,"Yankton County, SD",Nov-19,11949,11598,351,2.9
28178,CN4613700000000,46,137,"Ziebach County, SD",Nov-19,939,885,54,5.8
28179,CN4700100000000,47,1,"Anderson County, TN",Nov-19,35045,33924,1121,3.2
28180,CN4700300000000,47,3,"Bedford County, TN",Nov-19,21327,20598,729,3.4
28181,CN4700500000000,47,5,"Benton County, TN",Nov-19,6899,6627,272,3.9
28182,CN4700700000000,47,7,"Bledsoe County, TN",Nov-19,4471,4247,224,5.0
28183,CN4700900000000,47,9,"Blount County, TN",Nov-19,64482,62598,1884,2.9
28184,CN4701100000000,47,11,"Bradley County, TN",Nov-19,54464,52807,1657,3.0
28185,CN4701300000000,47,13,"Campbell County, TN",Nov-19,15067,14412,655,4.3
28186,CN4701500000000,47,15,"Cannon County, TN",Nov-19,6777,6590,187,2.8
28187,CN4701700000000,47,17,"Carroll County, TN",Nov-19,12121,11618,503,4.1
28188,CN4701900000000,47,19,"Carter County, TN",Nov-19,24276,23416,860,3.5
28189,CN4702100000000,47,21,"Cheatham County, TN",Nov-19,22430,21893,537,2.4
28190,CN4702300000000,47,23,"Chester County, TN",Nov-19,8684,8407,277,3.2
28191,CN4702500000000,47,25,"Claiborne County, TN",Nov-19,13222,12708,514,3.9
28192,CN4702700000000,47,27,"Clay County, TN",Nov-19,2813,2653,160,5.7
28193,CN4702900000000,47,29,"Cocke County, TN",Nov-19,15013,14420,593,3.9
28194,CN4703100000000,47,31,"Coffee County, TN",Nov-19,25930,25084,846,3.3
28195,CN4703300000000,47,33,"Crockett County, TN",Nov-19,7188,6960,228,3.2
28196,CN4703500000000,47,35,"Cumberland County, TN",Nov-19,23880,22850,1030,4.3
28197,CN4703700000000,47,37,"Davidson County, TN",Nov-19,413696,404061,9635,2.3
28198,CN4703900000000,47,39,"Decatur County, TN",Nov-19,4596,4373,223,4.9
28199,CN4704100000000,47,41,"DeKalb County, TN",Nov-19,7843,7531,312,4.0
28200,CN4704300000000,47,43,"Dickson County, TN",Nov-19,27691,26951,740,2.7
28201,CN4704500000000,47,45,"Dyer County, TN",Nov-19,16698,15967,731,4.4
28202,CN4704700000000,47,47,"Fayette County, TN",Nov-19,19650,18948,702,3.6
28203,CN4704900000000,47,49,"Fentress County, TN",Nov-19,7733,7421,312,4.0
28204,CN4705100000000,47,51,"Franklin County, TN",Nov-19,20702,20026,676,3.3
28205,CN4705300000000,47,53,"Gibson County, TN",Nov-19,22458,21546,912,4.1
28206,CN4705500000000,47,55,"Giles County, TN",Nov-19,15175,14630,545,3.6
28207,CN4705700000000,47,57,"Grainger County, TN",Nov-19,9703,9346,357,3.7
28208,CN4705900000000,47,59,"Greene County, TN",Nov-19,29719,28508,1211,4.1
28209,CN4706100000000,47,61,"Grundy County, TN",Nov-19,5105,4905,200,3.9
28210,CN4706300000000,47,63,"Hamblen County, TN",Nov-19,28633,27595,1038,3.6
28211,CN4706500000000,47,65,"Hamilton County, TN",Nov-19,185417,179784,5633,3.0
28212,CN4706700000000,47,67,"Hancock County, TN",Nov-19,2156,2049,107,5.0
28213,CN4706900000000,47,69,"Hardeman County, TN",Nov-19,9684,9200,484,5.0
28214,CN4707100000000,47,71,"Hardin County, TN",Nov-19,10536,10113,423,4.0
28215,CN4707300000000,47,73,"Hawkins County, TN",Nov-19,23949,23009,940,3.9
28216,CN4707500000000,47,75,"Haywood County, TN",Nov-19,7882,7547,335,4.3
28217,CN4707700000000,47,77,"Henderson County, TN",Nov-19,12377,11885,492,4.0
28218,CN4707900000000,47,79,"Henry County, TN",Nov-19,14288,13737,551,3.9
28219,CN4708100000000,47,81,"Hickman County, TN",Nov-19,11744,11419,325,2.8
28220,CN4708300000000,47,83,"Houston County, TN",Nov-19,3341,3203,138,4.1
28221,CN4708500000000,47,85,"Humphreys County, TN",Nov-19,9003,8684,319,3.5
28222,CN4708700000000,47,87,"Jackson County, TN",Nov-19,4749,4555,194,4.1
28223,CN4708900000000,47,89,"Jefferson County, TN",Nov-19,24959,24148,811,3.2
28224,CN4709100000000,47,91,"Johnson County, TN",Nov-19,7832,7582,250,3.2
28225,CN4709300000000,47,93,"Knox County, TN",Nov-19,247278,240724,6554,2.7
28226,CN4709500000000,47,95,"Lake County, TN",Nov-19,1772,1689,83,4.7
28227,CN4709700000000,47,97,"Lauderdale County, TN",Nov-19,9893,9396,497,5.0
28228,CN4709900000000,47,99,"Lawrence County, TN",Nov-19,19678,18947,731,3.7
28229,CN4710100000000,47,101,"Lewis County, TN",Nov-19,5335,5162,173,3.2
28230,CN4710300000000,47,103,"Lincoln County, TN",Nov-19,16761,16021,740,4.4
28231,CN4710500000000,47,105,"Loudon County, TN",Nov-19,23976,23223,753,3.1
28232,CN4710700000000,47,107,"McMinn County, TN",Nov-19,23988,23155,833,3.5
28233,CN4710900000000,47,109,"McNairy County, TN",Nov-19,8665,8245,420,4.8
28234,CN4711100000000,47,111,"Macon County, TN",Nov-19,11744,11404,340,2.9
28235,CN4711300000000,47,113,"Madison County, TN",Nov-19,49425,47792,1633,3.3
28236,CN4711500000000,47,115,"Marion County, TN",Nov-19,12600,12087,513,4.1
28237,CN4711700000000,47,117,"Marshall County, TN",Nov-19,15897,15344,553,3.5
28238,CN4711900000000,47,119,"Maury County, TN",Nov-19,50644,49229,1415,2.8
28239,CN4712100000000,47,121,"Meigs County, TN",Nov-19,5246,5036,210,4.0
28240,CN4712300000000,47,123,"Monroe County, TN",Nov-19,20412,19707,705,3.5
28241,CN4712500000000,47,125,"Montgomery County, TN",Nov-19,86707,83629,3078,3.5
28242,CN4712700000000,47,127,"Moore County, TN",Nov-19,3707,3609,98,2.6
28243,CN4712900000000,47,129,"Morgan County, TN",Nov-19,8010,7722,288,3.6
28244,CN4713100000000,47,131,"Obion County, TN",Nov-19,12592,12092,500,4.0
28245,CN4713300000000,47,133,"Overton County, TN",Nov-19,10203,9876,327,3.2
28246,CN4713500000000,47,135,"Perry County, TN",Nov-19,3136,3003,133,4.2
28247,CN4713700000000,47,137,"Pickett County, TN",Nov-19,2410,2304,106,4.4
28248,CN4713900000000,47,139,"Polk County, TN",Nov-19,7862,7596,266,3.4
28249,CN4714100000000,47,141,"Putnam County, TN",Nov-19,35860,34735,1125,3.1
28250,CN4714300000000,47,143,"Rhea County, TN",Nov-19,13622,12991,631,4.6
28251,CN4714500000000,47,145,"Roane County, TN",Nov-19,23709,22863,846,3.6
28252,CN4714700000000,47,147,"Robertson County, TN",Nov-19,39148,38118,1030,2.6
28253,CN4714900000000,47,149,"Rutherford County, TN",Nov-19,188619,184095,4524,2.4
28254,CN4715100000000,47,151,"Scott County, TN",Nov-19,8309,7984,325,3.9
28255,CN4715300000000,47,153,"Sequatchie County, TN",Nov-19,6262,6015,247,3.9
28256,CN4715500000000,47,155,"Sevier County, TN",Nov-19,54890,53515,1375,2.5
28257,CN4715700000000,47,157,"Shelby County, TN",Nov-19,450811,434025,16786,3.7
28258,CN4715900000000,47,159,"Smith County, TN",Nov-19,9723,9462,261,2.7
28259,CN4716100000000,47,161,"Stewart County, TN",Nov-19,5575,5356,219,3.9
28260,CN4716300000000,47,163,"Sullivan County, TN",Nov-19,70666,68295,2371,3.4
28261,CN4716500000000,47,165,"Sumner County, TN",Nov-19,104891,102260,2631,2.5
28262,CN4716700000000,47,167,"Tipton County, TN",Nov-19,28632,27597,1035,3.6
28263,CN4716900000000,47,169,"Trousdale County, TN",Nov-19,5570,5421,149,2.7
28264,CN4717100000000,47,171,"Unicoi County, TN",Nov-19,7268,6940,328,4.5
28265,CN4717300000000,47,173,"Union County, TN",Nov-19,7725,7449,276,3.6
28266,CN4717500000000,47,175,"Van Buren County, TN",Nov-19,2065,1985,80,3.9
28267,CN4717700000000,47,177,"Warren County, TN",Nov-19,16909,16276,633,3.7
28268,CN4717900000000,47,179,"Washington County, TN",Nov-19,61210,59255,1955,3.2
28269,CN4718100000000,47,181,"Wayne County, TN",Nov-19,6282,6002,280,4.5
28270,CN4718300000000,47,183,"Weakley County, TN",Nov-19,16408,15844,564,3.4
28271,CN4718500000000,47,185,"White County, TN",Nov-19,12441,12018,423,3.4
28272,CN4718700000000,47,187,"Williamson County, TN",Nov-19,131645,128670,2975,2.3
28273,CN4718900000000,47,189,"Wilson County, TN",Nov-19,78634,76686,1948,2.5
28274,CN4800100000000,48,1,"Anderson County, TX",Nov-19,24148,23468,680,2.8
28275,CN4800300000000,48,3,"Andrews County, TX",Nov-19,9863,9632,231,2.3
28276,CN4800500000000,48,5,"Angelina County, TX",Nov-19,36071,34659,1412,3.9
28277,CN4800700000000,48,7,"Aransas County, TX",Nov-19,9445,9072,373,3.9
28278,CN4800900000000,48,9,"Archer County, TX",Nov-19,4154,4043,111,2.7
28279,CN4801100000000,48,11,"Armstrong County, TX",Nov-19,928,905,23,2.5
28280,CN4801300000000,48,13,"Atascosa County, TX",Nov-19,21929,21163,766,3.5
28281,CN4801500000000,48,15,"Austin County, TX",Nov-19,14222,13737,485,3.4
28282,CN4801700000000,48,17,"Bailey County, TX",Nov-19,2415,2333,82,3.4
28283,CN4801900000000,48,19,"Bandera County, TX",Nov-19,10155,9847,308,3.0
28284,CN4802100000000,48,21,"Bastrop County, TX",Nov-19,43397,42178,1219,2.8
28285,CN4802300000000,48,23,"Baylor County, TX",Nov-19,1783,1744,39,2.2
28286,CN4802500000000,48,25,"Bee County, TX",Nov-19,9848,9408,440,4.5
28287,CN4802700000000,48,27,"Bell County, TX",Nov-19,145914,140640,5274,3.6
28288,CN4802900000000,48,29,"Bexar County, TX",Nov-19,962122,933297,28825,3.0
28289,CN4803100000000,48,31,"Blanco County, TX",Nov-19,6486,6341,145,2.2
28290,CN4803300000000,48,33,"Borden County, TX",Nov-19,422,413,9,2.1
28291,CN4803500000000,48,35,"Bosque County, TX",Nov-19,8327,8046,281,3.4
28292,CN4803700000000,48,37,"Bowie County, TX",Nov-19,40176,38554,1622,4.0
28293,CN4803900000000,48,39,"Brazoria County, TX",Nov-19,181882,174206,7676,4.2
28294,CN4804100000000,48,41,"Brazos County, TX",Nov-19,123148,120063,3085,2.5
28295,CN4804300000000,48,43,"Brewster County, TX",Nov-19,4190,4079,111,2.6
28296,CN4804500000000,48,45,"Briscoe County, TX",Nov-19,563,544,19,3.4
28297,CN4804700000000,48,47,"Brooks County, TX",Nov-19,2569,2442,127,4.9
28298,CN4804900000000,48,49,"Brown County, TX",Nov-19,15509,14932,577,3.7
28299,CN4805100000000,48,51,"Burleson County, TX",Nov-19,8640,8364,276,3.2
28300,CN4805300000000,48,53,"Burnet County, TX",Nov-19,23638,23004,634,2.7
28301,CN4805500000000,48,55,"Caldwell County, TX",Nov-19,19904,19277,627,3.2
28302,CN4805700000000,48,57,"Calhoun County, TX",Nov-19,12196,11793,403,3.3
28303,CN4805900000000,48,59,"Callahan County, TX",Nov-19,6209,6028,181,2.9
28304,CN4806100000000,48,61,"Cameron County, TX",Nov-19,167329,158361,8968,5.4
28305,CN4806300000000,48,63,"Camp County, TX",Nov-19,5003,4794,209,4.2
28306,CN4806500000000,48,65,"Carson County, TX",Nov-19,3013,2938,75,2.5
28307,CN4806700000000,48,67,"Cass County, TX",Nov-19,12414,11900,514,4.1
28308,CN4806900000000,48,69,"Castro County, TX",Nov-19,3351,3268,83,2.5
28309,CN4807100000000,48,71,"Chambers County, TX",Nov-19,19696,18845,851,4.3
28310,CN4807300000000,48,73,"Cherokee County, TX",Nov-19,20929,20121,808,3.9
28311,CN4807500000000,48,75,"Childress County, TX",Nov-19,2911,2820,91,3.1
28312,CN4807700000000,48,77,"Clay County, TX",Nov-19,4938,4798,140,2.8
28313,CN4807900000000,48,79,"Cochran County, TX",Nov-19,1084,1049,35,3.2
28314,CN4808100000000,48,81,"Coke County, TX",Nov-19,1467,1422,45,3.1
28315,CN4808300000000,48,83,"Coleman County, TX",Nov-19,2847,2729,118,4.1
28316,CN4808500000000,48,85,"Collin County, TX",Nov-19,572761,556059,16702,2.9
28317,CN4808700000000,48,87,"Collingsworth County, TX",Nov-19,1144,1105,39,3.4
28318,CN4808900000000,48,89,"Colorado County, TX",Nov-19,9797,9508,289,2.9
28319,CN4809100000000,48,91,"Comal County, TX",Nov-19,74243,72119,2124,2.9
28320,CN4809300000000,48,93,"Comanche County, TX",Nov-19,5605,5414,191,3.4
28321,CN4809500000000,48,95,"Concho County, TX",Nov-19,1307,1269,38,2.9
28322,CN4809700000000,48,97,"Cooke County, TX",Nov-19,19784,19236,548,2.8
28323,CN4809900000000,48,99,"Coryell County, TX",Nov-19,24466,23544,922,3.8
28324,CN4810100000000,48,101,"Cottle County, TX",Nov-19,549,521,28,5.1
28325,CN4810300000000,48,103,"Crane County, TX",Nov-19,1577,1513,64,4.1
28326,CN4810500000000,48,105,"Crockett County, TX",Nov-19,1617,1561,56,3.5
28327,CN4810700000000,48,107,"Crosby County, TX",Nov-19,2464,2379,85,3.4
28328,CN4810900000000,48,109,"Culberson County, TX",Nov-19,1054,1012,42,4.0
28329,CN4811100000000,48,111,"Dallam County, TX",Nov-19,3837,3761,76,2.0
28330,CN4811300000000,48,113,"Dallas County, TX",Nov-19,1386025,1340838,45187,3.3
28331,CN4811500000000,48,115,"Dawson County, TX",Nov-19,4635,4455,180,3.9
28332,CN4811700000000,48,117,"Deaf Smith County, TX",Nov-19,8419,8191,228,2.7
28333,CN4811900000000,48,119,"Delta County, TX",Nov-19,2452,2369,83,3.4
28334,CN4812100000000,48,121,"Denton County, TX",Nov-19,502765,488652,14113,2.8
28335,CN4812300000000,48,123,"DeWitt County, TX",Nov-19,9777,9518,259,2.6
28336,CN4812500000000,48,125,"Dickens County, TX",Nov-19,664,636,28,4.2
28337,CN4812700000000,48,127,"Dimmit County, TX",Nov-19,7338,7151,187,2.5
28338,CN4812900000000,48,129,"Donley County, TX",Nov-19,1393,1348,45,3.2
28339,CN4813100000000,48,131,"Duval County, TX",Nov-19,4920,4691,229,4.7
28340,CN4813300000000,48,133,"Eastland County, TX",Nov-19,8201,7947,254,3.1
28341,CN4813500000000,48,135,"Ector County, TX",Nov-19,88379,85816,2563,2.9
28342,CN4813700000000,48,137,"Edwards County, TX",Nov-19,1132,1112,20,1.8
28343,CN4813900000000,48,139,"Ellis County, TX",Nov-19,94079,91364,2715,2.9
28344,CN4814100000000,48,141,"El Paso County, TX",Nov-19,367074,353523,13551,3.7
28345,CN4814300000000,48,143,"Erath County, TX",Nov-19,20957,20264,693,3.3
28346,CN4814500000000,48,145,"Falls County, TX",Nov-19,6588,6389,199,3.0
28347,CN4814700000000,48,147,"Fannin County, TX",Nov-19,17432,16975,457,2.6
28348,CN4814900000000,48,149,"Fayette County, TX",Nov-19,12000,11697,303,2.5
28349,CN4815100000000,48,151,"Fisher County, TX",Nov-19,1612,1568,44,2.7
28350,CN4815300000000,48,153,"Floyd County, TX",Nov-19,2516,2425,91,3.6
28351,CN4815500000000,48,155,"Foard County, TX",Nov-19,584,568,16,2.7
28352,CN4815700000000,48,157,"Fort Bend County, TX",Nov-19,396637,383473,13164,3.3
28353,CN4815900000000,48,159,"Franklin County, TX",Nov-19,4626,4464,162,3.5
28354,CN4816100000000,48,161,"Freestone County, TX",Nov-19,6367,6054,313,4.9
28355,CN4816300000000,48,163,"Frio County, TX",Nov-19,10324,10058,266,2.6
28356,CN4816500000000,48,165,"Gaines County, TX",Nov-19,9715,9480,235,2.4
28357,CN4816700000000,48,167,"Galveston County, TX",Nov-19,167238,160772,6466,3.9
28358,CN4816900000000,48,169,"Garza County, TX",Nov-19,2157,2100,57,2.6
28359,CN4817100000000,48,171,"Gillespie County, TX",Nov-19,13593,13283,310,2.3
28360,CN4817300000000,48,173,"Glasscock County, TX",Nov-19,774,759,15,1.9
28361,CN4817500000000,48,175,"Goliad County, TX",Nov-19,3283,3166,117,3.6
28362,CN4817700000000,48,177,"Gonzales County, TX",Nov-19,9484,9227,257,2.7
28363,CN4817900000000,48,179,"Gray County, TX",Nov-19,8054,7759,295,3.7
28364,CN4818100000000,48,181,"Grayson County, TX",Nov-19,64467,62526,1941,3.0
28365,CN4818300000000,48,183,"Gregg County, TX",Nov-19,58633,56528,2105,3.6
28366,CN4818500000000,48,185,"Grimes County, TX",Nov-19,11378,10934,444,3.9
28367,CN4818700000000,48,187,"Guadalupe County, TX",Nov-19,82531,80234,2297,2.8
28368,CN4818900000000,48,189,"Hale County, TX",Nov-19,11994,11493,501,4.2
28369,CN4819100000000,48,191,"Hall County, TX",Nov-19,1046,996,50,4.8
28370,CN4819300000000,48,193,"Hamilton County, TX",Nov-19,3634,3536,98,2.7
28371,CN4819500000000,48,195,"Hansford County, TX",Nov-19,2703,2643,60,2.2
28372,CN4819700000000,48,197,"Hardeman County, TX",Nov-19,1721,1670,51,3.0
28373,CN4819900000000,48,199,"Hardin County, TX",Nov-19,25500,24367,1133,4.4
28374,CN4820100000000,48,201,"Harris County, TX",Nov-19,2343231,2256589,86642,3.7
28375,CN4820300000000,48,203,"Harrison County, TX",Nov-19,29692,28521,1171,3.9
28376,CN4820500000000,48,205,"Hartley County, TX",Nov-19,2763,2715,48,1.7
28377,CN4820700000000,48,207,"Haskell County, TX",Nov-19,2270,2198,72,3.2
28378,CN4820900000000,48,209,"Hays County, TX",Nov-19,121499,118328,3171,2.6
28379,CN4821100000000,48,211,"Hemphill County, TX",Nov-19,1895,1842,53,2.8
28380,CN4821300000000,48,213,"Henderson County, TX",Nov-19,36778,35539,1239,3.4
28381,CN4821500000000,48,215,"Hidalgo County, TX",Nov-19,356747,334685,22062,6.2
28382,CN4821700000000,48,217,"Hill County, TX",Nov-19,16563,16049,514,3.1
28383,CN4821900000000,48,219,"Hockley County, TX",Nov-19,11210,10900,310,2.8
28384,CN4822100000000,48,221,"Hood County, TX",Nov-19,27974,27046,928,3.3
28385,CN4822300000000,48,223,"Hopkins County, TX",Nov-19,17607,17085,522,3.0
28386,CN4822500000000,48,225,"Houston County, TX",Nov-19,10488,10165,323,3.1
28387,CN4822700000000,48,227,"Howard County, TX",Nov-19,14107,13666,441,3.1
28388,CN4822900000000,48,229,"Hudspeth County, TX",Nov-19,1824,1745,79,4.3
28389,CN4823100000000,48,231,"Hunt County, TX",Nov-19,44059,42565,1494,3.4
28390,CN4823300000000,48,233,"Hutchinson County, TX",Nov-19,8731,8360,371,4.2
28391,CN4823500000000,48,235,"Irion County, TX",Nov-19,754,738,16,2.1
28392,CN4823700000000,48,237,"Jack County, TX",Nov-19,3435,3318,117,3.4
28393,CN4823900000000,48,239,"Jackson County, TX",Nov-19,7652,7427,225,2.9
28394,CN4824100000000,48,241,"Jasper County, TX",Nov-19,12845,12069,776,6.0
28395,CN4824300000000,48,243,"Jeff Davis County, TX",Nov-19,985,954,31,3.1
28396,CN4824500000000,48,245,"Jefferson County, TX",Nov-19,107505,101593,5912,5.5
28397,CN4824700000000,48,247,"Jim Hogg County, TX",Nov-19,1870,1785,85,4.5
28398,CN4824900000000,48,249,"Jim Wells County, TX",Nov-19,16678,15836,842,5.0
28399,CN4825100000000,48,251,"Johnson County, TX",Nov-19,83581,80974,2607,3.1
28400,CN4825300000000,48,253,"Jones County, TX",Nov-19,5798,5571,227,3.9
28401,CN4825500000000,48,255,"Karnes County, TX",Nov-19,7343,7159,184,2.5
28402,CN4825700000000,48,257,"Kaufman County, TX",Nov-19,65668,63603,2065,3.1
28403,CN4825900000000,48,259,"Kendall County, TX",Nov-19,22328,21748,580,2.6
28404,CN4826100000000,48,261,"Kenedy County, TX",Nov-19,200,191,9,4.5
28405,CN4826300000000,48,263,"Kent County, TX",Nov-19,471,458,13,2.8
28406,CN4826500000000,48,265,"Kerr County, TX",Nov-19,22417,21775,642,2.9
28407,CN4826700000000,48,267,"Kimble County, TX",Nov-19,1833,1776,57,3.1
28408,CN4826900000000,48,269,"King County, TX",Nov-19,230,226,4,1.7
28409,CN4827100000000,48,271,"Kinney County, TX",Nov-19,1381,1331,50,3.6
28410,CN4827300000000,48,273,"Kleberg County, TX",Nov-19,13628,13043,585,4.3
28411,CN4827500000000,48,275,"Knox County, TX",Nov-19,1402,1358,44,3.1
28412,CN4827700000000,48,277,"Lamar County, TX",Nov-19,24302,23505,797,3.3
28413,CN4827900000000,48,279,"Lamb County, TX",Nov-19,5226,5046,180,3.4
28414,CN4828100000000,48,281,"Lampasas County, TX",Nov-19,9329,9028,301,3.2
28415,CN4828300000000,48,283,"La Salle County, TX",Nov-19,4302,4185,117,2.7
28416,CN4828500000000,48,285,"Lavaca County, TX",Nov-19,8472,8229,243,2.9
28417,CN4828700000000,48,287,"Lee County, TX",Nov-19,10023,9756,267,2.7
28418,CN4828900000000,48,289,"Leon County, TX",Nov-19,6325,6058,267,4.2
28419,CN4829100000000,48,291,"Liberty County, TX",Nov-19,33452,31787,1665,5.0
28420,CN4829300000000,48,293,"Limestone County, TX",Nov-19,8622,8292,330,3.8
28421,CN4829500000000,48,295,"Lipscomb County, TX",Nov-19,1606,1567,39,2.4
28422,CN4829700000000,48,297,"Live Oak County, TX",Nov-19,5650,5479,171,3.0
28423,CN4829900000000,48,299,"Llano County, TX",Nov-19,8700,8424,276,3.2
28424,CN4830100000000,48,301,"Loving County, TX",Nov-19,654,650,4,0.6
28425,CN4830300000000,48,303,"Lubbock County, TX",Nov-19,159358,155193,4165,2.6
28426,CN4830500000000,48,305,"Lynn County, TX",Nov-19,2754,2677,77,2.8
28427,CN4830700000000,48,307,"McCulloch County, TX",Nov-19,3339,3180,159,4.8
28428,CN4830900000000,48,309,"McLennan County, TX",Nov-19,120631,116878,3753,3.1
28429,CN4831100000000,48,311,"McMullen County, TX",Nov-19,888,873,15,1.7
28430,CN4831300000000,48,313,"Madison County, TX",Nov-19,4532,4351,181,4.0
28431,CN4831500000000,48,315,"Marion County, TX",Nov-19,4250,4064,186,4.4
28432,CN4831700000000,48,317,"Martin County, TX",Nov-19,2891,2808,83,2.9
28433,CN4831900000000,48,319,"Mason County, TX",Nov-19,1744,1690,54,3.1
28434,CN4832100000000,48,321,"Matagorda County, TX",Nov-19,16749,15792,957,5.7
28435,CN4832300000000,48,323,"Maverick County, TX",Nov-19,23914,22238,1676,7.0
28436,CN4832500000000,48,325,"Medina County, TX",Nov-19,22048,21377,671,3.0
28437,CN4832700000000,48,327,"Menard County, TX",Nov-19,869,840,29,3.3
28438,CN4832900000000,48,329,"Midland County, TX",Nov-19,108232,105951,2281,2.1
28439,CN4833100000000,48,331,"Milam County, TX",Nov-19,9701,9274,427,4.4
28440,CN4833300000000,48,333,"Mills County, TX",Nov-19,1906,1846,60,3.1
28441,CN4833500000000,48,335,"Mitchell County, TX",Nov-19,2328,2243,85,3.7
28442,CN4833700000000,48,337,"Montague County, TX",Nov-19,9399,9143,256,2.7
28443,CN4833900000000,48,339,"Montgomery County, TX",Nov-19,287306,277749,9557,3.3
28444,CN4834100000000,48,341,"Moore County, TX",Nov-19,10832,10586,246,2.3
28445,CN4834300000000,48,343,"Morris County, TX",Nov-19,4805,4565,240,5.0
28446,CN4834500000000,48,345,"Motley County, TX",Nov-19,471,455,16,3.4
28447,CN4834700000000,48,347,"Nacogdoches County, TX",Nov-19,28231,27211,1020,3.6
28448,CN4834900000000,48,349,"Navarro County, TX",Nov-19,24593,23883,710,2.9
28449,CN4835100000000,48,351,"Newton County, TX",Nov-19,5201,4893,308,5.9
28450,CN4835300000000,48,353,"Nolan County, TX",Nov-19,7209,7001,208,2.9
28451,CN4835500000000,48,355,"Nueces County, TX",Nov-19,168435,161845,6590,3.9
28452,CN4835700000000,48,357,"Ochiltree County, TX",Nov-19,4312,4186,126,2.9
28453,CN4835900000000,48,359,"Oldham County, TX",Nov-19,916,890,26,2.8
28454,CN4836100000000,48,361,"Orange County, TX",Nov-19,36662,34823,1839,5.0
28455,CN4836300000000,48,363,"Palo Pinto County, TX",Nov-19,13625,13223,402,3.0
28456,CN4836500000000,48,365,"Panola County, TX",Nov-19,10139,9720,419,4.1
28457,CN4836700000000,48,367,"Parker County, TX",Nov-19,68425,66491,1934,2.8
28458,CN4836900000000,48,369,"Parmer County, TX",Nov-19,4813,4708,105,2.2
28459,CN4837100000000,48,371,"Pecos County, TX",Nov-19,6358,6131,227,3.6
28460,CN4837300000000,48,373,"Polk County, TX",Nov-19,18200,17338,862,4.7
28461,CN4837500000000,48,375,"Potter County, TX",Nov-19,55722,54246,1476,2.6
28462,CN4837700000000,48,377,"Presidio County, TX",Nov-19,3137,2889,248,7.9
28463,CN4837900000000,48,379,"Rains County, TX",Nov-19,6027,5860,167,2.8
28464,CN4838100000000,48,381,"Randall County, TX",Nov-19,72723,71054,1669,2.3
28465,CN4838300000000,48,383,"Reagan County, TX",Nov-19,1907,1856,51,2.7
28466,CN4838500000000,48,385,"Real County, TX",Nov-19,995,956,39,3.9
28467,CN4838700000000,48,387,"Red River County, TX",Nov-19,5138,4910,228,4.4
28468,CN4838900000000,48,389,"Reeves County, TX",Nov-19,12051,11839,212,1.8
28469,CN4839100000000,48,391,"Refugio County, TX",Nov-19,3123,3009,114,3.7
28470,CN4839300000000,48,393,"Roberts County, TX",Nov-19,415,405,10,2.4
28471,CN4839500000000,48,395,"Robertson County, TX",Nov-19,7866,7606,260,3.3
28472,CN4839700000000,48,397,"Rockwall County, TX",Nov-19,52915,51363,1552,2.9
28473,CN4839900000000,48,399,"Runnels County, TX",Nov-19,4595,4466,129,2.8
28474,CN4840100000000,48,401,"Rusk County, TX",Nov-19,23193,22354,839,3.6
28475,CN4840300000000,48,403,"Sabine County, TX",Nov-19,3663,3423,240,6.6
28476,CN4840500000000,48,405,"San Augustine County, TX",Nov-19,3424,3249,175,5.1
28477,CN4840700000000,48,407,"San Jacinto County, TX",Nov-19,11854,11313,541,4.6
28478,CN4840900000000,48,409,"San Patricio County, TX",Nov-19,30024,28481,1543,5.1
28479,CN4841100000000,48,411,"San Saba County, TX",Nov-19,2564,2492,72,2.8
28480,CN4841300000000,48,413,"Schleicher County, TX",Nov-19,1299,1258,41,3.2
28481,CN4841500000000,48,415,"Scurry County, TX",Nov-19,6731,6518,213,3.2
28482,CN4841700000000,48,417,"Shackelford County, TX",Nov-19,1875,1834,41,2.2
28483,CN4841900000000,48,419,"Shelby County, TX",Nov-19,11213,10773,440,3.9
28484,CN4842100000000,48,421,"Sherman County, TX",Nov-19,1351,1319,32,2.4
28485,CN4842300000000,48,423,"Smith County, TX",Nov-19,108146,104653,3493,3.2
28486,CN4842500000000,48,425,"Somervell County, TX",Nov-19,4432,4283,149,3.4
28487,CN4842700000000,48,427,"Starr County, TX",Nov-19,25426,22643,2783,10.9
28488,CN4842900000000,48,429,"Stephens County, TX",Nov-19,4036,3922,114,2.8
28489,CN4843100000000,48,431,"Sterling County, TX",Nov-19,561,542,19,3.4
28490,CN4843300000000,48,433,"Stonewall County, TX",Nov-19,564,546,18,3.2
28491,CN4843500000000,48,435,"Sutton County, TX",Nov-19,1296,1239,57,4.4
28492,CN4843700000000,48,437,"Swisher County, TX",Nov-19,2575,2481,94,3.7
28493,CN4843900000000,48,439,"Tarrant County, TX",Nov-19,1100806,1066663,34143,3.1
28494,CN4844100000000,48,441,"Taylor County, TX",Nov-19,68204,66341,1863,2.7
28495,CN4844300000000,48,443,"Terrell County, TX",Nov-19,371,358,13,3.5
28496,CN4844500000000,48,445,"Terry County, TX",Nov-19,4909,4739,170,3.5
28497,CN4844700000000,48,447,"Throckmorton County, TX",Nov-19,640,615,25,3.9
28498,CN4844900000000,48,449,"Titus County, TX",Nov-19,13094,12585,509,3.9
28499,CN4845100000000,48,451,"Tom Green County, TX",Nov-19,54772,53163,1609,2.9
28500,CN4845300000000,48,453,"Travis County, TX",Nov-19,751192,732931,18261,2.4
28501,CN4845500000000,48,455,"Trinity County, TX",Nov-19,5327,5057,270,5.1
28502,CN4845700000000,48,457,"Tyler County, TX",Nov-19,7129,6711,418,5.9
28503,CN4845900000000,48,459,"Upshur County, TX",Nov-19,18011,17331,680,3.8
28504,CN4846100000000,48,461,"Upton County, TX",Nov-19,1675,1634,41,2.4
28505,CN4846300000000,48,463,"Uvalde County, TX",Nov-19,11350,10950,400,3.5
28506,CN4846500000000,48,465,"Val Verde County, TX",Nov-19,23099,22314,785,3.4
28507,CN4846700000000,48,467,"Van Zandt County, TX",Nov-19,26090,25269,821,3.1
28508,CN4846900000000,48,469,"Victoria County, TX",Nov-19,43066,41543,1523,3.5
28509,CN4847100000000,48,471,"Walker County, TX",Nov-19,24393,23490,903,3.7
28510,CN4847300000000,48,473,"Waller County, TX",Nov-19,23690,22828,862,3.6
28511,CN4847500000000,48,475,"Ward County, TX",Nov-19,7584,7398,186,2.5
28512,CN4847700000000,48,477,"Washington County, TX",Nov-19,15237,14768,469,3.1
28513,CN4847900000000,48,479,"Webb County, TX",Nov-19,119514,115308,4206,3.5
28514,CN4848100000000,48,481,"Wharton County, TX",Nov-19,21766,21037,729,3.3
28515,CN4848300000000,48,483,"Wheeler County, TX",Nov-19,2239,2163,76,3.4
28516,CN4848500000000,48,485,"Wichita County, TX",Nov-19,56729,55047,1682,3.0
28517,CN4848700000000,48,487,"Wilbarger County, TX",Nov-19,4958,4788,170,3.4
28518,CN4848900000000,48,489,"Willacy County, TX",Nov-19,6650,6181,469,7.1
28519,CN4849100000000,48,491,"Williamson County, TX",Nov-19,318419,309903,8516,2.7
28520,CN4849300000000,48,493,"Wilson County, TX",Nov-19,25183,24487,696,2.8
28521,CN4849500000000,48,495,"Winkler County, TX",Nov-19,4051,3930,121,3.0
28522,CN4849700000000,48,497,"Wise County, TX",Nov-19,32358,31363,995,3.1
28523,CN4849900000000,48,499,"Wood County, TX",Nov-19,17796,17119,677,3.8
28524,CN4850100000000,48,501,"Yoakum County, TX",Nov-19,3640,3529,111,3.0
28525,CN4850300000000,48,503,"Young County, TX",Nov-19,8050,7816,234,2.9
28526,CN4850500000000,48,505,"Zapata County, TX",Nov-19,4856,4590,266,5.5
28527,CN4850700000000,48,507,"Zavala County, TX",Nov-19,3323,3053,270,8.1
28528,CN4900100000000,49,1,"Beaver County, UT",Nov-19,2793,2729,64,2.3
28529,CN4900300000000,49,3,"Box Elder County, UT",Nov-19,26058,25530,528,2.0
28530,CN4900500000000,49,5,"Cache County, UT",Nov-19,65258,64194,1064,1.6
28531,CN4900700000000,49,7,"Carbon County, UT",Nov-19,8551,8305,246,2.9
28532,CN4900900000000,49,9,"Daggett County, UT",Nov-19,361,348,13,3.6
28533,CN4901100000000,49,11,"Davis County, UT",Nov-19,175536,172121,3415,1.9
28534,CN4901300000000,49,13,"Duchesne County, UT",Nov-19,7825,7576,249,3.2
28535,CN4901500000000,49,15,"Emery County, UT",Nov-19,4266,4132,134,3.1
28536,CN4901700000000,49,17,"Garfield County, UT",Nov-19,2534,2394,140,5.5
28537,CN4901900000000,49,19,"Grand County, UT",Nov-19,5992,5800,192,3.2
28538,CN4902100000000,49,21,"Iron County, UT",Nov-19,24879,24326,553,2.2
28539,CN4902300000000,49,23,"Juab County, UT",Nov-19,5835,5731,104,1.8
28540,CN4902500000000,49,25,"Kane County, UT",Nov-19,3673,3588,85,2.3
28541,CN4902700000000,49,27,"Millard County, UT",Nov-19,5853,5726,127,2.2
28542,CN4902900000000,49,29,"Morgan County, UT",Nov-19,5608,5503,105,1.9
28543,CN4903100000000,49,31,"Piute County, UT",Nov-19,483,462,21,4.3
28544,CN4903300000000,49,33,"Rich County, UT",Nov-19,1027,995,32,3.1
28545,CN4903500000000,49,35,"Salt Lake County, UT",Nov-19,644632,631537,13095,2.0
28546,CN4903700000000,49,37,"San Juan County, UT",Nov-19,5563,5326,237,4.3
28547,CN4903900000000,49,39,"Sanpete County, UT",Nov-19,12438,12123,315,2.5
28548,CN4904100000000,49,41,"Sevier County, UT",Nov-19,9686,9463,223,2.3
28549,CN4904300000000,49,43,"Summit County, UT",Nov-19,24657,24089,568,2.3
28550,CN4904500000000,49,45,"Tooele County, UT",Nov-19,34496,33722,774,2.2
28551,CN4904700000000,49,47,"Uintah County, UT",Nov-19,13615,13100,515,3.8
28552,CN4904900000000,49,49,"Utah County, UT",Nov-19,314426,308533,5893,1.9
28553,CN4905100000000,49,51,"Wasatch County, UT",Nov-19,16417,16033,384,2.3
28554,CN4905300000000,49,53,"Washington County, UT",Nov-19,77464,75633,1831,2.4
28555,CN4905500000000,49,55,"Wayne County, UT",Nov-19,1358,1292,66,4.9
28556,CN4905700000000,49,57,"Weber County, UT",Nov-19,128437,125656,2781,2.2
28557,CN5000100000000,50,1,"Addison County, VT",Nov-19,20414,19984,430,2.1
28558,CN5000300000000,50,3,"Bennington County, VT",Nov-19,17737,17176,561,3.2
28559,CN5000500000000,50,5,"Caledonia County, VT",Nov-19,14332,13979,353,2.5
28560,CN5000700000000,50,7,"Chittenden County, VT",Nov-19,96047,94355,1692,1.8
28561,CN5000900000000,50,9,"Essex County, VT",Nov-19,2644,2570,74,2.8
28562,CN5001100000000,50,11,"Franklin County, VT",Nov-19,27062,26484,578,2.1
28563,CN5001300000000,50,13,"Grand Isle County, VT",Nov-19,4042,3910,132,3.3
28564,CN5001500000000,50,15,"Lamoille County, VT",Nov-19,13692,13284,408,3.0
28565,CN5001700000000,50,17,"Orange County, VT",Nov-19,15814,15493,321,2.0
28566,CN5001900000000,50,19,"Orleans County, VT",Nov-19,13115,12639,476,3.6
28567,CN5002100000000,50,21,"Rutland County, VT",Nov-19,30164,29388,776,2.6
28568,CN5002300000000,50,23,"Washington County, VT",Nov-19,34223,33540,683,2.0
28569,CN5002500000000,50,25,"Windham County, VT",Nov-19,21622,21063,559,2.6
28570,CN5002700000000,50,27,"Windsor County, VT",Nov-19,28465,27859,606,2.1
28571,CN5100100000000,51,1,"Accomack County, VA",Nov-19,16553,16055,498,3.0
28572,CN5100300000000,51,3,"Albemarle County, VA",Nov-19,58238,56983,1255,2.2
28573,CN5100500000000,51,5,"Alleghany County, VA",Nov-19,6858,6635,223,3.3
28574,CN5100700000000,51,7,"Amelia County, VA",Nov-19,6382,6210,172,2.7
28575,CN5100900000000,51,9,"Amherst County, VA",Nov-19,15164,14733,431,2.8
28576,CN5101100000000,51,11,"Appomattox County, VA",Nov-19,7230,7006,224,3.1
28577,CN5101300000000,51,13,"Arlington County, VA",Nov-19,157073,154441,2632,1.7
28578,CN5101500000000,51,15,"Augusta County, VA",Nov-19,38025,37200,825,2.2
28579,CN5101700000000,51,17,"Bath County, VA",Nov-19,2510,2456,54,2.2
28580,CN5101900000000,51,19,"Bedford County, VA",Nov-19,38801,37826,975,2.5
28581,CN5102100000000,51,21,"Bland County, VA",Nov-19,2871,2795,76,2.6
28582,CN5102300000000,51,23,"Botetourt County, VA",Nov-19,17528,17121,407,2.3
28583,CN5102500000000,51,25,"Brunswick County, VA",Nov-19,6007,5759,248,4.1
28584,CN5102700000000,51,27,"Buchanan County, VA",Nov-19,6644,6272,372,5.6
28585,CN5102900000000,51,29,"Buckingham County, VA",Nov-19,6541,6294,247,3.8
28586,CN5103100000000,51,31,"Campbell County, VA",Nov-19,26217,25480,737,2.8
28587,CN5103300000000,51,33,"Caroline County, VA",Nov-19,15478,15044,434,2.8
28588,CN5103500000000,51,35,"Carroll County, VA",Nov-19,13207,12795,412,3.1
28589,CN5103600000000,51,36,"Charles City County, VA",Nov-19,3713,3612,101,2.7
28590,CN5103700000000,51,37,"Charlotte County, VA",Nov-19,5282,5116,166,3.1
28591,CN5104100000000,51,41,"Chesterfield County, VA",Nov-19,190312,185708,4604,2.4
28592,CN5104300000000,51,43,"Clarke County, VA",Nov-19,7749,7588,161,2.1
28593,CN5104500000000,51,45,"Craig County, VA",Nov-19,2313,2250,63,2.7
28594,CN5104700000000,51,47,"Culpeper County, VA",Nov-19,25061,24507,554,2.2
28595,CN5104900000000,51,49,"Cumberland County, VA",Nov-19,4649,4526,123,2.6
28596,CN5105100000000,51,51,"Dickenson County, VA",Nov-19,4762,4535,227,4.8
28597,CN5105300000000,51,53,"Dinwiddie County, VA",Nov-19,13876,13490,386,2.8
28598,CN5105700000000,51,57,"Essex County, VA",Nov-19,5505,5336,169,3.1
28599,CN5105900000000,51,59,"Fairfax County, VA",Nov-19,646369,633377,12992,2.0
28600,CN5106100000000,51,61,"Fauquier County, VA",Nov-19,37959,37171,788,2.1
28601,CN5106300000000,51,63,"Floyd County, VA",Nov-19,8350,8167,183,2.2
28602,CN5106500000000,51,65,"Fluvanna County, VA",Nov-19,14153,13863,290,2.0
28603,CN5106700000000,51,67,"Franklin County, VA",Nov-19,26620,25891,729,2.7
28604,CN5106900000000,51,69,"Frederick County, VA",Nov-19,48944,47914,1030,2.1
28605,CN5107100000000,51,71,"Giles County, VA",Nov-19,8001,7780,221,2.8
28606,CN5107300000000,51,73,"Gloucester County, VA",Nov-19,19669,19219,450,2.3
28607,CN5107500000000,51,75,"Goochland County, VA",Nov-19,11404,11128,276,2.4
28608,CN5107700000000,51,77,"Grayson County, VA",Nov-19,8129,7909,220,2.7
28609,CN5107900000000,51,79,"Greene County, VA",Nov-19,10687,10466,221,2.1
28610,CN5108100000000,51,81,"Greensville County, VA",Nov-19,4287,4160,127,3.0
28611,CN5108300000000,51,83,"Halifax County, VA",Nov-19,15545,15001,544,3.5
28612,CN5108500000000,51,85,"Hanover County, VA",Nov-19,60163,58896,1267,2.1
28613,CN5108700000000,51,87,"Henrico County, VA",Nov-19,184710,180149,4561,2.5
28614,CN5108900000000,51,89,"Henry County, VA",Nov-19,23698,22973,725,3.1
28615,CN5109100000000,51,91,"Highland County, VA",Nov-19,1233,1198,35,2.8
28616,CN5109300000000,51,93,"Isle of Wight County, VA",Nov-19,19540,19048,492,2.5
28617,CN5109500000000,51,95,"James City County, VA",Nov-19,36717,35860,857,2.3
28618,CN5109700000000,51,97,"King and Queen County, VA",Nov-19,3867,3774,93,2.4
28619,CN5109900000000,51,99,"King George County, VA",Nov-19,13625,13302,323,2.4
28620,CN5110100000000,51,101,"King William County, VA",Nov-19,9309,9089,220,2.4
28621,CN5110300000000,51,103,"Lancaster County, VA",Nov-19,5462,5310,152,2.8
28622,CN5110500000000,51,105,"Lee County, VA",Nov-19,8279,7955,324,3.9
28623,CN5110700000000,51,107,"Loudoun County, VA",Nov-19,226387,221820,4567,2.0
28624,CN5110900000000,51,109,"Louisa County, VA",Nov-19,20369,19891,478,2.3
28625,CN5111100000000,51,111,"Lunenburg County, VA",Nov-19,5300,5152,148,2.8
28626,CN5111300000000,51,113,"Madison County, VA",Nov-19,7668,7524,144,1.9
28627,CN5111500000000,51,115,"Mathews County, VA",Nov-19,4161,4050,111,2.7
28628,CN5111700000000,51,117,"Mecklenburg County, VA",Nov-19,12420,11963,457,3.7
28629,CN5111900000000,51,119,"Middlesex County, VA",Nov-19,5343,5229,114,2.1
28630,CN5112100000000,51,121,"Montgomery County, VA",Nov-19,50794,49549,1245,2.5
28631,CN5112500000000,51,125,"Nelson County, VA",Nov-19,7595,7424,171,2.3
28632,CN5112700000000,51,127,"New Kent County, VA",Nov-19,12679,12417,262,2.1
28633,CN5113100000000,51,131,"Northampton County, VA",Nov-19,5486,5286,200,3.6
28634,CN5113300000000,51,133,"Northumberland County, VA",Nov-19,5755,5577,178,3.1
28635,CN5113500000000,51,135,"Nottoway County, VA",Nov-19,7359,7166,193,2.6
28636,CN5113700000000,51,137,"Orange County, VA",Nov-19,17663,17215,448,2.5
28637,CN5113900000000,51,139,"Page County, VA",Nov-19,12072,11718,354,2.9
28638,CN5114100000000,51,141,"Patrick County, VA",Nov-19,7206,6975,231,3.2
28639,CN5114300000000,51,143,"Pittsylvania County, VA",Nov-19,30332,29433,899,3.0
28640,CN5114500000000,51,145,"Powhatan County, VA",Nov-19,14382,14049,333,2.3
28641,CN5114700000000,51,147,"Prince Edward County, VA",Nov-19,10322,9974,348,3.4
28642,CN5114900000000,51,149,"Prince George County, VA",Nov-19,15309,14847,462,3.0
28643,CN5115300000000,51,153,"Prince William County, VA",Nov-19,249663,244138,5525,2.2
28644,CN5115500000000,51,155,"Pulaski County, VA",Nov-19,16249,15795,454,2.8
28645,CN5115700000000,51,157,"Rappahannock County, VA",Nov-19,3777,3697,80,2.1
28646,CN5115900000000,51,159,"Richmond County, VA",Nov-19,4119,4020,99,2.4
28647,CN5116100000000,51,161,"Roanoke County, VA",Nov-19,49645,48500,1145,2.3
28648,CN5116300000000,51,163,"Rockbridge County, VA",Nov-19,10883,10621,262,2.4
28649,CN5116500000000,51,165,"Rockingham County, VA",Nov-19,42832,41988,844,2.0
28650,CN5116700000000,51,167,"Russell County, VA",Nov-19,11227,10820,407,3.6
28651,CN5116900000000,51,169,"Scott County, VA",Nov-19,9154,8910,244,2.7
28652,CN5117100000000,51,171,"Shenandoah County, VA",Nov-19,22423,21928,495,2.2
28653,CN5117300000000,51,173,"Smyth County, VA",Nov-19,13857,13388,469,3.4
28654,CN5117500000000,51,175,"Southampton County, VA",Nov-19,9177,8959,218,2.4
28655,CN5117700000000,51,177,"Spotsylvania County, VA",Nov-19,68133,66433,1700,2.5
28656,CN5117900000000,51,179,"Stafford County, VA",Nov-19,73236,71444,1792,2.4
28657,CN5118100000000,51,181,"Surry County, VA",Nov-19,3778,3667,111,2.9
28658,CN5118300000000,51,183,"Sussex County, VA",Nov-19,3889,3733,156,4.0
28659,CN5118500000000,51,185,"Tazewell County, VA",Nov-19,15670,15055,615,3.9
28660,CN5118700000000,51,187,"Warren County, VA",Nov-19,20787,20275,512,2.5
28661,CN5119100000000,51,191,"Washington County, VA",Nov-19,26813,26038,775,2.9
28662,CN5119300000000,51,193,"Westmoreland County, VA",Nov-19,9648,9358,290,3.0
28663,CN5119500000000,51,195,"Wise County, VA",Nov-19,13443,12879,564,4.2
28664,CN5119700000000,51,197,"Wythe County, VA",Nov-19,13790,13350,440,3.2
28665,CN5119900000000,51,199,"York County, VA",Nov-19,32868,32073,795,2.4
28666,CN5151000000000,51,510,"Alexandria city, VA",Nov-19,103116,101176,1940,1.9
28667,CN5152000000000,51,520,"Bristol city, VA",Nov-19,7225,6978,247,3.4
28668,CN5153000000000,51,530,"Buena Vista city, VA",Nov-19,3533,3451,82,2.3
28669,CN5154000000000,51,540,"Charlottesville city, VA",Nov-19,26824,26300,524,2.0
28670,CN5155000000000,51,550,"Chesapeake city, VA",Nov-19,122966,119807,3159,2.6
28671,CN5157000000000,51,570,"Colonial Heights city, VA",Nov-19,8936,8679,257,2.9
28672,CN5158000000000,51,580,"Covington city, VA",Nov-19,2371,2282,89,3.8
28673,CN5159000000000,51,590,"Danville city, VA",Nov-19,19347,18541,806,4.2
28674,CN5159500000000,51,595,"Emporia city, VA",Nov-19,2274,2180,94,4.1
28675,CN5160000000000,51,600,"Fairfax city, VA",Nov-19,13694,13432,262,1.9
28676,CN5161000000000,51,610,"Falls Church city, VA",Nov-19,8748,8593,155,1.8
28677,CN5162000000000,51,620,"Franklin city, VA",Nov-19,3597,3460,137,3.8
28678,CN5163000000000,51,630,"Fredericksburg city, VA",Nov-19,14359,13945,414,2.9
28679,CN5164000000000,51,640,"Galax city, VA",Nov-19,2917,2830,87,3.0
28680,CN5165000000000,51,650,"Hampton city, VA",Nov-19,64402,62265,2137,3.3
28681,CN5166000000000,51,660,"Harrisonburg city, VA",Nov-19,25446,24769,677,2.7
28682,CN5167000000000,51,670,"Hopewell city, VA",Nov-19,9810,9431,379,3.9
28683,CN5167800000000,51,678,"Lexington city, VA",Nov-19,2108,2022,86,4.1
28684,CN5168000000000,51,680,"Lynchburg city, VA",Nov-19,36552,35386,1166,3.2
28685,CN5168300000000,51,683,"Manassas city, VA",Nov-19,22409,21931,478,2.1
28686,CN5168500000000,51,685,"Manassas Park city, VA",Nov-19,9534,9335,199,2.1
28687,CN5169000000000,51,690,"Martinsville city, VA",Nov-19,5487,5281,206,3.8
28688,CN5170000000000,51,700,"Newport News city, VA",Nov-19,88843,86165,2678,3.0
28689,CN5171000000000,51,710,"Norfolk city, VA",Nov-19,111683,108303,3380,3.0
28690,CN5172000000000,51,720,"Norton city, VA",Nov-19,1688,1633,55,3.3
28691,CN5173000000000,51,730,"Petersburg city, VA",Nov-19,13171,12520,651,4.9
28692,CN5173500000000,51,735,"Poquoson city, VA",Nov-19,6418,6281,137,2.1
28693,CN5174000000000,51,740,"Portsmouth city, VA",Nov-19,44329,42766,1563,3.5
28694,CN5175000000000,51,750,"Radford city, VA",Nov-19,8738,8474,264,3.0
28695,CN5176000000000,51,760,"Richmond city, VA",Nov-19,120010,116548,3462,2.9
28696,CN5177000000000,51,770,"Roanoke city, VA",Nov-19,49378,48046,1332,2.7
28697,CN5177500000000,51,775,"Salem city, VA",Nov-19,13027,12707,320,2.5
28698,CN5179000000000,51,790,"Staunton city, VA",Nov-19,12367,12085,282,2.3
28699,CN5180000000000,51,800,"Suffolk city, VA",Nov-19,44706,43508,1198,2.7
28700,CN5181000000000,51,810,"Virginia Beach city, VA",Nov-19,233715,228046,5669,2.4
28701,CN5182000000000,51,820,"Waynesboro city, VA",Nov-19,10798,10530,268,2.5
28702,CN5183000000000,51,830,"Williamsburg city, VA",Nov-19,6685,6467,218,3.3
28703,CN5184000000000,51,840,"Winchester city, VA",Nov-19,15051,14687,364,2.4
28704,CN5300100000000,53,1,"Adams County, WA",Nov-19,9257,8748,509,5.5
28705,CN5300300000000,53,3,"Asotin County, WA",Nov-19,10682,10291,391,3.7
28706,CN5300500000000,53,5,"Benton County, WA",Nov-19,103890,99040,4850,4.7
28707,CN5300700000000,53,7,"Chelan County, WA",Nov-19,43665,41648,2017,4.6
28708,CN5300900000000,53,9,"Clallam County, WA",Nov-19,29296,27577,1719,5.9
28709,CN5301100000000,53,11,"Clark County, WA",Nov-19,246005,235364,10641,4.3
28710,CN5301300000000,53,13,"Columbia County, WA",Nov-19,1878,1778,100,5.3
28711,CN5301500000000,53,15,"Cowlitz County, WA",Nov-19,48596,45978,2618,5.4
28712,CN5301700000000,53,17,"Douglas County, WA",Nov-19,21483,20336,1147,5.3
28713,CN5301900000000,53,19,"Ferry County, WA",Nov-19,2430,2188,242,10.0
28714,CN5302100000000,53,21,"Franklin County, WA",Nov-19,42399,39964,2435,5.7
28715,CN5302300000000,53,23,"Garfield County, WA",Nov-19,927,874,53,5.7
28716,CN5302500000000,53,25,"Grant County, WA",Nov-19,45380,42446,2934,6.5
28717,CN5302700000000,53,27,"Grays Harbor County, WA",Nov-19,29213,27290,1923,6.6
28718,CN5302900000000,53,29,"Island County, WA",Nov-19,37238,35577,1661,4.5
28719,CN5303100000000,53,31,"Jefferson County, WA",Nov-19,13339,12658,681,5.1
28720,CN5303300000000,53,33,"King County, WA",Nov-19,1298436,1265360,33076,2.5
28721,CN5303500000000,53,35,"Kitsap County, WA",Nov-19,131624,126391,5233,4.0
28722,CN5303700000000,53,37,"Kittitas County, WA",Nov-19,24220,23088,1132,4.7
28723,CN5303900000000,53,39,"Klickitat County, WA",Nov-19,10027,9514,513,5.1
28724,CN5304100000000,53,41,"Lewis County, WA",Nov-19,35428,33422,2006,5.7
28725,CN5304300000000,53,43,"Lincoln County, WA",Nov-19,4992,4768,224,4.5
28726,CN5304500000000,53,45,"Mason County, WA",Nov-19,26705,25248,1457,5.5
28727,CN5304700000000,53,47,"Okanogan County, WA",Nov-19,19224,17978,1246,6.5
28728,CN5304900000000,53,49,"Pacific County, WA",Nov-19,8556,7977,579,6.8
28729,CN5305100000000,53,51,"Pend Oreille County, WA",Nov-19,5171,4791,380,7.3
28730,CN5305300000000,53,53,"Pierce County, WA",Nov-19,449788,428706,21082,4.7
28731,CN5305500000000,53,55,"San Juan County, WA",Nov-19,8533,8235,298,3.5
28732,CN5305700000000,53,57,"Skagit County, WA",Nov-19,63525,60306,3219,5.1
28733,CN5305900000000,53,59,"Skamania County, WA",Nov-19,5622,5349,273,4.9
28734,CN5306100000000,53,61,"Snohomish County, WA",Nov-19,441899,429513,12386,2.8
28735,CN5306300000000,53,63,"Spokane County, WA",Nov-19,259520,247834,11686,4.5
28736,CN5306500000000,53,65,"Stevens County, WA",Nov-19,19276,18141,1135,5.9
28737,CN5306700000000,53,67,"Thurston County, WA",Nov-19,146356,139933,6423,4.4
28738,CN5306900000000,53,69,"Wahkiakum County, WA",Nov-19,1384,1296,88,6.4
28739,CN5307100000000,53,71,"Walla Walla County, WA",Nov-19,31486,30193,1293,4.1
28740,CN5307300000000,53,73,"Whatcom County, WA",Nov-19,116639,111274,5365,4.6
28741,CN5307500000000,53,75,"Whitman County, WA",Nov-19,24734,23794,940,3.8
28742,CN5307700000000,53,77,"Yakima County, WA",Nov-19,129158,120859,8299,6.4
28743,CN5400100000000,54,1,"Barbour County, WV",Nov-19,7378,6968,410,5.6
28744,CN5400300000000,54,3,"Berkeley County, WV",Nov-19,60227,58436,1791,3.0
28745,CN5400500000000,54,5,"Boone County, WV",Nov-19,7457,7032,425,5.7
28746,CN5400700000000,54,7,"Braxton County, WV",Nov-19,5257,4830,427,8.1
28747,CN5400900000000,54,9,"Brooke County, WV",Nov-19,10050,9503,547,5.4
28748,CN5401100000000,54,11,"Cabell County, WV",Nov-19,41918,40337,1581,3.8
28749,CN5401300000000,54,13,"Calhoun County, WV",Nov-19,2612,2226,386,14.8
28750,CN5401500000000,54,15,"Clay County, WV",Nov-19,3166,2867,299,9.4
28751,CN5401700000000,54,17,"Doddridge County, WV",Nov-19,4041,3848,193,4.8
28752,CN5401900000000,54,19,"Fayette County, WV",Nov-19,16255,15293,962,5.9
28753,CN5402100000000,54,21,"Gilmer County, WV",Nov-19,2471,2289,182,7.4
28754,CN5402300000000,54,23,"Grant County, WV",Nov-19,5920,5598,322,5.4
28755,CN5402500000000,54,25,"Greenbrier County, WV",Nov-19,15657,14981,676,4.3
28756,CN5402700000000,54,27,"Hampshire County, WV",Nov-19,10762,10409,353,3.3
28757,CN5402900000000,54,29,"Hancock County, WV",Nov-19,13138,12467,671,5.1
28758,CN5403100000000,54,31,"Hardy County, WV",Nov-19,5728,5468,260,4.5
28759,CN5403300000000,54,33,"Harrison County, WV",Nov-19,34965,33372,1593,4.6
28760,CN5403500000000,54,35,"Jackson County, WV",Nov-19,13367,12685,682,5.1
28761,CN5403700000000,54,37,"Jefferson County, WV",Nov-19,30376,29541,835,2.7
28762,CN5403900000000,54,39,"Kanawha County, WV",Nov-19,82202,78614,3588,4.4
28763,CN5404100000000,54,41,"Lewis County, WV",Nov-19,6735,6243,492,7.3
28764,CN5404300000000,54,43,"Lincoln County, WV",Nov-19,7296,6838,458,6.3
28765,CN5404500000000,54,45,"Logan County, WV",Nov-19,11303,10591,712,6.3
28766,CN5404700000000,54,47,"McDowell County, WV",Nov-19,4471,4091,380,8.5
28767,CN5404900000000,54,49,"Marion County, WV",Nov-19,25924,24631,1293,5.0
28768,CN5405100000000,54,51,"Marshall County, WV",Nov-19,14433,13534,899,6.2
28769,CN5405300000000,54,53,"Mason County, WV",Nov-19,10277,9728,549,5.3
28770,CN5405500000000,54,55,"Mercer County, WV",Nov-19,21359,20261,1098,5.1
28771,CN5405700000000,54,57,"Mineral County, WV",Nov-19,12722,11994,728,5.7
28772,CN5405900000000,54,59,"Mingo County, WV",Nov-19,6998,6466,532,7.6
28773,CN5406100000000,54,61,"Monongalia County, WV",Nov-19,55862,54023,1839,3.3
28774,CN5406300000000,54,63,"Monroe County, WV",Nov-19,5917,5676,241,4.1
28775,CN5406500000000,54,65,"Morgan County, WV",Nov-19,8160,7879,281,3.4
28776,CN5406700000000,54,67,"Nicholas County, WV",Nov-19,9622,8955,667,6.9
28777,CN5406900000000,54,69,"Ohio County, WV",Nov-19,21688,20671,1017,4.7
28778,CN5407100000000,54,71,"Pendleton County, WV",Nov-19,3693,3560,133,3.6
28779,CN5407300000000,54,73,"Pleasants County, WV",Nov-19,2963,2747,216,7.3
28780,CN5407500000000,54,75,"Pocahontas County, WV",Nov-19,3670,3403,267,7.3
28781,CN5407700000000,54,77,"Preston County, WV",Nov-19,15811,15129,682,4.3
28782,CN5407900000000,54,79,"Putnam County, WV",Nov-19,26930,25889,1041,3.9
28783,CN5408100000000,54,81,"Raleigh County, WV",Nov-19,30355,28978,1377,4.5
28784,CN5408300000000,54,83,"Randolph County, WV",Nov-19,12367,11628,739,6.0
28785,CN5408500000000,54,85,"Ritchie County, WV",Nov-19,4408,4133,275,6.2
28786,CN5408700000000,54,87,"Roane County, WV",Nov-19,5230,4705,525,10.0
28787,CN5408900000000,54,89,"Summers County, WV",Nov-19,4316,4085,231,5.4
28788,CN5409100000000,54,91,"Taylor County, WV",Nov-19,8015,7635,380,4.7
28789,CN5409300000000,54,93,"Tucker County, WV",Nov-19,3348,3183,165,4.9
28790,CN5409500000000,54,95,"Tyler County, WV",Nov-19,3107,2880,227,7.3
28791,CN5409700000000,54,97,"Upshur County, WV",Nov-19,9593,9012,581,6.1
28792,CN5409900000000,54,99,"Wayne County, WV",Nov-19,15945,15152,793,5.0
28793,CN5410100000000,54,101,"Webster County, WV",Nov-19,3319,3084,235,7.1
28794,CN5410300000000,54,103,"Wetzel County, WV",Nov-19,6738,6230,508,7.5
28795,CN5410500000000,54,105,"Wirt County, WV",Nov-19,2317,2127,190,8.2
28796,CN5410700000000,54,107,"Wood County, WV",Nov-19,37149,35335,1814,4.9
28797,CN5410900000000,54,109,"Wyoming County, WV",Nov-19,6697,6257,440,6.6
28798,CN5500100000000,55,1,"Adams County, WI",Nov-19,8053,7681,372,4.6
28799,CN5500300000000,55,3,"Ashland County, WI",Nov-19,7815,7491,324,4.1
28800,CN5500500000000,55,5,"Barron County, WI",Nov-19,24097,23289,808,3.4
28801,CN5500700000000,55,7,"Bayfield County, WI",Nov-19,7539,7164,375,5.0
28802,CN5500900000000,55,9,"Brown County, WI",Nov-19,141948,138000,3948,2.8
28803,CN5501100000000,55,11,"Buffalo County, WI",Nov-19,6388,6148,240,3.8
28804,CN5501300000000,55,13,"Burnett County, WI",Nov-19,7032,6716,316,4.5
28805,CN5501500000000,55,15,"Calumet County, WI",Nov-19,27408,26703,705,2.6
28806,CN5501700000000,55,17,"Chippewa County, WI",Nov-19,33143,32108,1035,3.1
28807,CN5501900000000,55,19,"Clark County, WI",Nov-19,17497,17030,467,2.7
28808,CN5502100000000,55,21,"Columbia County, WI",Nov-19,31824,30961,863,2.7
28809,CN5502300000000,55,23,"Crawford County, WI",Nov-19,7587,7313,274,3.6
28810,CN5502500000000,55,25,"Dane County, WI",Nov-19,325396,318319,7077,2.2
28811,CN5502700000000,55,27,"Dodge County, WI",Nov-19,47187,45865,1322,2.8
28812,CN5502900000000,55,29,"Door County, WI",Nov-19,14544,14071,473,3.3
28813,CN5503100000000,55,31,"Douglas County, WI",Nov-19,23035,22141,894,3.9
28814,CN5503300000000,55,33,"Dunn County, WI",Nov-19,24575,23889,686,2.8
28815,CN5503500000000,55,35,"Eau Claire County, WI",Nov-19,58970,57470,1500,2.5
28816,CN5503700000000,55,37,"Florence County, WI",Nov-19,2206,2090,116,5.3
28817,CN5503900000000,55,39,"Fond du Lac County, WI",Nov-19,57087,55652,1435,2.5
28818,CN5504100000000,55,41,"Forest County, WI",Nov-19,3963,3795,168,4.2
28819,CN5504300000000,55,43,"Grant County, WI",Nov-19,28208,27417,791,2.8
28820,CN5504500000000,55,45,"Green County, WI",Nov-19,21175,20664,511,2.4
28821,CN5504700000000,55,47,"Green Lake County, WI",Nov-19,9220,8904,316,3.4
28822,CN5504900000000,55,49,"Iowa County, WI",Nov-19,13790,13474,316,2.3
28823,CN5505100000000,55,51,"Iron County, WI",Nov-19,2530,2389,141,5.6
28824,CN5505300000000,55,53,"Jackson County, WI",Nov-19,10124,9781,343,3.4
28825,CN5505500000000,55,55,"Jefferson County, WI",Nov-19,45680,44447,1233,2.7
28826,CN5505700000000,55,57,"Juneau County, WI",Nov-19,13240,12868,372,2.8
28827,CN5505900000000,55,59,"Kenosha County, WI",Nov-19,88679,85411,3268,3.7
28828,CN5506100000000,55,61,"Kewaunee County, WI",Nov-19,10981,10688,293,2.7
28829,CN5506300000000,55,63,"La Crosse County, WI",Nov-19,66803,65191,1612,2.4
28830,CN5506500000000,55,65,"Lafayette County, WI",Nov-19,10049,9843,206,2.0
28831,CN5506700000000,55,67,"Langlade County, WI",Nov-19,9162,8836,326,3.6
28832,CN5506900000000,55,69,"Lincoln County, WI",Nov-19,15041,14544,497,3.3
28833,CN5507100000000,55,71,"Manitowoc County, WI",Nov-19,40716,39342,1374,3.4
28834,CN5507300000000,55,73,"Marathon County, WI",Nov-19,73448,71594,1854,2.5
28835,CN5507500000000,55,75,"Marinette County, WI",Nov-19,19350,18534,816,4.2
28836,CN5507700000000,55,77,"Marquette County, WI",Nov-19,7718,7449,269,3.5
28837,CN5507800000000,55,78,"Menominee County, WI",Nov-19,1594,1476,118,7.4
28838,CN5507900000000,55,79,"Milwaukee County, WI",Nov-19,467037,449360,17677,3.8
28839,CN5508100000000,55,81,"Monroe County, WI",Nov-19,23134,22545,589,2.5
28840,CN5508300000000,55,83,"Oconto County, WI",Nov-19,20555,19934,621,3.0
28841,CN5508500000000,55,85,"Oneida County, WI",Nov-19,17324,16672,652,3.8
28842,CN5508700000000,55,87,"Outagamie County, WI",Nov-19,102419,99807,2612,2.6
28843,CN5508900000000,55,89,"Ozaukee County, WI",Nov-19,49183,47914,1269,2.6
28844,CN5509100000000,55,91,"Pepin County, WI",Nov-19,4128,3993,135,3.3
28845,CN5509300000000,55,93,"Pierce County, WI",Nov-19,25268,24519,749,3.0
28846,CN5509500000000,55,95,"Polk County, WI",Nov-19,24402,23533,869,3.6
28847,CN5509700000000,55,97,"Portage County, WI",Nov-19,38909,37878,1031,2.6
28848,CN5509900000000,55,99,"Price County, WI",Nov-19,6555,6241,314,4.8
28849,CN5510100000000,55,101,"Racine County, WI",Nov-19,97594,93873,3721,3.8
28850,CN5510300000000,55,103,"Richland County, WI",Nov-19,9091,8843,248,2.7
28851,CN5510500000000,55,105,"Rock County, WI",Nov-19,85334,82325,3009,3.5
28852,CN5510700000000,55,107,"Rusk County, WI",Nov-19,6685,6411,274,4.1
28853,CN5510900000000,55,109,"St. Croix County, WI",Nov-19,50386,48862,1524,3.0
28854,CN5511100000000,55,111,"Sauk County, WI",Nov-19,35029,34078,951,2.7
28855,CN5511300000000,55,113,"Sawyer County, WI",Nov-19,7791,7450,341,4.4
28856,CN5511500000000,55,115,"Shawano County, WI",Nov-19,20803,20212,591,2.8
28857,CN5511700000000,55,117,"Sheboygan County, WI",Nov-19,61032,59397,1635,2.7
28858,CN5511900000000,55,119,"Taylor County, WI",Nov-19,10801,10490,311,2.9
28859,CN5512100000000,55,121,"Trempealeau County, WI",Nov-19,15708,15285,423,2.7
28860,CN5512300000000,55,123,"Vernon County, WI",Nov-19,15185,14766,419,2.8
28861,CN5512500000000,55,125,"Vilas County, WI",Nov-19,9869,9494,375,3.8
28862,CN5512700000000,55,127,"Walworth County, WI",Nov-19,58022,56339,1683,2.9
28863,CN5512900000000,55,129,"Washburn County, WI",Nov-19,7765,7491,274,3.5
28864,CN5513100000000,55,131,"Washington County, WI",Nov-19,77082,75100,1982,2.6
28865,CN5513300000000,55,133,"Waukesha County, WI",Nov-19,224979,218950,6029,2.7
28866,CN5513500000000,55,135,"Waupaca County, WI",Nov-19,25473,24764,709,2.8
28867,CN5513700000000,55,137,"Waushara County, WI",Nov-19,11344,10940,404,3.6
28868,CN5513900000000,55,139,"Winnebago County, WI",Nov-19,91241,88743,2498,2.7
28869,CN5514100000000,55,141,"Wood County, WI",Nov-19,34967,33829,1138,3.3
28870,CN5600100000000,56,1,"Albany County, WY",Nov-19,20984,20388,596,2.8
28871,CN5600300000000,56,3,"Big Horn County, WY",Nov-19,5410,5193,217,4.0
28872,CN5600500000000,56,5,"Campbell County, WY",Nov-19,23713,22950,763,3.2
28873,CN5600700000000,56,7,"Carbon County, WY",Nov-19,8070,7803,267,3.3
28874,CN5600900000000,56,9,"Converse County, WY",Nov-19,9024,8768,256,2.8
28875,CN5601100000000,56,11,"Crook County, WY",Nov-19,3768,3652,116,3.1
28876,CN5601300000000,56,13,"Fremont County, WY",Nov-19,18906,18115,791,4.2
28877,CN5601500000000,56,15,"Goshen County, WY",Nov-19,6787,6535,252,3.7
28878,CN5601700000000,56,17,"Hot Springs County, WY",Nov-19,2137,2062,75,3.5
28879,CN5601900000000,56,19,"Johnson County, WY",Nov-19,4149,4009,140,3.4
28880,CN5602100000000,56,21,"Laramie County, WY",Nov-19,48745,47086,1659,3.4
28881,CN5602300000000,56,23,"Lincoln County, WY",Nov-19,8691,8394,297,3.4
28882,CN5602500000000,56,25,"Natrona County, WY",Nov-19,39651,38081,1570,4.0
28883,CN5602700000000,56,27,"Niobrara County, WY",Nov-19,1241,1202,39,3.1
28884,CN5602900000000,56,29,"Park County, WY",Nov-19,14907,14261,646,4.3
28885,CN5603100000000,56,31,"Platte County, WY",Nov-19,4515,4375,140,3.1
28886,CN5603300000000,56,33,"Sheridan County, WY",Nov-19,15700,15183,517,3.3
28887,CN5603500000000,56,35,"Sublette County, WY",Nov-19,4204,4000,204,4.9
28888,CN5603700000000,56,37,"Sweetwater County, WY",Nov-19,21418,20527,891,4.2
28889,CN5603900000000,56,39,"Teton County, WY",Nov-19,13871,13123,748,5.4
28890,CN5604100000000,56,41,"Uinta County, WY",Nov-19,9012,8654,358,4.0
28891,CN5604300000000,56,43,"Washakie County, WY",Nov-19,3974,3840,134,3.4
28892,CN5604500000000,56,45,"Weston County, WY",Nov-19,3845,3752,93,2.4
28893,CN7200100000000,72,1,"Adjuntas Municipio, PR",Nov-19,3994,3445,549,13.7
28894,CN7200300000000,72,3,"Aguada Municipio, PR",Nov-19,11440,10236,1204,10.5
28895,CN7200500000000,72,5,"Aguadilla Municipio, PR",Nov-19,13960,12509,1451,10.4
28896,CN7200700000000,72,7,"Aguas Buenas Municipio, PR",Nov-19,6276,5697,579,9.2
28897,CN7200900000000,72,9,"Aibonito Municipio, PR",Nov-19,6259,5627,632,10.1
28898,CN7201100000000,72,11,"Anasco Municipio, PR",Nov-19,8469,7724,745,8.8
28899,CN7201300000000,72,13,"Arecibo Municipio, PR",Nov-19,23439,21052,2387,10.2
28900,CN7201500000000,72,15,"Arroyo Municipio, PR",Nov-19,4459,3836,623,14.0
28901,CN7201700000000,72,17,"Barceloneta Municipio, PR",Nov-19,5706,5034,672,11.8
28902,CN7201900000000,72,19,"Barranquitas Municipio, PR",Nov-19,7151,6528,623,8.7
28903,CN7202100000000,72,21,"Bayamon Municipio, PR",Nov-19,62470,58336,4134,6.6
28904,CN7202300000000,72,23,"Cabo Rojo Municipio, PR",Nov-19,13099,11990,1109,8.5
28905,CN7202500000000,72,25,"Caguas Municipio, PR",Nov-19,45608,42506,3102,6.8
28906,CN7202700000000,72,27,"Camuy Municipio, PR",Nov-19,9271,8439,832,9.0
28907,CN7202900000000,72,29,"Canovanas Municipio, PR",Nov-19,15342,14312,1030,6.7
28908,CN7203100000000,72,31,"Carolina Municipio, PR",Nov-19,58828,55196,3632,6.2
28909,CN7203300000000,72,33,"Catano Municipio, PR",Nov-19,7490,6920,570,7.6
28910,CN7203500000000,72,35,"Cayey Municipio, PR",Nov-19,15389,14289,1100,7.1
28911,CN7203700000000,72,37,"Ceiba Municipio, PR",Nov-19,3525,3178,347,9.8
28912,CN7203900000000,72,39,"Ciales Municipio, PR",Nov-19,3598,3183,415,11.5
28913,CN7204100000000,72,41,"Cidra Municipio, PR",Nov-19,14768,13798,970,6.6
28914,CN7204300000000,72,43,"Coamo Municipio, PR",Nov-19,9622,8450,1172,12.2
28915,CN7204500000000,72,45,"Comerio Municipio, PR",Nov-19,4724,4288,436,9.2
28916,CN7204700000000,72,47,"Corozal Municipio, PR",Nov-19,8635,7835,800,9.3
28917,CN7204900000000,72,49,"Culebra Municipio, PR",Nov-19,866,836,30,3.5
28918,CN7205100000000,72,51,"Dorado Municipio, PR",Nov-19,12644,11874,770,6.1
28919,CN7205300000000,72,53,"Fajardo Municipio, PR",Nov-19,10419,9359,1060,10.2
28920,CN7205400000000,72,54,"Florida Municipio, PR",Nov-19,3184,2839,345,10.8
28921,CN7205500000000,72,55,"Guanica Municipio, PR",Nov-19,3958,3354,604,15.3
28922,CN7205700000000,72,57,"Guayama Municipio, PR",Nov-19,10571,9269,1302,12.3
28923,CN7205900000000,72,59,"Guayanilla Municipio, PR",Nov-19,4723,4070,653,13.8
28924,CN7206100000000,72,61,"Guaynabo Municipio, PR",Nov-19,35812,34299,1513,4.2
28925,CN7206300000000,72,63,"Gurabo Municipio, PR",Nov-19,17256,16269,987,5.7
28926,CN7206500000000,72,65,"Hatillo Municipio, PR",Nov-19,13564,11634,1930,14.2
28927,CN7206700000000,72,67,"Hormigueros Municipio, PR",Nov-19,5137,4699,438,8.5
28928,CN7206900000000,72,69,"Humacao Municipio, PR",Nov-19,16409,14788,1621,9.9
28929,CN7207100000000,72,71,"Isabela Municipio, PR",Nov-19,12011,10926,1085,9.0
28930,CN7207300000000,72,73,"Jayuya Municipio, PR",Nov-19,4108,3548,560,13.6
28931,CN7207500000000,72,75,"Juana Diaz Municipio, PR",Nov-19,14494,13043,1451,10.0
28932,CN7207700000000,72,77,"Juncos Municipio, PR",Nov-19,11794,10781,1013,8.6
28933,CN7207900000000,72,79,"Lajas Municipio, PR",Nov-19,5064,4455,609,12.0
28934,CN7208100000000,72,81,"Lares Municipio, PR",Nov-19,7040,6014,1026,14.6
28935,CN7208300000000,72,83,"Las Marias Municipio, PR",Nov-19,2524,2209,315,12.5
28936,CN7208500000000,72,85,"Las Piedras Municipio, PR",Nov-19,10839,9841,998,9.2
28937,CN7208700000000,72,87,"Loiza Municipio, PR",Nov-19,8133,7437,696,8.6
28938,CN7208900000000,72,89,"Luquillo Municipio, PR",Nov-19,5917,5349,568,9.6
28939,CN7209100000000,72,91,"Manati Municipio, PR",Nov-19,11077,10162,915,8.3
28940,CN7209300000000,72,93,"Maricao Municipio, PR",Nov-19,1910,1638,272,14.2
28941,CN7209500000000,72,95,"Maunabo Municipio, PR",Nov-19,2757,2395,362,13.1
28942,CN7209700000000,72,97,"Mayaguez Municipio, PR",Nov-19,20828,18675,2153,10.3
28943,CN7209900000000,72,99,"Moca Municipio, PR",Nov-19,10064,9002,1062,10.6
28944,CN7210100000000,72,101,"Morovis Municipio, PR",Nov-19,7690,6956,734,9.5
28945,CN7210300000000,72,103,"Naguabo Municipio, PR",Nov-19,7826,7120,706,9.0
28946,CN7210500000000,72,105,"Naranjito Municipio, PR",Nov-19,6799,6203,596,8.8
28947,CN7210700000000,72,107,"Orocovis Municipio, PR",Nov-19,4771,4275,496,10.4
28948,CN7210900000000,72,109,"Patillas Municipio, PR",Nov-19,4086,3482,604,14.8
28949,CN7211100000000,72,111,"Penuelas Municipio, PR",Nov-19,5690,4877,813,14.3
28950,CN7211300000000,72,113,"Ponce Municipio, PR",Nov-19,43759,39495,4264,9.7
28951,CN7211500000000,72,115,"Quebradillas Municipio, PR",Nov-19,5860,5190,670,11.4
28952,CN7211700000000,72,117,"Rincon Municipio, PR",Nov-19,4649,3915,734,15.8
28953,CN7211900000000,72,119,"Rio Grande Municipio, PR",Nov-19,16196,15002,1194,7.4
28954,CN7212100000000,72,121,"Sabana Grande Municipio, PR",Nov-19,5924,5205,719,12.1
28955,CN7212300000000,72,123,"Salinas Municipio, PR",Nov-19,6985,5898,1087,15.6
28956,CN7212500000000,72,125,"San German Municipio, PR",Nov-19,9358,8341,1017,10.9
28957,CN7212700000000,72,127,"San Juan Municipio, PR",Nov-19,127762,120364,7398,5.8
28958,CN7212900000000,72,129,"San Lorenzo Municipio, PR",Nov-19,11219,10225,994,8.9
28959,CN7213100000000,72,131,"San Sebastian Municipio, PR",Nov-19,10093,8710,1383,13.7
28960,CN7213300000000,72,133,"Santa Isabel Municipio, PR",Nov-19,8621,7521,1100,12.8
28961,CN7213500000000,72,135,"Toa Alta Municipio, PR",Nov-19,25916,24393,1523,5.9
28962,CN7213700000000,72,137,"Toa Baja Municipio, PR",Nov-19,27965,26259,1706,6.1
28963,CN7213900000000,72,139,"Trujillo Alto Municipio, PR",Nov-19,25801,24546,1255,4.9
28964,CN7214100000000,72,141,"Utuado Municipio, PR",Nov-19,6481,5728,753,11.6
28965,CN7214300000000,72,143,"Vega Alta Municipio, PR",Nov-19,9360,8547,813,8.7
28966,CN7214500000000,72,145,"Vega Baja Municipio, PR",Nov-19,12754,11496,1258,9.9
28967,CN7214700000000,72,147,"Vieques Municipio, PR",Nov-19,2430,2277,153,6.3
28968,CN7214900000000,72,149,"Villalba Municipio, PR",Nov-19,7221,6085,1136,15.7
28969,CN7215100000000,72,151,"Yabucoa Municipio, PR",Nov-19,8523,7351,1172,13.8
28970,CN7215300000000,72,153,"Yauco Municipio, PR",Nov-19,9625,8240,1385,14.4
28971,CN0100100000000,01,1,"Autauga County, AL",Dec-19,26127,25513,614,2.4
28972,CN0100300000000,01,3,"Baldwin County, AL",Dec-19,95993,93689,2304,2.4
28973,CN0100500000000,01,5,"Barbour County, AL",Dec-19,8624,8349,275,3.2
28974,CN0100700000000,01,7,"Bibb County, AL",Dec-19,8752,8534,218,2.5
28975,CN0100900000000,01,9,"Blount County, AL",Dec-19,25508,24930,578,2.3
28976,CN0101100000000,01,11,"Bullock County, AL",Dec-19,4757,4588,169,3.6
28977,CN0101300000000,01,13,"Butler County, AL",Dec-19,9225,8906,319,3.5
28978,CN0101500000000,01,15,"Calhoun County, AL",Dec-19,46320,44930,1390,3.0
28979,CN0101700000000,01,17,"Chambers County, AL",Dec-19,15830,15449,381,2.4
28980,CN0101900000000,01,19,"Cherokee County, AL",Dec-19,11486,11201,285,2.5
28981,CN0102100000000,01,21,"Chilton County, AL",Dec-19,19958,19498,460,2.3
28982,CN0102300000000,01,23,"Choctaw County, AL",Dec-19,4603,4407,196,4.3
28983,CN0102500000000,01,25,"Clarke County, AL",Dec-19,7496,7089,407,5.4
28984,CN0102700000000,01,27,"Clay County, AL",Dec-19,6105,5942,163,2.7
28985,CN0102900000000,01,29,"Cleburne County, AL",Dec-19,5821,5664,157,2.7
28986,CN0103100000000,01,31,"Coffee County, AL",Dec-19,21198,20692,506,2.4
28987,CN0103300000000,01,33,"Colbert County, AL",Dec-19,23527,22739,788,3.3
28988,CN0103500000000,01,35,"Conecuh County, AL",Dec-19,4483,4329,154,3.4
28989,CN0103700000000,01,37,"Coosa County, AL",Dec-19,4525,4416,109,2.4
28990,CN0103900000000,01,39,"Covington County, AL",Dec-19,15532,15073,459,3.0
28991,CN0104100000000,01,41,"Crenshaw County, AL",Dec-19,6350,6201,149,2.3
28992,CN0104300000000,01,43,"Cullman County, AL",Dec-19,38760,37929,831,2.1
28993,CN0104500000000,01,45,"Dale County, AL",Dec-19,20648,20126,522,2.5
28994,CN0104700000000,01,47,"Dallas County, AL",Dec-19,14546,13915,631,4.3
28995,CN0104900000000,01,49,"DeKalb County, AL",Dec-19,30958,30235,723,2.3
28996,CN0105100000000,01,51,"Elmore County, AL",Dec-19,37543,36694,849,2.3
28997,CN0105300000000,01,53,"Escambia County, AL",Dec-19,14787,14334,453,3.1
28998,CN0105500000000,01,55,"Etowah County, AL",Dec-19,42804,41591,1213,2.8
28999,CN0105700000000,01,57,"Fayette County, AL",Dec-19,6551,6378,173,2.6
29000,CN0105900000000,01,59,"Franklin County, AL",Dec-19,14712,14364,348,2.4
29001,CN0106100000000,01,61,"Geneva County, AL",Dec-19,10983,10716,267,2.4
29002,CN0106300000000,01,63,"Greene County, AL",Dec-19,2864,2727,137,4.8
29003,CN0106500000000,01,65,"Hale County, AL",Dec-19,6111,5907,204,3.3
29004,CN0106700000000,01,67,"Henry County, AL",Dec-19,6915,6717,198,2.9
29005,CN0106900000000,01,69,"Houston County, AL",Dec-19,46329,45167,1162,2.5
29006,CN0107100000000,01,71,"Jackson County, AL",Dec-19,23229,22548,681,2.9
29007,CN0107300000000,01,73,"Jefferson County, AL",Dec-19,321910,314357,7553,2.3
29008,CN0107500000000,01,75,"Lamar County, AL",Dec-19,5846,5691,155,2.7
29009,CN0107700000000,01,77,"Lauderdale County, AL",Dec-19,42304,41101,1203,2.8
29010,CN0107900000000,01,79,"Lawrence County, AL",Dec-19,14317,13940,377,2.6
29011,CN0108100000000,01,81,"Lee County, AL",Dec-19,77615,75898,1717,2.2
29012,CN0108300000000,01,83,"Limestone County, AL",Dec-19,43962,43003,959,2.2
29013,CN0108500000000,01,85,"Lowndes County, AL",Dec-19,3557,3384,173,4.9
29014,CN0108700000000,01,87,"Macon County, AL",Dec-19,7880,7595,285,3.6
29015,CN0108900000000,01,89,"Madison County, AL",Dec-19,185936,182025,3911,2.1
29016,CN0109100000000,01,91,"Marengo County, AL",Dec-19,7617,7388,229,3.0
29017,CN0109300000000,01,93,"Marion County, AL",Dec-19,12854,12476,378,2.9
29018,CN0109500000000,01,95,"Marshall County, AL",Dec-19,43945,43046,899,2.0
29019,CN0109700000000,01,97,"Mobile County, AL",Dec-19,189207,183131,6076,3.2
29020,CN0109900000000,01,99,"Monroe County, AL",Dec-19,7367,7041,326,4.4
29021,CN0110100000000,01,101,"Montgomery County, AL",Dec-19,105682,102896,2786,2.6
29022,CN0110300000000,01,103,"Morgan County, AL",Dec-19,58527,57250,1277,2.2
29023,CN0110500000000,01,105,"Perry County, AL",Dec-19,3379,3245,134,4.0
29024,CN0110700000000,01,107,"Pickens County, AL",Dec-19,7939,7728,211,2.7
29025,CN0110900000000,01,109,"Pike County, AL",Dec-19,15461,15024,437,2.8
29026,CN0111100000000,01,111,"Randolph County, AL",Dec-19,9646,9409,237,2.5
29027,CN0111300000000,01,113,"Russell County, AL",Dec-19,23875,23273,602,2.5
29028,CN0111500000000,01,115,"St. Clair County, AL",Dec-19,40911,39994,917,2.2
29029,CN0111700000000,01,117,"Shelby County, AL",Dec-19,117216,115105,2111,1.8
29030,CN0111900000000,01,119,"Sumter County, AL",Dec-19,4874,4688,186,3.8
29031,CN0112100000000,01,121,"Talladega County, AL",Dec-19,35719,34675,1044,2.9
29032,CN0112300000000,01,123,"Tallapoosa County, AL",Dec-19,18548,18089,459,2.5
29033,CN0112500000000,01,125,"Tuscaloosa County, AL",Dec-19,106133,103785,2348,2.2
29034,CN0112700000000,01,127,"Walker County, AL",Dec-19,25553,24838,715,2.8
29035,CN0112900000000,01,129,"Washington County, AL",Dec-19,6818,6514,304,4.5
29036,CN0113100000000,01,131,"Wilcox County, AL",Dec-19,2740,2560,180,6.6
29037,CN0113300000000,01,133,"Winston County, AL",Dec-19,10080,9778,302,3.0
29038,CN0201300000000,02,13,"Aleutians East Borough, AK",Dec-19,1137,1055,82,7.2
29039,CN0201600000000,02,16,"Aleutians West Census Area, AK",Dec-19,2521,2370,151,6.0
29040,CN0202000000000,02,20,"Anchorage Borough/municipality, AK",Dec-19,147801,140718,7083,4.8
29041,CN0205000000000,02,50,"Bethel Census Area, AK",Dec-19,7158,6368,790,11.0
29042,CN0206000000000,02,60,"Bristol Bay Borough, AK",Dec-19,234,205,29,12.4
29043,CN0206800000000,02,68,"Denali Borough, AK",Dec-19,581,466,115,19.8
29044,CN0207000000000,02,70,"Dillingham Census Area, AK",Dec-19,1584,1452,132,8.3
29045,CN0209000000000,02,90,"Fairbanks North Star Borough, AK",Dec-19,44329,41985,2344,5.3
29046,CN0210000000000,02,100,"Haines Borough, AK",Dec-19,979,840,139,14.2
29047,CN0210500000000,02,105,"Hoonah-Angoon Census Area, AK",Dec-19,968,827,141,14.6
29048,CN0211000000000,02,110,"Juneau Borough/city, AK",Dec-19,16284,15572,712,4.4
29049,CN0212200000000,02,122,"Kenai Peninsula Borough, AK",Dec-19,25535,23643,1892,7.4
29050,CN0213000000000,02,130,"Ketchikan Gateway Borough, AK",Dec-19,6518,6086,432,6.6
29051,CN0215000000000,02,150,"Kodiak Island Borough, AK",Dec-19,5405,4891,514,9.5
29052,CN0215800000000,02,158,"Kusilvak Census Area, AK",Dec-19,2644,2210,434,16.4
29053,CN0216400000000,02,164,"Lake and Peninsula Borough, AK",Dec-19,573,517,56,9.8
29054,CN0217000000000,02,170,"Matanuska-Susitna Borough, AK",Dec-19,47235,44078,3157,6.7
29055,CN0218000000000,02,180,"Nome Census Area, AK",Dec-19,4178,3802,376,9.0
29056,CN0218500000000,02,185,"North Slope Borough, AK",Dec-19,3538,3338,200,5.7
29057,CN0218800000000,02,188,"Northwest Arctic Borough, AK",Dec-19,3058,2673,385,12.6
29058,CN0219500000000,02,195,"Petersburg Borough, AK",Dec-19,1317,1206,111,8.4
29059,CN0219800000000,02,198,"Prince of Wales-Hyder Census Area, AK",Dec-19,2750,2510,240,8.7
29060,CN0222000000000,02,220,"Sitka Borough/city, AK",Dec-19,4038,3851,187,4.6
29061,CN0223000000000,02,230,"Skagway Municipality, AK",Dec-19,627,504,123,19.6
29062,CN0224000000000,02,240,"Southeast Fairbanks Census Area, AK",Dec-19,2798,2547,251,9.0
29063,CN0226100000000,02,261,"Valdez-Cordova Census Area, AK",Dec-19,4236,3831,405,9.6
29064,CN0227500000000,02,275,"Wrangell Borough/city, AK",Dec-19,979,897,82,8.4
29065,CN0228200000000,02,282,"Yakutat Borough/city, AK",Dec-19,231,208,23,10.0
29066,CN0229000000000,02,290,"Yukon-Koyukuk Census Area, AK",Dec-19,2432,2153,279,11.5
29067,CN0400100000000,04,1,"Apache County, AZ",Dec-19,20475,18461,2014,9.8
29068,CN0400300000000,04,3,"Cochise County, AZ",Dec-19,51388,48698,2690,5.2
29069,CN0400500000000,04,5,"Coconino County, AZ",Dec-19,77257,73032,4225,5.5
29070,CN0400700000000,04,7,"Gila County, AZ",Dec-19,21538,20445,1093,5.1
29071,CN0400900000000,04,9,"Graham County, AZ",Dec-19,15713,15023,690,4.4
29072,CN0401100000000,04,11,"Greenlee County, AZ",Dec-19,4536,4385,151,3.3
29073,CN0401200000000,04,12,"La Paz County, AZ",Dec-19,9661,9151,510,5.3
29074,CN0401300000000,04,13,"Maricopa County, AZ",Dec-19,2356629,2272589,84040,3.6
29075,CN0401500000000,04,15,"Mohave County, AZ",Dec-19,88387,83680,4707,5.3
29076,CN0401700000000,04,17,"Navajo County, AZ",Dec-19,40889,38046,2843,7.0
29077,CN0401900000000,04,19,"Pima County, AZ",Dec-19,504172,483909,20263,4.0
29078,CN0402100000000,04,21,"Pinal County, AZ",Dec-19,192051,183536,8515,4.4
29079,CN0402300000000,04,23,"Santa Cruz County, AZ",Dec-19,19943,18404,1539,7.7
29080,CN0402500000000,04,25,"Yavapai County, AZ",Dec-19,107107,102814,4293,4.0
29081,CN0402700000000,04,27,"Yuma County, AZ",Dec-19,101964,87383,14581,14.3
29082,CN0500100000000,05,1,"Arkansas County, AR",Dec-19,9419,9136,283,3.0
29083,CN0500300000000,05,3,"Ashley County, AR",Dec-19,7585,7158,427,5.6
29084,CN0500500000000,05,5,"Baxter County, AR",Dec-19,16140,15523,617,3.8
29085,CN0500700000000,05,7,"Benton County, AR",Dec-19,137770,134463,3307,2.4
29086,CN0500900000000,05,9,"Boone County, AR",Dec-19,15960,15475,485,3.0
29087,CN0501100000000,05,11,"Bradley County, AR",Dec-19,4489,4332,157,3.5
29088,CN0501300000000,05,13,"Calhoun County, AR",Dec-19,2441,2345,96,3.9
29089,CN0501500000000,05,15,"Carroll County, AR",Dec-19,12565,12203,362,2.9
29090,CN0501700000000,05,17,"Chicot County, AR",Dec-19,3259,3041,218,6.7
29091,CN0501900000000,05,19,"Clark County, AR",Dec-19,9756,9415,341,3.5
29092,CN0502100000000,05,21,"Clay County, AR",Dec-19,5625,5341,284,5.0
29093,CN0502300000000,05,23,"Cleburne County, AR",Dec-19,9065,8638,427,4.7
29094,CN0502500000000,05,25,"Cleveland County, AR",Dec-19,3208,3081,127,4.0
29095,CN0502700000000,05,27,"Columbia County, AR",Dec-19,9151,8784,367,4.0
29096,CN0502900000000,05,29,"Conway County, AR",Dec-19,8284,7951,333,4.0
29097,CN0503100000000,05,31,"Craighead County, AR",Dec-19,55922,54519,1403,2.5
29098,CN0503300000000,05,33,"Crawford County, AR",Dec-19,26734,25922,812,3.0
29099,CN0503500000000,05,35,"Crittenden County, AR",Dec-19,21355,20548,807,3.8
29100,CN0503700000000,05,37,"Cross County, AR",Dec-19,7395,7091,304,4.1
29101,CN0503900000000,05,39,"Dallas County, AR",Dec-19,2826,2703,123,4.4
29102,CN0504100000000,05,41,"Desha County, AR",Dec-19,5382,5147,235,4.4
29103,CN0504300000000,05,43,"Drew County, AR",Dec-19,7936,7548,388,4.9
29104,CN0504500000000,05,45,"Faulkner County, AR",Dec-19,61703,59931,1772,2.9
29105,CN0504700000000,05,47,"Franklin County, AR",Dec-19,7417,7179,238,3.2
29106,CN0504900000000,05,49,"Fulton County, AR",Dec-19,4931,4758,173,3.5
29107,CN0505100000000,05,51,"Garland County, AR",Dec-19,40408,39008,1400,3.5
29108,CN0505300000000,05,53,"Grant County, AR",Dec-19,8323,8072,251,3.0
29109,CN0505500000000,05,55,"Greene County, AR",Dec-19,19978,19316,662,3.3
29110,CN0505700000000,05,57,"Hempstead County, AR",Dec-19,9825,9467,358,3.6
29111,CN0505900000000,05,59,"Hot Spring County, AR",Dec-19,13898,13445,453,3.3
29112,CN0506100000000,05,61,"Howard County, AR",Dec-19,5743,5545,198,3.4
29113,CN0506300000000,05,63,"Independence County, AR",Dec-19,16555,15937,618,3.7
29114,CN0506500000000,05,65,"Izard County, AR",Dec-19,4900,4612,288,5.9
29115,CN0506700000000,05,67,"Jackson County, AR",Dec-19,5871,5464,407,6.9
29116,CN0506900000000,05,69,"Jefferson County, AR",Dec-19,27477,26032,1445,5.3
29117,CN0507100000000,05,71,"Johnson County, AR",Dec-19,10216,9824,392,3.8
29118,CN0507300000000,05,73,"Lafayette County, AR",Dec-19,2439,2343,96,3.9
29119,CN0507500000000,05,75,"Lawrence County, AR",Dec-19,6835,6560,275,4.0
29120,CN0507700000000,05,77,"Lee County, AR",Dec-19,2838,2707,131,4.6
29121,CN0507900000000,05,79,"Lincoln County, AR",Dec-19,3932,3766,166,4.2
29122,CN0508100000000,05,81,"Little River County, AR",Dec-19,5523,5297,226,4.1
29123,CN0508300000000,05,83,"Logan County, AR",Dec-19,8551,8167,384,4.5
29124,CN0508500000000,05,85,"Lonoke County, AR",Dec-19,34203,33076,1127,3.3
29125,CN0508700000000,05,87,"Madison County, AR",Dec-19,7481,7313,168,2.2
29126,CN0508900000000,05,89,"Marion County, AR",Dec-19,6579,6321,258,3.9
29127,CN0509100000000,05,91,"Miller County, AR",Dec-19,19724,18982,742,3.8
29128,CN0509300000000,05,93,"Mississippi County, AR",Dec-19,17257,16421,836,4.8
29129,CN0509500000000,05,95,"Monroe County, AR",Dec-19,2747,2622,125,4.6
29130,CN0509700000000,05,97,"Montgomery County, AR",Dec-19,2891,2762,129,4.5
29131,CN0509900000000,05,99,"Nevada County, AR",Dec-19,3600,3471,129,3.6
29132,CN0510100000000,05,101,"Newton County, AR",Dec-19,3325,3213,112,3.4
29133,CN0510300000000,05,103,"Ouachita County, AR",Dec-19,9774,9292,482,4.9
29134,CN0510500000000,05,105,"Perry County, AR",Dec-19,4215,4063,152,3.6
29135,CN0510700000000,05,107,"Phillips County, AR",Dec-19,6329,5938,391,6.2
29136,CN0510900000000,05,109,"Pike County, AR",Dec-19,4227,4066,161,3.8
29137,CN0511100000000,05,111,"Poinsett County, AR",Dec-19,10386,10037,349,3.4
29138,CN0511300000000,05,113,"Polk County, AR",Dec-19,8162,7803,359,4.4
29139,CN0511500000000,05,115,"Pope County, AR",Dec-19,28903,27693,1210,4.2
29140,CN0511700000000,05,117,"Prairie County, AR",Dec-19,3599,3442,157,4.4
29141,CN0511900000000,05,119,"Pulaski County, AR",Dec-19,188032,181818,6214,3.3
29142,CN0512100000000,05,121,"Randolph County, AR",Dec-19,7363,7071,292,4.0
29143,CN0512300000000,05,123,"St. Francis County, AR",Dec-19,8095,7716,379,4.7
29144,CN0512500000000,05,125,"Saline County, AR",Dec-19,58378,56834,1544,2.6
29145,CN0512700000000,05,127,"Scott County, AR",Dec-19,4320,4176,144,3.3
29146,CN0512900000000,05,129,"Searcy County, AR",Dec-19,2819,2674,145,5.1
29147,CN0513100000000,05,131,"Sebastian County, AR",Dec-19,56319,54555,1764,3.1
29148,CN0513300000000,05,133,"Sevier County, AR",Dec-19,5528,5270,258,4.7
29149,CN0513500000000,05,135,"Sharp County, AR",Dec-19,5670,5387,283,5.0
29150,CN0513700000000,05,137,"Stone County, AR",Dec-19,4613,4402,211,4.6
29151,CN0513900000000,05,139,"Union County, AR",Dec-19,15788,14947,841,5.3
29152,CN0514100000000,05,141,"Van Buren County, AR",Dec-19,5636,5353,283,5.0
29153,CN0514300000000,05,143,"Washington County, AR",Dec-19,125398,122658,2740,2.2
29154,CN0514500000000,05,145,"White County, AR",Dec-19,33765,32279,1486,4.4
29155,CN0514700000000,05,147,"Woodruff County, AR",Dec-19,2773,2634,139,5.0
29156,CN0514900000000,05,149,"Yell County, AR",Dec-19,8418,8135,283,3.4
29157,CN0600100000000,06,1,"Alameda County, CA",Dec-19,845181,823865,21316,2.5
29158,CN0600300000000,06,3,"Alpine County, CA",Dec-19,608,585,23,3.8
29159,CN0600500000000,06,5,"Amador County, CA",Dec-19,14803,14263,540,3.6
29160,CN0600700000000,06,7,"Butte County, CA",Dec-19,98635,94342,4293,4.4
29161,CN0600900000000,06,9,"Calaveras County, CA",Dec-19,21678,20943,735,3.4
29162,CN0601100000000,06,11,"Colusa County, CA",Dec-19,10507,9014,1493,14.2
29163,CN0601300000000,06,13,"Contra Costa County, CA",Dec-19,562014,547030,14984,2.7
29164,CN0601500000000,06,15,"Del Norte County, CA",Dec-19,9552,9006,546,5.7
29165,CN0601700000000,06,17,"El Dorado County, CA",Dec-19,92267,89444,2823,3.1
29166,CN0601900000000,06,19,"Fresno County, CA",Dec-19,449548,418389,31159,6.9
29167,CN0602100000000,06,21,"Glenn County, CA",Dec-19,12957,12261,696,5.4
29168,CN0602300000000,06,23,"Humboldt County, CA",Dec-19,62522,60597,1925,3.1
29169,CN0602500000000,06,25,"Imperial County, CA",Dec-19,71883,59622,12261,17.1
29170,CN0602700000000,06,27,"Inyo County, CA",Dec-19,8662,8395,267,3.1
29171,CN0602900000000,06,29,"Kern County, CA",Dec-19,389804,362153,27651,7.1
29172,CN0603100000000,06,31,"Kings County, CA",Dec-19,57722,53282,4440,7.7
29173,CN0603300000000,06,33,"Lake County, CA",Dec-19,28784,27317,1467,5.1
29174,CN0603500000000,06,35,"Lassen County, CA",Dec-19,9674,9277,397,4.1
29175,CN0603700000000,06,37,"Los Angeles County, CA",Dec-19,5158181,4951091,207090,4.0
29176,CN0603900000000,06,39,"Madera County, CA",Dec-19,61963,57803,4160,6.7
29177,CN0604100000000,06,41,"Marin County, CA",Dec-19,140629,137879,2750,2.0
29178,CN0604300000000,06,43,"Mariposa County, CA",Dec-19,7124,6808,316,4.4
29179,CN0604500000000,06,45,"Mendocino County, CA",Dec-19,38382,36948,1434,3.7
29180,CN0604700000000,06,47,"Merced County, CA",Dec-19,114943,105874,9069,7.9
29181,CN0604900000000,06,49,"Modoc County, CA",Dec-19,3033,2818,215,7.1
29182,CN0605100000000,06,51,"Mono County, CA",Dec-19,8734,8450,284,3.3
29183,CN0605300000000,06,53,"Monterey County, CA",Dec-19,210947,195663,15284,7.2
29184,CN0605500000000,06,55,"Napa County, CA",Dec-19,71939,69883,2056,2.9
29185,CN0605700000000,06,57,"Nevada County, CA",Dec-19,48863,47443,1420,2.9
29186,CN0605900000000,06,59,"Orange County, CA",Dec-19,1631145,1592027,39118,2.4
29187,CN0606100000000,06,61,"Placer County, CA",Dec-19,188635,183581,5054,2.7
29188,CN0606300000000,06,63,"Plumas County, CA",Dec-19,7512,6932,580,7.7
29189,CN0606500000000,06,65,"Riverside County, CA",Dec-19,1111894,1071322,40572,3.6
29190,CN0606700000000,06,67,"Sacramento County, CA",Dec-19,714835,691943,22892,3.2
29191,CN0606900000000,06,69,"San Benito County, CA",Dec-19,31303,29775,1528,4.9
29192,CN0607100000000,06,71,"San Bernardino County, CA",Dec-19,975489,943280,32209,3.3
29193,CN0607300000000,06,73,"San Diego County, CA",Dec-19,1597099,1552857,44242,2.8
29194,CN0607500000000,06,75,"San Francisco County/city, CA",Dec-19,589286,578146,11140,1.9
29195,CN0607700000000,06,77,"San Joaquin County, CA",Dec-19,325993,307645,18348,5.6
29196,CN0607900000000,06,79,"San Luis Obispo County, CA",Dec-19,139351,135817,3534,2.5
29197,CN0608100000000,06,81,"San Mateo County, CA",Dec-19,464779,456645,8134,1.8
29198,CN0608300000000,06,83,"Santa Barbara County, CA",Dec-19,214976,207294,7682,3.6
29199,CN0608500000000,06,85,"Santa Clara County, CA",Dec-19,1058880,1035852,23028,2.2
29200,CN0608700000000,06,87,"Santa Cruz County, CA",Dec-19,139049,132443,6606,4.8
29201,CN0608900000000,06,89,"Shasta County, CA",Dec-19,74102,71028,3074,4.1
29202,CN0609100000000,06,91,"Sierra County, CA",Dec-19,1322,1262,60,4.5
29203,CN0609300000000,06,93,"Siskiyou County, CA",Dec-19,16852,15784,1068,6.3
29204,CN0609500000000,06,95,"Solano County, CA",Dec-19,209564,202607,6957,3.3
29205,CN0609700000000,06,97,"Sonoma County, CA",Dec-19,259689,253575,6114,2.4
29206,CN0609900000000,06,99,"Stanislaus County, CA",Dec-19,242518,229013,13505,5.6
29207,CN0610100000000,06,101,"Sutter County, CA",Dec-19,46236,42929,3307,7.2
29208,CN0610300000000,06,103,"Tehama County, CA",Dec-19,25386,24148,1238,4.9
29209,CN0610500000000,06,105,"Trinity County, CA",Dec-19,4474,4239,235,5.3
29210,CN0610700000000,06,107,"Tulare County, CA",Dec-19,202541,183652,18889,9.3
29211,CN0610900000000,06,109,"Tuolumne County, CA",Dec-19,21469,20635,834,3.9
29212,CN0611100000000,06,111,"Ventura County, CA",Dec-19,424525,410292,14233,3.4
29213,CN0611300000000,06,113,"Yolo County, CA",Dec-19,108879,104652,4227,3.9
29214,CN0611500000000,06,115,"Yuba County, CA",Dec-19,30800,29092,1708,5.5
29215,CN0800100000000,08,1,"Adams County, CO",Dec-19,277770,270813,6957,2.5
29216,CN0800300000000,08,3,"Alamosa County, CO",Dec-19,8932,8656,276,3.1
29217,CN0800500000000,08,5,"Arapahoe County, CO",Dec-19,370624,362076,8548,2.3
29218,CN0800700000000,08,7,"Archuleta County, CO",Dec-19,6783,6600,183,2.7
29219,CN0800900000000,08,9,"Baca County, CO",Dec-19,2285,2255,30,1.3
29220,CN0801100000000,08,11,"Bent County, CO",Dec-19,2025,1981,44,2.2
29221,CN0801300000000,08,13,"Boulder County, CO",Dec-19,197746,193839,3907,2.0
29222,CN0801400000000,08,14,"Broomfield County/city, CO",Dec-19,40845,40001,844,2.1
29223,CN0801500000000,08,15,"Chaffee County, CO",Dec-19,9651,9447,204,2.1
29224,CN0801700000000,08,17,"Cheyenne County, CO",Dec-19,1274,1257,17,1.3
29225,CN0801900000000,08,19,"Clear Creek County, CO",Dec-19,6135,6016,119,1.9
29226,CN0802100000000,08,21,"Conejos County, CO",Dec-19,4327,4194,133,3.1
29227,CN0802300000000,08,23,"Costilla County, CO",Dec-19,1927,1864,63,3.3
29228,CN0802500000000,08,25,"Crowley County, CO",Dec-19,1534,1480,54,3.5
29229,CN0802700000000,08,27,"Custer County, CO",Dec-19,2110,2054,56,2.7
29230,CN0802900000000,08,29,"Delta County, CO",Dec-19,14730,14296,434,2.9
29231,CN0803100000000,08,31,"Denver County/city, CO",Dec-19,423917,414090,9827,2.3
29232,CN0803300000000,08,33,"Dolores County, CO",Dec-19,1210,1180,30,2.5
29233,CN0803500000000,08,35,"Douglas County, CO",Dec-19,197525,193632,3893,2.0
29234,CN0803700000000,08,37,"Eagle County, CO",Dec-19,38840,38137,703,1.8
29235,CN0803900000000,08,39,"Elbert County, CO",Dec-19,15602,15321,281,1.8
29236,CN0804100000000,08,41,"El Paso County, CO",Dec-19,343832,334234,9598,2.8
29237,CN0804300000000,08,43,"Fremont County, CO",Dec-19,14865,14274,591,4.0
29238,CN0804500000000,08,45,"Garfield County, CO",Dec-19,33835,33012,823,2.4
29239,CN0804700000000,08,47,"Gilpin County, CO",Dec-19,3834,3761,73,1.9
29240,CN0804900000000,08,49,"Grand County, CO",Dec-19,10483,10302,181,1.7
29241,CN0805100000000,08,51,"Gunnison County, CO",Dec-19,12000,11774,226,1.9
29242,CN0805300000000,08,53,"Hinsdale County, CO",Dec-19,389,375,14,3.6
29243,CN0805500000000,08,55,"Huerfano County, CO",Dec-19,2545,2416,129,5.1
29244,CN0805700000000,08,57,"Jackson County, CO",Dec-19,1050,1031,19,1.8
29245,CN0805900000000,08,59,"Jefferson County, CO",Dec-19,340652,333266,7386,2.2
29246,CN0806100000000,08,61,"Kiowa County, CO",Dec-19,1059,1048,11,1.0
29247,CN0806300000000,08,63,"Kit Carson County, CO",Dec-19,4562,4496,66,1.4
29248,CN0806500000000,08,65,"Lake County, CO",Dec-19,5265,5181,84,1.6
29249,CN0806700000000,08,67,"La Plata County, CO",Dec-19,32030,31343,687,2.1
29250,CN0806900000000,08,69,"Larimer County, CO",Dec-19,209156,205003,4153,2.0
29251,CN0807100000000,08,71,"Las Animas County, CO",Dec-19,6714,6491,223,3.3
29252,CN0807300000000,08,73,"Lincoln County, CO",Dec-19,2467,2411,56,2.3
29253,CN0807500000000,08,75,"Logan County, CO",Dec-19,11355,11139,216,1.9
29254,CN0807700000000,08,77,"Mesa County, CO",Dec-19,76241,73867,2374,3.1
29255,CN0807900000000,08,79,"Mineral County, CO",Dec-19,557,546,11,2.0
29256,CN0808100000000,08,81,"Moffat County, CO",Dec-19,7431,7192,239,3.2
29257,CN0808300000000,08,83,"Montezuma County, CO",Dec-19,12866,12346,520,4.0
29258,CN0808500000000,08,85,"Montrose County, CO",Dec-19,22175,21614,561,2.5
29259,CN0808700000000,08,87,"Morgan County, CO",Dec-19,16949,16573,376,2.2
29260,CN0808900000000,08,89,"Otero County, CO",Dec-19,8631,8344,287,3.3
29261,CN0809100000000,08,91,"Ouray County, CO",Dec-19,2355,2278,77,3.3
29262,CN0809300000000,08,93,"Park County, CO",Dec-19,11316,11077,239,2.1
29263,CN0809500000000,08,95,"Phillips County, CO",Dec-19,2810,2776,34,1.2
29264,CN0809700000000,08,97,"Pitkin County, CO",Dec-19,11629,11300,329,2.8
29265,CN0809900000000,08,99,"Prowers County, CO",Dec-19,6667,6534,133,2.0
29266,CN0810100000000,08,101,"Pueblo County, CO",Dec-19,76594,73860,2734,3.6
29267,CN0810300000000,08,103,"Rio Blanco County, CO",Dec-19,3009,2922,87,2.9
29268,CN0810500000000,08,105,"Rio Grande County, CO",Dec-19,5738,5505,233,4.1
29269,CN0810700000000,08,107,"Routt County, CO",Dec-19,17200,16903,297,1.7
29270,CN0810900000000,08,109,"Saguache County, CO",Dec-19,3808,3668,140,3.7
29271,CN0811100000000,08,111,"San Juan County, CO",Dec-19,507,488,19,3.7
29272,CN0811300000000,08,113,"San Miguel County, CO",Dec-19,6448,6284,164,2.5
29273,CN0811500000000,08,115,"Sedgwick County, CO",Dec-19,1318,1297,21,1.6
29274,CN0811700000000,08,117,"Summit County, CO",Dec-19,25565,25224,341,1.3
29275,CN0811900000000,08,119,"Teller County, CO",Dec-19,12771,12447,324,2.5
29276,CN0812100000000,08,121,"Washington County, CO",Dec-19,3061,3010,51,1.7
29277,CN0812300000000,08,123,"Weld County, CO",Dec-19,172545,168655,3890,2.3
29278,CN0812500000000,08,125,"Yuma County, CO",Dec-19,6394,6313,81,1.3
29279,CN0900100000000,09,1,"Fairfield County, CT",Dec-19,482315,467277,15038,3.1
29280,CN0900300000000,09,3,"Hartford County, CT",Dec-19,485242,468918,16324,3.4
29281,CN0900500000000,09,5,"Litchfield County, CT",Dec-19,105362,102206,3156,3.0
29282,CN0900700000000,09,7,"Middlesex County, CT",Dec-19,94284,91661,2623,2.8
29283,CN0900900000000,09,9,"New Haven County, CT",Dec-19,464244,448627,15617,3.4
29284,CN0901100000000,09,11,"New London County, CT",Dec-19,136738,132425,4313,3.2
29285,CN0901300000000,09,13,"Tolland County, CT",Dec-19,87519,85012,2507,2.9
29286,CN0901500000000,09,15,"Windham County, CT",Dec-19,64500,62238,2262,3.5
29287,CN1000100000000,10,1,"Kent County, DE",Dec-19,80327,77341,2986,3.7
29288,CN1000300000000,10,3,"New Castle County, DE",Dec-19,301422,291335,10087,3.3
29289,CN1000500000000,10,5,"Sussex County, DE",Dec-19,106540,102313,4227,4.0
29290,CN1100100000000,11,1,District of Columbia,Dec-19,411233,390807,20426,5.0
29291,CN1200100000000,12,1,"Alachua County, FL",Dec-19,140376,136953,3423,2.4
29292,CN1200300000000,12,3,"Baker County, FL",Dec-19,12010,11692,318,2.6
29293,CN1200500000000,12,5,"Bay County, FL",Dec-19,81471,79066,2405,3.0
29294,CN1200700000000,12,7,"Bradford County, FL",Dec-19,11192,10898,294,2.6
29295,CN1200900000000,12,9,"Brevard County, FL",Dec-19,285212,277466,7746,2.7
29296,CN1201100000000,12,11,"Broward County, FL",Dec-19,1042504,1015693,26811,2.6
29297,CN1201300000000,12,13,"Calhoun County, FL",Dec-19,4737,4582,155,3.3
29298,CN1201500000000,12,15,"Charlotte County, FL",Dec-19,72814,70598,2216,3.0
29299,CN1201700000000,12,17,"Citrus County, FL",Dec-19,46961,45017,1944,4.1
29300,CN1201900000000,12,19,"Clay County, FL",Dec-19,109095,106332,2763,2.5
29301,CN1202100000000,12,21,"Collier County, FL",Dec-19,184631,179927,4704,2.5
29302,CN1202300000000,12,23,"Columbia County, FL",Dec-19,30325,29525,800,2.6
29303,CN1202700000000,12,27,"DeSoto County, FL",Dec-19,14711,14271,440,3.0
29304,CN1202900000000,12,29,"Dixie County, FL",Dec-19,5872,5667,205,3.5
29305,CN1203100000000,12,31,"Duval County, FL",Dec-19,497767,484351,13416,2.7
29306,CN1203300000000,12,33,"Escambia County, FL",Dec-19,145900,141872,4028,2.8
29307,CN1203500000000,12,35,"Flagler County, FL",Dec-19,47053,45498,1555,3.3
29308,CN1203700000000,12,37,"Franklin County, FL",Dec-19,4468,4348,120,2.7
29309,CN1203900000000,12,39,"Gadsden County, FL",Dec-19,18795,18152,643,3.4
29310,CN1204100000000,12,41,"Gilchrist County, FL",Dec-19,7195,6987,208,2.9
29311,CN1204300000000,12,43,"Glades County, FL",Dec-19,5479,5296,183,3.3
29312,CN1204500000000,12,45,"Gulf County, FL",Dec-19,5561,5366,195,3.5
29313,CN1204700000000,12,47,"Hamilton County, FL",Dec-19,4214,4058,156,3.7
29314,CN1204900000000,12,49,"Hardee County, FL",Dec-19,8950,8596,354,4.0
29315,CN1205100000000,12,51,"Hendry County, FL",Dec-19,15933,15173,760,4.8
29316,CN1205300000000,12,53,"Hernando County, FL",Dec-19,72300,69714,2586,3.6
29317,CN1205500000000,12,55,"Highlands County, FL",Dec-19,36638,35223,1415,3.9
29318,CN1205700000000,12,57,"Hillsborough County, FL",Dec-19,757213,737843,19370,2.6
29319,CN1205900000000,12,59,"Holmes County, FL",Dec-19,7006,6796,210,3.0
29320,CN1206100000000,12,61,"Indian River County, FL",Dec-19,66150,64044,2106,3.2
29321,CN1206300000000,12,63,"Jackson County, FL",Dec-19,17114,16586,528,3.1
29322,CN1206500000000,12,65,"Jefferson County, FL",Dec-19,5643,5488,155,2.7
29323,CN1206700000000,12,67,"Lafayette County, FL",Dec-19,2824,2754,70,2.5
29324,CN1206900000000,12,69,"Lake County, FL",Dec-19,160371,155998,4373,2.7
29325,CN1207100000000,12,71,"Lee County, FL",Dec-19,353248,344074,9174,2.6
29326,CN1207300000000,12,73,"Leon County, FL",Dec-19,155941,151948,3993,2.6
29327,CN1207500000000,12,75,"Levy County, FL",Dec-19,16706,16208,498,3.0
29328,CN1207700000000,12,77,"Liberty County, FL",Dec-19,2630,2551,79,3.0
29329,CN1207900000000,12,79,"Madison County, FL",Dec-19,7497,7255,242,3.2
29330,CN1208100000000,12,81,"Manatee County, FL",Dec-19,181336,176542,4794,2.6
29331,CN1208300000000,12,83,"Marion County, FL",Dec-19,137663,133193,4470,3.2
29332,CN1208500000000,12,85,"Martin County, FL",Dec-19,74393,72437,1956,2.6
29333,CN1208600000000,12,86,"Miami-Dade County, FL",Dec-19,1392870,1370836,22034,1.6
29334,CN1208700000000,12,87,"Monroe County, FL",Dec-19,47857,47029,828,1.7
29335,CN1208900000000,12,89,"Nassau County, FL",Dec-19,41728,40684,1044,2.5
29336,CN1209100000000,12,91,"Okaloosa County, FL",Dec-19,94702,92494,2208,2.3
29337,CN1209300000000,12,93,"Okeechobee County, FL",Dec-19,18123,17629,494,2.7
29338,CN1209500000000,12,95,"Orange County, FL",Dec-19,768745,750030,18715,2.4
29339,CN1209700000000,12,97,"Osceola County, FL",Dec-19,185651,180524,5127,2.8
29340,CN1209900000000,12,99,"Palm Beach County, FL",Dec-19,735236,715236,20000,2.7
29341,CN1210100000000,12,101,"Pasco County, FL",Dec-19,239444,232367,7077,3.0
29342,CN1210300000000,12,103,"Pinellas County, FL",Dec-19,497735,485209,12526,2.5
29343,CN1210500000000,12,105,"Polk County, FL",Dec-19,308057,298597,9460,3.1
29344,CN1210700000000,12,107,"Putnam County, FL",Dec-19,26496,25501,995,3.8
29345,CN1210900000000,12,109,"St. Johns County, FL",Dec-19,134084,131113,2971,2.2
29346,CN1211100000000,12,111,"St. Lucie County, FL",Dec-19,145449,140635,4814,3.3
29347,CN1211300000000,12,113,"Santa Rosa County, FL",Dec-19,82991,80886,2105,2.5
29348,CN1211500000000,12,115,"Sarasota County, FL",Dec-19,190002,185038,4964,2.6
29349,CN1211700000000,12,117,"Seminole County, FL",Dec-19,257406,251096,6310,2.5
29350,CN1211900000000,12,119,"Sumter County, FL",Dec-19,32789,31500,1289,3.9
29351,CN1212100000000,12,121,"Suwannee County, FL",Dec-19,18033,17496,537,3.0
29352,CN1212300000000,12,123,"Taylor County, FL",Dec-19,8182,7937,245,3.0
29353,CN1212500000000,12,125,"Union County, FL",Dec-19,4660,4540,120,2.6
29354,CN1212700000000,12,127,"Volusia County, FL",Dec-19,254308,246741,7567,3.0
29355,CN1212900000000,12,129,"Wakulla County, FL",Dec-19,14993,14624,369,2.5
29356,CN1213100000000,12,131,"Walton County, FL",Dec-19,30850,30062,788,2.6
29357,CN1213300000000,12,133,"Washington County, FL",Dec-19,9598,9320,278,2.9
29358,CN1300100000000,13,1,"Appling County, GA",Dec-19,9422,9102,320,3.4
29359,CN1300300000000,13,3,"Atkinson County, GA",Dec-19,4672,4546,126,2.7
29360,CN1300500000000,13,5,"Bacon County, GA",Dec-19,4854,4677,177,3.6
29361,CN1300700000000,13,7,"Baker County, GA",Dec-19,1154,1107,47,4.1
29362,CN1300900000000,13,9,"Baldwin County, GA",Dec-19,17417,16761,656,3.8
29363,CN1301100000000,13,11,"Banks County, GA",Dec-19,9702,9483,219,2.3
29364,CN1301300000000,13,13,"Barrow County, GA",Dec-19,40948,40004,944,2.3
29365,CN1301500000000,13,15,"Bartow County, GA",Dec-19,51416,49804,1612,3.1
29366,CN1301700000000,13,17,"Ben Hill County, GA",Dec-19,5308,5016,292,5.5
29367,CN1301900000000,13,19,"Berrien County, GA",Dec-19,7499,7167,332,4.4
29368,CN1302100000000,13,21,"Bibb County, GA",Dec-19,67979,65861,2118,3.1
29369,CN1302300000000,13,23,"Bleckley County, GA",Dec-19,4445,4275,170,3.8
29370,CN1302500000000,13,25,"Brantley County, GA",Dec-19,7150,6896,254,3.6
29371,CN1302700000000,13,27,"Brooks County, GA",Dec-19,6848,6647,201,2.9
29372,CN1302900000000,13,29,"Bryan County, GA",Dec-19,18160,17703,457,2.5
29373,CN1303100000000,13,31,"Bulloch County, GA",Dec-19,36161,35042,1119,3.1
29374,CN1303300000000,13,33,"Burke County, GA",Dec-19,9120,8738,382,4.2
29375,CN1303500000000,13,35,"Butts County, GA",Dec-19,10870,10575,295,2.7
29376,CN1303700000000,13,37,"Calhoun County, GA",Dec-19,2257,2192,65,2.9
29377,CN1303900000000,13,39,"Camden County, GA",Dec-19,20829,20206,623,3.0
29378,CN1304300000000,13,43,"Candler County, GA",Dec-19,5569,5401,168,3.0
29379,CN1304500000000,13,45,"Carroll County, GA",Dec-19,55806,54244,1562,2.8
29380,CN1304700000000,13,47,"Catoosa County, GA",Dec-19,33665,32764,901,2.7
29381,CN1304900000000,13,49,"Charlton County, GA",Dec-19,4801,4655,146,3.0
29382,CN1305100000000,13,51,"Chatham County, GA",Dec-19,138786,134914,3872,2.8
29383,CN1305300000000,13,53,"Chattahoochee County, GA",Dec-19,1984,1912,72,3.6
29384,CN1305500000000,13,55,"Chattooga County, GA",Dec-19,11134,9775,1359,12.2
29385,CN1305700000000,13,57,"Cherokee County, GA",Dec-19,137554,134474,3080,2.2
29386,CN1305900000000,13,59,"Clarke County, GA",Dec-19,59225,57596,1629,2.8
29387,CN1306100000000,13,61,"Clay County, GA",Dec-19,868,811,57,6.6
29388,CN1306300000000,13,63,"Clayton County, GA",Dec-19,139417,134601,4816,3.5
29389,CN1306500000000,13,65,"Clinch County, GA",Dec-19,2508,2420,88,3.5
29390,CN1306700000000,13,67,"Cobb County, GA",Dec-19,430626,420158,10468,2.4
29391,CN1306900000000,13,69,"Coffee County, GA",Dec-19,18949,18142,807,4.3
29392,CN1307100000000,13,71,"Colquitt County, GA",Dec-19,21063,20496,567,2.7
29393,CN1307300000000,13,73,"Columbia County, GA",Dec-19,75115,73255,1860,2.5
29394,CN1307500000000,13,75,"Cook County, GA",Dec-19,8013,7747,266,3.3
29395,CN1307700000000,13,77,"Coweta County, GA",Dec-19,75623,73793,1830,2.4
29396,CN1307900000000,13,79,"Crawford County, GA",Dec-19,5600,5442,158,2.8
29397,CN1308100000000,13,81,"Crisp County, GA",Dec-19,9382,9073,309,3.3
29398,CN1308300000000,13,83,"Dade County, GA",Dec-19,8166,7935,231,2.8
29399,CN1308500000000,13,85,"Dawson County, GA",Dec-19,12437,12142,295,2.4
29400,CN1308700000000,13,87,"Decatur County, GA",Dec-19,11444,11076,368,3.2
29401,CN1308900000000,13,89,"DeKalb County, GA",Dec-19,404537,393076,11461,2.8
29402,CN1309100000000,13,91,"Dodge County, GA",Dec-19,6961,6635,326,4.7
29403,CN1309300000000,13,93,"Dooly County, GA",Dec-19,5096,4929,167,3.3
29404,CN1309500000000,13,95,"Dougherty County, GA",Dec-19,38552,37006,1546,4.0
29405,CN1309700000000,13,97,"Douglas County, GA",Dec-19,74144,71971,2173,2.9
29406,CN1309900000000,13,99,"Early County, GA",Dec-19,4439,4278,161,3.6
29407,CN1310100000000,13,101,"Echols County, GA",Dec-19,1896,1851,45,2.4
29408,CN1310300000000,13,103,"Effingham County, GA",Dec-19,30746,29992,754,2.5
29409,CN1310500000000,13,105,"Elbert County, GA",Dec-19,7646,7371,275,3.6
29410,CN1310700000000,13,107,"Emanuel County, GA",Dec-19,8257,7875,382,4.6
29411,CN1310900000000,13,109,"Evans County, GA",Dec-19,4858,4722,136,2.8
29412,CN1311100000000,13,111,"Fannin County, GA",Dec-19,11376,11050,326,2.9
29413,CN1311300000000,13,113,"Fayette County, GA",Dec-19,58750,57354,1396,2.4
29414,CN1311500000000,13,115,"Floyd County, GA",Dec-19,44694,43021,1673,3.7
29415,CN1311700000000,13,117,"Forsyth County, GA",Dec-19,123634,120927,2707,2.2
29416,CN1311900000000,13,119,"Franklin County, GA",Dec-19,9816,9509,307,3.1
29417,CN1312100000000,13,121,"Fulton County, GA",Dec-19,563666,547729,15937,2.8
29418,CN1312300000000,13,123,"Gilmer County, GA",Dec-19,11758,11402,356,3.0
29419,CN1312500000000,13,125,"Glascock County, GA",Dec-19,1264,1228,36,2.8
29420,CN1312700000000,13,127,"Glynn County, GA",Dec-19,39063,37982,1081,2.8
29421,CN1312900000000,13,129,"Gordon County, GA",Dec-19,28137,27165,972,3.5
29422,CN1313100000000,13,131,"Grady County, GA",Dec-19,10303,10006,297,2.9
29423,CN1313300000000,13,133,"Greene County, GA",Dec-19,6890,6649,241,3.5
29424,CN1313500000000,13,135,"Gwinnett County, GA",Dec-19,495462,483334,12128,2.4
29425,CN1313700000000,13,137,"Habersham County, GA",Dec-19,19026,18459,567,3.0
29426,CN1313900000000,13,139,"Hall County, GA",Dec-19,102925,100611,2314,2.2
29427,CN1314100000000,13,141,"Hancock County, GA",Dec-19,2449,2313,136,5.6
29428,CN1314300000000,13,143,"Haralson County, GA",Dec-19,12703,12345,358,2.8
29429,CN1314500000000,13,145,"Harris County, GA",Dec-19,16592,16158,434,2.6
29430,CN1314700000000,13,147,"Hart County, GA",Dec-19,10884,10551,333,3.1
29431,CN1314900000000,13,149,"Heard County, GA",Dec-19,5307,5159,148,2.8
29432,CN1315100000000,13,151,"Henry County, GA",Dec-19,117073,113759,3314,2.8
29433,CN1315300000000,13,153,"Houston County, GA",Dec-19,70424,68512,1912,2.7
29434,CN1315500000000,13,155,"Irwin County, GA",Dec-19,3334,3188,146,4.4
29435,CN1315700000000,13,157,"Jackson County, GA",Dec-19,37500,36704,796,2.1
29436,CN1315900000000,13,159,"Jasper County, GA",Dec-19,7008,6831,177,2.5
29437,CN1316100000000,13,161,"Jeff Davis County, GA",Dec-19,5973,5710,263,4.4
29438,CN1316300000000,13,163,"Jefferson County, GA",Dec-19,6596,6320,276,4.2
29439,CN1316500000000,13,165,"Jenkins County, GA",Dec-19,3101,2959,142,4.6
29440,CN1316700000000,13,167,"Johnson County, GA",Dec-19,3982,3859,123,3.1
29441,CN1316900000000,13,169,"Jones County, GA",Dec-19,13728,13361,367,2.7
29442,CN1317100000000,13,171,"Lamar County, GA",Dec-19,8310,8044,266,3.2
29443,CN1317300000000,13,173,"Lanier County, GA",Dec-19,3752,3615,137,3.7
29444,CN1317500000000,13,175,"Laurens County, GA",Dec-19,18927,18142,785,4.1
29445,CN1317700000000,13,177,"Lee County, GA",Dec-19,14839,14453,386,2.6
29446,CN1317900000000,13,179,"Liberty County, GA",Dec-19,26311,25475,836,3.2
29447,CN1318100000000,13,181,"Lincoln County, GA",Dec-19,3541,3425,116,3.3
29448,CN1318300000000,13,183,"Long County, GA",Dec-19,8153,7913,240,2.9
29449,CN1318500000000,13,185,"Lowndes County, GA",Dec-19,51301,49779,1522,3.0
29450,CN1318700000000,13,187,"Lumpkin County, GA",Dec-19,16774,16367,407,2.4
29451,CN1318900000000,13,189,"McDuffie County, GA",Dec-19,8862,8460,402,4.5
29452,CN1319100000000,13,191,"McIntosh County, GA",Dec-19,6104,5924,180,2.9
29453,CN1319300000000,13,193,"Macon County, GA",Dec-19,4634,4457,177,3.8
29454,CN1319500000000,13,195,"Madison County, GA",Dec-19,13319,12973,346,2.6
29455,CN1319700000000,13,197,"Marion County, GA",Dec-19,3276,3162,114,3.5
29456,CN1319900000000,13,199,"Meriwether County, GA",Dec-19,8983,8637,346,3.9
29457,CN1320100000000,13,201,"Miller County, GA",Dec-19,2718,2640,78,2.9
29458,CN1320500000000,13,205,"Mitchell County, GA",Dec-19,8505,8136,369,4.3
29459,CN1320700000000,13,207,"Monroe County, GA",Dec-19,13010,12649,361,2.8
29460,CN1320900000000,13,209,"Montgomery County, GA",Dec-19,3753,3601,152,4.1
29461,CN1321100000000,13,211,"Morgan County, GA",Dec-19,9300,9055,245,2.6
29462,CN1321300000000,13,213,"Murray County, GA",Dec-19,15586,14690,896,5.7
29463,CN1321500000000,13,215,"Muscogee County, GA",Dec-19,77054,74185,2869,3.7
29464,CN1321700000000,13,217,"Newton County, GA",Dec-19,52789,51135,1654,3.1
29465,CN1321900000000,13,219,"Oconee County, GA",Dec-19,19550,19158,392,2.0
29466,CN1322100000000,13,221,"Oglethorpe County, GA",Dec-19,6938,6756,182,2.6
29467,CN1322300000000,13,223,"Paulding County, GA",Dec-19,87146,85027,2119,2.4
29468,CN1322500000000,13,225,"Peach County, GA",Dec-19,11750,11377,373,3.2
29469,CN1322700000000,13,227,"Pickens County, GA",Dec-19,15488,15098,390,2.5
29470,CN1322900000000,13,229,"Pierce County, GA",Dec-19,8651,8400,251,2.9
29471,CN1323100000000,13,231,"Pike County, GA",Dec-19,8998,8768,230,2.6
29472,CN1323300000000,13,233,"Polk County, GA",Dec-19,18485,17893,592,3.2
29473,CN1323500000000,13,235,"Pulaski County, GA",Dec-19,4027,3904,123,3.1
29474,CN1323700000000,13,237,"Putnam County, GA",Dec-19,8164,7870,294,3.6
29475,CN1323900000000,13,239,"Quitman County, GA",Dec-19,788,754,34,4.3
29476,CN1324100000000,13,241,"Rabun County, GA",Dec-19,6917,6706,211,3.1
29477,CN1324300000000,13,243,"Randolph County, GA",Dec-19,2510,2409,101,4.0
29478,CN1324500000000,13,245,"Richmond County, GA",Dec-19,84980,81874,3106,3.7
29479,CN1324700000000,13,247,"Rockdale County, GA",Dec-19,45285,43871,1414,3.1
29480,CN1324900000000,13,249,"Schley County, GA",Dec-19,2211,2143,68,3.1
29481,CN1325100000000,13,251,"Screven County, GA",Dec-19,5069,4777,292,5.8
29482,CN1325300000000,13,253,"Seminole County, GA",Dec-19,2977,2858,119,4.0
29483,CN1325500000000,13,255,"Spalding County, GA",Dec-19,28981,28038,943,3.3
29484,CN1325700000000,13,257,"Stephens County, GA",Dec-19,10570,10201,369,3.5
29485,CN1325900000000,13,259,"Stewart County, GA",Dec-19,2399,2321,78,3.3
29486,CN1326100000000,13,261,"Sumter County, GA",Dec-19,12794,12252,542,4.2
29487,CN1326300000000,13,263,"Talbot County, GA",Dec-19,2800,2694,106,3.8
29488,CN1326500000000,13,265,"Taliaferro County, GA",Dec-19,557,531,26,4.7
29489,CN1326700000000,13,267,"Tattnall County, GA",Dec-19,9458,9149,309,3.3
29490,CN1326900000000,13,269,"Taylor County, GA",Dec-19,3149,3046,103,3.3
29491,CN1327100000000,13,271,"Telfair County, GA",Dec-19,3923,3567,356,9.1
29492,CN1327300000000,13,273,"Terrell County, GA",Dec-19,3512,3371,141,4.0
29493,CN1327500000000,13,275,"Thomas County, GA",Dec-19,16236,15684,552,3.4
29494,CN1327700000000,13,277,"Tift County, GA",Dec-19,19830,19256,574,2.9
29495,CN1327900000000,13,279,"Toombs County, GA",Dec-19,11466,11040,426,3.7
29496,CN1328100000000,13,281,"Towns County, GA",Dec-19,3741,3586,155,4.1
29497,CN1328300000000,13,283,"Treutlen County, GA",Dec-19,2546,2439,107,4.2
29498,CN1328500000000,13,285,"Troup County, GA",Dec-19,37460,36485,975,2.6
29499,CN1328700000000,13,287,"Turner County, GA",Dec-19,3130,3014,116,3.7
29500,CN1328900000000,13,289,"Twiggs County, GA",Dec-19,2893,2755,138,4.8
29501,CN1329100000000,13,291,"Union County, GA",Dec-19,10194,9921,273,2.7
29502,CN1329300000000,13,293,"Upson County, GA",Dec-19,11352,11011,341,3.0
29503,CN1329500000000,13,295,"Walker County, GA",Dec-19,31857,30458,1399,4.4
29504,CN1329700000000,13,297,"Walton County, GA",Dec-19,46620,45460,1160,2.5
29505,CN1329900000000,13,299,"Ware County, GA",Dec-19,15528,15004,524,3.4
29506,CN1330100000000,13,301,"Warren County, GA",Dec-19,2880,2762,118,4.1
29507,CN1330300000000,13,303,"Washington County, GA",Dec-19,6963,6703,260,3.7
29508,CN1330500000000,13,305,"Wayne County, GA",Dec-19,11199,10832,367,3.3
29509,CN1330700000000,13,307,"Webster County, GA",Dec-19,1015,977,38,3.7
29510,CN1330900000000,13,309,"Wheeler County, GA",Dec-19,1583,1466,117,7.4
29511,CN1331100000000,13,311,"White County, GA",Dec-19,16390,16036,354,2.2
29512,CN1331300000000,13,313,"Whitfield County, GA",Dec-19,43562,41576,1986,4.6
29513,CN1331500000000,13,315,"Wilcox County, GA",Dec-19,2651,2547,104,3.9
29514,CN1331700000000,13,317,"Wilkes County, GA",Dec-19,3775,3595,180,4.8
29515,CN1331900000000,13,319,"Wilkinson County, GA",Dec-19,3980,3848,132,3.3
29516,CN1332100000000,13,321,"Worth County, GA",Dec-19,8942,8644,298,3.3
29517,CN1500100000000,15,1,"Hawaii County, HI",Dec-19,91694,89111,2583,2.8
29518,CN1500300000000,15,3,"Honolulu County/city, HI",Dec-19,452859,443191,9668,2.1
29519,CN1500700000000,15,7,"Kauai County, HI",Dec-19,36383,35522,861,2.4
29520,CN1500900000000,15,9,"Maui County, HI",Dec-19,86389,84519,1870,2.2
29521,CN1600100000000,16,1,"Ada County, ID",Dec-19,258737,252619,6118,2.4
29522,CN1600300000000,16,3,"Adams County, ID",Dec-19,1666,1567,99,5.9
29523,CN1600500000000,16,5,"Bannock County, ID",Dec-19,43565,42373,1192,2.7
29524,CN1600700000000,16,7,"Bear Lake County, ID",Dec-19,2896,2809,87,3.0
29525,CN1600900000000,16,9,"Benewah County, ID",Dec-19,4061,3885,176,4.3
29526,CN1601100000000,16,11,"Bingham County, ID",Dec-19,23300,22656,644,2.8
29527,CN1601300000000,16,13,"Blaine County, ID",Dec-19,12529,12204,325,2.6
29528,CN1601500000000,16,15,"Boise County, ID",Dec-19,3579,3426,153,4.3
29529,CN1601700000000,16,17,"Bonner County, ID",Dec-19,20186,19342,844,4.2
29530,CN1601900000000,16,19,"Bonneville County, ID",Dec-19,58135,56792,1343,2.3
29531,CN1602100000000,16,21,"Boundary County, ID",Dec-19,5245,5026,219,4.2
29532,CN1602300000000,16,23,"Butte County, ID",Dec-19,1402,1362,40,2.9
29533,CN1602500000000,16,25,"Camas County, ID",Dec-19,679,661,18,2.7
29534,CN1602700000000,16,27,"Canyon County, ID",Dec-19,105319,102076,3243,3.1
29535,CN1602900000000,16,29,"Caribou County, ID",Dec-19,4106,3982,124,3.0
29536,CN1603100000000,16,31,"Cassia County, ID",Dec-19,12103,11813,290,2.4
29537,CN1603300000000,16,33,"Clark County, ID",Dec-19,373,357,16,4.3
29538,CN1603500000000,16,35,"Clearwater County, ID",Dec-19,2801,2659,142,5.1
29539,CN1603700000000,16,37,"Custer County, ID",Dec-19,2039,1944,95,4.7
29540,CN1603900000000,16,39,"Elmore County, ID",Dec-19,11388,11050,338,3.0
29541,CN1604100000000,16,41,"Franklin County, ID",Dec-19,7132,6973,159,2.2
29542,CN1604300000000,16,43,"Fremont County, ID",Dec-19,7922,7726,196,2.5
29543,CN1604500000000,16,45,"Gem County, ID",Dec-19,8413,8123,290,3.4
29544,CN1604700000000,16,47,"Gooding County, ID",Dec-19,8225,7983,242,2.9
29545,CN1604900000000,16,49,"Idaho County, ID",Dec-19,6394,6104,290,4.5
29546,CN1605100000000,16,51,"Jefferson County, ID",Dec-19,14200,13876,324,2.3
29547,CN1605300000000,16,53,"Jerome County, ID",Dec-19,12178,11844,334,2.7
29548,CN1605500000000,16,55,"Kootenai County, ID",Dec-19,80167,77136,3031,3.8
29549,CN1605700000000,16,57,"Latah County, ID",Dec-19,20965,20482,483,2.3
29550,CN1605900000000,16,59,"Lemhi County, ID",Dec-19,3464,3269,195,5.6
29551,CN1606100000000,16,61,"Lewis County, ID",Dec-19,1583,1493,90,5.7
29552,CN1606300000000,16,63,"Lincoln County, ID",Dec-19,2694,2583,111,4.1
29553,CN1606500000000,16,65,"Madison County, ID",Dec-19,22167,21805,362,1.6
29554,CN1606700000000,16,67,"Minidoka County, ID",Dec-19,11276,10969,307,2.7
29555,CN1606900000000,16,69,"Nez Perce County, ID",Dec-19,21307,20694,613,2.9
29556,CN1607100000000,16,71,"Oneida County, ID",Dec-19,2301,2248,53,2.3
29557,CN1607300000000,16,73,"Owyhee County, ID",Dec-19,5182,4987,195,3.8
29558,CN1607500000000,16,75,"Payette County, ID",Dec-19,11615,11220,395,3.4
29559,CN1607700000000,16,77,"Power County, ID",Dec-19,3860,3701,159,4.1
29560,CN1607900000000,16,79,"Shoshone County, ID",Dec-19,5141,4818,323,6.3
29561,CN1608100000000,16,81,"Teton County, ID",Dec-19,6416,6275,141,2.2
29562,CN1608300000000,16,83,"Twin Falls County, ID",Dec-19,41686,40509,1177,2.8
29563,CN1608500000000,16,85,"Valley County, ID",Dec-19,5453,5231,222,4.1
29564,CN1608700000000,16,87,"Washington County, ID",Dec-19,4605,4430,175,3.8
29565,CN1700100000000,17,1,"Adams County, IL",Dec-19,31943,30931,1012,3.2
29566,CN1700300000000,17,3,"Alexander County, IL",Dec-19,2050,1934,116,5.7
29567,CN1700500000000,17,5,"Bond County, IL",Dec-19,7710,7437,273,3.5
29568,CN1700700000000,17,7,"Boone County, IL",Dec-19,25982,24416,1566,6.0
29569,CN1700900000000,17,9,"Brown County, IL",Dec-19,2969,2903,66,2.2
29570,CN1701100000000,17,11,"Bureau County, IL",Dec-19,16970,16097,873,5.1
29571,CN1701300000000,17,13,"Calhoun County, IL",Dec-19,2308,2200,108,4.7
29572,CN1701500000000,17,15,"Carroll County, IL",Dec-19,7233,6912,321,4.4
29573,CN1701700000000,17,17,"Cass County, IL",Dec-19,5980,5748,232,3.9
29574,CN1701900000000,17,19,"Champaign County, IL",Dec-19,111809,108287,3522,3.2
29575,CN1702100000000,17,21,"Christian County, IL",Dec-19,14216,13521,695,4.9
29576,CN1702300000000,17,23,"Clark County, IL",Dec-19,7600,7257,343,4.5
29577,CN1702500000000,17,25,"Clay County, IL",Dec-19,6370,6103,267,4.2
29578,CN1702700000000,17,27,"Clinton County, IL",Dec-19,20291,19729,562,2.8
29579,CN1702900000000,17,29,"Coles County, IL",Dec-19,23947,23128,819,3.4
29580,CN1703100000000,17,31,"Cook County, IL",Dec-19,2563136,2487571,75565,2.9
29581,CN1703300000000,17,33,"Crawford County, IL",Dec-19,8597,8229,368,4.3
29582,CN1703500000000,17,35,"Cumberland County, IL",Dec-19,6100,5902,198,3.2
29583,CN1703700000000,17,37,"DeKalb County, IL",Dec-19,54976,52852,2124,3.9
29584,CN1703900000000,17,39,"De Witt County, IL",Dec-19,7358,7074,284,3.9
29585,CN1704100000000,17,41,"Douglas County, IL",Dec-19,10257,9943,314,3.1
29586,CN1704300000000,17,43,"DuPage County, IL",Dec-19,502257,491173,11084,2.2
29587,CN1704500000000,17,45,"Edgar County, IL",Dec-19,8738,8375,363,4.2
29588,CN1704700000000,17,47,"Edwards County, IL",Dec-19,2636,2523,113,4.3
29589,CN1704900000000,17,49,"Effingham County, IL",Dec-19,19255,18704,551,2.9
29590,CN1705100000000,17,51,"Fayette County, IL",Dec-19,9719,9309,410,4.2
29591,CN1705300000000,17,53,"Ford County, IL",Dec-19,6553,6282,271,4.1
29592,CN1705500000000,17,55,"Franklin County, IL",Dec-19,16232,15402,830,5.1
29593,CN1705700000000,17,57,"Fulton County, IL",Dec-19,15037,14221,816,5.4
29594,CN1705900000000,17,59,"Gallatin County, IL",Dec-19,2318,2214,104,4.5
29595,CN1706100000000,17,61,"Greene County, IL",Dec-19,5893,5667,226,3.8
29596,CN1706300000000,17,63,"Grundy County, IL",Dec-19,25056,24167,889,3.5
29597,CN1706500000000,17,65,"Hamilton County, IL",Dec-19,4430,4287,143,3.2
29598,CN1706700000000,17,67,"Hancock County, IL",Dec-19,8294,7934,360,4.3
29599,CN1706900000000,17,69,"Hardin County, IL",Dec-19,1335,1253,82,6.1
29600,CN1707100000000,17,71,"Henderson County, IL",Dec-19,3570,3430,140,3.9
29601,CN1707300000000,17,73,"Henry County, IL",Dec-19,24909,23661,1248,5.0
29602,CN1707500000000,17,75,"Iroquois County, IL",Dec-19,14427,13760,667,4.6
29603,CN1707700000000,17,77,"Jackson County, IL",Dec-19,27989,27036,953,3.4
29604,CN1707900000000,17,79,"Jasper County, IL",Dec-19,4640,4457,183,3.9
29605,CN1708100000000,17,81,"Jefferson County, IL",Dec-19,17372,16632,740,4.3
29606,CN1708300000000,17,83,"Jersey County, IL",Dec-19,10948,10496,452,4.1
29607,CN1708500000000,17,85,"Jo Daviess County, IL",Dec-19,10574,10073,501,4.7
29608,CN1708700000000,17,87,"Johnson County, IL",Dec-19,4130,3902,228,5.5
29609,CN1708900000000,17,89,"Kane County, IL",Dec-19,273682,261311,12371,4.5
29610,CN1709100000000,17,91,"Kankakee County, IL",Dec-19,56636,53596,3040,5.4
29611,CN1709300000000,17,93,"Kendall County, IL",Dec-19,67811,66035,1776,2.6
29612,CN1709500000000,17,95,"Knox County, IL",Dec-19,21315,20308,1007,4.7
29613,CN1709700000000,17,97,"Lake County, IL",Dec-19,374640,359069,15571,4.2
29614,CN1709900000000,17,99,"LaSalle County, IL",Dec-19,54628,51740,2888,5.3
29615,CN1710100000000,17,101,"Lawrence County, IL",Dec-19,5869,5551,318,5.4
29616,CN1710300000000,17,103,"Lee County, IL",Dec-19,17675,16955,720,4.1
29617,CN1710500000000,17,105,"Livingston County, IL",Dec-19,16364,15741,623,3.8
29618,CN1710700000000,17,107,"Logan County, IL",Dec-19,12423,11922,501,4.0
29619,CN1710900000000,17,109,"McDonough County, IL",Dec-19,13468,12967,501,3.7
29620,CN1711100000000,17,111,"McHenry County, IL",Dec-19,163703,159332,4371,2.7
29621,CN1711300000000,17,113,"McLean County, IL",Dec-19,87529,84643,2886,3.3
29622,CN1711500000000,17,115,"Macon County, IL",Dec-19,48099,45589,2510,5.2
29623,CN1711700000000,17,117,"Macoupin County, IL",Dec-19,22891,21947,944,4.1
29624,CN1711900000000,17,119,"Madison County, IL",Dec-19,134013,129275,4738,3.5
29625,CN1712100000000,17,121,"Marion County, IL",Dec-19,17429,16682,747,4.3
29626,CN1712300000000,17,123,"Marshall County, IL",Dec-19,5243,4980,263,5.0
29627,CN1712500000000,17,125,"Mason County, IL",Dec-19,6221,5882,339,5.4
29628,CN1712700000000,17,127,"Massac County, IL",Dec-19,5697,5382,315,5.5
29629,CN1712900000000,17,129,"Menard County, IL",Dec-19,6398,6166,232,3.6
29630,CN1713100000000,17,131,"Mercer County, IL",Dec-19,8028,7618,410,5.1
29631,CN1713300000000,17,133,"Monroe County, IL",Dec-19,18751,18228,523,2.8
29632,CN1713500000000,17,135,"Montgomery County, IL",Dec-19,11593,10934,659,5.7
29633,CN1713700000000,17,137,"Morgan County, IL",Dec-19,16341,15667,674,4.1
29634,CN1713900000000,17,139,"Moultrie County, IL",Dec-19,7538,7318,220,2.9
29635,CN1714100000000,17,141,"Ogle County, IL",Dec-19,24543,23320,1223,5.0
29636,CN1714300000000,17,143,"Peoria County, IL",Dec-19,84068,79755,4313,5.1
29637,CN1714500000000,17,145,"Perry County, IL",Dec-19,8310,7931,379,4.6
29638,CN1714700000000,17,147,"Piatt County, IL",Dec-19,8782,8497,285,3.2
29639,CN1714900000000,17,149,"Pike County, IL",Dec-19,6847,6536,311,4.5
29640,CN1715100000000,17,151,"Pope County, IL",Dec-19,1667,1578,89,5.3
29641,CN1715300000000,17,153,"Pulaski County, IL",Dec-19,2019,1893,126,6.2
29642,CN1715500000000,17,155,"Putnam County, IL",Dec-19,3075,2896,179,5.8
29643,CN1715700000000,17,157,"Randolph County, IL",Dec-19,14132,13644,488,3.5
29644,CN1715900000000,17,159,"Richland County, IL",Dec-19,7182,6909,273,3.8
29645,CN1716100000000,17,161,"Rock Island County, IL",Dec-19,71352,67788,3564,5.0
29646,CN1716300000000,17,163,"St. Clair County, IL",Dec-19,126402,121344,5058,4.0
29647,CN1716500000000,17,165,"Saline County, IL",Dec-19,9617,9140,477,5.0
29648,CN1716700000000,17,167,"Sangamon County, IL",Dec-19,99716,95963,3753,3.8
29649,CN1716900000000,17,169,"Schuyler County, IL",Dec-19,3112,2968,144,4.6
29650,CN1717100000000,17,171,"Scott County, IL",Dec-19,2530,2394,136,5.4
29651,CN1717300000000,17,173,"Shelby County, IL",Dec-19,10421,10016,405,3.9
29652,CN1717500000000,17,175,"Stark County, IL",Dec-19,2473,2332,141,5.7
29653,CN1717700000000,17,177,"Stephenson County, IL",Dec-19,21446,20533,913,4.3
29654,CN1717900000000,17,179,"Tazewell County, IL",Dec-19,62937,60228,2709,4.3
29655,CN1718100000000,17,181,"Union County, IL",Dec-19,7478,7041,437,5.8
29656,CN1718300000000,17,183,"Vermilion County, IL",Dec-19,33140,31426,1714,5.2
29657,CN1718500000000,17,185,"Wabash County, IL",Dec-19,5940,5761,179,3.0
29658,CN1718700000000,17,187,"Warren County, IL",Dec-19,8386,8064,322,3.8
29659,CN1718900000000,17,189,"Washington County, IL",Dec-19,10090,9869,221,2.2
29660,CN1719100000000,17,191,"Wayne County, IL",Dec-19,6991,6692,299,4.3
29661,CN1719300000000,17,193,"White County, IL",Dec-19,6508,6260,248,3.8
29662,CN1719500000000,17,195,"Whiteside County, IL",Dec-19,28541,27301,1240,4.3
29663,CN1719700000000,17,197,"Will County, IL",Dec-19,352832,342104,10728,3.0
29664,CN1719900000000,17,199,"Williamson County, IL",Dec-19,32111,30834,1277,4.0
29665,CN1720100000000,17,201,"Winnebago County, IL",Dec-19,138050,130045,8005,5.8
29666,CN1720300000000,17,203,"Woodford County, IL",Dec-19,18433,17801,632,3.4
29667,CN1800100000000,18,1,"Adams County, IN",Dec-19,16977,16583,394,2.3
29668,CN1800300000000,18,3,"Allen County, IN",Dec-19,184893,179630,5263,2.8
29669,CN1800500000000,18,5,"Bartholomew County, IN",Dec-19,44704,43747,957,2.1
29670,CN1800700000000,18,7,"Benton County, IN",Dec-19,4693,4566,127,2.7
29671,CN1800900000000,18,9,"Blackford County, IN",Dec-19,4873,4685,188,3.9
29672,CN1801100000000,18,11,"Boone County, IN",Dec-19,36072,35329,743,2.1
29673,CN1801300000000,18,13,"Brown County, IN",Dec-19,7656,7462,194,2.5
29674,CN1801500000000,18,15,"Carroll County, IN",Dec-19,10506,10237,269,2.6
29675,CN1801700000000,18,17,"Cass County, IN",Dec-19,17754,17169,585,3.3
29676,CN1801900000000,18,19,"Clark County, IN",Dec-19,61603,59816,1787,2.9
29677,CN1802100000000,18,21,"Clay County, IN",Dec-19,12045,11663,382,3.2
29678,CN1802300000000,18,23,"Clinton County, IN",Dec-19,17180,16786,394,2.3
29679,CN1802500000000,18,25,"Crawford County, IN",Dec-19,4808,4612,196,4.1
29680,CN1802700000000,18,27,"Daviess County, IN",Dec-19,16728,16338,390,2.3
29681,CN1802900000000,18,29,"Dearborn County, IN",Dec-19,25777,24953,824,3.2
29682,CN1803100000000,18,31,"Decatur County, IN",Dec-19,14674,14292,382,2.6
29683,CN1803300000000,18,33,"DeKalb County, IN",Dec-19,22611,22048,563,2.5
29684,CN1803500000000,18,35,"Delaware County, IN",Dec-19,54147,52302,1845,3.4
29685,CN1803700000000,18,37,"Dubois County, IN",Dec-19,22989,22543,446,1.9
29686,CN1803900000000,18,39,"Elkhart County, IN",Dec-19,110818,107779,3039,2.7
29687,CN1804100000000,18,41,"Fayette County, IN",Dec-19,8571,8177,394,4.6
29688,CN1804300000000,18,43,"Floyd County, IN",Dec-19,41650,40471,1179,2.8
29689,CN1804500000000,18,45,"Fountain County, IN",Dec-19,8029,7756,273,3.4
29690,CN1804700000000,18,47,"Franklin County, IN",Dec-19,11276,10937,339,3.0
29691,CN1804900000000,18,49,"Fulton County, IN",Dec-19,9796,9481,315,3.2
29692,CN1805100000000,18,51,"Gibson County, IN",Dec-19,19566,19110,456,2.3
29693,CN1805300000000,18,53,"Grant County, IN",Dec-19,32119,31059,1060,3.3
29694,CN1805500000000,18,55,"Greene County, IN",Dec-19,13669,13160,509,3.7
29695,CN1805700000000,18,57,"Hamilton County, IN",Dec-19,182546,178710,3836,2.1
29696,CN1805900000000,18,59,"Hancock County, IN",Dec-19,40013,39058,955,2.4
29697,CN1806100000000,18,61,"Harrison County, IN",Dec-19,20306,19727,579,2.9
29698,CN1806300000000,18,63,"Hendricks County, IN",Dec-19,89402,87333,2069,2.3
29699,CN1806500000000,18,65,"Henry County, IN",Dec-19,22001,21363,638,2.9
29700,CN1806700000000,18,67,"Howard County, IN",Dec-19,36962,35680,1282,3.5
29701,CN1806900000000,18,69,"Huntington County, IN",Dec-19,18092,17581,511,2.8
29702,CN1807100000000,18,71,"Jackson County, IN",Dec-19,22919,22443,476,2.1
29703,CN1807300000000,18,73,"Jasper County, IN",Dec-19,16317,15756,561,3.4
29704,CN1807500000000,18,75,"Jay County, IN",Dec-19,9403,9143,260,2.8
29705,CN1807700000000,18,77,"Jefferson County, IN",Dec-19,14908,14444,464,3.1
29706,CN1807900000000,18,79,"Jennings County, IN",Dec-19,13620,13216,404,3.0
29707,CN1808100000000,18,81,"Johnson County, IN",Dec-19,82491,80583,1908,2.3
29708,CN1808300000000,18,83,"Knox County, IN",Dec-19,18622,18125,497,2.7
29709,CN1808500000000,18,85,"Kosciusko County, IN",Dec-19,41863,40771,1092,2.6
29710,CN1808700000000,18,87,"LaGrange County, IN",Dec-19,19922,19494,428,2.1
29711,CN1808900000000,18,89,"Lake County, IN",Dec-19,230317,219211,11106,4.8
29712,CN1809100000000,18,91,"LaPorte County, IN",Dec-19,47670,45716,1954,4.1
29713,CN1809300000000,18,93,"Lawrence County, IN",Dec-19,21194,20485,709,3.3
29714,CN1809500000000,18,95,"Madison County, IN",Dec-19,58897,56888,2009,3.4
29715,CN1809700000000,18,97,"Marion County, IN",Dec-19,487220,473273,13947,2.9
29716,CN1809900000000,18,99,"Marshall County, IN",Dec-19,22852,22208,644,2.8
29717,CN1810100000000,18,101,"Martin County, IN",Dec-19,5360,5247,113,2.1
29718,CN1810300000000,18,103,"Miami County, IN",Dec-19,15214,14657,557,3.7
29719,CN1810500000000,18,105,"Monroe County, IN",Dec-19,71013,69166,1847,2.6
29720,CN1810700000000,18,107,"Montgomery County, IN",Dec-19,18707,18206,501,2.7
29721,CN1810900000000,18,109,"Morgan County, IN",Dec-19,36130,35161,969,2.7
29722,CN1811100000000,18,111,"Newton County, IN",Dec-19,6979,6717,262,3.8
29723,CN1811300000000,18,113,"Noble County, IN",Dec-19,23398,22742,656,2.8
29724,CN1811500000000,18,115,"Ohio County, IN",Dec-19,3181,3080,101,3.2
29725,CN1811700000000,18,117,"Orange County, IN",Dec-19,8608,8346,262,3.0
29726,CN1811900000000,18,119,"Owen County, IN",Dec-19,9524,9199,325,3.4
29727,CN1812100000000,18,121,"Parke County, IN",Dec-19,7001,6741,260,3.7
29728,CN1812300000000,18,123,"Perry County, IN",Dec-19,9200,8905,295,3.2
29729,CN1812500000000,18,125,"Pike County, IN",Dec-19,6188,5982,206,3.3
29730,CN1812700000000,18,127,"Porter County, IN",Dec-19,86605,83591,3014,3.5
29731,CN1812900000000,18,129,"Posey County, IN",Dec-19,13558,13221,337,2.5
29732,CN1813100000000,18,131,"Pulaski County, IN",Dec-19,6473,6269,204,3.2
29733,CN1813300000000,18,133,"Putnam County, IN",Dec-19,16700,16191,509,3.0
29734,CN1813500000000,18,135,"Randolph County, IN",Dec-19,11220,10800,420,3.7
29735,CN1813700000000,18,137,"Ripley County, IN",Dec-19,14152,13744,408,2.9
29736,CN1813900000000,18,139,"Rush County, IN",Dec-19,8893,8697,196,2.2
29737,CN1814100000000,18,141,"St. Joseph County, IN",Dec-19,135284,130711,4573,3.4
29738,CN1814300000000,18,143,"Scott County, IN",Dec-19,10551,10222,329,3.1
29739,CN1814500000000,18,145,"Shelby County, IN",Dec-19,23049,22457,592,2.6
29740,CN1814700000000,18,147,"Spencer County, IN",Dec-19,10202,9885,317,3.1
29741,CN1814900000000,18,149,"Starke County, IN",Dec-19,9793,9403,390,4.0
29742,CN1815100000000,18,151,"Steuben County, IN",Dec-19,20618,20152,466,2.3
29743,CN1815300000000,18,153,"Sullivan County, IN",Dec-19,8433,8078,355,4.2
29744,CN1815500000000,18,155,"Switzerland County, IN",Dec-19,4959,4812,147,3.0
29745,CN1815700000000,18,157,"Tippecanoe County, IN",Dec-19,101136,98707,2429,2.4
29746,CN1815900000000,18,159,"Tipton County, IN",Dec-19,9169,8975,194,2.1
29747,CN1816100000000,18,161,"Union County, IN",Dec-19,3562,3457,105,2.9
29748,CN1816300000000,18,163,"Vanderburgh County, IN",Dec-19,93776,91232,2544,2.7
29749,CN1816500000000,18,165,"Vermillion County, IN",Dec-19,7012,6665,347,4.9
29750,CN1816700000000,18,167,"Vigo County, IN",Dec-19,48101,46227,1874,3.9
29751,CN1816900000000,18,169,"Wabash County, IN",Dec-19,15048,14644,404,2.7
29752,CN1817100000000,18,171,"Warren County, IN",Dec-19,4247,4124,123,2.9
29753,CN1817300000000,18,173,"Warrick County, IN",Dec-19,32831,31955,876,2.7
29754,CN1817500000000,18,175,"Washington County, IN",Dec-19,13755,13355,400,2.9
29755,CN1817700000000,18,177,"Wayne County, IN",Dec-19,30482,29499,983,3.2
29756,CN1817900000000,18,179,"Wells County, IN",Dec-19,14415,14060,355,2.5
29757,CN1818100000000,18,181,"White County, IN",Dec-19,13466,13161,305,2.3
29758,CN1818300000000,18,183,"Whitley County, IN",Dec-19,17690,17252,438,2.5
29759,CN1900100000000,19,1,"Adair County, IA",Dec-19,4356,4250,106,2.4
29760,CN1900300000000,19,3,"Adams County, IA",Dec-19,2216,2180,36,1.6
29761,CN1900500000000,19,5,"Allamakee County, IA",Dec-19,7666,7383,283,3.7
29762,CN1900700000000,19,7,"Appanoose County, IA",Dec-19,6036,5823,213,3.5
29763,CN1900900000000,19,9,"Audubon County, IA",Dec-19,3206,3125,81,2.5
29764,CN1901100000000,19,11,"Benton County, IA",Dec-19,13850,13396,454,3.3
29765,CN1901300000000,19,13,"Black Hawk County, IA",Dec-19,69873,67362,2511,3.6
29766,CN1901500000000,19,15,"Boone County, IA",Dec-19,15181,14814,367,2.4
29767,CN1901700000000,19,17,"Bremer County, IA",Dec-19,14150,13771,379,2.7
29768,CN1901900000000,19,19,"Buchanan County, IA",Dec-19,11531,11161,370,3.2
29769,CN1902100000000,19,21,"Buena Vista County, IA",Dec-19,12360,12115,245,2.0
29770,CN1902300000000,19,23,"Butler County, IA",Dec-19,8205,7918,287,3.5
29771,CN1902500000000,19,25,"Calhoun County, IA",Dec-19,4384,4268,116,2.6
29772,CN1902700000000,19,27,"Carroll County, IA",Dec-19,11287,11068,219,1.9
29773,CN1902900000000,19,29,"Cass County, IA",Dec-19,7005,6815,190,2.7
29774,CN1903100000000,19,31,"Cedar County, IA",Dec-19,11048,10746,302,2.7
29775,CN1903300000000,19,33,"Cerro Gordo County, IA",Dec-19,23902,23228,674,2.8
29776,CN1903500000000,19,35,"Cherokee County, IA",Dec-19,6325,6164,161,2.5
29777,CN1903700000000,19,37,"Chickasaw County, IA",Dec-19,6775,6545,230,3.4
29778,CN1903900000000,19,39,"Clarke County, IA",Dec-19,4951,4811,140,2.8
29779,CN1904100000000,19,41,"Clay County, IA",Dec-19,8742,8485,257,2.9
29780,CN1904300000000,19,43,"Clayton County, IA",Dec-19,10355,9881,474,4.6
29781,CN1904500000000,19,45,"Clinton County, IA",Dec-19,23216,22270,946,4.1
29782,CN1904700000000,19,47,"Crawford County, IA",Dec-19,8520,8151,369,4.3
29783,CN1904900000000,19,49,"Dallas County, IA",Dec-19,50443,49381,1062,2.1
29784,CN1905100000000,19,51,"Davis County, IA",Dec-19,4327,4202,125,2.9
29785,CN1905300000000,19,53,"Decatur County, IA",Dec-19,4567,4469,98,2.1
29786,CN1905500000000,19,55,"Delaware County, IA",Dec-19,10907,10632,275,2.5
29787,CN1905700000000,19,57,"Des Moines County, IA",Dec-19,19208,18393,815,4.2
29788,CN1905900000000,19,59,"Dickinson County, IA",Dec-19,9915,9584,331,3.3
29789,CN1906100000000,19,61,"Dubuque County, IA",Dec-19,57289,55510,1779,3.1
29790,CN1906300000000,19,63,"Emmet County, IA",Dec-19,5336,5214,122,2.3
29791,CN1906500000000,19,65,"Fayette County, IA",Dec-19,11043,10632,411,3.7
29792,CN1906700000000,19,67,"Floyd County, IA",Dec-19,8904,8495,409,4.6
29793,CN1906900000000,19,69,"Franklin County, IA",Dec-19,5850,5715,135,2.3
29794,CN1907100000000,19,71,"Fremont County, IA",Dec-19,3806,3724,82,2.2
29795,CN1907300000000,19,73,"Greene County, IA",Dec-19,5631,5508,123,2.2
29796,CN1907500000000,19,75,"Grundy County, IA",Dec-19,6711,6520,191,2.8
29797,CN1907700000000,19,77,"Guthrie County, IA",Dec-19,5809,5642,167,2.9
29798,CN1907900000000,19,79,"Hamilton County, IA",Dec-19,7091,6876,215,3.0
29799,CN1908100000000,19,81,"Hancock County, IA",Dec-19,6068,5906,162,2.7
29800,CN1908300000000,19,83,"Hardin County, IA",Dec-19,8255,7998,257,3.1
29801,CN1908500000000,19,85,"Harrison County, IA",Dec-19,7639,7442,197,2.6
29802,CN1908700000000,19,87,"Henry County, IA",Dec-19,9972,9679,293,2.9
29803,CN1908900000000,19,89,"Howard County, IA",Dec-19,5370,5218,152,2.8
29804,CN1909100000000,19,91,"Humboldt County, IA",Dec-19,5279,5122,157,3.0
29805,CN1909300000000,19,93,"Ida County, IA",Dec-19,4268,4182,86,2.0
29806,CN1909500000000,19,95,"Iowa County, IA",Dec-19,10828,10575,253,2.3
29807,CN1909700000000,19,97,"Jackson County, IA",Dec-19,11212,10817,395,3.5
29808,CN1909900000000,19,99,"Jasper County, IA",Dec-19,20183,19567,616,3.1
29809,CN1910100000000,19,101,"Jefferson County, IA",Dec-19,10465,10218,247,2.4
29810,CN1910300000000,19,103,"Johnson County, IA",Dec-19,86638,84694,1944,2.2
29811,CN1910500000000,19,105,"Jones County, IA",Dec-19,11036,10633,403,3.7
29812,CN1910700000000,19,107,"Keokuk County, IA",Dec-19,5380,5200,180,3.3
29813,CN1910900000000,19,109,"Kossuth County, IA",Dec-19,8705,8518,187,2.1
29814,CN1911100000000,19,111,"Lee County, IA",Dec-19,16464,15815,649,3.9
29815,CN1911300000000,19,113,"Linn County, IA",Dec-19,123808,119946,3862,3.1
29816,CN1911500000000,19,115,"Louisa County, IA",Dec-19,6239,6021,218,3.5
29817,CN1911700000000,19,117,"Lucas County, IA",Dec-19,4717,4619,98,2.1
29818,CN1911900000000,19,119,"Lyon County, IA",Dec-19,7340,7190,150,2.0
29819,CN1912100000000,19,121,"Madison County, IA",Dec-19,8756,8453,303,3.5
29820,CN1912300000000,19,123,"Mahaska County, IA",Dec-19,12098,11787,311,2.6
29821,CN1912500000000,19,125,"Marion County, IA",Dec-19,18773,18328,445,2.4
29822,CN1912700000000,19,127,"Marshall County, IA",Dec-19,18263,17231,1032,5.7
29823,CN1912900000000,19,129,"Mills County, IA",Dec-19,7629,7442,187,2.5
29824,CN1913100000000,19,131,"Mitchell County, IA",Dec-19,7310,7185,125,1.7
29825,CN1913300000000,19,133,"Monona County, IA",Dec-19,4544,4402,142,3.1
29826,CN1913500000000,19,135,"Monroe County, IA",Dec-19,4141,4021,120,2.9
29827,CN1913700000000,19,137,"Montgomery County, IA",Dec-19,5140,4993,147,2.9
29828,CN1913900000000,19,139,"Muscatine County, IA",Dec-19,22142,21472,670,3.0
29829,CN1914100000000,19,141,"O'Brien County, IA",Dec-19,8511,8315,196,2.3
29830,CN1914300000000,19,143,"Osceola County, IA",Dec-19,3660,3590,70,1.9
29831,CN1914500000000,19,145,"Page County, IA",Dec-19,6498,6313,185,2.8
29832,CN1914700000000,19,147,"Palo Alto County, IA",Dec-19,4903,4789,114,2.3
29833,CN1914900000000,19,149,"Plymouth County, IA",Dec-19,15228,14852,376,2.5
29834,CN1915100000000,19,151,"Pocahontas County, IA",Dec-19,4824,4736,88,1.8
29835,CN1915300000000,19,153,"Polk County, IA",Dec-19,272980,265144,7836,2.9
29836,CN1915500000000,19,155,"Pottawattamie County, IA",Dec-19,49713,48464,1249,2.5
29837,CN1915700000000,19,157,"Poweshiek County, IA",Dec-19,10749,10431,318,3.0
29838,CN1915900000000,19,159,"Ringgold County, IA",Dec-19,2546,2483,63,2.5
29839,CN1916100000000,19,161,"Sac County, IA",Dec-19,5407,5280,127,2.3
29840,CN1916300000000,19,163,"Scott County, IA",Dec-19,90184,86842,3342,3.7
29841,CN1916500000000,19,165,"Shelby County, IA",Dec-19,6866,6706,160,2.3
29842,CN1916700000000,19,167,"Sioux County, IA",Dec-19,21989,21532,457,2.1
29843,CN1916900000000,19,169,"Story County, IA",Dec-19,60047,58787,1260,2.1
29844,CN1917100000000,19,171,"Tama County, IA",Dec-19,9697,9306,391,4.0
29845,CN1917300000000,19,173,"Taylor County, IA",Dec-19,3304,3240,64,1.9
29846,CN1917500000000,19,175,"Union County, IA",Dec-19,6460,6270,190,2.9
29847,CN1917700000000,19,177,"Van Buren County, IA",Dec-19,3771,3670,101,2.7
29848,CN1917900000000,19,179,"Wapello County, IA",Dec-19,17945,17324,621,3.5
29849,CN1918100000000,19,181,"Warren County, IA",Dec-19,28740,28010,730,2.5
29850,CN1918300000000,19,183,"Washington County, IA",Dec-19,12234,11916,318,2.6
29851,CN1918500000000,19,185,"Wayne County, IA",Dec-19,2920,2843,77,2.6
29852,CN1918700000000,19,187,"Webster County, IA",Dec-19,20021,19379,642,3.2
29853,CN1918900000000,19,189,"Winnebago County, IA",Dec-19,5247,5094,153,2.9
29854,CN1919100000000,19,191,"Winneshiek County, IA",Dec-19,12603,12202,401,3.2
29855,CN1919300000000,19,193,"Woodbury County, IA",Dec-19,56508,54802,1706,3.0
29856,CN1919500000000,19,195,"Worth County, IA",Dec-19,4353,4218,135,3.1
29857,CN1919700000000,19,197,"Wright County, IA",Dec-19,7182,6996,186,2.6
29858,CN2000100000000,20,1,"Allen County, KS",Dec-19,6386,6175,211,3.3
29859,CN2000300000000,20,3,"Anderson County, KS",Dec-19,4219,4104,115,2.7
29860,CN2000500000000,20,5,"Atchison County, KS",Dec-19,6996,6659,337,4.8
29861,CN2000700000000,20,7,"Barber County, KS",Dec-19,2373,2309,64,2.7
29862,CN2000900000000,20,9,"Barton County, KS",Dec-19,13337,12916,421,3.2
29863,CN2001100000000,20,11,"Bourbon County, KS",Dec-19,6637,6390,247,3.7
29864,CN2001300000000,20,13,"Brown County, KS",Dec-19,5365,5213,152,2.8
29865,CN2001500000000,20,15,"Butler County, KS",Dec-19,32601,31602,999,3.1
29866,CN2001700000000,20,17,"Chase County, KS",Dec-19,1523,1482,41,2.7
29867,CN2001900000000,20,19,"Chautauqua County, KS",Dec-19,1460,1411,49,3.4
29868,CN2002100000000,20,21,"Cherokee County, KS",Dec-19,10159,9872,287,2.8
29869,CN2002300000000,20,23,"Cheyenne County, KS",Dec-19,1390,1361,29,2.1
29870,CN2002500000000,20,25,"Clark County, KS",Dec-19,1117,1092,25,2.2
29871,CN2002700000000,20,27,"Clay County, KS",Dec-19,3842,3737,105,2.7
29872,CN2002900000000,20,29,"Cloud County, KS",Dec-19,3796,3688,108,2.8
29873,CN2003100000000,20,31,"Coffey County, KS",Dec-19,4169,3991,178,4.3
29874,CN2003300000000,20,33,"Comanche County, KS",Dec-19,885,861,24,2.7
29875,CN2003500000000,20,35,"Cowley County, KS",Dec-19,16296,15775,521,3.2
29876,CN2003700000000,20,37,"Crawford County, KS",Dec-19,18698,18054,644,3.4
29877,CN2003900000000,20,39,"Decatur County, KS",Dec-19,1294,1258,36,2.8
29878,CN2004100000000,20,41,"Dickinson County, KS",Dec-19,8826,8545,281,3.2
29879,CN2004300000000,20,43,"Doniphan County, KS",Dec-19,4142,4025,117,2.8
29880,CN2004500000000,20,45,"Douglas County, KS",Dec-19,66297,64601,1696,2.6
29881,CN2004700000000,20,47,"Edwards County, KS",Dec-19,1624,1594,30,1.8
29882,CN2004900000000,20,49,"Elk County, KS",Dec-19,1208,1176,32,2.6
29883,CN2005100000000,20,51,"Ellis County, KS",Dec-19,17177,16830,347,2.0
29884,CN2005300000000,20,53,"Ellsworth County, KS",Dec-19,2747,2683,64,2.3
29885,CN2005500000000,20,55,"Finney County, KS",Dec-19,20752,20336,416,2.0
29886,CN2005700000000,20,57,"Ford County, KS",Dec-19,17142,16772,370,2.2
29887,CN2005900000000,20,59,"Franklin County, KS",Dec-19,14068,13677,391,2.8
29888,CN2006100000000,20,61,"Geary County, KS",Dec-19,11328,10885,443,3.9
29889,CN2006300000000,20,63,"Gove County, KS",Dec-19,1521,1491,30,2.0
29890,CN2006500000000,20,65,"Graham County, KS",Dec-19,1123,1089,34,3.0
29891,CN2006700000000,20,67,"Grant County, KS",Dec-19,3247,3166,81,2.5
29892,CN2006900000000,20,69,"Gray County, KS",Dec-19,3340,3276,64,1.9
29893,CN2007100000000,20,71,"Greeley County, KS",Dec-19,810,793,17,2.1
29894,CN2007300000000,20,73,"Greenwood County, KS",Dec-19,3453,3352,101,2.9
29895,CN2007500000000,20,75,"Hamilton County, KS",Dec-19,1686,1657,29,1.7
29896,CN2007700000000,20,77,"Harper County, KS",Dec-19,2862,2791,71,2.5
29897,CN2007900000000,20,79,"Harvey County, KS",Dec-19,17034,16594,440,2.6
29898,CN2008100000000,20,81,"Haskell County, KS",Dec-19,2240,2199,41,1.8
29899,CN2008300000000,20,83,"Hodgeman County, KS",Dec-19,1026,999,27,2.6
29900,CN2008500000000,20,85,"Jackson County, KS",Dec-19,7106,6925,181,2.5
29901,CN2008700000000,20,87,"Jefferson County, KS",Dec-19,10038,9749,289,2.9
29902,CN2008900000000,20,89,"Jewell County, KS",Dec-19,1287,1255,32,2.5
29903,CN2009100000000,20,91,"Johnson County, KS",Dec-19,340790,332435,8355,2.5
29904,CN2009300000000,20,93,"Kearny County, KS",Dec-19,2096,2054,42,2.0
29905,CN2009500000000,20,95,"Kingman County, KS",Dec-19,3475,3375,100,2.9
29906,CN2009700000000,20,97,"Kiowa County, KS",Dec-19,1340,1310,30,2.2
29907,CN2009900000000,20,99,"Labette County, KS",Dec-19,9953,9616,337,3.4
29908,CN2010100000000,20,101,"Lane County, KS",Dec-19,817,797,20,2.4
29909,CN2010300000000,20,103,"Leavenworth County, KS",Dec-19,36699,35558,1141,3.1
29910,CN2010500000000,20,105,"Lincoln County, KS",Dec-19,1755,1719,36,2.1
29911,CN2010700000000,20,107,"Linn County, KS",Dec-19,4485,4231,254,5.7
29912,CN2010900000000,20,109,"Logan County, KS",Dec-19,1686,1657,29,1.7
29913,CN2011100000000,20,111,"Lyon County, KS",Dec-19,16695,16172,523,3.1
29914,CN2011300000000,20,113,"McPherson County, KS",Dec-19,17200,16852,348,2.0
29915,CN2011500000000,20,115,"Marion County, KS",Dec-19,6073,5914,159,2.6
29916,CN2011700000000,20,117,"Marshall County, KS",Dec-19,5526,5391,135,2.4
29917,CN2011900000000,20,119,"Meade County, KS",Dec-19,2188,2144,44,2.0
29918,CN2012100000000,20,121,"Miami County, KS",Dec-19,17600,17059,541,3.1
29919,CN2012300000000,20,123,"Mitchell County, KS",Dec-19,3286,3217,69,2.1
29920,CN2012500000000,20,125,"Montgomery County, KS",Dec-19,14691,14089,602,4.1
29921,CN2012700000000,20,127,"Morris County, KS",Dec-19,3050,2967,83,2.7
29922,CN2012900000000,20,129,"Morton County, KS",Dec-19,1153,1123,30,2.6
29923,CN2013100000000,20,131,"Nemaha County, KS",Dec-19,5437,5297,140,2.6
29924,CN2013300000000,20,133,"Neosho County, KS",Dec-19,6185,5926,259,4.2
29925,CN2013500000000,20,135,"Ness County, KS",Dec-19,1370,1334,36,2.6
29926,CN2013700000000,20,137,"Norton County, KS",Dec-19,2705,2651,54,2.0
29927,CN2013900000000,20,139,"Osage County, KS",Dec-19,7936,7665,271,3.4
29928,CN2014100000000,20,141,"Osborne County, KS",Dec-19,2102,2065,37,1.8
29929,CN2014300000000,20,143,"Ottawa County, KS",Dec-19,3030,2957,73,2.4
29930,CN2014500000000,20,145,"Pawnee County, KS",Dec-19,2925,2851,74,2.5
29931,CN2014700000000,20,147,"Phillips County, KS",Dec-19,2662,2601,61,2.3
29932,CN2014900000000,20,149,"Pottawatomie County, KS",Dec-19,12600,12292,308,2.4
29933,CN2015100000000,20,151,"Pratt County, KS",Dec-19,4955,4850,105,2.1
29934,CN2015300000000,20,153,"Rawlins County, KS",Dec-19,1544,1514,30,1.9
29935,CN2015500000000,20,155,"Reno County, KS",Dec-19,29548,28699,849,2.9
29936,CN2015700000000,20,157,"Republic County, KS",Dec-19,2302,2251,51,2.2
29937,CN2015900000000,20,159,"Rice County, KS",Dec-19,5214,5087,127,2.4
29938,CN2016100000000,20,161,"Riley County, KS",Dec-19,35513,34654,859,2.4
29939,CN2016300000000,20,163,"Rooks County, KS",Dec-19,2550,2474,76,3.0
29940,CN2016500000000,20,165,"Rush County, KS",Dec-19,1658,1619,39,2.4
29941,CN2016700000000,20,167,"Russell County, KS",Dec-19,3297,3206,91,2.8
29942,CN2016900000000,20,169,"Saline County, KS",Dec-19,30033,29184,849,2.8
29943,CN2017100000000,20,171,"Scott County, KS",Dec-19,2933,2881,52,1.8
29944,CN2017300000000,20,173,"Sedgwick County, KS",Dec-19,251488,243395,8093,3.2
29945,CN2017500000000,20,175,"Seward County, KS",Dec-19,9427,9168,259,2.7
29946,CN2017700000000,20,177,"Shawnee County, KS",Dec-19,89595,86710,2885,3.2
29947,CN2017900000000,20,179,"Sheridan County, KS",Dec-19,1454,1424,30,2.1
29948,CN2018100000000,20,181,"Sherman County, KS",Dec-19,2842,2768,74,2.6
29949,CN2018300000000,20,183,"Smith County, KS",Dec-19,2011,1962,49,2.4
29950,CN2018500000000,20,185,"Stafford County, KS",Dec-19,2112,2058,54,2.6
29951,CN2018700000000,20,187,"Stanton County, KS",Dec-19,1023,998,25,2.4
29952,CN2018900000000,20,189,"Stevens County, KS",Dec-19,2552,2491,61,2.4
29953,CN2019100000000,20,191,"Sumner County, KS",Dec-19,10949,10624,325,3.0
29954,CN2019300000000,20,193,"Thomas County, KS",Dec-19,4327,4246,81,1.9
29955,CN2019500000000,20,195,"Trego County, KS",Dec-19,1449,1412,37,2.6
29956,CN2019700000000,20,197,"Wabaunsee County, KS",Dec-19,3644,3537,107,2.9
29957,CN2019900000000,20,199,"Wallace County, KS",Dec-19,812,793,19,2.3
29958,CN2020100000000,20,201,"Washington County, KS",Dec-19,3006,2949,57,1.9
29959,CN2020300000000,20,203,"Wichita County, KS",Dec-19,1245,1221,24,1.9
29960,CN2020500000000,20,205,"Wilson County, KS",Dec-19,3982,3823,159,4.0
29961,CN2020700000000,20,207,"Woodson County, KS",Dec-19,1610,1544,66,4.1
29962,CN2020900000000,20,209,"Wyandotte County, KS",Dec-19,77490,74592,2898,3.7
29963,CN2100100000000,21,1,"Adair County, KY",Dec-19,7229,6883,346,4.8
29964,CN2100300000000,21,3,"Allen County, KY",Dec-19,9184,8840,344,3.7
29965,CN2100500000000,21,5,"Anderson County, KY",Dec-19,12459,12032,427,3.4
29966,CN2100700000000,21,7,"Ballard County, KY",Dec-19,3576,3379,197,5.5
29967,CN2100900000000,21,9,"Barren County, KY",Dec-19,18822,18035,787,4.2
29968,CN2101100000000,21,11,"Bath County, KY",Dec-19,4664,4395,269,5.8
29969,CN2101300000000,21,13,"Bell County, KY",Dec-19,8518,7950,568,6.7
29970,CN2101500000000,21,15,"Boone County, KY",Dec-19,71168,69014,2154,3.0
29971,CN2101700000000,21,17,"Bourbon County, KY",Dec-19,9930,9581,349,3.5
29972,CN2101900000000,21,19,"Boyd County, KY",Dec-19,17851,16904,947,5.3
29973,CN2102100000000,21,21,"Boyle County, KY",Dec-19,12347,11842,505,4.1
29974,CN2102300000000,21,23,"Bracken County, KY",Dec-19,3854,3687,167,4.3
29975,CN2102500000000,21,25,"Breathitt County, KY",Dec-19,3458,3157,301,8.7
29976,CN2102700000000,21,27,"Breckinridge County, KY",Dec-19,7941,7543,398,5.0
29977,CN2102900000000,21,29,"Bullitt County, KY",Dec-19,43021,41469,1552,3.6
29978,CN2103100000000,21,31,"Butler County, KY",Dec-19,5208,4983,225,4.3
29979,CN2103300000000,21,33,"Caldwell County, KY",Dec-19,5525,5269,256,4.6
29980,CN2103500000000,21,35,"Calloway County, KY",Dec-19,18684,18012,672,3.6
29981,CN2103700000000,21,37,"Campbell County, KY",Dec-19,50970,49386,1584,3.1
29982,CN2103900000000,21,39,"Carlisle County, KY",Dec-19,2290,2202,88,3.8
29983,CN2104100000000,21,41,"Carroll County, KY",Dec-19,5375,5182,193,3.6
29984,CN2104300000000,21,43,"Carter County, KY",Dec-19,9868,9054,814,8.2
29985,CN2104500000000,21,45,"Casey County, KY",Dec-19,6723,6478,245,3.6
29986,CN2104700000000,21,47,"Christian County, KY",Dec-19,25276,24036,1240,4.9
29987,CN2104900000000,21,49,"Clark County, KY",Dec-19,17246,16622,624,3.6
29988,CN2105100000000,21,51,"Clay County, KY",Dec-19,5183,4842,341,6.6
29989,CN2105300000000,21,53,"Clinton County, KY",Dec-19,4034,3821,213,5.3
29990,CN2105500000000,21,55,"Crittenden County, KY",Dec-19,3826,3675,151,3.9
29991,CN2105700000000,21,57,"Cumberland County, KY",Dec-19,3212,3086,126,3.9
29992,CN2105900000000,21,59,"Daviess County, KY",Dec-19,47482,45767,1715,3.6
29993,CN2106100000000,21,61,"Edmonson County, KY",Dec-19,4880,4657,223,4.6
29994,CN2106300000000,21,63,"Elliott County, KY",Dec-19,2103,1912,191,9.1
29995,CN2106500000000,21,65,"Estill County, KY",Dec-19,5437,5168,269,4.9
29996,CN2106700000000,21,67,"Fayette County, KY",Dec-19,175216,170118,5098,2.9
29997,CN2106900000000,21,69,"Fleming County, KY",Dec-19,6162,5850,312,5.1
29998,CN2107100000000,21,71,"Floyd County, KY",Dec-19,11035,10320,715,6.5
29999,CN2107300000000,21,73,"Franklin County, KY",Dec-19,26034,25216,818,3.1
30000,CN2107500000000,21,75,"Fulton County, KY",Dec-19,2058,1962,96,4.7
30001,CN2107700000000,21,77,"Gallatin County, KY",Dec-19,4110,3968,142,3.5
30002,CN2107900000000,21,79,"Garrard County, KY",Dec-19,7703,7369,334,4.3
30003,CN2108100000000,21,81,"Grant County, KY",Dec-19,11775,11351,424,3.6
30004,CN2108300000000,21,83,"Graves County, KY",Dec-19,15994,15328,666,4.2
30005,CN2108500000000,21,85,"Grayson County, KY",Dec-19,11138,10649,489,4.4
30006,CN2108700000000,21,87,"Green County, KY",Dec-19,5210,5009,201,3.9
30007,CN2108900000000,21,89,"Greenup County, KY",Dec-19,13465,12592,873,6.5
30008,CN2109100000000,21,91,"Hancock County, KY",Dec-19,3972,3841,131,3.3
30009,CN2109300000000,21,93,"Hardin County, KY",Dec-19,48895,47094,1801,3.7
30010,CN2109500000000,21,95,"Harlan County, KY",Dec-19,6679,5940,739,11.1
30011,CN2109700000000,21,97,"Harrison County, KY",Dec-19,8875,8550,325,3.7
30012,CN2109900000000,21,99,"Hart County, KY",Dec-19,8086,7608,478,5.9
30013,CN2110100000000,21,101,"Henderson County, KY",Dec-19,22082,21262,820,3.7
30014,CN2110300000000,21,103,"Henry County, KY",Dec-19,8331,8060,271,3.3
30015,CN2110500000000,21,105,"Hickman County, KY",Dec-19,1775,1691,84,4.7
30016,CN2110700000000,21,107,"Hopkins County, KY",Dec-19,18549,17766,783,4.2
30017,CN2110900000000,21,109,"Jackson County, KY",Dec-19,4144,3891,253,6.1
30018,CN2111100000000,21,111,"Jefferson County, KY",Dec-19,402027,388284,13743,3.4
30019,CN2111300000000,21,113,"Jessamine County, KY",Dec-19,26598,25759,839,3.2
30020,CN2111500000000,21,115,"Johnson County, KY",Dec-19,6727,6303,424,6.3
30021,CN2111700000000,21,117,"Kenton County, KY",Dec-19,88136,85260,2876,3.3
30022,CN2111900000000,21,119,"Knott County, KY",Dec-19,4446,4153,293,6.6
30023,CN2112100000000,21,121,"Knox County, KY",Dec-19,9813,9256,557,5.7
30024,CN2112300000000,21,123,"Larue County, KY",Dec-19,6029,5776,253,4.2
30025,CN2112500000000,21,125,"Laurel County, KY",Dec-19,24306,23239,1067,4.4
30026,CN2112700000000,21,127,"Lawrence County, KY",Dec-19,5265,4897,368,7.0
30027,CN2112900000000,21,129,"Lee County, KY",Dec-19,2059,1946,113,5.5
30028,CN2113100000000,21,131,"Leslie County, KY",Dec-19,2730,2464,266,9.7
30029,CN2113300000000,21,133,"Letcher County, KY",Dec-19,6419,5898,521,8.1
30030,CN2113500000000,21,135,"Lewis County, KY",Dec-19,4719,4292,427,9.0
30031,CN2113700000000,21,137,"Lincoln County, KY",Dec-19,9168,8760,408,4.5
30032,CN2113900000000,21,139,"Livingston County, KY",Dec-19,3687,3499,188,5.1
30033,CN2114100000000,21,141,"Logan County, KY",Dec-19,12678,12192,486,3.8
30034,CN2114300000000,21,143,"Lyon County, KY",Dec-19,3026,2899,127,4.2
30035,CN2114500000000,21,145,"McCracken County, KY",Dec-19,29533,28175,1358,4.6
30036,CN2114700000000,21,147,"McCreary County, KY",Dec-19,4673,4410,263,5.6
30037,CN2114900000000,21,149,"McLean County, KY",Dec-19,4238,4072,166,3.9
30038,CN2115100000000,21,151,"Madison County, KY",Dec-19,48161,46554,1607,3.3
30039,CN2115300000000,21,153,"Magoffin County, KY",Dec-19,3286,2890,396,12.1
30040,CN2115500000000,21,155,"Marion County, KY",Dec-19,9686,9369,317,3.3
30041,CN2115700000000,21,157,"Marshall County, KY",Dec-19,15081,14465,616,4.1
30042,CN2115900000000,21,159,"Martin County, KY",Dec-19,2747,2564,183,6.7
30043,CN2116100000000,21,161,"Mason County, KY",Dec-19,7136,6749,387,5.4
30044,CN2116300000000,21,163,"Meade County, KY",Dec-19,12262,11740,522,4.3
30045,CN2116500000000,21,165,"Menifee County, KY",Dec-19,2322,2166,156,6.7
30046,CN2116700000000,21,167,"Mercer County, KY",Dec-19,9971,9536,435,4.4
30047,CN2116900000000,21,169,"Metcalfe County, KY",Dec-19,4159,3954,205,4.9
30048,CN2117100000000,21,171,"Monroe County, KY",Dec-19,4770,4612,158,3.3
30049,CN2117300000000,21,173,"Montgomery County, KY",Dec-19,11657,11111,546,4.7
30050,CN2117500000000,21,175,"Morgan County, KY",Dec-19,4598,4345,253,5.5
30051,CN2117700000000,21,177,"Muhlenberg County, KY",Dec-19,10376,9741,635,6.1
30052,CN2117900000000,21,179,"Nelson County, KY",Dec-19,23349,22453,896,3.8
30053,CN2118100000000,21,181,"Nicholas County, KY",Dec-19,3363,3226,137,4.1
30054,CN2118300000000,21,183,"Ohio County, KY",Dec-19,9754,9305,449,4.6
30055,CN2118500000000,21,185,"Oldham County, KY",Dec-19,33538,32614,924,2.8
30056,CN2118700000000,21,187,"Owen County, KY",Dec-19,5110,4925,185,3.6
30057,CN2118900000000,21,189,"Owsley County, KY",Dec-19,1137,1065,72,6.3
30058,CN2119100000000,21,191,"Pendleton County, KY",Dec-19,7046,6799,247,3.5
30059,CN2119300000000,21,193,"Perry County, KY",Dec-19,8269,7723,546,6.6
30060,CN2119500000000,21,195,"Pike County, KY",Dec-19,19654,18512,1142,5.8
30061,CN2119700000000,21,197,"Powell County, KY",Dec-19,5101,4816,285,5.6
30062,CN2119900000000,21,199,"Pulaski County, KY",Dec-19,26837,25671,1166,4.3
30063,CN2120100000000,21,201,"Robertson County, KY",Dec-19,836,798,38,4.5
30064,CN2120300000000,21,203,"Rockcastle County, KY",Dec-19,6796,6514,282,4.1
30065,CN2120500000000,21,205,"Rowan County, KY",Dec-19,10476,9938,538,5.1
30066,CN2120700000000,21,207,"Russell County, KY",Dec-19,6203,5865,338,5.4
30067,CN2120900000000,21,209,"Scott County, KY",Dec-19,29195,28275,920,3.2
30068,CN2121100000000,21,211,"Shelby County, KY",Dec-19,25737,24998,739,2.9
30069,CN2121300000000,21,213,"Simpson County, KY",Dec-19,8987,8613,374,4.2
30070,CN2121500000000,21,215,"Spencer County, KY",Dec-19,10285,9970,315,3.1
30071,CN2121700000000,21,217,"Taylor County, KY",Dec-19,13120,12650,470,3.6
30072,CN2121900000000,21,219,"Todd County, KY",Dec-19,5541,5332,209,3.8
30073,CN2122100000000,21,221,"Trigg County, KY",Dec-19,6092,5840,252,4.1
30074,CN2122300000000,21,223,"Trimble County, KY",Dec-19,3925,3766,159,4.1
30075,CN2122500000000,21,225,"Union County, KY",Dec-19,6207,5952,255,4.1
30076,CN2122700000000,21,227,"Warren County, KY",Dec-19,65983,63421,2562,3.9
30077,CN2122900000000,21,229,"Washington County, KY",Dec-19,6347,6121,226,3.6
30078,CN2123100000000,21,231,"Wayne County, KY",Dec-19,7514,7125,389,5.2
30079,CN2123300000000,21,233,"Webster County, KY",Dec-19,5669,5451,218,3.8
30080,CN2123500000000,21,235,"Whitley County, KY",Dec-19,13514,12850,664,4.9
30081,CN2123700000000,21,237,"Wolfe County, KY",Dec-19,1997,1847,150,7.5
30082,CN2123900000000,21,239,"Woodford County, KY",Dec-19,15141,14689,452,3.0
30083,CN2200100000000,22,1,"Acadia Parish, LA",Dec-19,23679,22394,1285,5.4
30084,CN2200300000000,22,3,"Allen Parish, LA",Dec-19,8824,8239,585,6.6
30085,CN2200500000000,22,5,"Ascension Parish, LA",Dec-19,63944,61243,2701,4.2
30086,CN2200700000000,22,7,"Assumption Parish, LA",Dec-19,8837,8303,534,6.0
30087,CN2200900000000,22,9,"Avoyelles Parish, LA",Dec-19,14993,14044,949,6.3
30088,CN2201100000000,22,11,"Beauregard Parish, LA",Dec-19,14391,13606,785,5.5
30089,CN2201300000000,22,13,"Bienville Parish, LA",Dec-19,5465,5121,344,6.3
30090,CN2201500000000,22,15,"Bossier Parish, LA",Dec-19,57408,54920,2488,4.3
30091,CN2201700000000,22,17,"Caddo Parish, LA",Dec-19,103144,97506,5638,5.5
30092,CN2201900000000,22,19,"Calcasieu Parish, LA",Dec-19,103592,98969,4623,4.5
30093,CN2202100000000,22,21,"Caldwell Parish, LA",Dec-19,3791,3500,291,7.7
30094,CN2202300000000,22,23,"Cameron Parish, LA",Dec-19,3843,3680,163,4.2
30095,CN2202500000000,22,25,"Catahoula Parish, LA",Dec-19,3345,3126,219,6.5
30096,CN2202700000000,22,27,"Claiborne Parish, LA",Dec-19,5852,5472,380,6.5
30097,CN2202900000000,22,29,"Concordia Parish, LA",Dec-19,7074,6599,475,6.7
30098,CN2203100000000,22,31,"De Soto Parish, LA",Dec-19,10848,10152,696,6.4
30099,CN2203300000000,22,33,"East Baton Rouge Parish, LA",Dec-19,230393,220084,10309,4.5
30100,CN2203500000000,22,35,"East Carroll Parish, LA",Dec-19,1859,1646,213,11.5
30101,CN2203700000000,22,37,"East Feliciana Parish, LA",Dec-19,7927,7575,352,4.4
30102,CN2203900000000,22,39,"Evangeline Parish, LA",Dec-19,11771,11070,701,6.0
30103,CN2204100000000,22,41,"Franklin Parish, LA",Dec-19,7273,6731,542,7.5
30104,CN2204300000000,22,43,"Grant Parish, LA",Dec-19,8226,7648,578,7.0
30105,CN2204500000000,22,45,"Iberia Parish, LA",Dec-19,27959,26343,1616,5.8
30106,CN2204700000000,22,47,"Iberville Parish, LA",Dec-19,14034,13165,869,6.2
30107,CN2204900000000,22,49,"Jackson Parish, LA",Dec-19,6776,6451,325,4.8
30108,CN2205100000000,22,51,"Jefferson Parish, LA",Dec-19,214052,205295,8757,4.1
30109,CN2205300000000,22,53,"Jefferson Davis Parish, LA",Dec-19,13009,12393,616,4.7
30110,CN2205500000000,22,55,"Lafayette Parish, LA",Dec-19,113213,108278,4935,4.4
30111,CN2205700000000,22,57,"Lafourche Parish, LA",Dec-19,41788,39971,1817,4.3
30112,CN2205900000000,22,59,"LaSalle Parish, LA",Dec-19,6746,6457,289,4.3
30113,CN2206100000000,22,61,"Lincoln Parish, LA",Dec-19,22179,21042,1137,5.1
30114,CN2206300000000,22,63,"Livingston Parish, LA",Dec-19,68528,65724,2804,4.1
30115,CN2206500000000,22,65,"Madison Parish, LA",Dec-19,3446,3170,276,8.0
30116,CN2206700000000,22,67,"Morehouse Parish, LA",Dec-19,10088,9126,962,9.5
30117,CN2206900000000,22,69,"Natchitoches Parish, LA",Dec-19,16608,15555,1053,6.3
30118,CN2207100000000,22,71,"Orleans Parish, LA",Dec-19,179138,170426,8712,4.9
30119,CN2207300000000,22,73,"Ouachita Parish, LA",Dec-19,70175,66312,3863,5.5
30120,CN2207500000000,22,75,"Plaquemines Parish, LA",Dec-19,10014,9586,428,4.3
30121,CN2207700000000,22,77,"Pointe Coupee Parish, LA",Dec-19,9790,9254,536,5.5
30122,CN2207900000000,22,79,"Rapides Parish, LA",Dec-19,54878,52053,2825,5.1
30123,CN2208100000000,22,81,"Red River Parish, LA",Dec-19,3716,3503,213,5.7
30124,CN2208300000000,22,83,"Richland Parish, LA",Dec-19,8124,7567,557,6.9
30125,CN2208500000000,22,85,"Sabine Parish, LA",Dec-19,9068,8600,468,5.2
30126,CN2208700000000,22,87,"St. Bernard Parish, LA",Dec-19,19843,18860,983,5.0
30127,CN2208900000000,22,89,"St. Charles Parish, LA",Dec-19,25206,24113,1093,4.3
30128,CN2209100000000,22,91,"St. Helena Parish, LA",Dec-19,4270,3994,276,6.5
30129,CN2209300000000,22,93,"St. James Parish, LA",Dec-19,9278,8702,576,6.2
30130,CN2209500000000,22,95,"St. John the Baptist Parish, LA",Dec-19,19821,18620,1201,6.1
30131,CN2209700000000,22,97,"St. Landry Parish, LA",Dec-19,31849,29758,2091,6.6
30132,CN2209900000000,22,99,"St. Martin Parish, LA",Dec-19,22155,20986,1169,5.3
30133,CN2210100000000,22,101,"St. Mary Parish, LA",Dec-19,19858,18679,1179,5.9
30134,CN2210300000000,22,103,"St. Tammany Parish, LA",Dec-19,119335,114440,4895,4.1
30135,CN2210500000000,22,105,"Tangipahoa Parish, LA",Dec-19,54896,51815,3081,5.6
30136,CN2210700000000,22,107,"Tensas Parish, LA",Dec-19,1309,1199,110,8.4
30137,CN2210900000000,22,109,"Terrebonne Parish, LA",Dec-19,46094,43957,2137,4.6
30138,CN2211100000000,22,111,"Union Parish, LA",Dec-19,9056,8510,546,6.0
30139,CN2211300000000,22,113,"Vermilion Parish, LA",Dec-19,23917,22666,1251,5.2
30140,CN2211500000000,22,115,"Vernon Parish, LA",Dec-19,15727,14767,960,6.1
30141,CN2211700000000,22,117,"Washington Parish, LA",Dec-19,16644,15676,968,5.8
30142,CN2211900000000,22,119,"Webster Parish, LA",Dec-19,14465,13556,909,6.3
30143,CN2212100000000,22,121,"West Baton Rouge Parish, LA",Dec-19,13629,13021,608,4.5
30144,CN2212300000000,22,123,"West Carroll Parish, LA",Dec-19,3659,3176,483,13.2
30145,CN2212500000000,22,125,"West Feliciana Parish, LA",Dec-19,5365,5131,234,4.4
30146,CN2212700000000,22,127,"Winn Parish, LA",Dec-19,4816,4489,327,6.8
30147,CN2300100000000,23,1,"Androscoggin County, ME",Dec-19,55516,54015,1501,2.7
30148,CN2300300000000,23,3,"Aroostook County, ME",Dec-19,30000,28709,1291,4.3
30149,CN2300500000000,23,5,"Cumberland County, ME",Dec-19,163827,160206,3621,2.2
30150,CN2300700000000,23,7,"Franklin County, ME",Dec-19,14452,13951,501,3.5
30151,CN2300900000000,23,9,"Hancock County, ME",Dec-19,27724,26628,1096,4.0
30152,CN2301100000000,23,11,"Kennebec County, ME",Dec-19,61641,59922,1719,2.8
30153,CN2301300000000,23,13,"Knox County, ME",Dec-19,19653,19097,556,2.8
30154,CN2301500000000,23,15,"Lincoln County, ME",Dec-19,16341,15882,459,2.8
30155,CN2301700000000,23,17,"Oxford County, ME",Dec-19,26369,25473,896,3.4
30156,CN2301900000000,23,19,"Penobscot County, ME",Dec-19,77662,75311,2351,3.0
30157,CN2302100000000,23,21,"Piscataquis County, ME",Dec-19,7236,6960,276,3.8
30158,CN2302300000000,23,23,"Sagadahoc County, ME",Dec-19,19247,18823,424,2.2
30159,CN2302500000000,23,25,"Somerset County, ME",Dec-19,22068,21068,1000,4.5
30160,CN2302700000000,23,27,"Waldo County, ME",Dec-19,20414,19778,636,3.1
30161,CN2302900000000,23,29,"Washington County, ME",Dec-19,13823,13261,562,4.1
30162,CN2303100000000,23,31,"York County, ME",Dec-19,112921,109891,3030,2.7
30163,CN2400100000000,24,1,"Allegany County, MD",Dec-19,32023,30591,1432,4.5
30164,CN2400300000000,24,3,"Anne Arundel County, MD",Dec-19,318588,310668,7920,2.5
30165,CN2400500000000,24,5,"Baltimore County, MD",Dec-19,458445,444346,14099,3.1
30166,CN2400900000000,24,9,"Calvert County, MD",Dec-19,50681,49400,1281,2.5
30167,CN2401100000000,24,11,"Caroline County, MD",Dec-19,18084,17527,557,3.1
30168,CN2401300000000,24,13,"Carroll County, MD",Dec-19,96751,94442,2309,2.4
30169,CN2401500000000,24,15,"Cecil County, MD",Dec-19,53208,51451,1757,3.3
30170,CN2401700000000,24,17,"Charles County, MD",Dec-19,88445,85770,2675,3.0
30171,CN2401900000000,24,19,"Dorchester County, MD",Dec-19,15223,14586,637,4.2
30172,CN2402100000000,24,21,"Frederick County, MD",Dec-19,135197,131633,3564,2.6
30173,CN2402300000000,24,23,"Garrett County, MD",Dec-19,15486,14786,700,4.5
30174,CN2402500000000,24,25,"Harford County, MD",Dec-19,142311,138454,3857,2.7
30175,CN2402700000000,24,27,"Howard County, MD",Dec-19,189696,185505,4191,2.2
30176,CN2402900000000,24,29,"Kent County, MD",Dec-19,9949,9588,361,3.6
30177,CN2403100000000,24,31,"Montgomery County, MD",Dec-19,564087,550548,13539,2.4
30178,CN2403300000000,24,33,"Prince George's County, MD",Dec-19,516196,499789,16407,3.2
30179,CN2403500000000,24,35,"Queen Anne's County, MD",Dec-19,28181,27448,733,2.6
30180,CN2403700000000,24,37,"St. Mary's County, MD",Dec-19,57301,55796,1505,2.6
30181,CN2403900000000,24,39,"Somerset County, MD",Dec-19,8967,8468,499,5.6
30182,CN2404100000000,24,41,"Talbot County, MD",Dec-19,19398,18832,566,2.9
30183,CN2404300000000,24,43,"Washington County, MD",Dec-19,76547,74077,2470,3.2
30184,CN2404500000000,24,45,"Wicomico County, MD",Dec-19,50287,48021,2266,4.5
30185,CN2404700000000,24,47,"Worcester County, MD",Dec-19,25750,23306,2444,9.5
30186,CN2451000000000,24,510,"Baltimore city, MD",Dec-19,290523,278177,12346,4.2
30187,CN2500100000000,25,1,"Barnstable County, MA",Dec-19,110894,106645,4249,3.8
30188,CN2500300000000,25,3,"Berkshire County, MA",Dec-19,65063,63043,2020,3.1
30189,CN2500500000000,25,5,"Bristol County, MA",Dec-19,306280,296654,9626,3.1
30190,CN2500700000000,25,7,"Dukes County, MA",Dec-19,8560,8163,397,4.6
30191,CN2500900000000,25,9,"Essex County, MA",Dec-19,430487,420080,10407,2.4
30192,CN2501100000000,25,11,"Franklin County, MA",Dec-19,41679,40769,910,2.2
30193,CN2501300000000,25,13,"Hampden County, MA",Dec-19,231489,223719,7770,3.4
30194,CN2501500000000,25,15,"Hampshire County, MA",Dec-19,91474,89652,1822,2.0
30195,CN2501700000000,25,17,"Middlesex County, MA",Dec-19,930476,913870,16606,1.8
30196,CN2501900000000,25,19,"Nantucket County/town, MA",Dec-19,6688,6329,359,5.4
30197,CN2502100000000,25,21,"Norfolk County, MA",Dec-19,396424,388516,7908,2.0
30198,CN2502300000000,25,23,"Plymouth County, MA",Dec-19,287192,279949,7243,2.5
30199,CN2502500000000,25,25,"Suffolk County, MA",Dec-19,461862,452543,9319,2.0
30200,CN2502700000000,25,27,"Worcester County, MA",Dec-19,454423,442619,11804,2.6
30201,CN2600100000000,26,1,"Alcona County, MI",Dec-19,3755,3521,234,6.2
30202,CN2600300000000,26,3,"Alger County, MI",Dec-19,3031,2762,269,8.9
30203,CN2600500000000,26,5,"Allegan County, MI",Dec-19,61579,59883,1696,2.8
30204,CN2600700000000,26,7,"Alpena County, MI",Dec-19,13229,12667,562,4.2
30205,CN2600900000000,26,9,"Antrim County, MI",Dec-19,9928,9436,492,5.0
30206,CN2601100000000,26,11,"Arenac County, MI",Dec-19,5936,5543,393,6.6
30207,CN2601300000000,26,13,"Baraga County, MI",Dec-19,3195,2980,215,6.7
30208,CN2601500000000,26,15,"Barry County, MI",Dec-19,31391,30479,912,2.9
30209,CN2601700000000,26,17,"Bay County, MI",Dec-19,49453,47373,2080,4.2
30210,CN2601900000000,26,19,"Benzie County, MI",Dec-19,8751,8304,447,5.1
30211,CN2602100000000,26,21,"Berrien County, MI",Dec-19,72410,69820,2590,3.6
30212,CN2602300000000,26,23,"Branch County, MI",Dec-19,19155,18516,639,3.3
30213,CN2602500000000,26,25,"Calhoun County, MI",Dec-19,62350,60200,2150,3.4
30214,CN2602700000000,26,27,"Cass County, MI",Dec-19,24332,23460,872,3.6
30215,CN2602900000000,26,29,"Charlevoix County, MI",Dec-19,12283,11699,584,4.8
30216,CN2603100000000,26,31,"Cheboygan County, MI",Dec-19,9838,8663,1175,11.9
30217,CN2603300000000,26,33,"Chippewa County, MI",Dec-19,15907,14881,1026,6.4
30218,CN2603500000000,26,35,"Clare County, MI",Dec-19,11564,10855,709,6.1
30219,CN2603700000000,26,37,"Clinton County, MI",Dec-19,41124,40102,1022,2.5
30220,CN2603900000000,26,39,"Crawford County, MI",Dec-19,5491,5158,333,6.1
30221,CN2604100000000,26,41,"Delta County, MI",Dec-19,17054,16034,1020,6.0
30222,CN2604300000000,26,43,"Dickinson County, MI",Dec-19,12216,11684,532,4.4
30223,CN2604500000000,26,45,"Eaton County, MI",Dec-19,57356,55749,1607,2.8
30224,CN2604700000000,26,47,"Emmet County, MI",Dec-19,17188,16208,980,5.7
30225,CN2604900000000,26,49,"Genesee County, MI",Dec-19,183587,176302,7285,4.0
30226,CN2605100000000,26,51,"Gladwin County, MI",Dec-19,9679,9130,549,5.7
30227,CN2605300000000,26,53,"Gogebic County, MI",Dec-19,6038,5754,284,4.7
30228,CN2605500000000,26,55,"Grand Traverse County, MI",Dec-19,48974,47436,1538,3.1
30229,CN2605700000000,26,57,"Gratiot County, MI",Dec-19,18063,17393,670,3.7
30230,CN2605900000000,26,59,"Hillsdale County, MI",Dec-19,20251,19541,710,3.5
30231,CN2606100000000,26,61,"Houghton County, MI",Dec-19,16443,15750,693,4.2
30232,CN2606300000000,26,63,"Huron County, MI",Dec-19,15096,14505,591,3.9
30233,CN2606500000000,26,65,"Ingham County, MI",Dec-19,151224,147144,4080,2.7
30234,CN2606700000000,26,67,"Ionia County, MI",Dec-19,30090,29265,825,2.7
30235,CN2606900000000,26,69,"Iosco County, MI",Dec-19,10090,9493,597,5.9
30236,CN2607100000000,26,71,"Iron County, MI",Dec-19,5093,4807,286,5.6
30237,CN2607300000000,26,73,"Isabella County, MI",Dec-19,34613,33430,1183,3.4
30238,CN2607500000000,26,75,"Jackson County, MI",Dec-19,73961,71582,2379,3.2
30239,CN2607700000000,26,77,"Kalamazoo County, MI",Dec-19,133921,130309,3612,2.7
30240,CN2607900000000,26,79,"Kalkaska County, MI",Dec-19,7836,7380,456,5.8
30241,CN2608100000000,26,81,"Kent County, MI",Dec-19,356995,348545,8450,2.4
30242,CN2608300000000,26,83,"Keweenaw County, MI",Dec-19,906,838,68,7.5
30243,CN2608500000000,26,85,"Lake County, MI",Dec-19,3786,3565,221,5.8
30244,CN2608700000000,26,87,"Lapeer County, MI",Dec-19,41625,39344,2281,5.5
30245,CN2608900000000,26,89,"Leelanau County, MI",Dec-19,10295,9957,338,3.3
30246,CN2609100000000,26,91,"Lenawee County, MI",Dec-19,46306,44923,1383,3.0
30247,CN2609300000000,26,93,"Livingston County, MI",Dec-19,104219,101131,3088,3.0
30248,CN2609500000000,26,95,"Luce County, MI",Dec-19,2262,2107,155,6.9
30249,CN2609700000000,26,97,"Mackinac County, MI",Dec-19,4188,3486,702,16.8
30250,CN2609900000000,26,99,"Macomb County, MI",Dec-19,450438,434047,16391,3.6
30251,CN2610100000000,26,101,"Manistee County, MI",Dec-19,10190,9638,552,5.4
30252,CN2610300000000,26,103,"Marquette County, MI",Dec-19,32961,31574,1387,4.2
30253,CN2610500000000,26,105,"Mason County, MI",Dec-19,13171,12507,664,5.0
30254,CN2610700000000,26,107,"Mecosta County, MI",Dec-19,18273,17496,777,4.3
30255,CN2610900000000,26,109,"Menominee County, MI",Dec-19,11042,10494,548,5.0
30256,CN2611100000000,26,111,"Midland County, MI",Dec-19,39763,38450,1313,3.3
30257,CN2611300000000,26,113,"Missaukee County, MI",Dec-19,6829,6515,314,4.6
30258,CN2611500000000,26,115,"Monroe County, MI",Dec-19,75201,72915,2286,3.0
30259,CN2611700000000,26,117,"Montcalm County, MI",Dec-19,28012,27018,994,3.5
30260,CN2611900000000,26,119,"Montmorency County, MI",Dec-19,2994,2701,293,9.8
30261,CN2612100000000,26,121,"Muskegon County, MI",Dec-19,76923,74004,2919,3.8
30262,CN2612300000000,26,123,"Newaygo County, MI",Dec-19,23165,22292,873,3.8
30263,CN2612500000000,26,125,"Oakland County, MI",Dec-19,679992,660057,19935,2.9
30264,CN2612700000000,26,127,"Oceana County, MI",Dec-19,11455,10766,689,6.0
30265,CN2612900000000,26,129,"Ogemaw County, MI",Dec-19,7832,7294,538,6.9
30266,CN2613100000000,26,131,"Ontonagon County, MI",Dec-19,2089,1936,153,7.3
30267,CN2613300000000,26,133,"Osceola County, MI",Dec-19,11267,10849,418,3.7
30268,CN2613500000000,26,135,"Oscoda County, MI",Dec-19,2933,2716,217,7.4
30269,CN2613700000000,26,137,"Otsego County, MI",Dec-19,11388,10878,510,4.5
30270,CN2613900000000,26,139,"Ottawa County, MI",Dec-19,159487,155897,3590,2.3
30271,CN2614100000000,26,141,"Presque Isle County, MI",Dec-19,4794,4400,394,8.2
30272,CN2614300000000,26,143,"Roscommon County, MI",Dec-19,7382,6827,555,7.5
30273,CN2614500000000,26,145,"Saginaw County, MI",Dec-19,86682,83144,3538,4.1
30274,CN2614700000000,26,147,"St. Clair County, MI",Dec-19,76151,72793,3358,4.4
30275,CN2614900000000,26,149,"St. Joseph County, MI",Dec-19,27385,26498,887,3.2
30276,CN2615100000000,26,151,"Sanilac County, MI",Dec-19,19094,18321,773,4.0
30277,CN2615300000000,26,153,"Schoolcraft County, MI",Dec-19,3297,3041,256,7.8
30278,CN2615500000000,26,155,"Shiawassee County, MI",Dec-19,33500,32247,1253,3.7
30279,CN2615700000000,26,157,"Tuscola County, MI",Dec-19,23646,22624,1022,4.3
30280,CN2615900000000,26,159,"Van Buren County, MI",Dec-19,34982,33509,1473,4.2
30281,CN2616100000000,26,161,"Washtenaw County, MI",Dec-19,200349,196082,4267,2.1
30282,CN2616300000000,26,163,"Wayne County, MI",Dec-19,810632,774479,36153,4.5
30283,CN2616500000000,26,165,"Wexford County, MI",Dec-19,14751,14142,609,4.1
30284,CN2700100000000,27,1,"Aitkin County, MN",Dec-19,7397,6778,619,8.4
30285,CN2700300000000,27,3,"Anoka County, MN",Dec-19,200257,193999,6258,3.1
30286,CN2700500000000,27,5,"Becker County, MN",Dec-19,18935,17963,972,5.1
30287,CN2700700000000,27,7,"Beltrami County, MN",Dec-19,24903,23649,1254,5.0
30288,CN2700900000000,27,9,"Benton County, MN",Dec-19,22382,21309,1073,4.8
30289,CN2701100000000,27,11,"Big Stone County, MN",Dec-19,2496,2348,148,5.9
30290,CN2701300000000,27,13,"Blue Earth County, MN",Dec-19,41456,40377,1079,2.6
30291,CN2701500000000,27,15,"Brown County, MN",Dec-19,14387,13806,581,4.0
30292,CN2701700000000,27,17,"Carlton County, MN",Dec-19,18060,17082,978,5.4
30293,CN2701900000000,27,19,"Carver County, MN",Dec-19,59305,57657,1648,2.8
30294,CN2702100000000,27,21,"Cass County, MN",Dec-19,14230,13143,1087,7.6
30295,CN2702300000000,27,23,"Chippewa County, MN",Dec-19,7112,6796,316,4.4
30296,CN2702500000000,27,25,"Chisago County, MN",Dec-19,30564,29201,1363,4.5
30297,CN2702700000000,27,27,"Clay County, MN",Dec-19,36705,35593,1112,3.0
30298,CN2702900000000,27,29,"Clearwater County, MN",Dec-19,4701,4211,490,10.4
30299,CN2703100000000,27,31,"Cook County, MN",Dec-19,3019,2828,191,6.3
30300,CN2703300000000,27,33,"Cottonwood County, MN",Dec-19,6100,5899,201,3.3
30301,CN2703500000000,27,35,"Crow Wing County, MN",Dec-19,32164,30279,1885,5.9
30302,CN2703700000000,27,37,"Dakota County, MN",Dec-19,244624,237642,6982,2.9
30303,CN2703900000000,27,39,"Dodge County, MN",Dec-19,12000,11543,457,3.8
30304,CN2704100000000,27,41,"Douglas County, MN",Dec-19,21018,20205,813,3.9
30305,CN2704300000000,27,43,"Faribault County, MN",Dec-19,7111,6750,361,5.1
30306,CN2704500000000,27,45,"Fillmore County, MN",Dec-19,11684,11233,451,3.9
30307,CN2704700000000,27,47,"Freeborn County, MN",Dec-19,16330,15734,596,3.6
30308,CN2704900000000,27,49,"Goodhue County, MN",Dec-19,27508,26572,936,3.4
30309,CN2705100000000,27,51,"Grant County, MN",Dec-19,3359,3175,184,5.5
30310,CN2705300000000,27,53,"Hennepin County, MN",Dec-19,713985,695396,18589,2.6
30311,CN2705500000000,27,55,"Houston County, MN",Dec-19,10592,10220,372,3.5
30312,CN2705700000000,27,57,"Hubbard County, MN",Dec-19,9963,9260,703,7.1
30313,CN2705900000000,27,59,"Isanti County, MN",Dec-19,21802,20701,1101,5.0
30314,CN2706100000000,27,61,"Itasca County, MN",Dec-19,21975,20436,1539,7.0
30315,CN2706300000000,27,63,"Jackson County, MN",Dec-19,5766,5588,178,3.1
30316,CN2706500000000,27,65,"Kanabec County, MN",Dec-19,9392,8582,810,8.6
30317,CN2706700000000,27,67,"Kandiyohi County, MN",Dec-19,24731,23694,1037,4.2
30318,CN2706900000000,27,69,"Kittson County, MN",Dec-19,2429,2323,106,4.4
30319,CN2707100000000,27,71,"Koochiching County, MN",Dec-19,5905,5496,409,6.9
30320,CN2707300000000,27,73,"Lac qui Parle County, MN",Dec-19,3620,3484,136,3.8
30321,CN2707500000000,27,75,"Lake County, MN",Dec-19,5352,5128,224,4.2
30322,CN2707700000000,27,77,"Lake of the Woods County, MN",Dec-19,2559,2438,121,4.7
30323,CN2707900000000,27,79,"Le Sueur County, MN",Dec-19,16650,15613,1037,6.2
30324,CN2708100000000,27,81,"Lincoln County, MN",Dec-19,3364,3191,173,5.1
30325,CN2708300000000,27,83,"Lyon County, MN",Dec-19,14659,14138,521,3.6
30326,CN2708500000000,27,85,"McLeod County, MN",Dec-19,19445,18614,831,4.3
30327,CN2708700000000,27,87,"Mahnomen County, MN",Dec-19,2320,2180,140,6.0
30328,CN2708900000000,27,89,"Marshall County, MN",Dec-19,5560,5126,434,7.8
30329,CN2709100000000,27,91,"Martin County, MN",Dec-19,10062,9713,349,3.5
30330,CN2709300000000,27,93,"Meeker County, MN",Dec-19,13642,12938,704,5.2
30331,CN2709500000000,27,95,"Mille Lacs County, MN",Dec-19,13324,12385,939,7.0
30332,CN2709700000000,27,97,"Morrison County, MN",Dec-19,17916,16556,1360,7.6
30333,CN2709900000000,27,99,"Mower County, MN",Dec-19,20484,19836,648,3.2
30334,CN2710100000000,27,101,"Murray County, MN",Dec-19,4930,4666,264,5.4
30335,CN2710300000000,27,103,"Nicollet County, MN",Dec-19,21410,20874,536,2.5
30336,CN2710500000000,27,105,"Nobles County, MN",Dec-19,11372,11053,319,2.8
30337,CN2710700000000,27,107,"Norman County, MN",Dec-19,3315,3136,179,5.4
30338,CN2710900000000,27,109,"Olmsted County, MN",Dec-19,89100,86818,2282,2.6
30339,CN2711100000000,27,111,"Otter Tail County, MN",Dec-19,31775,30048,1727,5.4
30340,CN2711300000000,27,113,"Pennington County, MN",Dec-19,8808,8235,573,6.5
30341,CN2711500000000,27,115,"Pine County, MN",Dec-19,15487,14347,1140,7.4
30342,CN2711700000000,27,117,"Pipestone County, MN",Dec-19,4944,4759,185,3.7
30343,CN2711900000000,27,119,"Polk County, MN",Dec-19,16872,16203,669,4.0
30344,CN2712100000000,27,121,"Pope County, MN",Dec-19,6645,6400,245,3.7
30345,CN2712300000000,27,123,"Ramsey County, MN",Dec-19,292786,284453,8333,2.8
30346,CN2712500000000,27,125,"Red Lake County, MN",Dec-19,2244,2104,140,6.2
30347,CN2712700000000,27,127,"Redwood County, MN",Dec-19,7787,7487,300,3.9
30348,CN2712900000000,27,129,"Renville County, MN",Dec-19,8666,8205,461,5.3
30349,CN2713100000000,27,131,"Rice County, MN",Dec-19,37629,36272,1357,3.6
30350,CN2713300000000,27,133,"Rock County, MN",Dec-19,5727,5581,146,2.5
30351,CN2713500000000,27,135,"Roseau County, MN",Dec-19,7959,7626,333,4.2
30352,CN2713700000000,27,137,"St. Louis County, MN",Dec-19,102499,98065,4434,4.3
30353,CN2713900000000,27,139,"Scott County, MN",Dec-19,84637,82261,2376,2.8
30354,CN2714100000000,27,141,"Sherburne County, MN",Dec-19,53401,51238,2163,4.1
30355,CN2714300000000,27,143,"Sibley County, MN",Dec-19,8753,8328,425,4.9
30356,CN2714500000000,27,145,"Stearns County, MN",Dec-19,91549,88354,3195,3.5
30357,CN2714700000000,27,147,"Steele County, MN",Dec-19,21600,20890,710,3.3
30358,CN2714900000000,27,149,"Stevens County, MN",Dec-19,5473,5295,178,3.3
30359,CN2715100000000,27,151,"Swift County, MN",Dec-19,5062,4753,309,6.1
30360,CN2715300000000,27,153,"Todd County, MN",Dec-19,13913,13129,784,5.6
30361,CN2715500000000,27,155,"Traverse County, MN",Dec-19,1757,1684,73,4.2
30362,CN2715700000000,27,157,"Wabasha County, MN",Dec-19,12479,11973,506,4.1
30363,CN2715900000000,27,159,"Wadena County, MN",Dec-19,6152,5655,497,8.1
30364,CN2716100000000,27,161,"Waseca County, MN",Dec-19,9079,8639,440,4.8
30365,CN2716300000000,27,163,"Washington County, MN",Dec-19,145139,141051,4088,2.8
30366,CN2716500000000,27,165,"Watonwan County, MN",Dec-19,6574,6314,260,4.0
30367,CN2716700000000,27,167,"Wilkin County, MN",Dec-19,3495,3374,121,3.5
30368,CN2716900000000,27,169,"Winona County, MN",Dec-19,28882,28031,851,2.9
30369,CN2717100000000,27,171,"Wright County, MN",Dec-19,77000,74124,2876,3.7
30370,CN2717300000000,27,173,"Yellow Medicine County, MN",Dec-19,5506,5290,216,3.9
30371,CN2800100000000,28,1,"Adams County, MS",Dec-19,11436,10631,805,7.0
30372,CN2800300000000,28,3,"Alcorn County, MS",Dec-19,16159,15433,726,4.5
30373,CN2800500000000,28,5,"Amite County, MS",Dec-19,4391,4070,321,7.3
30374,CN2800700000000,28,7,"Attala County, MS",Dec-19,7053,6614,439,6.2
30375,CN2800900000000,28,9,"Benton County, MS",Dec-19,3092,2902,190,6.1
30376,CN2801100000000,28,11,"Bolivar County, MS",Dec-19,12048,11138,910,7.6
30377,CN2801300000000,28,13,"Calhoun County, MS",Dec-19,5546,5236,310,5.6
30378,CN2801500000000,28,15,"Carroll County, MS",Dec-19,3469,3254,215,6.2
30379,CN2801700000000,28,17,"Chickasaw County, MS",Dec-19,6846,6492,354,5.2
30380,CN2801900000000,28,19,"Choctaw County, MS",Dec-19,3732,3511,221,5.9
30381,CN2802100000000,28,21,"Claiborne County, MS",Dec-19,3041,2714,327,10.8
30382,CN2802300000000,28,23,"Clarke County, MS",Dec-19,5945,5573,372,6.3
30383,CN2802500000000,28,25,"Clay County, MS",Dec-19,7798,7163,635,8.1
30384,CN2802700000000,28,27,"Coahoma County, MS",Dec-19,8268,7623,645,7.8
30385,CN2802900000000,28,29,"Copiah County, MS",Dec-19,11145,10475,670,6.0
30386,CN2803100000000,28,31,"Covington County, MS",Dec-19,8159,7780,379,4.6
30387,CN2803300000000,28,33,"DeSoto County, MS",Dec-19,92289,88522,3767,4.1
30388,CN2803500000000,28,35,"Forrest County, MS",Dec-19,33571,32015,1556,4.6
30389,CN2803700000000,28,37,"Franklin County, MS",Dec-19,2777,2570,207,7.5
30390,CN2803900000000,28,39,"George County, MS",Dec-19,8846,8155,691,7.8
30391,CN2804100000000,28,41,"Greene County, MS",Dec-19,4377,3984,393,9.0
30392,CN2804300000000,28,43,"Grenada County, MS",Dec-19,9364,8905,459,4.9
30393,CN2804500000000,28,45,"Hancock County, MS",Dec-19,18915,17887,1028,5.4
30394,CN2804700000000,28,47,"Harrison County, MS",Dec-19,87112,82724,4388,5.0
30395,CN2804900000000,28,49,"Hinds County, MS",Dec-19,107238,101994,5244,4.9
30396,CN2805100000000,28,51,"Holmes County, MS",Dec-19,5664,5095,569,10.0
30397,CN2805300000000,28,53,"Humphreys County, MS",Dec-19,2201,1944,257,11.7
30398,CN2805500000000,28,55,"Issaquena County, MS",Dec-19,369,336,33,8.9
30399,CN2805700000000,28,57,"Itawamba County, MS",Dec-19,10585,10132,453,4.3
30400,CN2805900000000,28,59,"Jackson County, MS",Dec-19,58958,55515,3443,5.8
30401,CN2806100000000,28,61,"Jasper County, MS",Dec-19,6206,5722,484,7.8
30402,CN2806300000000,28,63,"Jefferson County, MS",Dec-19,2059,1703,356,17.3
30403,CN2806500000000,28,65,"Jefferson Davis County, MS",Dec-19,4110,3837,273,6.6
30404,CN2806700000000,28,67,"Jones County, MS",Dec-19,26102,24772,1330,5.1
30405,CN2806900000000,28,69,"Kemper County, MS",Dec-19,3509,3250,259,7.4
30406,CN2807100000000,28,71,"Lafayette County, MS",Dec-19,28899,27834,1065,3.7
30407,CN2807300000000,28,73,"Lamar County, MS",Dec-19,31079,29879,1200,3.9
30408,CN2807500000000,28,75,"Lauderdale County, MS",Dec-19,30632,29076,1556,5.1
30409,CN2807700000000,28,77,"Lawrence County, MS",Dec-19,4596,4275,321,7.0
30410,CN2807900000000,28,79,"Leake County, MS",Dec-19,7800,7376,424,5.4
30411,CN2808100000000,28,81,"Lee County, MS",Dec-19,41672,39976,1696,4.1
30412,CN2808300000000,28,83,"Leflore County, MS",Dec-19,10044,9293,751,7.5
30413,CN2808500000000,28,85,"Lincoln County, MS",Dec-19,14652,13798,854,5.8
30414,CN2808700000000,28,87,"Lowndes County, MS",Dec-19,25735,24425,1310,5.1
30415,CN2808900000000,28,89,"Madison County, MS",Dec-19,53412,51242,2170,4.1
30416,CN2809100000000,28,91,"Marion County, MS",Dec-19,10007,9455,552,5.5
30417,CN2809300000000,28,93,"Marshall County, MS",Dec-19,14676,13832,844,5.8
30418,CN2809500000000,28,95,"Monroe County, MS",Dec-19,15676,14871,805,5.1
30419,CN2809700000000,28,97,"Montgomery County, MS",Dec-19,3894,3660,234,6.0
30420,CN2809900000000,28,99,"Neshoba County, MS",Dec-19,10023,9433,590,5.9
30421,CN2810100000000,28,101,"Newton County, MS",Dec-19,8915,8439,476,5.3
30422,CN2810300000000,28,103,"Noxubee County, MS",Dec-19,3750,3471,279,7.4
30423,CN2810500000000,28,105,"Oktibbeha County, MS",Dec-19,22822,21705,1117,4.9
30424,CN2810700000000,28,107,"Panola County, MS",Dec-19,12607,11821,786,6.2
30425,CN2810900000000,28,109,"Pearl River County, MS",Dec-19,23910,22725,1185,5.0
30426,CN2811100000000,28,111,"Perry County, MS",Dec-19,4334,4046,288,6.6
30427,CN2811300000000,28,113,"Pike County, MS",Dec-19,14502,13573,929,6.4
30428,CN2811500000000,28,115,"Pontotoc County, MS",Dec-19,14920,14312,608,4.1
30429,CN2811700000000,28,117,"Prentiss County, MS",Dec-19,11298,10787,511,4.5
30430,CN2811900000000,28,119,"Quitman County, MS",Dec-19,2321,2122,199,8.6
30431,CN2812100000000,28,121,"Rankin County, MS",Dec-19,76393,73550,2843,3.7
30432,CN2812300000000,28,123,"Scott County, MS",Dec-19,12575,12050,525,4.2
30433,CN2812500000000,28,125,"Sharkey County, MS",Dec-19,1609,1450,159,9.9
30434,CN2812700000000,28,127,"Simpson County, MS",Dec-19,10729,10206,523,4.9
30435,CN2812900000000,28,129,"Smith County, MS",Dec-19,6770,6400,370,5.5
30436,CN2813100000000,28,131,"Stone County, MS",Dec-19,6884,6472,412,6.0
30437,CN2813300000000,28,133,"Sunflower County, MS",Dec-19,7713,6902,811,10.5
30438,CN2813500000000,28,135,"Tallahatchie County, MS",Dec-19,5199,4874,325,6.3
30439,CN2813700000000,28,137,"Tate County, MS",Dec-19,12444,11786,658,5.3
30440,CN2813900000000,28,139,"Tippah County, MS",Dec-19,9427,9003,424,4.5
30441,CN2814100000000,28,141,"Tishomingo County, MS",Dec-19,8572,8117,455,5.3
30442,CN2814300000000,28,143,"Tunica County, MS",Dec-19,4459,4182,277,6.2
30443,CN2814500000000,28,145,"Union County, MS",Dec-19,14444,13854,590,4.1
30444,CN2814700000000,28,147,"Walthall County, MS",Dec-19,4899,4547,352,7.2
30445,CN2814900000000,28,149,"Warren County, MS",Dec-19,20417,19230,1187,5.8
30446,CN2815100000000,28,151,"Washington County, MS",Dec-19,16996,15653,1343,7.9
30447,CN2815300000000,28,153,"Wayne County, MS",Dec-19,7349,6898,451,6.1
30448,CN2815500000000,28,155,"Webster County, MS",Dec-19,3985,3770,215,5.4
30449,CN2815700000000,28,157,"Wilkinson County, MS",Dec-19,2855,2549,306,10.7
30450,CN2815900000000,28,159,"Winston County, MS",Dec-19,7402,6984,418,5.6
30451,CN2816100000000,28,161,"Yalobusha County, MS",Dec-19,4967,4717,250,5.0
30452,CN2816300000000,28,163,"Yazoo County, MS",Dec-19,9333,8766,567,6.1
30453,CN2900100000000,29,1,"Adair County, MO",Dec-19,10369,10030,339,3.3
30454,CN2900300000000,29,3,"Andrew County, MO",Dec-19,9789,9528,261,2.7
30455,CN2900500000000,29,5,"Atchison County, MO",Dec-19,2662,2573,89,3.3
30456,CN2900700000000,29,7,"Audrain County, MO",Dec-19,10678,10333,345,3.2
30457,CN2900900000000,29,9,"Barry County, MO",Dec-19,15483,14889,594,3.8
30458,CN2901100000000,29,11,"Barton County, MO",Dec-19,5192,5013,179,3.4
30459,CN2901300000000,29,13,"Bates County, MO",Dec-19,7893,7595,298,3.8
30460,CN2901500000000,29,15,"Benton County, MO",Dec-19,7185,6838,347,4.8
30461,CN2901700000000,29,17,"Bollinger County, MO",Dec-19,5531,5317,214,3.9
30462,CN2901900000000,29,19,"Boone County, MO",Dec-19,99481,97069,2412,2.4
30463,CN2902100000000,29,21,"Buchanan County, MO",Dec-19,44825,43455,1370,3.1
30464,CN2902300000000,29,23,"Butler County, MO",Dec-19,18276,17416,860,4.7
30465,CN2902500000000,29,25,"Caldwell County, MO",Dec-19,4368,4228,140,3.2
30466,CN2902700000000,29,27,"Callaway County, MO",Dec-19,21220,20573,647,3.0
30467,CN2902900000000,29,29,"Camden County, MO",Dec-19,18301,17164,1137,6.2
30468,CN2903100000000,29,31,"Cape Girardeau County, MO",Dec-19,41392,40164,1228,3.0
30469,CN2903300000000,29,33,"Carroll County, MO",Dec-19,4714,4543,171,3.6
30470,CN2903500000000,29,35,"Carter County, MO",Dec-19,2554,2432,122,4.8
30471,CN2903700000000,29,37,"Cass County, MO",Dec-19,55207,53529,1678,3.0
30472,CN2903900000000,29,39,"Cedar County, MO",Dec-19,5750,5547,203,3.5
30473,CN2904100000000,29,41,"Chariton County, MO",Dec-19,3797,3667,130,3.4
30474,CN2904300000000,29,43,"Christian County, MO",Dec-19,45463,44188,1275,2.8
30475,CN2904500000000,29,45,"Clark County, MO",Dec-19,3197,3075,122,3.8
30476,CN2904700000000,29,47,"Clay County, MO",Dec-19,137324,133415,3909,2.8
30477,CN2904900000000,29,49,"Clinton County, MO",Dec-19,10755,10427,328,3.0
30478,CN2905100000000,29,51,"Cole County, MO",Dec-19,38822,37767,1055,2.7
30479,CN2905300000000,29,53,"Cooper County, MO",Dec-19,7526,7273,253,3.4
30480,CN2905500000000,29,55,"Crawford County, MO",Dec-19,10985,10510,475,4.3
30481,CN2905700000000,29,57,"Dade County, MO",Dec-19,3533,3415,118,3.3
30482,CN2905900000000,29,59,"Dallas County, MO",Dec-19,7189,6780,409,5.7
30483,CN2906100000000,29,61,"Daviess County, MO",Dec-19,4071,3937,134,3.3
30484,CN2906300000000,29,63,"DeKalb County, MO",Dec-19,4815,4670,145,3.0
30485,CN2906500000000,29,65,"Dent County, MO",Dec-19,6304,6047,257,4.1
30486,CN2906700000000,29,67,"Douglas County, MO",Dec-19,5153,4843,310,6.0
30487,CN2906900000000,29,69,"Dunklin County, MO",Dec-19,11424,10780,644,5.6
30488,CN2907100000000,29,71,"Franklin County, MO",Dec-19,53487,51644,1843,3.4
30489,CN2907300000000,29,73,"Gasconade County, MO",Dec-19,7695,7423,272,3.5
30490,CN2907500000000,29,75,"Gentry County, MO",Dec-19,3464,3365,99,2.9
30491,CN2907700000000,29,77,"Greene County, MO",Dec-19,153178,148575,4603,3.0
30492,CN2907900000000,29,79,"Grundy County, MO",Dec-19,4407,4244,163,3.7
30493,CN2908100000000,29,81,"Harrison County, MO",Dec-19,3777,3649,128,3.4
30494,CN2908300000000,29,83,"Henry County, MO",Dec-19,9722,9377,345,3.5
30495,CN2908500000000,29,85,"Hickory County, MO",Dec-19,3802,3626,176,4.6
30496,CN2908700000000,29,87,"Holt County, MO",Dec-19,2534,2470,64,2.5
30497,CN2908900000000,29,89,"Howard County, MO",Dec-19,4917,4773,144,2.9
30498,CN2909100000000,29,91,"Howell County, MO",Dec-19,16898,16078,820,4.9
30499,CN2909300000000,29,93,"Iron County, MO",Dec-19,3532,3349,183,5.2
30500,CN2909500000000,29,95,"Jackson County, MO",Dec-19,365774,352321,13453,3.7
30501,CN2909700000000,29,97,"Jasper County, MO",Dec-19,58049,56206,1843,3.2
30502,CN2909900000000,29,99,"Jefferson County, MO",Dec-19,118932,115032,3900,3.3
30503,CN2910100000000,29,101,"Johnson County, MO",Dec-19,23201,22369,832,3.6
30504,CN2910300000000,29,103,"Knox County, MO",Dec-19,1777,1724,53,3.0
30505,CN2910500000000,29,105,"Laclede County, MO",Dec-19,17760,15981,1779,10.0
30506,CN2910700000000,29,107,"Lafayette County, MO",Dec-19,16849,16331,518,3.1
30507,CN2910900000000,29,109,"Lawrence County, MO",Dec-19,18027,17358,669,3.7
30508,CN2911100000000,29,111,"Lewis County, MO",Dec-19,5004,4841,163,3.3
30509,CN2911300000000,29,113,"Lincoln County, MO",Dec-19,28476,27532,944,3.3
30510,CN2911500000000,29,115,"Linn County, MO",Dec-19,5150,4893,257,5.0
30511,CN2911700000000,29,117,"Livingston County, MO",Dec-19,7328,7128,200,2.7
30512,CN2911900000000,29,119,"McDonald County, MO",Dec-19,10864,10485,379,3.5
30513,CN2912100000000,29,121,"Macon County, MO",Dec-19,7594,7330,264,3.5
30514,CN2912300000000,29,123,"Madison County, MO",Dec-19,5509,5301,208,3.8
30515,CN2912500000000,29,125,"Maries County, MO",Dec-19,3902,3763,139,3.6
30516,CN2912700000000,29,127,"Marion County, MO",Dec-19,14724,14258,466,3.2
30517,CN2912900000000,29,129,"Mercer County, MO",Dec-19,1852,1794,58,3.1
30518,CN2913100000000,29,131,"Miller County, MO",Dec-19,12307,11770,537,4.4
30519,CN2913300000000,29,133,"Mississippi County, MO",Dec-19,5784,5534,250,4.3
30520,CN2913500000000,29,135,"Moniteau County, MO",Dec-19,7193,6984,209,2.9
30521,CN2913700000000,29,137,"Monroe County, MO",Dec-19,3906,3733,173,4.4
30522,CN2913900000000,29,139,"Montgomery County, MO",Dec-19,5730,5553,177,3.1
30523,CN2914100000000,29,141,"Morgan County, MO",Dec-19,8131,7737,394,4.8
30524,CN2914300000000,29,143,"New Madrid County, MO",Dec-19,8232,7853,379,4.6
30525,CN2914500000000,29,145,"Newton County, MO",Dec-19,27615,26731,884,3.2
30526,CN2914700000000,29,147,"Nodaway County, MO",Dec-19,10953,10661,292,2.7
30527,CN2914900000000,29,149,"Oregon County, MO",Dec-19,4043,3858,185,4.6
30528,CN2915100000000,29,151,"Osage County, MO",Dec-19,7027,6862,165,2.3
30529,CN2915300000000,29,153,"Ozark County, MO",Dec-19,3371,3118,253,7.5
30530,CN2915500000000,29,155,"Pemiscot County, MO",Dec-19,6354,5995,359,5.6
30531,CN2915700000000,29,157,"Perry County, MO",Dec-19,10061,9786,275,2.7
30532,CN2915900000000,29,159,"Pettis County, MO",Dec-19,21095,20388,707,3.4
30533,CN2916100000000,29,161,"Phelps County, MO",Dec-19,19934,19258,676,3.4
30534,CN2916300000000,29,163,"Pike County, MO",Dec-19,7504,7225,279,3.7
30535,CN2916500000000,29,165,"Platte County, MO",Dec-19,59109,57523,1586,2.7
30536,CN2916700000000,29,167,"Polk County, MO",Dec-19,14680,14202,478,3.3
30537,CN2916900000000,29,169,"Pulaski County, MO",Dec-19,14715,14022,693,4.7
30538,CN2917100000000,29,171,"Putnam County, MO",Dec-19,2225,2150,75,3.4
30539,CN2917300000000,29,173,"Ralls County, MO",Dec-19,5708,5529,179,3.1
30540,CN2917500000000,29,175,"Randolph County, MO",Dec-19,10528,10107,421,4.0
30541,CN2917700000000,29,177,"Ray County, MO",Dec-19,11062,10676,386,3.5
30542,CN2917900000000,29,179,"Reynolds County, MO",Dec-19,2996,2871,125,4.2
30543,CN2918100000000,29,181,"Ripley County, MO",Dec-19,5026,4777,249,5.0
30544,CN2918300000000,29,183,"St. Charles County, MO",Dec-19,227773,221693,6080,2.7
30545,CN2918500000000,29,185,"St. Clair County, MO",Dec-19,3748,3572,176,4.7
30546,CN2918600000000,29,186,"Ste. Genevieve County, MO",Dec-19,9171,8907,264,2.9
30547,CN2918700000000,29,187,"St. Francois County, MO",Dec-19,26896,25788,1108,4.1
30548,CN2918900000000,29,189,"St. Louis County, MO",Dec-19,535325,518621,16704,3.1
30549,CN2919500000000,29,195,"Saline County, MO",Dec-19,10566,10221,345,3.3
30550,CN2919700000000,29,197,"Schuyler County, MO",Dec-19,1932,1860,72,3.7
30551,CN2919900000000,29,199,"Scotland County, MO",Dec-19,2365,2310,55,2.3
30552,CN2920100000000,29,201,"Scott County, MO",Dec-19,20054,19310,744,3.7
30553,CN2920300000000,29,203,"Shannon County, MO",Dec-19,3209,3000,209,6.5
30554,CN2920500000000,29,205,"Shelby County, MO",Dec-19,3060,2962,98,3.2
30555,CN2920700000000,29,207,"Stoddard County, MO",Dec-19,13062,12434,628,4.8
30556,CN2920900000000,29,209,"Stone County, MO",Dec-19,13731,13082,649,4.7
30557,CN2921100000000,29,211,"Sullivan County, MO",Dec-19,2661,2563,98,3.7
30558,CN2921300000000,29,213,"Taney County, MO",Dec-19,26567,25463,1104,4.2
30559,CN2921500000000,29,215,"Texas County, MO",Dec-19,9102,8642,460,5.1
30560,CN2921700000000,29,217,"Vernon County, MO",Dec-19,9397,9066,331,3.5
30561,CN2921900000000,29,219,"Warren County, MO",Dec-19,18029,17478,551,3.1
30562,CN2922100000000,29,221,"Washington County, MO",Dec-19,10282,9781,501,4.9
30563,CN2922300000000,29,223,"Wayne County, MO",Dec-19,5276,5029,247,4.7
30564,CN2922500000000,29,225,"Webster County, MO",Dec-19,17497,16772,725,4.1
30565,CN2922700000000,29,227,"Worth County, MO",Dec-19,1160,1128,32,2.8
30566,CN2922900000000,29,229,"Wright County, MO",Dec-19,7693,7072,621,8.1
30567,CN2951000000000,29,510,"St. Louis city, MO",Dec-19,153635,147586,6049,3.9
30568,CN3000100000000,30,1,"Beaverhead County, MT",Dec-19,5009,4843,166,3.3
30569,CN3000300000000,30,3,"Big Horn County, MT",Dec-19,4740,4424,316,6.7
30570,CN3000500000000,30,5,"Blaine County, MT",Dec-19,2524,2421,103,4.1
30571,CN3000700000000,30,7,"Broadwater County, MT",Dec-19,2558,2451,107,4.2
30572,CN3000900000000,30,9,"Carbon County, MT",Dec-19,5482,5283,199,3.6
30573,CN3001100000000,30,11,"Carter County, MT",Dec-19,660,647,13,2.0
30574,CN3001300000000,30,13,"Cascade County, MT",Dec-19,37894,36616,1278,3.4
30575,CN3001500000000,30,15,"Chouteau County, MT",Dec-19,2509,2428,81,3.2
30576,CN3001700000000,30,17,"Custer County, MT",Dec-19,6093,5907,186,3.1
30577,CN3001900000000,30,19,"Daniels County, MT",Dec-19,906,883,23,2.5
30578,CN3002100000000,30,21,"Dawson County, MT",Dec-19,4603,4478,125,2.7
30579,CN3002300000000,30,23,"Deer Lodge County, MT",Dec-19,4904,4738,166,3.4
30580,CN3002500000000,30,25,"Fallon County, MT",Dec-19,1708,1669,39,2.3
30581,CN3002700000000,30,27,"Fergus County, MT",Dec-19,6038,5820,218,3.6
30582,CN3002900000000,30,29,"Flathead County, MT",Dec-19,47451,44991,2460,5.2
30583,CN3003100000000,30,31,"Gallatin County, MT",Dec-19,68746,67096,1650,2.4
30584,CN3003300000000,30,33,"Garfield County, MT",Dec-19,764,738,26,3.4
30585,CN3003500000000,30,35,"Glacier County, MT",Dec-19,5431,5028,403,7.4
30586,CN3003700000000,30,37,"Golden Valley County, MT",Dec-19,368,355,13,3.5
30587,CN3003900000000,30,39,"Granite County, MT",Dec-19,1647,1539,108,6.6
30588,CN3004100000000,30,41,"Hill County, MT",Dec-19,7598,7346,252,3.3
30589,CN3004300000000,30,43,"Jefferson County, MT",Dec-19,5655,5444,211,3.7
30590,CN3004500000000,30,45,"Judith Basin County, MT",Dec-19,1008,976,32,3.2
30591,CN3004700000000,30,47,"Lake County, MT",Dec-19,13112,12547,565,4.3
30592,CN3004900000000,30,49,"Lewis and Clark County, MT",Dec-19,35311,34244,1067,3.0
30593,CN3005100000000,30,51,"Liberty County, MT",Dec-19,975,952,23,2.4
30594,CN3005300000000,30,53,"Lincoln County, MT",Dec-19,8038,7334,704,8.8
30595,CN3005500000000,30,55,"McCone County, MT",Dec-19,974,953,21,2.2
30596,CN3005700000000,30,57,"Madison County, MT",Dec-19,5187,5014,173,3.3
30597,CN3005900000000,30,59,"Meagher County, MT",Dec-19,1002,967,35,3.5
30598,CN3006100000000,30,61,"Mineral County, MT",Dec-19,1683,1573,110,6.5
30599,CN3006300000000,30,63,"Missoula County, MT",Dec-19,63663,61408,2255,3.5
30600,CN3006500000000,30,65,"Musselshell County, MT",Dec-19,2280,2188,92,4.0
30601,CN3006700000000,30,67,"Park County, MT",Dec-19,8699,8345,354,4.1
30602,CN3006900000000,30,69,"Petroleum County, MT",Dec-19,289,276,13,4.5
30603,CN3007100000000,30,71,"Phillips County, MT",Dec-19,1928,1842,86,4.5
30604,CN3007300000000,30,73,"Pondera County, MT",Dec-19,2656,2570,86,3.2
30605,CN3007500000000,30,75,"Powder River County, MT",Dec-19,975,952,23,2.4
30606,CN3007700000000,30,77,"Powell County, MT",Dec-19,3008,2907,101,3.4
30607,CN3007900000000,30,79,"Prairie County, MT",Dec-19,481,464,17,3.5
30608,CN3008100000000,30,81,"Ravalli County, MT",Dec-19,20172,19327,845,4.2
30609,CN3008300000000,30,83,"Richland County, MT",Dec-19,5917,5774,143,2.4
30610,CN3008500000000,30,85,"Roosevelt County, MT",Dec-19,4474,4293,181,4.0
30611,CN3008700000000,30,87,"Rosebud County, MT",Dec-19,3779,3621,158,4.2
30612,CN3008900000000,30,89,"Sanders County, MT",Dec-19,4771,4476,295,6.2
30613,CN3009100000000,30,91,"Sheridan County, MT",Dec-19,1741,1699,42,2.4
30614,CN3009300000000,30,93,"Silver Bow County, MT",Dec-19,17016,16346,670,3.9
30615,CN3009500000000,30,95,"Stillwater County, MT",Dec-19,5310,5140,170,3.2
30616,CN3009700000000,30,97,"Sweet Grass County, MT",Dec-19,1816,1765,51,2.8
30617,CN3009900000000,30,99,"Teton County, MT",Dec-19,2759,2647,112,4.1
30618,CN3010100000000,30,101,"Toole County, MT",Dec-19,2102,2042,60,2.9
30619,CN3010300000000,30,103,"Treasure County, MT",Dec-19,339,331,8,2.4
30620,CN3010500000000,30,105,"Valley County, MT",Dec-19,4037,3901,136,3.4
30621,CN3010700000000,30,107,"Wheatland County, MT",Dec-19,810,775,35,4.3
30622,CN3010900000000,30,109,"Wibaux County, MT",Dec-19,464,451,13,2.8
30623,CN3011100000000,30,111,"Yellowstone County, MT",Dec-19,81095,78573,2522,3.1
30624,CN3100100000000,31,1,"Adams County, NE",Dec-19,16640,16132,508,3.1
30625,CN3100300000000,31,3,"Antelope County, NE",Dec-19,3572,3500,72,2.0
30626,CN3100500000000,31,5,"Arthur County, NE",Dec-19,232,219,13,5.6
30627,CN3100700000000,31,7,"Banner County, NE",Dec-19,392,379,13,3.3
30628,CN3100900000000,31,9,"Blaine County, NE",Dec-19,269,253,16,5.9
30629,CN3101100000000,31,11,"Boone County, NE",Dec-19,2981,2909,72,2.4
30630,CN3101300000000,31,13,"Box Butte County, NE",Dec-19,5362,5204,158,2.9
30631,CN3101500000000,31,15,"Boyd County, NE",Dec-19,1094,1059,35,3.2
30632,CN3101700000000,31,17,"Brown County, NE",Dec-19,1393,1353,40,2.9
30633,CN3101900000000,31,19,"Buffalo County, NE",Dec-19,27659,27090,569,2.1
30634,CN3102100000000,31,21,"Burt County, NE",Dec-19,3468,3348,120,3.5
30635,CN3102300000000,31,23,"Butler County, NE",Dec-19,4474,4370,104,2.3
30636,CN3102500000000,31,25,"Cass County, NE",Dec-19,13578,13185,393,2.9
30637,CN3102700000000,31,27,"Cedar County, NE",Dec-19,4532,4433,99,2.2
30638,CN3102900000000,31,29,"Chase County, NE",Dec-19,2292,2249,43,1.9
30639,CN3103100000000,31,31,"Cherry County, NE",Dec-19,3391,3324,67,2.0
30640,CN3103300000000,31,33,"Cheyenne County, NE",Dec-19,4314,4172,142,3.3
30641,CN3103500000000,31,35,"Clay County, NE",Dec-19,3293,3189,104,3.2
30642,CN3103700000000,31,37,"Colfax County, NE",Dec-19,5540,5409,131,2.4
30643,CN3103900000000,31,39,"Cuming County, NE",Dec-19,4655,4540,115,2.5
30644,CN3104100000000,31,41,"Custer County, NE",Dec-19,6402,6274,128,2.0
30645,CN3104300000000,31,43,"Dakota County, NE",Dec-19,10715,10293,422,3.9
30646,CN3104500000000,31,45,"Dawes County, NE",Dec-19,4906,4786,120,2.4
30647,CN3104700000000,31,47,"Dawson County, NE",Dec-19,12970,12636,334,2.6
30648,CN3104900000000,31,49,"Deuel County, NE",Dec-19,955,931,24,2.5
30649,CN3105100000000,31,51,"Dixon County, NE",Dec-19,3053,2959,94,3.1
30650,CN3105300000000,31,53,"Dodge County, NE",Dec-19,19476,18960,516,2.6
30651,CN3105500000000,31,55,"Douglas County, NE",Dec-19,299109,290524,8585,2.9
30652,CN3105700000000,31,57,"Dundy County, NE",Dec-19,1202,1170,32,2.7
30653,CN3105900000000,31,59,"Fillmore County, NE",Dec-19,3147,3078,69,2.2
30654,CN3106100000000,31,61,"Franklin County, NE",Dec-19,1452,1409,43,3.0
30655,CN3106300000000,31,63,"Frontier County, NE",Dec-19,1641,1590,51,3.1
30656,CN3106500000000,31,65,"Furnas County, NE",Dec-19,2544,2480,64,2.5
30657,CN3106700000000,31,67,"Gage County, NE",Dec-19,10877,10535,342,3.1
30658,CN3106900000000,31,69,"Garden County, NE",Dec-19,1086,1049,37,3.4
30659,CN3107100000000,31,71,"Garfield County, NE",Dec-19,1176,1152,24,2.0
30660,CN3107300000000,31,73,"Gosper County, NE",Dec-19,1094,1070,24,2.2
30661,CN3107500000000,31,75,"Grant County, NE",Dec-19,438,427,11,2.5
30662,CN3107700000000,31,77,"Greeley County, NE",Dec-19,1230,1203,27,2.2
30663,CN3107900000000,31,79,"Hall County, NE",Dec-19,31446,30473,973,3.1
30664,CN3108100000000,31,81,"Hamilton County, NE",Dec-19,4748,4620,128,2.7
30665,CN3108300000000,31,83,"Harlan County, NE",Dec-19,1763,1710,53,3.0
30666,CN3108500000000,31,85,"Hayes County, NE",Dec-19,637,621,16,2.5
30667,CN3108700000000,31,87,"Hitchcock County, NE",Dec-19,1258,1221,37,2.9
30668,CN3108900000000,31,89,"Holt County, NE",Dec-19,5809,5681,128,2.2
30669,CN3109100000000,31,91,"Hooker County, NE",Dec-19,382,369,13,3.4
30670,CN3109300000000,31,93,"Howard County, NE",Dec-19,3325,3239,86,2.6
30671,CN3109500000000,31,95,"Jefferson County, NE",Dec-19,4143,4047,96,2.3
30672,CN3109700000000,31,97,"Johnson County, NE",Dec-19,2050,1986,64,3.1
30673,CN3109900000000,31,99,"Kearney County, NE",Dec-19,3787,3720,67,1.8
30674,CN3110100000000,31,101,"Keith County, NE",Dec-19,4503,4356,147,3.3
30675,CN3110300000000,31,103,"Keya Paha County, NE",Dec-19,614,601,13,2.1
30676,CN3110500000000,31,105,"Kimball County, NE",Dec-19,1991,1946,45,2.3
30677,CN3110700000000,31,107,"Knox County, NE",Dec-19,4614,4494,120,2.6
30678,CN3110900000000,31,109,"Lancaster County, NE",Dec-19,177971,173808,4163,2.3
30679,CN3111100000000,31,111,"Lincoln County, NE",Dec-19,18113,17530,583,3.2
30680,CN3111300000000,31,113,"Logan County, NE",Dec-19,484,471,13,2.7
30681,CN3111500000000,31,115,"Loup County, NE",Dec-19,424,400,24,5.7
30682,CN3111700000000,31,117,"McPherson County, NE",Dec-19,450,439,11,2.4
30683,CN3111900000000,31,119,"Madison County, NE",Dec-19,19561,19093,468,2.4
30684,CN3112100000000,31,121,"Merrick County, NE",Dec-19,3986,3879,107,2.7
30685,CN3112300000000,31,123,"Morrill County, NE",Dec-19,2628,2548,80,3.0
30686,CN3112500000000,31,125,"Nance County, NE",Dec-19,2025,1921,104,5.1
30687,CN3112700000000,31,127,"Nemaha County, NE",Dec-19,3599,3492,107,3.0
30688,CN3112900000000,31,129,"Nuckolls County, NE",Dec-19,2411,2358,53,2.2
30689,CN3113100000000,31,131,"Otoe County, NE",Dec-19,8413,8191,222,2.6
30690,CN3113300000000,31,133,"Pawnee County, NE",Dec-19,1482,1453,29,2.0
30691,CN3113500000000,31,135,"Perkins County, NE",Dec-19,1837,1794,43,2.3
30692,CN3113700000000,31,137,"Phelps County, NE",Dec-19,4983,4871,112,2.2
30693,CN3113900000000,31,139,"Pierce County, NE",Dec-19,4055,3967,88,2.2
30694,CN3114100000000,31,141,"Platte County, NE",Dec-19,17582,17106,476,2.7
30695,CN3114300000000,31,143,"Polk County, NE",Dec-19,2972,2886,86,2.9
30696,CN3114500000000,31,145,"Red Willow County, NE",Dec-19,5822,5691,131,2.3
30697,CN3114700000000,31,147,"Richardson County, NE",Dec-19,4185,4075,110,2.6
30698,CN3114900000000,31,149,"Rock County, NE",Dec-19,903,876,27,3.0
30699,CN3115100000000,31,151,"Saline County, NE",Dec-19,7326,7120,206,2.8
30700,CN3115300000000,31,153,"Sarpy County, NE",Dec-19,96421,94011,2410,2.5
30701,CN3115500000000,31,155,"Saunders County, NE",Dec-19,11213,10943,270,2.4
30702,CN3115700000000,31,157,"Scotts Bluff County, NE",Dec-19,18095,17467,628,3.5
30703,CN3115900000000,31,159,"Seward County, NE",Dec-19,9027,8805,222,2.5
30704,CN3116100000000,31,161,"Sheridan County, NE",Dec-19,2679,2618,61,2.3
30705,CN3116300000000,31,163,"Sherman County, NE",Dec-19,1696,1645,51,3.0
30706,CN3116500000000,31,165,"Sioux County, NE",Dec-19,762,743,19,2.5
30707,CN3116700000000,31,167,"Stanton County, NE",Dec-19,3486,3414,72,2.1
30708,CN3116900000000,31,169,"Thayer County, NE",Dec-19,2768,2701,67,2.4
30709,CN3117100000000,31,171,"Thomas County, NE",Dec-19,435,416,19,4.4
30710,CN3117300000000,31,173,"Thurston County, NE",Dec-19,3092,2966,126,4.1
30711,CN3117500000000,31,175,"Valley County, NE",Dec-19,2112,2064,48,2.3
30712,CN3117700000000,31,177,"Washington County, NE",Dec-19,11276,11011,265,2.4
30713,CN3117900000000,31,179,"Wayne County, NE",Dec-19,5875,5760,115,2.0
30714,CN3118100000000,31,181,"Webster County, NE",Dec-19,1688,1635,53,3.1
30715,CN3118300000000,31,183,"Wheeler County, NE",Dec-19,578,565,13,2.2
30716,CN3118500000000,31,185,"York County, NE",Dec-19,7186,7034,152,2.1
30717,CN3200100000000,32,1,"Churchill County, NV",Dec-19,11074,10745,329,3.0
30718,CN3200300000000,32,3,"Clark County, NV",Dec-19,1136500,1096609,39891,3.5
30719,CN3200500000000,32,5,"Douglas County, NV",Dec-19,23093,22276,817,3.5
30720,CN3200700000000,32,7,"Elko County, NV",Dec-19,26639,25950,689,2.6
30721,CN3200900000000,32,9,"Esmeralda County, NV",Dec-19,447,428,19,4.3
30722,CN3201100000000,32,11,"Eureka County, NV",Dec-19,1070,1046,24,2.2
30723,CN3201300000000,32,13,"Humboldt County, NV",Dec-19,8147,7938,209,2.6
30724,CN3201500000000,32,15,"Lander County, NV",Dec-19,3184,3089,95,3.0
30725,CN3201700000000,32,17,"Lincoln County, NV",Dec-19,2113,2045,68,3.2
30726,CN3201900000000,32,19,"Lyon County, NV",Dec-19,23184,22229,955,4.1
30727,CN3202100000000,32,21,"Mineral County, NV",Dec-19,1994,1927,67,3.4
30728,CN3202300000000,32,23,"Nye County, NV",Dec-19,17509,16718,791,4.5
30729,CN3202700000000,32,27,"Pershing County, NV",Dec-19,2523,2428,95,3.8
30730,CN3202900000000,32,29,"Storey County, NV",Dec-19,2074,2002,72,3.5
30731,CN3203100000000,32,31,"Washoe County, NV",Dec-19,259618,252484,7134,2.7
30732,CN3203300000000,32,33,"White Pine County, NV",Dec-19,4635,4521,114,2.5
30733,CN3251000000000,32,510,"Carson City, NV",Dec-19,26336,25433,903,3.4
30734,CN3300100000000,33,1,"Belknap County, NH",Dec-19,30897,30183,714,2.3
30735,CN3300300000000,33,3,"Carroll County, NH",Dec-19,23349,22854,495,2.1
30736,CN3300500000000,33,5,"Cheshire County, NH",Dec-19,41281,40339,942,2.3
30737,CN3300700000000,33,7,"Coos County, NH",Dec-19,14674,14240,434,3.0
30738,CN3300900000000,33,9,"Grafton County, NH",Dec-19,50242,49280,962,1.9
30739,CN3301100000000,33,11,"Hillsborough County, NH",Dec-19,243268,237512,5756,2.4
30740,CN3301300000000,33,13,"Merrimack County, NH",Dec-19,84127,82490,1637,1.9
30741,CN3301500000000,33,15,"Rockingham County, NH",Dec-19,187512,182904,4608,2.5
30742,CN3301700000000,33,17,"Strafford County, NH",Dec-19,74679,73123,1556,2.1
30743,CN3301900000000,33,19,"Sullivan County, NH",Dec-19,23020,22551,469,2.0
30744,CN3400100000000,34,1,"Atlantic County, NJ",Dec-19,120456,113885,6571,5.5
30745,CN3400300000000,34,3,"Bergen County, NJ",Dec-19,490413,476456,13957,2.8
30746,CN3400500000000,34,5,"Burlington County, NJ",Dec-19,233300,225747,7553,3.2
30747,CN3400700000000,34,7,"Camden County, NJ",Dec-19,256556,245963,10593,4.1
30748,CN3400900000000,34,9,"Cape May County, NJ",Dec-19,43012,38504,4508,10.5
30749,CN3401100000000,34,11,"Cumberland County, NJ",Dec-19,65813,61832,3981,6.0
30750,CN3401300000000,34,13,"Essex County, NJ",Dec-19,372921,355956,16965,4.5
30751,CN3401500000000,34,15,"Gloucester County, NJ",Dec-19,151788,146057,5731,3.8
30752,CN3401700000000,34,17,"Hudson County, NJ",Dec-19,367680,355800,11880,3.2
30753,CN3401900000000,34,19,"Hunterdon County, NJ",Dec-19,64974,63215,1759,2.7
30754,CN3402100000000,34,21,"Mercer County, NJ",Dec-19,206536,200083,6453,3.1
30755,CN3402300000000,34,23,"Middlesex County, NJ",Dec-19,443823,430370,13453,3.0
30756,CN3402500000000,34,25,"Monmouth County, NJ",Dec-19,332234,321753,10481,3.2
30757,CN3402700000000,34,27,"Morris County, NJ",Dec-19,259168,251968,7200,2.8
30758,CN3402900000000,34,29,"Ocean County, NJ",Dec-19,278635,267909,10726,3.8
30759,CN3403100000000,34,31,"Passaic County, NJ",Dec-19,246678,235960,10718,4.3
30760,CN3403300000000,34,33,"Salem County, NJ",Dec-19,29328,27777,1551,5.3
30761,CN3403500000000,34,35,"Somerset County, NJ",Dec-19,173038,167867,5171,3.0
30762,CN3403700000000,34,37,"Sussex County, NJ",Dec-19,74731,72041,2690,3.6
30763,CN3403900000000,34,39,"Union County, NJ",Dec-19,279272,268924,10348,3.7
30764,CN3404100000000,34,41,"Warren County, NJ",Dec-19,56777,54819,1958,3.4
30765,CN3500100000000,35,1,"Bernalillo County, NM",Dec-19,338145,324560,13585,4.0
30766,CN3500300000000,35,3,"Catron County, NM",Dec-19,1135,1055,80,7.0
30767,CN3500500000000,35,5,"Chaves County, NM",Dec-19,27334,26056,1278,4.7
30768,CN3500600000000,35,6,"Cibola County, NM",Dec-19,9061,8531,530,5.8
30769,CN3500700000000,35,7,"Colfax County, NM",Dec-19,5271,5040,231,4.4
30770,CN3500900000000,35,9,"Curry County, NM",Dec-19,21898,21085,813,3.7
30771,CN3501100000000,35,11,"De Baca County, NM",Dec-19,800,769,31,3.9
30772,CN3501300000000,35,13,"Dona Ana County, NM",Dec-19,99485,94243,5242,5.3
30773,CN3501500000000,35,15,"Eddy County, NM",Dec-19,36007,34991,1016,2.8
30774,CN3501700000000,35,17,"Grant County, NM",Dec-19,12521,11959,562,4.5
30775,CN3501900000000,35,19,"Guadalupe County, NM",Dec-19,1528,1463,65,4.3
30776,CN3502100000000,35,21,"Harding County, NM",Dec-19,274,262,12,4.4
30777,CN3502300000000,35,23,"Hidalgo County, NM",Dec-19,2013,1925,88,4.4
30778,CN3502500000000,35,25,"Lea County, NM",Dec-19,32466,31266,1200,3.7
30779,CN3502700000000,35,27,"Lincoln County, NM",Dec-19,8912,8513,399,4.5
30780,CN3502800000000,35,28,"Los Alamos County, NM",Dec-19,9499,9225,274,2.9
30781,CN3502900000000,35,29,"Luna County, NM",Dec-19,9827,8367,1460,14.9
30782,CN3503100000000,35,31,"McKinley County, NM",Dec-19,24420,22866,1554,6.4
30783,CN3503300000000,35,33,"Mora County, NM",Dec-19,2241,2098,143,6.4
30784,CN3503500000000,35,35,"Otero County, NM",Dec-19,25104,23966,1138,4.5
30785,CN3503700000000,35,37,"Quay County, NM",Dec-19,3239,3097,142,4.4
30786,CN3503900000000,35,39,"Rio Arriba County, NM",Dec-19,16820,15976,844,5.0
30787,CN3504100000000,35,41,"Roosevelt County, NM",Dec-19,7805,7488,317,4.1
30788,CN3504300000000,35,43,"Sandoval County, NM",Dec-19,67247,64341,2906,4.3
30789,CN3504500000000,35,45,"San Juan County, NM",Dec-19,52185,49286,2899,5.6
30790,CN3504700000000,35,47,"San Miguel County, NM",Dec-19,10712,10128,584,5.5
30791,CN3504900000000,35,49,"Santa Fe County, NM",Dec-19,76226,73546,2680,3.5
30792,CN3505100000000,35,51,"Sierra County, NM",Dec-19,3901,3673,228,5.8
30793,CN3505300000000,35,53,"Socorro County, NM",Dec-19,6433,6103,330,5.1
30794,CN3505500000000,35,55,"Taos County, NM",Dec-19,15723,14861,862,5.5
30795,CN3505700000000,35,57,"Torrance County, NM",Dec-19,5851,5482,369,6.3
30796,CN3505900000000,35,59,"Union County, NM",Dec-19,1792,1719,73,4.1
30797,CN3506100000000,35,61,"Valencia County, NM",Dec-19,30987,29501,1486,4.8
30798,CN3600100000000,36,1,"Albany County, NY",Dec-19,157856,152160,5696,3.6
30799,CN3600300000000,36,3,"Allegany County, NY",Dec-19,19909,18732,1177,5.9
30800,CN3600500000000,36,5,"Bronx County, NY",Dec-19,590723,565019,25704,4.4
30801,CN3600700000000,36,7,"Broome County, NY",Dec-19,83186,79005,4181,5.0
30802,CN3600900000000,36,9,"Cattaraugus County, NY",Dec-19,34622,32608,2014,5.8
30803,CN3601100000000,36,11,"Cayuga County, NY",Dec-19,35830,34154,1676,4.7
30804,CN3601300000000,36,13,"Chautauqua County, NY",Dec-19,54196,51284,2912,5.4
30805,CN3601500000000,36,15,"Chemung County, NY",Dec-19,35098,33527,1571,4.5
30806,CN3601700000000,36,17,"Chenango County, NY",Dec-19,22004,20909,1095,5.0
30807,CN3601900000000,36,19,"Clinton County, NY",Dec-19,36453,34753,1700,4.7
30808,CN3602100000000,36,21,"Columbia County, NY",Dec-19,31006,29979,1027,3.3
30809,CN3602300000000,36,23,"Cortland County, NY",Dec-19,22918,21673,1245,5.4
30810,CN3602500000000,36,25,"Delaware County, NY",Dec-19,18944,18021,923,4.9
30811,CN3602700000000,36,27,"Dutchess County, NY",Dec-19,143918,138687,5231,3.6
30812,CN3602900000000,36,29,"Erie County, NY",Dec-19,440751,420669,20082,4.6
30813,CN3603100000000,36,31,"Essex County, NY",Dec-19,17048,16093,955,5.6
30814,CN3603300000000,36,33,"Franklin County, NY",Dec-19,19630,18563,1067,5.4
30815,CN3603500000000,36,35,"Fulton County, NY",Dec-19,22711,21472,1239,5.5
30816,CN3603700000000,36,37,"Genesee County, NY",Dec-19,29682,28375,1307,4.4
30817,CN3603900000000,36,39,"Greene County, NY",Dec-19,20516,19504,1012,4.9
30818,CN3604100000000,36,41,"Hamilton County, NY",Dec-19,2114,1912,202,9.6
30819,CN3604300000000,36,43,"Herkimer County, NY",Dec-19,27843,26334,1509,5.4
30820,CN3604500000000,36,45,"Jefferson County, NY",Dec-19,43754,40739,3015,6.9
30821,CN3604700000000,36,47,"Kings County, NY",Dec-19,1186163,1148138,38025,3.2
30822,CN3604900000000,36,49,"Lewis County, NY",Dec-19,11894,11098,796,6.7
30823,CN3605100000000,36,51,"Livingston County, NY",Dec-19,30734,29355,1379,4.5
30824,CN3605300000000,36,53,"Madison County, NY",Dec-19,32948,31315,1633,5.0
30825,CN3605500000000,36,55,"Monroe County, NY",Dec-19,359998,344339,15659,4.3
30826,CN3605700000000,36,57,"Montgomery County, NY",Dec-19,22489,21251,1238,5.5
30827,CN3605900000000,36,59,"Nassau County, NY",Dec-19,707352,683043,24309,3.4
30828,CN3606100000000,36,61,"New York County, NY",Dec-19,903737,878653,25084,2.8
30829,CN3606300000000,36,63,"Niagara County, NY",Dec-19,99089,93529,5560,5.6
30830,CN3606500000000,36,65,"Oneida County, NY",Dec-19,100429,95885,4544,4.5
30831,CN3606700000000,36,67,"Onondaga County, NY",Dec-19,220473,211506,8967,4.1
30832,CN3606900000000,36,69,"Ontario County, NY",Dec-19,55321,53005,2316,4.2
30833,CN3607100000000,36,71,"Orange County, NY",Dec-19,183775,176624,7151,3.9
30834,CN3607300000000,36,73,"Orleans County, NY",Dec-19,17673,16719,954,5.4
30835,CN3607500000000,36,75,"Oswego County, NY",Dec-19,53216,50027,3189,6.0
30836,CN3607700000000,36,77,"Otsego County, NY",Dec-19,27724,26421,1303,4.7
30837,CN3607900000000,36,79,"Putnam County, NY",Dec-19,51213,49255,1958,3.8
30838,CN3608100000000,36,81,"Queens County, NY",Dec-19,1129372,1098757,30615,2.7
30839,CN3608300000000,36,83,"Rensselaer County, NY",Dec-19,81341,78286,3055,3.8
30840,CN3608500000000,36,85,"Richmond County, NY",Dec-19,220013,213450,6563,3.0
30841,CN3608700000000,36,87,"Rockland County, NY",Dec-19,153959,148534,5425,3.5
30842,CN3608900000000,36,89,"St. Lawrence County, NY",Dec-19,43921,41402,2519,5.7
30843,CN3609100000000,36,91,"Saratoga County, NY",Dec-19,119495,115305,4190,3.5
30844,CN3609300000000,36,93,"Schenectady County, NY",Dec-19,76287,73332,2955,3.9
30845,CN3609500000000,36,95,"Schoharie County, NY",Dec-19,14758,14037,721,4.9
30846,CN3609700000000,36,97,"Schuyler County, NY",Dec-19,7916,7475,441,5.6
30847,CN3609900000000,36,99,"Seneca County, NY",Dec-19,16077,15361,716,4.5
30848,CN3610100000000,36,101,"Steuben County, NY",Dec-19,42461,40317,2144,5.0
30849,CN3610300000000,36,103,"Suffolk County, NY",Dec-19,778232,748689,29543,3.8
30850,CN3610500000000,36,105,"Sullivan County, NY",Dec-19,36200,34598,1602,4.4
30851,CN3610700000000,36,107,"Tioga County, NY",Dec-19,22633,21627,1006,4.4
30852,CN3610900000000,36,109,"Tompkins County, NY",Dec-19,49738,48073,1665,3.3
30853,CN3611100000000,36,111,"Ulster County, NY",Dec-19,87580,84291,3289,3.8
30854,CN3611300000000,36,113,"Warren County, NY",Dec-19,30913,29161,1752,5.7
30855,CN3611500000000,36,115,"Washington County, NY",Dec-19,27402,26168,1234,4.5
30856,CN3611700000000,36,117,"Wayne County, NY",Dec-19,44049,41961,2088,4.7
30857,CN3611900000000,36,119,"Westchester County, NY",Dec-19,480882,462585,18297,3.8
30858,CN3612100000000,36,121,"Wyoming County, NY",Dec-19,18141,17172,969,5.3
30859,CN3612300000000,36,123,"Yates County, NY",Dec-19,11973,11437,536,4.5
30860,CN3700100000000,37,1,"Alamance County, NC",Dec-19,82658,80033,2625,3.2
30861,CN3700300000000,37,3,"Alexander County, NC",Dec-19,18128,17626,502,2.8
30862,CN3700500000000,37,5,"Alleghany County, NC",Dec-19,4396,4199,197,4.5
30863,CN3700700000000,37,7,"Anson County, NC",Dec-19,10925,10507,418,3.8
30864,CN3700900000000,37,9,"Ashe County, NC",Dec-19,13021,12628,393,3.0
30865,CN3701100000000,37,11,"Avery County, NC",Dec-19,7169,6928,241,3.4
30866,CN3701300000000,37,13,"Beaufort County, NC",Dec-19,19549,18792,757,3.9
30867,CN3701500000000,37,15,"Bertie County, NC",Dec-19,7877,7557,320,4.1
30868,CN3701700000000,37,17,"Bladen County, NC",Dec-19,14782,14167,615,4.2
30869,CN3701900000000,37,19,"Brunswick County, NC",Dec-19,53137,50617,2520,4.7
30870,CN3702100000000,37,21,"Buncombe County, NC",Dec-19,141638,138003,3635,2.6
30871,CN3702300000000,37,23,"Burke County, NC",Dec-19,41243,39906,1337,3.2
30872,CN3702500000000,37,25,"Cabarrus County, NC",Dec-19,110223,106840,3383,3.1
30873,CN3702700000000,37,27,"Caldwell County, NC",Dec-19,36706,35461,1245,3.4
30874,CN3702900000000,37,29,"Camden County, NC",Dec-19,4671,4511,160,3.4
30875,CN3703100000000,37,31,"Carteret County, NC",Dec-19,31674,30577,1097,3.5
30876,CN3703300000000,37,33,"Caswell County, NC",Dec-19,9993,9609,384,3.8
30877,CN3703500000000,37,35,"Catawba County, NC",Dec-19,79223,76760,2463,3.1
30878,CN3703700000000,37,37,"Chatham County, NC",Dec-19,35988,34946,1042,2.9
30879,CN3703900000000,37,39,"Cherokee County, NC",Dec-19,11057,10633,424,3.8
30880,CN3704100000000,37,41,"Chowan County, NC",Dec-19,5613,5401,212,3.8
30881,CN3704300000000,37,43,"Clay County, NC",Dec-19,4133,3968,165,4.0
30882,CN3704500000000,37,45,"Cleveland County, NC",Dec-19,48725,46946,1779,3.7
30883,CN3704700000000,37,47,"Columbus County, NC",Dec-19,23137,22121,1016,4.4
30884,CN3704900000000,37,49,"Craven County, NC",Dec-19,41904,40472,1432,3.4
30885,CN3705100000000,37,51,"Cumberland County, NC",Dec-19,128172,122502,5670,4.4
30886,CN3705300000000,37,53,"Currituck County, NC",Dec-19,14067,13620,447,3.2
30887,CN3705500000000,37,55,"Dare County, NC",Dec-19,17629,16823,806,4.6
30888,CN3705700000000,37,57,"Davidson County, NC",Dec-19,81266,78610,2656,3.3
30889,CN3705900000000,37,59,"Davie County, NC",Dec-19,20761,20143,618,3.0
30890,CN3706100000000,37,61,"Duplin County, NC",Dec-19,25974,25068,906,3.5
30891,CN3706300000000,37,63,"Durham County, NC",Dec-19,171635,166705,4930,2.9
30892,CN3706500000000,37,65,"Edgecombe County, NC",Dec-19,21462,20434,1028,4.8
30893,CN3706700000000,37,67,"Forsyth County, NC",Dec-19,188207,182184,6023,3.2
30894,CN3706900000000,37,69,"Franklin County, NC",Dec-19,31494,30435,1059,3.4
30895,CN3707100000000,37,71,"Gaston County, NC",Dec-19,112328,108414,3914,3.5
30896,CN3707300000000,37,73,"Gates County, NC",Dec-19,5351,5163,188,3.5
30897,CN3707500000000,37,75,"Graham County, NC",Dec-19,3119,2952,167,5.4
30898,CN3707700000000,37,77,"Granville County, NC",Dec-19,29981,29118,863,2.9
30899,CN3707900000000,37,79,"Greene County, NC",Dec-19,9673,9378,295,3.0
30900,CN3708100000000,37,81,"Guilford County, NC",Dec-19,264438,255358,9080,3.4
30901,CN3708300000000,37,83,"Halifax County, NC",Dec-19,20406,19341,1065,5.2
30902,CN3708500000000,37,85,"Harnett County, NC",Dec-19,53579,51546,2033,3.8
30903,CN3708700000000,37,87,"Haywood County, NC",Dec-19,30201,29314,887,2.9
30904,CN3708900000000,37,89,"Henderson County, NC",Dec-19,55618,54041,1577,2.8
30905,CN3709100000000,37,91,"Hertford County, NC",Dec-19,9195,8811,384,4.2
30906,CN3709300000000,37,93,"Hoke County, NC",Dec-19,20265,19381,884,4.4
30907,CN3709500000000,37,95,"Hyde County, NC",Dec-19,1844,1655,189,10.2
30908,CN3709700000000,37,97,"Iredell County, NC",Dec-19,90564,87683,2881,3.2
30909,CN3709900000000,37,99,"Jackson County, NC",Dec-19,19755,19098,657,3.3
30910,CN3710100000000,37,101,"Johnston County, NC",Dec-19,100002,96886,3116,3.1
30911,CN3710300000000,37,103,"Jones County, NC",Dec-19,4466,4319,147,3.3
30912,CN3710500000000,37,105,"Lee County, NC",Dec-19,26118,25136,982,3.8
30913,CN3710700000000,37,107,"Lenoir County, NC",Dec-19,28070,27141,929,3.3
30914,CN3710900000000,37,109,"Lincoln County, NC",Dec-19,44048,42680,1368,3.1
30915,CN3711100000000,37,111,"McDowell County, NC",Dec-19,20452,19741,711,3.5
30916,CN3711300000000,37,113,"Macon County, NC",Dec-19,15463,14956,507,3.3
30917,CN3711500000000,37,115,"Madison County, NC",Dec-19,10245,9937,308,3.0
30918,CN3711700000000,37,117,"Martin County, NC",Dec-19,9131,8743,388,4.2
30919,CN3711900000000,37,119,"Mecklenburg County, NC",Dec-19,627840,608435,19405,3.1
30920,CN3712100000000,37,121,"Mitchell County, NC",Dec-19,5990,5750,240,4.0
30921,CN3712300000000,37,123,"Montgomery County, NC",Dec-19,11489,11088,401,3.5
30922,CN3712500000000,37,125,"Moore County, NC",Dec-19,42403,41022,1381,3.3
30923,CN3712700000000,37,127,"Nash County, NC",Dec-19,43739,41996,1743,4.0
30924,CN3712900000000,37,129,"New Hanover County, NC",Dec-19,125535,121794,3741,3.0
30925,CN3713100000000,37,131,"Northampton County, NC",Dec-19,7788,7419,369,4.7
30926,CN3713300000000,37,133,"Onslow County, NC",Dec-19,65958,63370,2588,3.9
30927,CN3713500000000,37,135,"Orange County, NC",Dec-19,79138,77019,2119,2.7
30928,CN3713700000000,37,137,"Pamlico County, NC",Dec-19,5376,5208,168,3.1
30929,CN3713900000000,37,139,"Pasquotank County, NC",Dec-19,16736,16071,665,4.0
30930,CN3714100000000,37,141,"Pender County, NC",Dec-19,29345,28353,992,3.4
30931,CN3714300000000,37,143,"Perquimans County, NC",Dec-19,5019,4799,220,4.4
30932,CN3714500000000,37,145,"Person County, NC",Dec-19,18509,17852,657,3.5
30933,CN3714700000000,37,147,"Pitt County, NC",Dec-19,90462,87238,3224,3.6
30934,CN3714900000000,37,149,"Polk County, NC",Dec-19,8999,8706,293,3.3
30935,CN3715100000000,37,151,"Randolph County, NC",Dec-19,66941,64788,2153,3.2
30936,CN3715300000000,37,153,"Richmond County, NC",Dec-19,16716,15925,791,4.7
30937,CN3715500000000,37,155,"Robeson County, NC",Dec-19,50730,48370,2360,4.7
30938,CN3715700000000,37,157,"Rockingham County, NC",Dec-19,40541,38990,1551,3.8
30939,CN3715900000000,37,159,"Rowan County, NC",Dec-19,67192,64656,2536,3.8
30940,CN3716100000000,37,161,"Rutherford County, NC",Dec-19,25326,24211,1115,4.4
30941,CN3716300000000,37,163,"Sampson County, NC",Dec-19,30058,29085,973,3.2
30942,CN3716500000000,37,165,"Scotland County, NC",Dec-19,11607,10940,667,5.7
30943,CN3716700000000,37,167,"Stanly County, NC",Dec-19,30469,29456,1013,3.3
30944,CN3716900000000,37,169,"Stokes County, NC",Dec-19,21837,21141,696,3.2
30945,CN3717100000000,37,171,"Surry County, NC",Dec-19,34066,32961,1105,3.2
30946,CN3717300000000,37,173,"Swain County, NC",Dec-19,6742,6515,227,3.4
30947,CN3717500000000,37,175,"Transylvania County, NC",Dec-19,14473,14002,471,3.3
30948,CN3717700000000,37,177,"Tyrrell County, NC",Dec-19,1342,1266,76,5.7
30949,CN3717900000000,37,179,"Union County, NC",Dec-19,125276,121665,3611,2.9
30950,CN3718100000000,37,181,"Vance County, NC",Dec-19,17314,16424,890,5.1
30951,CN3718300000000,37,183,"Wake County, NC",Dec-19,599569,582580,16989,2.8
30952,CN3718500000000,37,185,"Warren County, NC",Dec-19,6664,6319,345,5.2
30953,CN3718700000000,37,187,"Washington County, NC",Dec-19,4405,4170,235,5.3
30954,CN3718900000000,37,189,"Watauga County, NC",Dec-19,29799,28991,808,2.7
30955,CN3719100000000,37,191,"Wayne County, NC",Dec-19,52215,50391,1824,3.5
30956,CN3719300000000,37,193,"Wilkes County, NC",Dec-19,29347,28300,1047,3.6
30957,CN3719500000000,37,195,"Wilson County, NC",Dec-19,35038,33330,1708,4.9
30958,CN3719700000000,37,197,"Yadkin County, NC",Dec-19,17873,17326,547,3.1
30959,CN3719900000000,37,199,"Yancey County, NC",Dec-19,8407,8122,285,3.4
30960,CN3800100000000,38,1,"Adams County, ND",Dec-19,1044,1018,26,2.5
30961,CN3800300000000,38,3,"Barnes County, ND",Dec-19,5109,5001,108,2.1
30962,CN3800500000000,38,5,"Benson County, ND",Dec-19,2275,2189,86,3.8
30963,CN3800700000000,38,7,"Billings County, ND",Dec-19,352,342,10,2.8
30964,CN3800900000000,38,9,"Bottineau County, ND",Dec-19,2833,2750,83,2.9
30965,CN3801100000000,38,11,"Bowman County, ND",Dec-19,1698,1664,34,2.0
30966,CN3801300000000,38,13,"Burke County, ND",Dec-19,1038,1006,32,3.1
30967,CN3801500000000,38,15,"Burleigh County, ND",Dec-19,48663,47564,1099,2.3
30968,CN3801700000000,38,17,"Cass County, ND",Dec-19,101697,99842,1855,1.8
30969,CN3801900000000,38,19,"Cavalier County, ND",Dec-19,1856,1809,47,2.5
30970,CN3802100000000,38,21,"Dickey County, ND",Dec-19,2227,2187,40,1.8
30971,CN3802300000000,38,23,"Divide County, ND",Dec-19,1371,1348,23,1.7
30972,CN3802500000000,38,25,"Dunn County, ND",Dec-19,3113,3067,46,1.5
30973,CN3802700000000,38,27,"Eddy County, ND",Dec-19,1201,1161,40,3.3
30974,CN3802900000000,38,29,"Emmons County, ND",Dec-19,1417,1351,66,4.7
30975,CN3803100000000,38,31,"Foster County, ND",Dec-19,1457,1415,42,2.9
30976,CN3803300000000,38,33,"Golden Valley County, ND",Dec-19,792,782,10,1.3
30977,CN3803500000000,38,35,"Grand Forks County, ND",Dec-19,36967,36289,678,1.8
30978,CN3803700000000,38,37,"Grant County, ND",Dec-19,1160,1131,29,2.5
30979,CN3803900000000,38,39,"Griggs County, ND",Dec-19,981,957,24,2.4
30980,CN3804100000000,38,41,"Hettinger County, ND",Dec-19,1334,1304,30,2.2
30981,CN3804300000000,38,43,"Kidder County, ND",Dec-19,1213,1166,47,3.9
30982,CN3804500000000,38,45,"LaMoure County, ND",Dec-19,2000,1967,33,1.7
30983,CN3804700000000,38,47,"Logan County, ND",Dec-19,862,840,22,2.6
30984,CN3804900000000,38,49,"McHenry County, ND",Dec-19,2983,2887,96,3.2
30985,CN3805100000000,38,51,"McIntosh County, ND",Dec-19,1083,1051,32,3.0
30986,CN3805300000000,38,53,"McKenzie County, ND",Dec-19,10208,10026,182,1.8
30987,CN3805500000000,38,55,"McLean County, ND",Dec-19,4541,4392,149,3.3
30988,CN3805700000000,38,57,"Mercer County, ND",Dec-19,3348,3186,162,4.8
30989,CN3805900000000,38,59,"Morton County, ND",Dec-19,15989,15529,460,2.9
30990,CN3806100000000,38,61,"Mountrail County, ND",Dec-19,7331,7229,102,1.4
30991,CN3806300000000,38,63,"Nelson County, ND",Dec-19,1335,1296,39,2.9
30992,CN3806500000000,38,65,"Oliver County, ND",Dec-19,852,815,37,4.3
30993,CN3806700000000,38,67,"Pembina County, ND",Dec-19,3220,3115,105,3.3
30994,CN3806900000000,38,69,"Pierce County, ND",Dec-19,1653,1607,46,2.8
30995,CN3807100000000,38,71,"Ramsey County, ND",Dec-19,5383,5221,162,3.0
30996,CN3807300000000,38,73,"Ransom County, ND",Dec-19,2748,2705,43,1.6
30997,CN3807500000000,38,75,"Renville County, ND",Dec-19,1204,1171,33,2.7
30998,CN3807700000000,38,77,"Richland County, ND",Dec-19,8336,8185,151,1.8
30999,CN3807900000000,38,79,"Rolette County, ND",Dec-19,4507,4178,329,7.3
31000,CN3808100000000,38,81,"Sargent County, ND",Dec-19,2582,2548,34,1.3
31001,CN3808300000000,38,83,"Sheridan County, ND",Dec-19,688,639,49,7.1
31002,CN3808500000000,38,85,"Sioux County, ND",Dec-19,1204,1170,34,2.8
31003,CN3808700000000,38,87,"Slope County, ND",Dec-19,386,377,9,2.3
31004,CN3808900000000,38,89,"Stark County, ND",Dec-19,18030,17675,355,2.0
31005,CN3809100000000,38,91,"Steele County, ND",Dec-19,946,930,16,1.7
31006,CN3809300000000,38,93,"Stutsman County, ND",Dec-19,9998,9785,213,2.1
31007,CN3809500000000,38,95,"Towner County, ND",Dec-19,1043,1011,32,3.1
31008,CN3809700000000,38,97,"Traill County, ND",Dec-19,4302,4216,86,2.0
31009,CN3809900000000,38,99,"Walsh County, ND",Dec-19,4940,4791,149,3.0
31010,CN3810100000000,38,101,"Ward County, ND",Dec-19,30876,30169,707,2.3
31011,CN3810300000000,38,103,"Wells County, ND",Dec-19,1835,1769,66,3.6
31012,CN3810500000000,38,105,"Williams County, ND",Dec-19,24085,23622,463,1.9
31013,CN3900100000000,39,1,"Adams County, OH",Dec-19,10562,9864,698,6.6
31014,CN3900300000000,39,3,"Allen County, OH",Dec-19,47440,45624,1816,3.8
31015,CN3900500000000,39,5,"Ashland County, OH",Dec-19,26450,25382,1068,4.0
31016,CN3900700000000,39,7,"Ashtabula County, OH",Dec-19,43946,41800,2146,4.9
31017,CN3900900000000,39,9,"Athens County, OH",Dec-19,28085,26755,1330,4.7
31018,CN3901100000000,39,11,"Auglaize County, OH",Dec-19,24791,24089,702,2.8
31019,CN3901300000000,39,13,"Belmont County, OH",Dec-19,30307,28468,1839,6.1
31020,CN3901500000000,39,15,"Brown County, OH",Dec-19,19623,18695,928,4.7
31021,CN3901700000000,39,17,"Butler County, OH",Dec-19,195551,188951,6600,3.4
31022,CN3901900000000,39,19,"Carroll County, OH",Dec-19,12883,12226,657,5.1
31023,CN3902100000000,39,21,"Champaign County, OH",Dec-19,19936,19257,679,3.4
31024,CN3902300000000,39,23,"Clark County, OH",Dec-19,63022,60465,2557,4.1
31025,CN3902500000000,39,25,"Clermont County, OH",Dec-19,107032,103467,3565,3.3
31026,CN3902700000000,39,27,"Clinton County, OH",Dec-19,17794,17038,756,4.2
31027,CN3902900000000,39,29,"Columbiana County, OH",Dec-19,47044,44955,2089,4.4
31028,CN3903100000000,39,31,"Coshocton County, OH",Dec-19,14042,13114,928,6.6
31029,CN3903300000000,39,33,"Crawford County, OH",Dec-19,18101,17296,805,4.4
31030,CN3903500000000,39,35,"Cuyahoga County, OH",Dec-19,604664,582953,21711,3.6
31031,CN3903700000000,39,37,"Darke County, OH",Dec-19,25480,24595,885,3.5
31032,CN3903900000000,39,39,"Defiance County, OH",Dec-19,18013,17280,733,4.1
31033,CN3904100000000,39,41,"Delaware County, OH",Dec-19,111107,107946,3161,2.8
31034,CN3904300000000,39,43,"Erie County, OH",Dec-19,35320,33551,1769,5.0
31035,CN3904500000000,39,45,"Fairfield County, OH",Dec-19,78541,75831,2710,3.5
31036,CN3904700000000,39,47,"Fayette County, OH",Dec-19,13944,13470,474,3.4
31037,CN3904900000000,39,49,"Franklin County, OH",Dec-19,702350,680181,22169,3.2
31038,CN3905100000000,39,51,"Fulton County, OH",Dec-19,22328,21467,861,3.9
31039,CN3905300000000,39,53,"Gallia County, OH",Dec-19,12105,11434,671,5.5
31040,CN3905500000000,39,55,"Geauga County, OH",Dec-19,48487,47005,1482,3.1
31041,CN3905700000000,39,57,"Greene County, OH",Dec-19,83394,80577,2817,3.4
31042,CN3905900000000,39,59,"Guernsey County, OH",Dec-19,18342,17259,1083,5.9
31043,CN3906100000000,39,61,"Hamilton County, OH",Dec-19,416835,402950,13885,3.3
31044,CN3906300000000,39,63,"Hancock County, OH",Dec-19,41802,40574,1228,2.9
31045,CN3906500000000,39,65,"Hardin County, OH",Dec-19,13615,13074,541,4.0
31046,CN3906700000000,39,67,"Harrison County, OH",Dec-19,6671,6285,386,5.8
31047,CN3906900000000,39,69,"Henry County, OH",Dec-19,13112,12497,615,4.7
31048,CN3907100000000,39,71,"Highland County, OH",Dec-19,16921,16040,881,5.2
31049,CN3907300000000,39,73,"Hocking County, OH",Dec-19,13213,12607,606,4.6
31050,CN3907500000000,39,75,"Holmes County, OH",Dec-19,20531,19953,578,2.8
31051,CN3907700000000,39,77,"Huron County, OH",Dec-19,27338,25723,1615,5.9
31052,CN3907900000000,39,79,"Jackson County, OH",Dec-19,12577,11753,824,6.6
31053,CN3908100000000,39,81,"Jefferson County, OH",Dec-19,27534,26007,1527,5.5
31054,CN3908300000000,39,83,"Knox County, OH",Dec-19,31437,30296,1141,3.6
31055,CN3908500000000,39,85,"Lake County, OH",Dec-19,124833,120775,4058,3.3
31056,CN3908700000000,39,87,"Lawrence County, OH",Dec-19,23755,22632,1123,4.7
31057,CN3908900000000,39,89,"Licking County, OH",Dec-19,91070,87953,3117,3.4
31058,CN3909100000000,39,91,"Logan County, OH",Dec-19,22698,21882,816,3.6
31059,CN3909300000000,39,93,"Lorain County, OH",Dec-19,151769,146017,5752,3.8
31060,CN3909500000000,39,95,"Lucas County, OH",Dec-19,209140,200401,8739,4.2
31061,CN3909700000000,39,97,"Madison County, OH",Dec-19,20888,20239,649,3.1
31062,CN3909900000000,39,99,"Mahoning County, OH",Dec-19,101701,96408,5293,5.2
31063,CN3910100000000,39,101,"Marion County, OH",Dec-19,28101,27071,1030,3.7
31064,CN3910300000000,39,103,"Medina County, OH",Dec-19,96353,93492,2861,3.0
31065,CN3910500000000,39,105,"Meigs County, OH",Dec-19,8927,8324,603,6.8
31066,CN3910700000000,39,107,"Mercer County, OH",Dec-19,23049,22485,564,2.4
31067,CN3910900000000,39,109,"Miami County, OH",Dec-19,54277,52423,1854,3.4
31068,CN3911100000000,39,111,"Monroe County, OH",Dec-19,5300,4827,473,8.9
31069,CN3911300000000,39,113,"Montgomery County, OH",Dec-19,253002,243485,9517,3.8
31070,CN3911500000000,39,115,"Morgan County, OH",Dec-19,6619,6113,506,7.6
31071,CN3911700000000,39,117,"Morrow County, OH",Dec-19,16935,16262,673,4.0
31072,CN3911900000000,39,119,"Muskingum County, OH",Dec-19,39747,37817,1930,4.9
31073,CN3912100000000,39,121,"Noble County, OH",Dec-19,4616,4283,333,7.2
31074,CN3912300000000,39,123,"Ottawa County, OH",Dec-19,20057,18729,1328,6.6
31075,CN3912500000000,39,125,"Paulding County, OH",Dec-19,8493,8186,307,3.6
31076,CN3912700000000,39,127,"Perry County, OH",Dec-19,16044,15225,819,5.1
31077,CN3912900000000,39,129,"Pickaway County, OH",Dec-19,26607,25620,987,3.7
31078,CN3913100000000,39,131,"Pike County, OH",Dec-19,10671,10003,668,6.3
31079,CN3913300000000,39,133,"Portage County, OH",Dec-19,86945,83395,3550,4.1
31080,CN3913500000000,39,135,"Preble County, OH",Dec-19,21066,20323,743,3.5
31081,CN3913700000000,39,137,"Putnam County, OH",Dec-19,18603,18048,555,3.0
31082,CN3913900000000,39,139,"Richland County, OH",Dec-19,51966,49597,2369,4.6
31083,CN3914100000000,39,141,"Ross County, OH",Dec-19,35463,33957,1506,4.2
31084,CN3914300000000,39,143,"Sandusky County, OH",Dec-19,29980,28726,1254,4.2
31085,CN3914500000000,39,145,"Scioto County, OH",Dec-19,28795,27032,1763,6.1
31086,CN3914700000000,39,147,"Seneca County, OH",Dec-19,27028,25956,1072,4.0
31087,CN3914900000000,39,149,"Shelby County, OH",Dec-19,23812,23032,780,3.3
31088,CN3915100000000,39,151,"Stark County, OH",Dec-19,184552,176328,8224,4.5
31089,CN3915300000000,39,153,"Summit County, OH",Dec-19,270842,260084,10758,4.0
31090,CN3915500000000,39,155,"Trumbull County, OH",Dec-19,85589,80791,4798,5.6
31091,CN3915700000000,39,157,"Tuscarawas County, OH",Dec-19,44444,42494,1950,4.4
31092,CN3915900000000,39,159,"Union County, OH",Dec-19,29098,28239,859,3.0
31093,CN3916100000000,39,161,"Van Wert County, OH",Dec-19,14887,14403,484,3.3
31094,CN3916300000000,39,163,"Vinton County, OH",Dec-19,5533,5196,337,6.1
31095,CN3916500000000,39,165,"Warren County, OH",Dec-19,119443,115715,3728,3.1
31096,CN3916700000000,39,167,"Washington County, OH",Dec-19,27244,25788,1456,5.3
31097,CN3916900000000,39,169,"Wayne County, OH",Dec-19,62015,60104,1911,3.1
31098,CN3917100000000,39,171,"Williams County, OH",Dec-19,18871,18263,608,3.2
31099,CN3917300000000,39,173,"Wood County, OH",Dec-19,70841,68515,2326,3.3
31100,CN3917500000000,39,175,"Wyandot County, OH",Dec-19,12921,12542,379,2.9
31101,CN4000100000000,40,1,"Adair County, OK",Dec-19,7970,7641,329,4.1
31102,CN4000300000000,40,3,"Alfalfa County, OK",Dec-19,2776,2724,52,1.9
31103,CN4000500000000,40,5,"Atoka County, OK",Dec-19,4940,4717,223,4.5
31104,CN4000700000000,40,7,"Beaver County, OK",Dec-19,2861,2809,52,1.8
31105,CN4000900000000,40,9,"Beckham County, OK",Dec-19,9885,9459,426,4.3
31106,CN4001100000000,40,11,"Blaine County, OK",Dec-19,4636,4535,101,2.2
31107,CN4001300000000,40,13,"Bryan County, OK",Dec-19,21337,20727,610,2.9
31108,CN4001500000000,40,15,"Caddo County, OK",Dec-19,11664,11219,445,3.8
31109,CN4001700000000,40,17,"Canadian County, OK",Dec-19,74667,72510,2157,2.9
31110,CN4001900000000,40,19,"Carter County, OK",Dec-19,21423,20691,732,3.4
31111,CN4002100000000,40,21,"Cherokee County, OK",Dec-19,18332,17640,692,3.8
31112,CN4002300000000,40,23,"Choctaw County, OK",Dec-19,5360,5080,280,5.2
31113,CN4002500000000,40,25,"Cimarron County, OK",Dec-19,1284,1264,20,1.6
31114,CN4002700000000,40,27,"Cleveland County, OK",Dec-19,143281,139655,3626,2.5
31115,CN4002900000000,40,29,"Coal County, OK",Dec-19,2429,2317,112,4.6
31116,CN4003100000000,40,31,"Comanche County, OK",Dec-19,48291,46690,1601,3.3
31117,CN4003300000000,40,33,"Cotton County, OK",Dec-19,2708,2625,83,3.1
31118,CN4003500000000,40,35,"Craig County, OK",Dec-19,5830,5626,204,3.5
31119,CN4003700000000,40,37,"Creek County, OK",Dec-19,31582,30458,1124,3.6
31120,CN4003900000000,40,39,"Custer County, OK",Dec-19,15733,15298,435,2.8
31121,CN4004100000000,40,41,"Delaware County, OK",Dec-19,17751,17116,635,3.6
31122,CN4004300000000,40,43,"Dewey County, OK",Dec-19,2855,2791,64,2.2
31123,CN4004500000000,40,45,"Ellis County, OK",Dec-19,2096,2032,64,3.1
31124,CN4004700000000,40,47,"Garfield County, OK",Dec-19,26722,25898,824,3.1
31125,CN4004900000000,40,49,"Garvin County, OK",Dec-19,12459,12030,429,3.4
31126,CN4005100000000,40,51,"Grady County, OK",Dec-19,26591,25717,874,3.3
31127,CN4005300000000,40,53,"Grant County, OK",Dec-19,2570,2515,55,2.1
31128,CN4005500000000,40,55,"Greer County, OK",Dec-19,1791,1717,74,4.1
31129,CN4005700000000,40,57,"Harmon County, OK",Dec-19,1135,1105,30,2.6
31130,CN4005900000000,40,59,"Harper County, OK",Dec-19,1713,1665,48,2.8
31131,CN4006100000000,40,61,"Haskell County, OK",Dec-19,4164,3916,248,6.0
31132,CN4006300000000,40,63,"Hughes County, OK",Dec-19,5303,5035,268,5.1
31133,CN4006500000000,40,65,"Jackson County, OK",Dec-19,10654,10354,300,2.8
31134,CN4006700000000,40,67,"Jefferson County, OK",Dec-19,2485,2405,80,3.2
31135,CN4006900000000,40,69,"Johnston County, OK",Dec-19,3676,3496,180,4.9
31136,CN4007100000000,40,71,"Kay County, OK",Dec-19,18092,17371,721,4.0
31137,CN4007300000000,40,73,"Kingfisher County, OK",Dec-19,9032,8850,182,2.0
31138,CN4007500000000,40,75,"Kiowa County, OK",Dec-19,3396,3278,118,3.5
31139,CN4007700000000,40,77,"Latimer County, OK",Dec-19,3125,2896,229,7.3
31140,CN4007900000000,40,79,"Le Flore County, OK",Dec-19,18947,18058,889,4.7
31141,CN4008100000000,40,81,"Lincoln County, OK",Dec-19,15792,15242,550,3.5
31142,CN4008300000000,40,83,"Logan County, OK",Dec-19,22098,21524,574,2.6
31143,CN4008500000000,40,85,"Love County, OK",Dec-19,6112,5974,138,2.3
31144,CN4008700000000,40,87,"McClain County, OK",Dec-19,19651,19109,542,2.8
31145,CN4008900000000,40,89,"McCurtain County, OK",Dec-19,14456,13567,889,6.1
31146,CN4009100000000,40,91,"McIntosh County, OK",Dec-19,7092,6632,460,6.5
31147,CN4009300000000,40,93,"Major County, OK",Dec-19,3755,3681,74,2.0
31148,CN4009500000000,40,95,"Marshall County, OK",Dec-19,6812,6576,236,3.5
31149,CN4009700000000,40,97,"Mayes County, OK",Dec-19,19286,18730,556,2.9
31150,CN4009900000000,40,99,"Murray County, OK",Dec-19,6269,6071,198,3.2
31151,CN4010100000000,40,101,"Muskogee County, OK",Dec-19,29746,28661,1085,3.6
31152,CN4010300000000,40,103,"Noble County, OK",Dec-19,5589,5450,139,2.5
31153,CN4010500000000,40,105,"Nowata County, OK",Dec-19,4567,4428,139,3.0
31154,CN4010700000000,40,107,"Okfuskee County, OK",Dec-19,4548,4331,217,4.8
31155,CN4010900000000,40,109,"Oklahoma County, OK",Dec-19,385882,374779,11103,2.9
31156,CN4011100000000,40,111,"Okmulgee County, OK",Dec-19,15674,14926,748,4.8
31157,CN4011300000000,40,113,"Osage County, OK",Dec-19,20659,19914,745,3.6
31158,CN4011500000000,40,115,"Ottawa County, OK",Dec-19,13897,13474,423,3.0
31159,CN4011700000000,40,117,"Pawnee County, OK",Dec-19,7339,7053,286,3.9
31160,CN4011900000000,40,119,"Payne County, OK",Dec-19,37431,36484,947,2.5
31161,CN4012100000000,40,121,"Pittsburg County, OK",Dec-19,16991,16182,809,4.8
31162,CN4012300000000,40,123,"Pontotoc County, OK",Dec-19,19247,18714,533,2.8
31163,CN4012500000000,40,125,"Pottawatomie County, OK",Dec-19,32486,31368,1118,3.4
31164,CN4012700000000,40,127,"Pushmataha County, OK",Dec-19,4205,3984,221,5.3
31165,CN4012900000000,40,129,"Roger Mills County, OK",Dec-19,1819,1761,58,3.2
31166,CN4013100000000,40,131,"Rogers County, OK",Dec-19,45128,43833,1295,2.9
31167,CN4013300000000,40,133,"Seminole County, OK",Dec-19,9469,9005,464,4.9
31168,CN4013500000000,40,135,"Sequoyah County, OK",Dec-19,16116,15421,695,4.3
31169,CN4013700000000,40,137,"Stephens County, OK",Dec-19,18367,17511,856,4.7
31170,CN4013900000000,40,139,"Texas County, OK",Dec-19,11076,10870,206,1.9
31171,CN4014100000000,40,141,"Tillman County, OK",Dec-19,2967,2843,124,4.2
31172,CN4014300000000,40,143,"Tulsa County, OK",Dec-19,323297,313599,9698,3.0
31173,CN4014500000000,40,145,"Wagoner County, OK",Dec-19,37994,36829,1165,3.1
31174,CN4014700000000,40,147,"Washington County, OK",Dec-19,22038,21355,683,3.1
31175,CN4014900000000,40,149,"Washita County, OK",Dec-19,5136,4927,209,4.1
31176,CN4015100000000,40,151,"Woods County, OK",Dec-19,4570,4494,76,1.7
31177,CN4015300000000,40,153,"Woodward County, OK",Dec-19,8831,8496,335,3.8
31178,CN4100100000000,41,1,"Baker County, OR",Dec-19,7056,6788,268,3.8
31179,CN4100300000000,41,3,"Benton County, OR",Dec-19,48517,47530,987,2.0
31180,CN4100500000000,41,5,"Clackamas County, OR",Dec-19,219024,213308,5716,2.6
31181,CN4100700000000,41,7,"Clatsop County, OR",Dec-19,18634,18030,604,3.2
31182,CN4100900000000,41,9,"Columbia County, OR",Dec-19,24418,23505,913,3.7
31183,CN4101100000000,41,11,"Coos County, OR",Dec-19,25815,24819,996,3.9
31184,CN4101300000000,41,13,"Crook County, OR",Dec-19,9457,8989,468,4.9
31185,CN4101500000000,41,15,"Curry County, OR",Dec-19,8620,8231,389,4.5
31186,CN4101700000000,41,17,"Deschutes County, OR",Dec-19,95386,92333,3053,3.2
31187,CN4101900000000,41,19,"Douglas County, OR",Dec-19,45829,44025,1804,3.9
31188,CN4102100000000,41,21,"Gilliam County, OR",Dec-19,868,837,31,3.6
31189,CN4102300000000,41,23,"Grant County, OR",Dec-19,3049,2859,190,6.2
31190,CN4102500000000,41,25,"Harney County, OR",Dec-19,3481,3320,161,4.6
31191,CN4102700000000,41,27,"Hood River County, OR",Dec-19,13736,13399,337,2.5
31192,CN4102900000000,41,29,"Jackson County, OR",Dec-19,102395,99167,3228,3.2
31193,CN4103100000000,41,31,"Jefferson County, OR",Dec-19,9802,9390,412,4.2
31194,CN4103300000000,41,33,"Josephine County, OR",Dec-19,35320,33918,1402,4.0
31195,CN4103500000000,41,35,"Klamath County, OR",Dec-19,28501,26852,1649,5.8
31196,CN4103700000000,41,37,"Lake County, OR",Dec-19,3547,3398,149,4.2
31197,CN4103900000000,41,39,"Lane County, OR",Dec-19,180491,174928,5563,3.1
31198,CN4104100000000,41,41,"Lincoln County, OR",Dec-19,19950,19208,742,3.7
31199,CN4104300000000,41,43,"Linn County, OR",Dec-19,58446,56468,1978,3.4
31200,CN4104500000000,41,45,"Malheur County, OR",Dec-19,12116,11712,404,3.3
31201,CN4104700000000,41,47,"Marion County, OR",Dec-19,160104,155151,4953,3.1
31202,CN4104900000000,41,49,"Morrow County, OR",Dec-19,5441,5247,194,3.6
31203,CN4105100000000,41,51,"Multnomah County, OR",Dec-19,455097,443644,11453,2.5
31204,CN4105300000000,41,53,"Polk County, OR",Dec-19,39585,38351,1234,3.1
31205,CN4105500000000,41,55,"Sherman County, OR",Dec-19,924,892,32,3.5
31206,CN4105700000000,41,57,"Tillamook County, OR",Dec-19,11416,11025,391,3.4
31207,CN4105900000000,41,59,"Umatilla County, OR",Dec-19,35266,33868,1398,4.0
31208,CN4106100000000,41,61,"Union County, OR",Dec-19,11683,11216,467,4.0
31209,CN4106300000000,41,63,"Wallowa County, OR",Dec-19,3224,3072,152,4.7
31210,CN4106500000000,41,65,"Wasco County, OR",Dec-19,12236,11784,452,3.7
31211,CN4106700000000,41,67,"Washington County, OR",Dec-19,325176,317612,7564,2.3
31212,CN4106900000000,41,69,"Wheeler County, OR",Dec-19,697,671,26,3.7
31213,CN4107100000000,41,71,"Yamhill County, OR",Dec-19,54472,53067,1405,2.6
31214,CN4200100000000,42,1,"Adams County, PA",Dec-19,54708,52876,1832,3.3
31215,CN4200300000000,42,3,"Allegheny County, PA",Dec-19,651334,624607,26727,4.1
31216,CN4200500000000,42,5,"Armstrong County, PA",Dec-19,32831,30749,2082,6.3
31217,CN4200700000000,42,7,"Beaver County, PA",Dec-19,84645,80559,4086,4.8
31218,CN4200900000000,42,9,"Bedford County, PA",Dec-19,23721,22268,1453,6.1
31219,CN4201100000000,42,11,"Berks County, PA",Dec-19,217465,207996,9469,4.4
31220,CN4201300000000,42,13,"Blair County, PA",Dec-19,59652,56650,3002,5.0
31221,CN4201500000000,42,15,"Bradford County, PA",Dec-19,28963,27532,1431,4.9
31222,CN4201700000000,42,17,"Bucks County, PA",Dec-19,345150,332013,13137,3.8
31223,CN4201900000000,42,19,"Butler County, PA",Dec-19,100616,96334,4282,4.3
31224,CN4202100000000,42,21,"Cambria County, PA",Dec-19,58471,55041,3430,5.9
31225,CN4202300000000,42,23,"Cameron County, PA",Dec-19,2081,1908,173,8.3
31226,CN4202500000000,42,25,"Carbon County, PA",Dec-19,32744,30801,1943,5.9
31227,CN4202700000000,42,27,"Centre County, PA",Dec-19,81215,78391,2824,3.5
31228,CN4202900000000,42,29,"Chester County, PA",Dec-19,285758,277087,8671,3.0
31229,CN4203100000000,42,31,"Clarion County, PA",Dec-19,17141,16158,983,5.7
31230,CN4203300000000,42,33,"Clearfield County, PA",Dec-19,36460,34100,2360,6.5
31231,CN4203500000000,42,35,"Clinton County, PA",Dec-19,18425,17246,1179,6.4
31232,CN4203700000000,42,37,"Columbia County, PA",Dec-19,33705,31879,1826,5.4
31233,CN4203900000000,42,39,"Crawford County, PA",Dec-19,38657,36655,2002,5.2
31234,CN4204100000000,42,41,"Cumberland County, PA",Dec-19,133637,129197,4440,3.3
31235,CN4204300000000,42,43,"Dauphin County, PA",Dec-19,146005,140115,5890,4.0
31236,CN4204500000000,42,45,"Delaware County, PA",Dec-19,301853,290048,11805,3.9
31237,CN4204700000000,42,47,"Elk County, PA",Dec-19,15528,14417,1111,7.2
31238,CN4204900000000,42,49,"Erie County, PA",Dec-19,128865,122483,6382,5.0
31239,CN4205100000000,42,51,"Fayette County, PA",Dec-19,58045,54004,4041,7.0
31240,CN4205300000000,42,53,"Forest County, PA",Dec-19,1807,1653,154,8.5
31241,CN4205500000000,42,55,"Franklin County, PA",Dec-19,79539,76197,3342,4.2
31242,CN4205700000000,42,57,"Fulton County, PA",Dec-19,8109,7573,536,6.6
31243,CN4205900000000,42,59,"Greene County, PA",Dec-19,16720,15765,955,5.7
31244,CN4206100000000,42,61,"Huntingdon County, PA",Dec-19,20279,18664,1615,8.0
31245,CN4206300000000,42,63,"Indiana County, PA",Dec-19,39757,37492,2265,5.7
31246,CN4206500000000,42,65,"Jefferson County, PA",Dec-19,20684,19405,1279,6.2
31247,CN4206700000000,42,67,"Juniata County, PA",Dec-19,12704,12056,648,5.1
31248,CN4206900000000,42,69,"Lackawanna County, PA",Dec-19,105702,100408,5294,5.0
31249,CN4207100000000,42,71,"Lancaster County, PA",Dec-19,285807,276305,9502,3.3
31250,CN4207300000000,42,73,"Lawrence County, PA",Dec-19,40924,38421,2503,6.1
31251,CN4207500000000,42,75,"Lebanon County, PA",Dec-19,73136,70120,3016,4.1
31252,CN4207700000000,42,77,"Lehigh County, PA",Dec-19,195539,186442,9097,4.7
31253,CN4207900000000,42,79,"Luzerne County, PA",Dec-19,158790,149253,9537,6.0
31254,CN4208100000000,42,81,"Lycoming County, PA",Dec-19,57240,54074,3166,5.5
31255,CN4208300000000,42,83,"McKean County, PA",Dec-19,17484,16341,1143,6.5
31256,CN4208500000000,42,85,"Mercer County, PA",Dec-19,49082,46459,2623,5.3
31257,CN4208700000000,42,87,"Mifflin County, PA",Dec-19,21193,20107,1086,5.1
31258,CN4208900000000,42,89,"Monroe County, PA",Dec-19,83934,79190,4744,5.7
31259,CN4209100000000,42,91,"Montgomery County, PA",Dec-19,455624,440241,15383,3.4
31260,CN4209300000000,42,93,"Montour County, PA",Dec-19,9120,8771,349,3.8
31261,CN4209500000000,42,95,"Northampton County, PA",Dec-19,163441,156126,7315,4.5
31262,CN4209700000000,42,97,"Northumberland County, PA",Dec-19,42894,40144,2750,6.4
31263,CN4209900000000,42,99,"Perry County, PA",Dec-19,24860,23853,1007,4.1
31264,CN4210100000000,42,101,"Philadelphia County/city, PA",Dec-19,729738,690247,39491,5.4
31265,CN4210300000000,42,103,"Pike County, PA",Dec-19,25574,24036,1538,6.0
31266,CN4210500000000,42,105,"Potter County, PA",Dec-19,7282,6728,554,7.6
31267,CN4210700000000,42,107,"Schuylkill County, PA",Dec-19,66833,63037,3796,5.7
31268,CN4210900000000,42,109,"Snyder County, PA",Dec-19,20600,19346,1254,6.1
31269,CN4211100000000,42,111,"Somerset County, PA",Dec-19,34177,31929,2248,6.6
31270,CN4211300000000,42,113,"Sullivan County, PA",Dec-19,2683,2493,190,7.1
31271,CN4211500000000,42,115,"Susquehanna County, PA",Dec-19,20662,19634,1028,5.0
31272,CN4211700000000,42,117,"Tioga County, PA",Dec-19,19371,18173,1198,6.2
31273,CN4211900000000,42,119,"Union County, PA",Dec-19,19997,19148,849,4.2
31274,CN4212100000000,42,121,"Venango County, PA",Dec-19,22314,21128,1186,5.3
31275,CN4212300000000,42,123,"Warren County, PA",Dec-19,18903,17950,953,5.0
31276,CN4212500000000,42,125,"Washington County, PA",Dec-19,107957,102740,5217,4.8
31277,CN4212700000000,42,127,"Wayne County, PA",Dec-19,22165,20889,1276,5.8
31278,CN4212900000000,42,129,"Westmoreland County, PA",Dec-19,182547,173807,8740,4.8
31279,CN4213100000000,42,131,"Wyoming County, PA",Dec-19,13738,12996,742,5.4
31280,CN4213300000000,42,133,"York County, PA",Dec-19,237714,228723,8991,3.8
31281,CN4400100000000,44,1,"Bristol County, RI",Dec-19,26188,25482,706,2.7
31282,CN4400300000000,44,3,"Kent County, RI",Dec-19,91457,88708,2749,3.0
31283,CN4400500000000,44,5,"Newport County, RI",Dec-19,44616,43340,1276,2.9
31284,CN4400700000000,44,7,"Providence County, RI",Dec-19,327222,316112,11110,3.4
31285,CN4400900000000,44,9,"Washington County, RI",Dec-19,69285,67329,1956,2.8
31286,CN4500100000000,45,1,"Abbeville County, SC",Dec-19,10138,9840,298,2.9
31287,CN4500300000000,45,3,"Aiken County, SC",Dec-19,74745,72970,1775,2.4
31288,CN4500500000000,45,5,"Allendale County, SC",Dec-19,2676,2543,133,5.0
31289,CN4500700000000,45,7,"Anderson County, SC",Dec-19,91598,89575,2023,2.2
31290,CN4500900000000,45,9,"Bamberg County, SC",Dec-19,4945,4715,230,4.7
31291,CN4501100000000,45,11,"Barnwell County, SC",Dec-19,8187,7887,300,3.7
31292,CN4501300000000,45,13,"Beaufort County, SC",Dec-19,77375,75731,1644,2.1
31293,CN4501500000000,45,15,"Berkeley County, SC",Dec-19,104569,102348,2221,2.1
31294,CN4501700000000,45,17,"Calhoun County, SC",Dec-19,6596,6398,198,3.0
31295,CN4501900000000,45,19,"Charleston County, SC",Dec-19,212623,208673,3950,1.9
31296,CN4502100000000,45,21,"Cherokee County, SC",Dec-19,25239,24562,677,2.7
31297,CN4502300000000,45,23,"Chester County, SC",Dec-19,13492,12996,496,3.7
31298,CN4502500000000,45,25,"Chesterfield County, SC",Dec-19,22029,21488,541,2.5
31299,CN4502700000000,45,27,"Clarendon County, SC",Dec-19,12702,12272,430,3.4
31300,CN4502900000000,45,29,"Colleton County, SC",Dec-19,16765,16315,450,2.7
31301,CN4503100000000,45,31,"Darlington County, SC",Dec-19,30527,29673,854,2.8
31302,CN4503300000000,45,33,"Dillon County, SC",Dec-19,13056,12601,455,3.5
31303,CN4503500000000,45,35,"Dorchester County, SC",Dec-19,78491,76917,1574,2.0
31304,CN4503700000000,45,37,"Edgefield County, SC",Dec-19,10712,10460,252,2.4
31305,CN4503900000000,45,39,"Fairfield County, SC",Dec-19,9613,9234,379,3.9
31306,CN4504100000000,45,41,"Florence County, SC",Dec-19,67226,65612,1614,2.4
31307,CN4504300000000,45,43,"Georgetown County, SC",Dec-19,25442,24595,847,3.3
31308,CN4504500000000,45,45,"Greenville County, SC",Dec-19,256113,250986,5127,2.0
31309,CN4504700000000,45,47,"Greenwood County, SC",Dec-19,31607,30788,819,2.6
31310,CN4504900000000,45,49,"Hampton County, SC",Dec-19,8383,8198,185,2.2
31311,CN4505100000000,45,51,"Horry County, SC",Dec-19,145007,140213,4794,3.3
31312,CN4505300000000,45,53,"Jasper County, SC",Dec-19,12631,12372,259,2.1
31313,CN4505500000000,45,55,"Kershaw County, SC",Dec-19,29296,28555,741,2.5
31314,CN4505700000000,45,57,"Lancaster County, SC",Dec-19,41494,40297,1197,2.9
31315,CN4505900000000,45,59,"Laurens County, SC",Dec-19,30322,29566,756,2.5
31316,CN4506100000000,45,61,"Lee County, SC",Dec-19,6651,6381,270,4.1
31317,CN4506300000000,45,63,"Lexington County, SC",Dec-19,150174,147345,2829,1.9
31318,CN4506500000000,45,65,"McCormick County, SC",Dec-19,3380,3293,87,2.6
31319,CN4506700000000,45,67,"Marion County, SC",Dec-19,12831,12390,441,3.4
31320,CN4506900000000,45,69,"Marlboro County, SC",Dec-19,9157,8814,343,3.7
31321,CN4507100000000,45,71,"Newberry County, SC",Dec-19,19122,18680,442,2.3
31322,CN4507300000000,45,73,"Oconee County, SC",Dec-19,35025,34247,778,2.2
31323,CN4507500000000,45,75,"Orangeburg County, SC",Dec-19,34973,33531,1442,4.1
31324,CN4507700000000,45,77,"Pickens County, SC",Dec-19,57692,56367,1325,2.3
31325,CN4507900000000,45,79,"Richland County, SC",Dec-19,198728,194263,4465,2.2
31326,CN4508100000000,45,81,"Saluda County, SC",Dec-19,8918,8724,194,2.2
31327,CN4508300000000,45,83,"Spartanburg County, SC",Dec-19,153496,150257,3239,2.1
31328,CN4508500000000,45,85,"Sumter County, SC",Dec-19,43703,42381,1322,3.0
31329,CN4508700000000,45,87,"Union County, SC",Dec-19,11669,11327,342,2.9
31330,CN4508900000000,45,89,"Williamsburg County, SC",Dec-19,11886,11379,507,4.3
31331,CN4509100000000,45,91,"York County, SC",Dec-19,141013,137775,3238,2.3
31332,CN4600300000000,46,3,"Aurora County, SD",Dec-19,1526,1479,47,3.1
31333,CN4600500000000,46,5,"Beadle County, SD",Dec-19,9552,9244,308,3.2
31334,CN4600700000000,46,7,"Bennett County, SD",Dec-19,1098,1040,58,5.3
31335,CN4600900000000,46,9,"Bon Homme County, SD",Dec-19,2886,2780,106,3.7
31336,CN4601100000000,46,11,"Brookings County, SD",Dec-19,19486,18767,719,3.7
31337,CN4601300000000,46,13,"Brown County, SD",Dec-19,20786,20119,667,3.2
31338,CN4601500000000,46,15,"Brule County, SD",Dec-19,2441,2364,77,3.2
31339,CN4601700000000,46,17,"Buffalo County, SD",Dec-19,675,630,45,6.7
31340,CN4601900000000,46,19,"Butte County, SD",Dec-19,5015,4809,206,4.1
31341,CN4602100000000,46,21,"Campbell County, SD",Dec-19,792,761,31,3.9
31342,CN4602300000000,46,23,"Charles Mix County, SD",Dec-19,3730,3575,155,4.2
31343,CN4602500000000,46,25,"Clark County, SD",Dec-19,1898,1840,58,3.1
31344,CN4602700000000,46,27,"Clay County, SD",Dec-19,7491,7206,285,3.8
31345,CN4602900000000,46,29,"Codington County, SD",Dec-19,15571,15066,505,3.2
31346,CN4603100000000,46,31,"Corson County, SD",Dec-19,1385,1314,71,5.1
31347,CN4603300000000,46,33,"Custer County, SD",Dec-19,3990,3788,202,5.1
31348,CN4603500000000,46,35,"Davison County, SD",Dec-19,11060,10697,363,3.3
31349,CN4603700000000,46,37,"Day County, SD",Dec-19,2751,2609,142,5.2
31350,CN4603900000000,46,39,"Deuel County, SD",Dec-19,2148,2027,121,5.6
31351,CN4604100000000,46,41,"Dewey County, SD",Dec-19,2221,2066,155,7.0
31352,CN4604300000000,46,43,"Douglas County, SD",Dec-19,1605,1553,52,3.2
31353,CN4604500000000,46,45,"Edmunds County, SD",Dec-19,2045,1979,66,3.2
31354,CN4604700000000,46,47,"Fall River County, SD",Dec-19,2859,2736,123,4.3
31355,CN4604900000000,46,49,"Faulk County, SD",Dec-19,1082,1045,37,3.4
31356,CN4605100000000,46,51,"Grant County, SD",Dec-19,4439,4287,152,3.4
31357,CN4605300000000,46,53,"Gregory County, SD",Dec-19,2103,2026,77,3.7
31358,CN4605500000000,46,55,"Haakon County, SD",Dec-19,1055,1021,34,3.2
31359,CN4605700000000,46,57,"Hamlin County, SD",Dec-19,3355,3245,110,3.3
31360,CN4605900000000,46,59,"Hand County, SD",Dec-19,1818,1765,53,2.9
31361,CN4606100000000,46,61,"Hanson County, SD",Dec-19,1750,1655,95,5.4
31362,CN4606300000000,46,63,"Harding County, SD",Dec-19,739,718,21,2.8
31363,CN4606500000000,46,65,"Hughes County, SD",Dec-19,9945,9679,266,2.7
31364,CN4606700000000,46,67,"Hutchinson County, SD",Dec-19,3632,3498,134,3.7
31365,CN4606900000000,46,69,"Hyde County, SD",Dec-19,685,659,26,3.8
31366,CN4607100000000,46,71,"Jackson County, SD",Dec-19,1231,1154,77,6.3
31367,CN4607300000000,46,73,"Jerauld County, SD",Dec-19,1112,1083,29,2.6
31368,CN4607500000000,46,75,"Jones County, SD",Dec-19,533,514,19,3.6
31369,CN4607700000000,46,77,"Kingsbury County, SD",Dec-19,2641,2564,77,2.9
31370,CN4607900000000,46,79,"Lake County, SD",Dec-19,6674,6431,243,3.6
31371,CN4608100000000,46,81,"Lawrence County, SD",Dec-19,13336,12881,455,3.4
31372,CN4608300000000,46,83,"Lincoln County, SD",Dec-19,34565,33628,937,2.7
31373,CN4608500000000,46,85,"Lyman County, SD",Dec-19,1692,1613,79,4.7
31374,CN4608700000000,46,87,"McCook County, SD",Dec-19,3082,2985,97,3.1
31375,CN4608900000000,46,89,"McPherson County, SD",Dec-19,1036,984,52,5.0
31376,CN4609100000000,46,91,"Marshall County, SD",Dec-19,2418,2310,108,4.5
31377,CN4609300000000,46,93,"Meade County, SD",Dec-19,13950,13444,506,3.6
31378,CN4609500000000,46,95,"Mellette County, SD",Dec-19,748,701,47,6.3
31379,CN4609700000000,46,97,"Miner County, SD",Dec-19,1192,1148,44,3.7
31380,CN4609900000000,46,99,"Minnehaha County, SD",Dec-19,113127,109585,3542,3.1
31381,CN4610100000000,46,101,"Moody County, SD",Dec-19,3996,3864,132,3.3
31382,CN4610200000000,46,102,"Oglala Lakota County, SD",Dec-19,3590,3232,358,10.0
31383,CN4610300000000,46,103,"Pennington County, SD",Dec-19,56118,54069,2049,3.7
31384,CN4610500000000,46,105,"Perkins County, SD",Dec-19,1427,1379,48,3.4
31385,CN4610700000000,46,107,"Potter County, SD",Dec-19,1049,1012,37,3.5
31386,CN4610900000000,46,109,"Roberts County, SD",Dec-19,4888,4640,248,5.1
31387,CN4611100000000,46,111,"Sanborn County, SD",Dec-19,1166,1124,42,3.6
31388,CN4611500000000,46,115,"Spink County, SD",Dec-19,3181,3065,116,3.6
31389,CN4611700000000,46,117,"Stanley County, SD",Dec-19,1836,1783,53,2.9
31390,CN4611900000000,46,119,"Sully County, SD",Dec-19,795,774,21,2.6
31391,CN4612100000000,46,121,"Todd County, SD",Dec-19,3161,2950,211,6.7
31392,CN4612300000000,46,123,"Tripp County, SD",Dec-19,3090,2995,95,3.1
31393,CN4612500000000,46,125,"Turner County, SD",Dec-19,4692,4545,147,3.1
31394,CN4612700000000,46,127,"Union County, SD",Dec-19,8527,8205,322,3.8
31395,CN4612900000000,46,129,"Walworth County, SD",Dec-19,2124,2010,114,5.4
31396,CN4613500000000,46,135,"Yankton County, SD",Dec-19,11926,11544,382,3.2
31397,CN4613700000000,46,137,"Ziebach County, SD",Dec-19,939,889,50,5.3
31398,CN4700100000000,47,1,"Anderson County, TN",Dec-19,34972,33881,1091,3.1
31399,CN4700300000000,47,3,"Bedford County, TN",Dec-19,21150,20437,713,3.4
31400,CN4700500000000,47,5,"Benton County, TN",Dec-19,6951,6651,300,4.3
31401,CN4700700000000,47,7,"Bledsoe County, TN",Dec-19,4407,4183,224,5.1
31402,CN4700900000000,47,9,"Blount County, TN",Dec-19,64232,62392,1840,2.9
31403,CN4701100000000,47,11,"Bradley County, TN",Dec-19,54415,52745,1670,3.1
31404,CN4701300000000,47,13,"Campbell County, TN",Dec-19,14995,14361,634,4.2
31405,CN4701500000000,47,15,"Cannon County, TN",Dec-19,6747,6566,181,2.7
31406,CN4701700000000,47,17,"Carroll County, TN",Dec-19,12148,11583,565,4.7
31407,CN4701900000000,47,19,"Carter County, TN",Dec-19,24293,23404,889,3.7
31408,CN4702100000000,47,21,"Cheatham County, TN",Dec-19,22363,21845,518,2.3
31409,CN4702300000000,47,23,"Chester County, TN",Dec-19,8649,8390,259,3.0
31410,CN4702500000000,47,25,"Claiborne County, TN",Dec-19,13186,12687,499,3.8
31411,CN4702700000000,47,27,"Clay County, TN",Dec-19,2818,2651,167,5.9
31412,CN4702900000000,47,29,"Cocke County, TN",Dec-19,15002,14393,609,4.1
31413,CN4703100000000,47,31,"Coffee County, TN",Dec-19,25871,25025,846,3.3
31414,CN4703300000000,47,33,"Crockett County, TN",Dec-19,7092,6864,228,3.2
31415,CN4703500000000,47,35,"Cumberland County, TN",Dec-19,23900,22666,1234,5.2
31416,CN4703700000000,47,37,"Davidson County, TN",Dec-19,413927,404589,9338,2.3
31417,CN4703900000000,47,39,"Decatur County, TN",Dec-19,4621,4386,235,5.1
31418,CN4704100000000,47,41,"DeKalb County, TN",Dec-19,7755,7455,300,3.9
31419,CN4704300000000,47,43,"Dickson County, TN",Dec-19,27670,26940,730,2.6
31420,CN4704500000000,47,45,"Dyer County, TN",Dec-19,16649,15910,739,4.4
31421,CN4704700000000,47,47,"Fayette County, TN",Dec-19,19465,18783,682,3.5
31422,CN4704900000000,47,49,"Fentress County, TN",Dec-19,7572,7266,306,4.0
31423,CN4705100000000,47,51,"Franklin County, TN",Dec-19,20558,19864,694,3.4
31424,CN4705300000000,47,53,"Gibson County, TN",Dec-19,22415,21533,882,3.9
31425,CN4705500000000,47,55,"Giles County, TN",Dec-19,15243,14632,611,4.0
31426,CN4705700000000,47,57,"Grainger County, TN",Dec-19,9622,9263,359,3.7
31427,CN4705900000000,47,59,"Greene County, TN",Dec-19,29704,28338,1366,4.6
31428,CN4706100000000,47,61,"Grundy County, TN",Dec-19,5024,4827,197,3.9
31429,CN4706300000000,47,63,"Hamblen County, TN",Dec-19,28675,27655,1020,3.6
31430,CN4706500000000,47,65,"Hamilton County, TN",Dec-19,185110,179449,5661,3.1
31431,CN4706700000000,47,67,"Hancock County, TN",Dec-19,2122,2018,104,4.9
31432,CN4706900000000,47,69,"Hardeman County, TN",Dec-19,9610,9116,494,5.1
31433,CN4707100000000,47,71,"Hardin County, TN",Dec-19,10545,10084,461,4.4
31434,CN4707300000000,47,73,"Hawkins County, TN",Dec-19,23932,22993,939,3.9
31435,CN4707500000000,47,75,"Haywood County, TN",Dec-19,7799,7464,335,4.3
31436,CN4707700000000,47,77,"Henderson County, TN",Dec-19,12344,11871,473,3.8
31437,CN4707900000000,47,79,"Henry County, TN",Dec-19,14341,13735,606,4.2
31438,CN4708100000000,47,81,"Hickman County, TN",Dec-19,11692,11374,318,2.7
31439,CN4708300000000,47,83,"Houston County, TN",Dec-19,3295,3157,138,4.2
31440,CN4708500000000,47,85,"Humphreys County, TN",Dec-19,8998,8654,344,3.8
31441,CN4708700000000,47,87,"Jackson County, TN",Dec-19,4745,4543,202,4.3
31442,CN4708900000000,47,89,"Jefferson County, TN",Dec-19,25007,24196,811,3.2
31443,CN4709100000000,47,91,"Johnson County, TN",Dec-19,7798,7532,266,3.4
31444,CN4709300000000,47,93,"Knox County, TN",Dec-19,246664,240364,6300,2.6
31445,CN4709500000000,47,95,"Lake County, TN",Dec-19,1741,1653,88,5.1
31446,CN4709700000000,47,97,"Lauderdale County, TN",Dec-19,9854,9360,494,5.0
31447,CN4709900000000,47,99,"Lawrence County, TN",Dec-19,19658,18948,710,3.6
31448,CN4710100000000,47,101,"Lewis County, TN",Dec-19,5220,5056,164,3.1
31449,CN4710300000000,47,103,"Lincoln County, TN",Dec-19,16369,15369,1000,6.1
31450,CN4710500000000,47,105,"Loudon County, TN",Dec-19,23789,23031,758,3.2
31451,CN4710700000000,47,107,"McMinn County, TN",Dec-19,24157,23251,906,3.8
31452,CN4710900000000,47,109,"McNairy County, TN",Dec-19,8744,8217,527,6.0
31453,CN4711100000000,47,111,"Macon County, TN",Dec-19,11551,11228,323,2.8
31454,CN4711300000000,47,113,"Madison County, TN",Dec-19,49527,47958,1569,3.2
31455,CN4711500000000,47,115,"Marion County, TN",Dec-19,12592,12057,535,4.2
31456,CN4711700000000,47,117,"Marshall County, TN",Dec-19,15873,15312,561,3.5
31457,CN4711900000000,47,119,"Maury County, TN",Dec-19,50572,49208,1364,2.7
31458,CN4712100000000,47,121,"Meigs County, TN",Dec-19,5357,5063,294,5.5
31459,CN4712300000000,47,123,"Monroe County, TN",Dec-19,20338,19615,723,3.6
31460,CN4712500000000,47,125,"Montgomery County, TN",Dec-19,86734,83771,2963,3.4
31461,CN4712700000000,47,127,"Moore County, TN",Dec-19,3684,3577,107,2.9
31462,CN4712900000000,47,129,"Morgan County, TN",Dec-19,7961,7683,278,3.5
31463,CN4713100000000,47,131,"Obion County, TN",Dec-19,12559,12026,533,4.2
31464,CN4713300000000,47,133,"Overton County, TN",Dec-19,10128,9805,323,3.2
31465,CN4713500000000,47,135,"Perry County, TN",Dec-19,3123,2973,150,4.8
31466,CN4713700000000,47,137,"Pickett County, TN",Dec-19,2385,2275,110,4.6
31467,CN4713900000000,47,139,"Polk County, TN",Dec-19,7860,7568,292,3.7
31468,CN4714100000000,47,141,"Putnam County, TN",Dec-19,35817,34716,1101,3.1
31469,CN4714300000000,47,143,"Rhea County, TN",Dec-19,13704,12975,729,5.3
31470,CN4714500000000,47,145,"Roane County, TN",Dec-19,23662,22795,867,3.7
31471,CN4714700000000,47,147,"Robertson County, TN",Dec-19,38971,37947,1024,2.6
31472,CN4714900000000,47,149,"Rutherford County, TN",Dec-19,188644,184350,4294,2.3
31473,CN4715100000000,47,151,"Scott County, TN",Dec-19,8293,7972,321,3.9
31474,CN4715300000000,47,153,"Sequatchie County, TN",Dec-19,6226,5983,243,3.9
31475,CN4715500000000,47,155,"Sevier County, TN",Dec-19,54840,53390,1450,2.6
31476,CN4715700000000,47,157,"Shelby County, TN",Dec-19,451150,434557,16593,3.7
31477,CN4715900000000,47,159,"Smith County, TN",Dec-19,9674,9418,256,2.6
31478,CN4716100000000,47,161,"Stewart County, TN",Dec-19,5569,5348,221,4.0
31479,CN4716300000000,47,163,"Sullivan County, TN",Dec-19,70675,68298,2377,3.4
31480,CN4716500000000,47,165,"Sumner County, TN",Dec-19,104850,102286,2564,2.4
31481,CN4716700000000,47,167,"Tipton County, TN",Dec-19,28577,27536,1041,3.6
31482,CN4716900000000,47,169,"Trousdale County, TN",Dec-19,5557,5405,152,2.7
31483,CN4717100000000,47,171,"Unicoi County, TN",Dec-19,7214,6872,342,4.7
31484,CN4717300000000,47,173,"Union County, TN",Dec-19,7692,7414,278,3.6
31485,CN4717500000000,47,175,"Van Buren County, TN",Dec-19,2043,1965,78,3.8
31486,CN4717700000000,47,177,"Warren County, TN",Dec-19,16663,16047,616,3.7
31487,CN4717900000000,47,179,"Washington County, TN",Dec-19,61231,59308,1923,3.1
31488,CN4718100000000,47,181,"Wayne County, TN",Dec-19,6266,5967,299,4.8
31489,CN4718300000000,47,183,"Weakley County, TN",Dec-19,16184,15638,546,3.4
31490,CN4718500000000,47,185,"White County, TN",Dec-19,12437,12019,418,3.4
31491,CN4718700000000,47,187,"Williamson County, TN",Dec-19,131381,128577,2804,2.1
31492,CN4718900000000,47,189,"Wilson County, TN",Dec-19,78528,76639,1889,2.4
31493,CN4800100000000,48,1,"Anderson County, TX",Dec-19,24104,23450,654,2.7
31494,CN4800300000000,48,3,"Andrews County, TX",Dec-19,9829,9600,229,2.3
31495,CN4800500000000,48,5,"Angelina County, TX",Dec-19,36017,34638,1379,3.8
31496,CN4800700000000,48,7,"Aransas County, TX",Dec-19,9411,9036,375,4.0
31497,CN4800900000000,48,9,"Archer County, TX",Dec-19,4144,4036,108,2.6
31498,CN4801100000000,48,11,"Armstrong County, TX",Dec-19,933,908,25,2.7
31499,CN4801300000000,48,13,"Atascosa County, TX",Dec-19,21938,21201,737,3.4
31500,CN4801500000000,48,15,"Austin County, TX",Dec-19,14210,13749,461,3.2
31501,CN4801700000000,48,17,"Bailey County, TX",Dec-19,2436,2364,72,3.0
31502,CN4801900000000,48,19,"Bandera County, TX",Dec-19,10164,9869,295,2.9
31503,CN4802100000000,48,21,"Bastrop County, TX",Dec-19,43487,42291,1196,2.8
31504,CN4802300000000,48,23,"Baylor County, TX",Dec-19,1792,1752,40,2.2
31505,CN4802500000000,48,25,"Bee County, TX",Dec-19,9837,9410,427,4.3
31506,CN4802700000000,48,27,"Bell County, TX",Dec-19,145296,140325,4971,3.4
31507,CN4802900000000,48,29,"Bexar County, TX",Dec-19,960322,933181,27141,2.8
31508,CN4803100000000,48,31,"Blanco County, TX",Dec-19,6515,6376,139,2.1
31509,CN4803300000000,48,33,"Borden County, TX",Dec-19,423,414,9,2.1
31510,CN4803500000000,48,35,"Bosque County, TX",Dec-19,8322,8046,276,3.3
31511,CN4803700000000,48,37,"Bowie County, TX",Dec-19,40043,38526,1517,3.8
31512,CN4803900000000,48,39,"Brazoria County, TX",Dec-19,181774,173972,7802,4.3
31513,CN4804100000000,48,41,"Brazos County, TX",Dec-19,120803,117956,2847,2.4
31514,CN4804300000000,48,43,"Brewster County, TX",Dec-19,4180,4075,105,2.5
31515,CN4804500000000,48,45,"Briscoe County, TX",Dec-19,573,555,18,3.1
31516,CN4804700000000,48,47,"Brooks County, TX",Dec-19,2616,2485,131,5.0
31517,CN4804900000000,48,49,"Brown County, TX",Dec-19,15505,14950,555,3.6
31518,CN4805100000000,48,51,"Burleson County, TX",Dec-19,8503,8240,263,3.1
31519,CN4805300000000,48,53,"Burnet County, TX",Dec-19,23540,22958,582,2.5
31520,CN4805500000000,48,55,"Caldwell County, TX",Dec-19,19898,19326,572,2.9
31521,CN4805700000000,48,57,"Calhoun County, TX",Dec-19,12154,11739,415,3.4
31522,CN4805900000000,48,59,"Callahan County, TX",Dec-19,6174,5994,180,2.9
31523,CN4806100000000,48,61,"Cameron County, TX",Dec-19,167835,158333,9502,5.7
31524,CN4806300000000,48,63,"Camp County, TX",Dec-19,4992,4794,198,4.0
31525,CN4806500000000,48,65,"Carson County, TX",Dec-19,3017,2949,68,2.3
31526,CN4806700000000,48,67,"Cass County, TX",Dec-19,12401,11908,493,4.0
31527,CN4806900000000,48,69,"Castro County, TX",Dec-19,3370,3293,77,2.3
31528,CN4807100000000,48,71,"Chambers County, TX",Dec-19,19708,18819,889,4.5
31529,CN4807300000000,48,73,"Cherokee County, TX",Dec-19,20927,20152,775,3.7
31530,CN4807500000000,48,75,"Childress County, TX",Dec-19,2905,2822,83,2.9
31531,CN4807700000000,48,77,"Clay County, TX",Dec-19,4932,4793,139,2.8
31532,CN4807900000000,48,79,"Cochran County, TX",Dec-19,1108,1070,38,3.4
31533,CN4808100000000,48,81,"Coke County, TX",Dec-19,1461,1424,37,2.5
31534,CN4808300000000,48,83,"Coleman County, TX",Dec-19,2873,2746,127,4.4
31535,CN4808500000000,48,85,"Collin County, TX",Dec-19,573039,557280,15759,2.8
31536,CN4808700000000,48,87,"Collingsworth County, TX",Dec-19,1144,1106,38,3.3
31537,CN4808900000000,48,89,"Colorado County, TX",Dec-19,9830,9546,284,2.9
31538,CN4809100000000,48,91,"Comal County, TX",Dec-19,74184,72165,2019,2.7
31539,CN4809300000000,48,93,"Comanche County, TX",Dec-19,5624,5438,186,3.3
31540,CN4809500000000,48,95,"Concho County, TX",Dec-19,1330,1296,34,2.6
31541,CN4809700000000,48,97,"Cooke County, TX",Dec-19,19767,19249,518,2.6
31542,CN4809900000000,48,99,"Coryell County, TX",Dec-19,24366,23496,870,3.6
31543,CN4810100000000,48,101,"Cottle County, TX",Dec-19,549,522,27,4.9
31544,CN4810300000000,48,103,"Crane County, TX",Dec-19,1588,1517,71,4.5
31545,CN4810500000000,48,105,"Crockett County, TX",Dec-19,1625,1563,62,3.8
31546,CN4810700000000,48,107,"Crosby County, TX",Dec-19,2476,2396,80,3.2
31547,CN4810900000000,48,109,"Culberson County, TX",Dec-19,1056,1019,37,3.5
31548,CN4811100000000,48,111,"Dallam County, TX",Dec-19,3842,3767,75,2.0
31549,CN4811300000000,48,113,"Dallas County, TX",Dec-19,1386624,1343894,42730,3.1
31550,CN4811500000000,48,115,"Dawson County, TX",Dec-19,4645,4468,177,3.8
31551,CN4811700000000,48,117,"Deaf Smith County, TX",Dec-19,8463,8253,210,2.5
31552,CN4811900000000,48,119,"Delta County, TX",Dec-19,2448,2368,80,3.3
31553,CN4812100000000,48,121,"Denton County, TX",Dec-19,503039,489671,13368,2.7
31554,CN4812300000000,48,123,"DeWitt County, TX",Dec-19,9786,9535,251,2.6
31555,CN4812500000000,48,125,"Dickens County, TX",Dec-19,670,642,28,4.2
31556,CN4812700000000,48,127,"Dimmit County, TX",Dec-19,7259,7079,180,2.5
31557,CN4812900000000,48,129,"Donley County, TX",Dec-19,1390,1347,43,3.1
31558,CN4813100000000,48,131,"Duval County, TX",Dec-19,4919,4678,241,4.9
31559,CN4813300000000,48,133,"Eastland County, TX",Dec-19,8163,7921,242,3.0
31560,CN4813500000000,48,135,"Ector County, TX",Dec-19,88129,85565,2564,2.9
31561,CN4813700000000,48,137,"Edwards County, TX",Dec-19,1126,1108,18,1.6
31562,CN4813900000000,48,139,"Ellis County, TX",Dec-19,94182,91598,2584,2.7
31563,CN4814100000000,48,141,"El Paso County, TX",Dec-19,365817,352780,13037,3.6
31564,CN4814300000000,48,143,"Erath County, TX",Dec-19,20904,20251,653,3.1
31565,CN4814500000000,48,145,"Falls County, TX",Dec-19,6580,6382,198,3.0
31566,CN4814700000000,48,147,"Fannin County, TX",Dec-19,17422,16997,425,2.4
31567,CN4814900000000,48,149,"Fayette County, TX",Dec-19,12026,11740,286,2.4
31568,CN4815100000000,48,151,"Fisher County, TX",Dec-19,1612,1575,37,2.3
31569,CN4815300000000,48,153,"Floyd County, TX",Dec-19,2524,2427,97,3.8
31570,CN4815500000000,48,155,"Foard County, TX",Dec-19,582,567,15,2.6
31571,CN4815700000000,48,157,"Fort Bend County, TX",Dec-19,395701,383009,12692,3.2
31572,CN4815900000000,48,159,"Franklin County, TX",Dec-19,4608,4460,148,3.2
31573,CN4816100000000,48,161,"Freestone County, TX",Dec-19,6363,6071,292,4.6
31574,CN4816300000000,48,163,"Frio County, TX",Dec-19,10330,10075,255,2.5
31575,CN4816500000000,48,165,"Gaines County, TX",Dec-19,9792,9572,220,2.2
31576,CN4816700000000,48,167,"Galveston County, TX",Dec-19,167164,160608,6556,3.9
31577,CN4816900000000,48,169,"Garza County, TX",Dec-19,2170,2108,62,2.9
31578,CN4817100000000,48,171,"Gillespie County, TX",Dec-19,13634,13348,286,2.1
31579,CN4817300000000,48,173,"Glasscock County, TX",Dec-19,790,775,15,1.9
31580,CN4817500000000,48,175,"Goliad County, TX",Dec-19,3277,3166,111,3.4
31581,CN4817700000000,48,177,"Gonzales County, TX",Dec-19,9546,9304,242,2.5
31582,CN4817900000000,48,179,"Gray County, TX",Dec-19,8074,7792,282,3.5
31583,CN4818100000000,48,181,"Grayson County, TX",Dec-19,64218,62354,1864,2.9
31584,CN4818300000000,48,183,"Gregg County, TX",Dec-19,58262,56186,2076,3.6
31585,CN4818500000000,48,185,"Grimes County, TX",Dec-19,11200,10782,418,3.7
31586,CN4818700000000,48,187,"Guadalupe County, TX",Dec-19,82389,80227,2162,2.6
31587,CN4818900000000,48,189,"Hale County, TX",Dec-19,11939,11462,477,4.0
31588,CN4819100000000,48,191,"Hall County, TX",Dec-19,1050,1006,44,4.2
31589,CN4819300000000,48,193,"Hamilton County, TX",Dec-19,3655,3553,102,2.8
31590,CN4819500000000,48,195,"Hansford County, TX",Dec-19,2733,2674,59,2.2
31591,CN4819700000000,48,197,"Hardeman County, TX",Dec-19,1714,1670,44,2.6
31592,CN4819900000000,48,199,"Hardin County, TX",Dec-19,25331,24192,1139,4.5
31593,CN4820100000000,48,201,"Harris County, TX",Dec-19,2340079,2254317,85762,3.7
31594,CN4820300000000,48,203,"Harrison County, TX",Dec-19,29512,28360,1152,3.9
31595,CN4820500000000,48,205,"Hartley County, TX",Dec-19,2771,2727,44,1.6
31596,CN4820700000000,48,207,"Haskell County, TX",Dec-19,2279,2214,65,2.9
31597,CN4820900000000,48,209,"Hays County, TX",Dec-19,121589,118563,3026,2.5
31598,CN4821100000000,48,211,"Hemphill County, TX",Dec-19,1902,1852,50,2.6
31599,CN4821300000000,48,213,"Henderson County, TX",Dec-19,36649,35469,1180,3.2
31600,CN4821500000000,48,215,"Hidalgo County, TX",Dec-19,361012,335734,25278,7.0
31601,CN4821700000000,48,217,"Hill County, TX",Dec-19,16493,15998,495,3.0
31602,CN4821900000000,48,219,"Hockley County, TX",Dec-19,11184,10893,291,2.6
31603,CN4822100000000,48,221,"Hood County, TX",Dec-19,27914,27021,893,3.2
31604,CN4822300000000,48,223,"Hopkins County, TX",Dec-19,17530,17032,498,2.8
31605,CN4822500000000,48,225,"Houston County, TX",Dec-19,10466,10153,313,3.0
31606,CN4822700000000,48,227,"Howard County, TX",Dec-19,14107,13679,428,3.0
31607,CN4822900000000,48,229,"Hudspeth County, TX",Dec-19,1831,1756,75,4.1
31608,CN4823100000000,48,231,"Hunt County, TX",Dec-19,44133,42686,1447,3.3
31609,CN4823300000000,48,233,"Hutchinson County, TX",Dec-19,8758,8365,393,4.5
31610,CN4823500000000,48,235,"Irion County, TX",Dec-19,757,741,16,2.1
31611,CN4823700000000,48,237,"Jack County, TX",Dec-19,3442,3336,106,3.1
31612,CN4823900000000,48,239,"Jackson County, TX",Dec-19,7704,7484,220,2.9
31613,CN4824100000000,48,241,"Jasper County, TX",Dec-19,12891,12049,842,6.5
31614,CN4824300000000,48,243,"Jeff Davis County, TX",Dec-19,991,961,30,3.0
31615,CN4824500000000,48,245,"Jefferson County, TX",Dec-19,107105,100882,6223,5.8
31616,CN4824700000000,48,247,"Jim Hogg County, TX",Dec-19,1874,1791,83,4.4
31617,CN4824900000000,48,249,"Jim Wells County, TX",Dec-19,16647,15798,849,5.1
31618,CN4825100000000,48,251,"Johnson County, TX",Dec-19,83241,80778,2463,3.0
31619,CN4825300000000,48,253,"Jones County, TX",Dec-19,5779,5547,232,4.0
31620,CN4825500000000,48,255,"Karnes County, TX",Dec-19,7294,7124,170,2.3
31621,CN4825700000000,48,257,"Kaufman County, TX",Dec-19,65696,63739,1957,3.0
31622,CN4825900000000,48,259,"Kendall County, TX",Dec-19,22345,21806,539,2.4
31623,CN4826100000000,48,261,"Kenedy County, TX",Dec-19,202,193,9,4.5
31624,CN4826300000000,48,263,"Kent County, TX",Dec-19,480,467,13,2.7
31625,CN4826500000000,48,265,"Kerr County, TX",Dec-19,22355,21767,588,2.6
31626,CN4826700000000,48,267,"Kimble County, TX",Dec-19,1843,1791,52,2.8
31627,CN4826900000000,48,269,"King County, TX",Dec-19,239,235,4,1.7
31628,CN4827100000000,48,271,"Kinney County, TX",Dec-19,1385,1333,52,3.8
31629,CN4827300000000,48,273,"Kleberg County, TX",Dec-19,13571,13020,551,4.1
31630,CN4827500000000,48,275,"Knox County, TX",Dec-19,1421,1380,41,2.9
31631,CN4827700000000,48,277,"Lamar County, TX",Dec-19,24216,23469,747,3.1
31632,CN4827900000000,48,279,"Lamb County, TX",Dec-19,5264,5085,179,3.4
31633,CN4828100000000,48,281,"Lampasas County, TX",Dec-19,9305,9024,281,3.0
31634,CN4828300000000,48,283,"La Salle County, TX",Dec-19,4312,4204,108,2.5
31635,CN4828500000000,48,285,"Lavaca County, TX",Dec-19,8455,8233,222,2.6
31636,CN4828700000000,48,287,"Lee County, TX",Dec-19,10003,9749,254,2.5
31637,CN4828900000000,48,289,"Leon County, TX",Dec-19,6350,6089,261,4.1
31638,CN4829100000000,48,291,"Liberty County, TX",Dec-19,33552,31774,1778,5.3
31639,CN4829300000000,48,293,"Limestone County, TX",Dec-19,8617,8298,319,3.7
31640,CN4829500000000,48,295,"Lipscomb County, TX",Dec-19,1634,1599,35,2.1
31641,CN4829700000000,48,297,"Live Oak County, TX",Dec-19,5625,5466,159,2.8
31642,CN4829900000000,48,299,"Llano County, TX",Dec-19,8678,8399,279,3.2
31643,CN4830100000000,48,301,"Loving County, TX",Dec-19,681,677,4,0.6
31644,CN4830300000000,48,303,"Lubbock County, TX",Dec-19,158392,154507,3885,2.5
31645,CN4830500000000,48,305,"Lynn County, TX",Dec-19,2768,2690,78,2.8
31646,CN4830700000000,48,307,"McCulloch County, TX",Dec-19,3360,3212,148,4.4
31647,CN4830900000000,48,309,"McLennan County, TX",Dec-19,120036,116419,3617,3.0
31648,CN4831100000000,48,311,"McMullen County, TX",Dec-19,886,873,13,1.5
31649,CN4831300000000,48,313,"Madison County, TX",Dec-19,4533,4357,176,3.9
31650,CN4831500000000,48,315,"Marion County, TX",Dec-19,4238,4045,193,4.6
31651,CN4831700000000,48,317,"Martin County, TX",Dec-19,2899,2816,83,2.9
31652,CN4831900000000,48,319,"Mason County, TX",Dec-19,1758,1703,55,3.1
31653,CN4832100000000,48,321,"Matagorda County, TX",Dec-19,16695,15669,1026,6.1
31654,CN4832300000000,48,323,"Maverick County, TX",Dec-19,24169,22243,1926,8.0
31655,CN4832500000000,48,325,"Medina County, TX",Dec-19,22064,21416,648,2.9
31656,CN4832700000000,48,327,"Menard County, TX",Dec-19,875,848,27,3.1
31657,CN4832900000000,48,329,"Midland County, TX",Dec-19,107893,105706,2187,2.0
31658,CN4833100000000,48,331,"Milam County, TX",Dec-19,9690,9276,414,4.3
31659,CN4833300000000,48,333,"Mills County, TX",Dec-19,1916,1857,59,3.1
31660,CN4833500000000,48,335,"Mitchell County, TX",Dec-19,2325,2251,74,3.2
31661,CN4833700000000,48,337,"Montague County, TX",Dec-19,9360,9122,238,2.5
31662,CN4833900000000,48,339,"Montgomery County, TX",Dec-19,286787,277538,9249,3.2
31663,CN4834100000000,48,341,"Moore County, TX",Dec-19,10829,10587,242,2.2
31664,CN4834300000000,48,343,"Morris County, TX",Dec-19,4800,4539,261,5.4
31665,CN4834500000000,48,345,"Motley County, TX",Dec-19,474,459,15,3.2
31666,CN4834700000000,48,347,"Nacogdoches County, TX",Dec-19,28125,27162,963,3.4
31667,CN4834900000000,48,349,"Navarro County, TX",Dec-19,24258,23570,688,2.8
31668,CN4835100000000,48,351,"Newton County, TX",Dec-19,5194,4862,332,6.4
31669,CN4835300000000,48,353,"Nolan County, TX",Dec-19,7185,6994,191,2.7
31670,CN4835500000000,48,355,"Nueces County, TX",Dec-19,167633,160846,6787,4.0
31671,CN4835700000000,48,357,"Ochiltree County, TX",Dec-19,4305,4172,133,3.1
31672,CN4835900000000,48,359,"Oldham County, TX",Dec-19,919,894,25,2.7
31673,CN4836100000000,48,361,"Orange County, TX",Dec-19,36434,34575,1859,5.1
31674,CN4836300000000,48,363,"Palo Pinto County, TX",Dec-19,13556,13176,380,2.8
31675,CN4836500000000,48,365,"Panola County, TX",Dec-19,10150,9750,400,3.9
31676,CN4836700000000,48,367,"Parker County, TX",Dec-19,68211,66372,1839,2.7
31677,CN4836900000000,48,369,"Parmer County, TX",Dec-19,4855,4758,97,2.0
31678,CN4837100000000,48,371,"Pecos County, TX",Dec-19,6316,6099,217,3.4
31679,CN4837300000000,48,373,"Polk County, TX",Dec-19,18199,17297,902,5.0
31680,CN4837500000000,48,375,"Potter County, TX",Dec-19,55554,54161,1393,2.5
31681,CN4837700000000,48,377,"Presidio County, TX",Dec-19,3158,2891,267,8.5
31682,CN4837900000000,48,379,"Rains County, TX",Dec-19,6080,5916,164,2.7
31683,CN4838100000000,48,381,"Randall County, TX",Dec-19,72492,70933,1559,2.2
31684,CN4838300000000,48,383,"Reagan County, TX",Dec-19,1926,1865,61,3.2
31685,CN4838500000000,48,385,"Real County, TX",Dec-19,991,956,35,3.5
31686,CN4838700000000,48,387,"Red River County, TX",Dec-19,5140,4916,224,4.4
31687,CN4838900000000,48,389,"Reeves County, TX",Dec-19,12031,11823,208,1.7
31688,CN4839100000000,48,391,"Refugio County, TX",Dec-19,3123,3017,106,3.4
31689,CN4839300000000,48,393,"Roberts County, TX",Dec-19,416,406,10,2.4
31690,CN4839500000000,48,395,"Robertson County, TX",Dec-19,7753,7500,253,3.3
31691,CN4839700000000,48,397,"Rockwall County, TX",Dec-19,52962,51488,1474,2.8
31692,CN4839900000000,48,399,"Runnels County, TX",Dec-19,4618,4498,120,2.6
31693,CN4840100000000,48,401,"Rusk County, TX",Dec-19,23065,22247,818,3.5
31694,CN4840300000000,48,403,"Sabine County, TX",Dec-19,3644,3403,241,6.6
31695,CN4840500000000,48,405,"San Augustine County, TX",Dec-19,3456,3270,186,5.4
31696,CN4840700000000,48,407,"San Jacinto County, TX",Dec-19,11858,11300,558,4.7
31697,CN4840900000000,48,409,"San Patricio County, TX",Dec-19,29972,28314,1658,5.5
31698,CN4841100000000,48,411,"San Saba County, TX",Dec-19,2601,2523,78,3.0
31699,CN4841300000000,48,413,"Schleicher County, TX",Dec-19,1307,1269,38,2.9
31700,CN4841500000000,48,415,"Scurry County, TX",Dec-19,6737,6527,210,3.1
31701,CN4841700000000,48,417,"Shackelford County, TX",Dec-19,1890,1850,40,2.1
31702,CN4841900000000,48,419,"Shelby County, TX",Dec-19,11208,10766,442,3.9
31703,CN4842100000000,48,421,"Sherman County, TX",Dec-19,1360,1333,27,2.0
31704,CN4842300000000,48,423,"Smith County, TX",Dec-19,107966,104609,3357,3.1
31705,CN4842500000000,48,425,"Somervell County, TX",Dec-19,4433,4274,159,3.6
31706,CN4842700000000,48,427,"Starr County, TX",Dec-19,25960,22741,3219,12.4
31707,CN4842900000000,48,429,"Stephens County, TX",Dec-19,4049,3938,111,2.7
31708,CN4843100000000,48,431,"Sterling County, TX",Dec-19,564,548,16,2.8
31709,CN4843300000000,48,433,"Stonewall County, TX",Dec-19,570,554,16,2.8
31710,CN4843500000000,48,435,"Sutton County, TX",Dec-19,1292,1239,53,4.1
31711,CN4843700000000,48,437,"Swisher County, TX",Dec-19,2591,2505,86,3.3
31712,CN4843900000000,48,439,"Tarrant County, TX",Dec-19,1095859,1063687,32172,2.9
31713,CN4844100000000,48,441,"Taylor County, TX",Dec-19,67546,65805,1741,2.6
31714,CN4844300000000,48,443,"Terrell County, TX",Dec-19,367,354,13,3.5
31715,CN4844500000000,48,445,"Terry County, TX",Dec-19,4918,4756,162,3.3
31716,CN4844700000000,48,447,"Throckmorton County, TX",Dec-19,646,624,22,3.4
31717,CN4844900000000,48,449,"Titus County, TX",Dec-19,13083,12579,504,3.9
31718,CN4845100000000,48,451,"Tom Green County, TX",Dec-19,54431,52897,1534,2.8
31719,CN4845300000000,48,453,"Travis County, TX",Dec-19,751789,734410,17379,2.3
31720,CN4845500000000,48,455,"Trinity County, TX",Dec-19,5305,5039,266,5.0
31721,CN4845700000000,48,457,"Tyler County, TX",Dec-19,7159,6709,450,6.3
31722,CN4845900000000,48,459,"Upshur County, TX",Dec-19,17913,17248,665,3.7
31723,CN4846100000000,48,461,"Upton County, TX",Dec-19,1674,1634,40,2.4
31724,CN4846300000000,48,463,"Uvalde County, TX",Dec-19,11347,10957,390,3.4
31725,CN4846500000000,48,465,"Val Verde County, TX",Dec-19,23166,22333,833,3.6
31726,CN4846700000000,48,467,"Van Zandt County, TX",Dec-19,26106,25298,808,3.1
31727,CN4846900000000,48,469,"Victoria County, TX",Dec-19,42931,41470,1461,3.4
31728,CN4847100000000,48,471,"Walker County, TX",Dec-19,24155,23315,840,3.5
31729,CN4847300000000,48,473,"Waller County, TX",Dec-19,23660,22830,830,3.5
31730,CN4847500000000,48,475,"Ward County, TX",Dec-19,7551,7374,177,2.3
31731,CN4847700000000,48,477,"Washington County, TX",Dec-19,15304,14852,452,3.0
31732,CN4847900000000,48,479,"Webb County, TX",Dec-19,119349,115066,4283,3.6
31733,CN4848100000000,48,481,"Wharton County, TX",Dec-19,21809,21075,734,3.4
31734,CN4848300000000,48,483,"Wheeler County, TX",Dec-19,2261,2195,66,2.9
31735,CN4848500000000,48,485,"Wichita County, TX",Dec-19,56462,54817,1645,2.9
31736,CN4848700000000,48,487,"Wilbarger County, TX",Dec-19,4960,4789,171,3.4
31737,CN4848900000000,48,489,"Willacy County, TX",Dec-19,6664,6181,483,7.2
31738,CN4849100000000,48,491,"Williamson County, TX",Dec-19,318437,310403,8034,2.5
31739,CN4849300000000,48,493,"Wilson County, TX",Dec-19,25162,24509,653,2.6
31740,CN4849500000000,48,495,"Winkler County, TX",Dec-19,4041,3915,126,3.1
31741,CN4849700000000,48,497,"Wise County, TX",Dec-19,32283,31322,961,3.0
31742,CN4849900000000,48,499,"Wood County, TX",Dec-19,17788,17126,662,3.7
31743,CN4850100000000,48,501,"Yoakum County, TX",Dec-19,3653,3544,109,3.0
31744,CN4850300000000,48,503,"Young County, TX",Dec-19,8037,7814,223,2.8
31745,CN4850500000000,48,505,"Zapata County, TX",Dec-19,4885,4601,284,5.8
31746,CN4850700000000,48,507,"Zavala County, TX",Dec-19,3398,3125,273,8.0
31747,CN4900100000000,49,1,"Beaver County, UT",Dec-19,2716,2650,66,2.4
31748,CN4900300000000,49,3,"Box Elder County, UT",Dec-19,25963,25382,581,2.2
31749,CN4900500000000,49,5,"Cache County, UT",Dec-19,65771,64658,1113,1.7
31750,CN4900700000000,49,7,"Carbon County, UT",Dec-19,8493,8219,274,3.2
31751,CN4900900000000,49,9,"Daggett County, UT",Dec-19,339,326,13,3.8
31752,CN4901100000000,49,11,"Davis County, UT",Dec-19,175052,171603,3449,2.0
31753,CN4901300000000,49,13,"Duchesne County, UT",Dec-19,7775,7496,279,3.6
31754,CN4901500000000,49,15,"Emery County, UT",Dec-19,4263,4100,163,3.8
31755,CN4901700000000,49,17,"Garfield County, UT",Dec-19,2314,2097,217,9.4
31756,CN4901900000000,49,19,"Grand County, UT",Dec-19,5585,5257,328,5.9
31757,CN4902100000000,49,21,"Iron County, UT",Dec-19,24759,24181,578,2.3
31758,CN4902300000000,49,23,"Juab County, UT",Dec-19,5837,5716,121,2.1
31759,CN4902500000000,49,25,"Kane County, UT",Dec-19,3551,3448,103,2.9
31760,CN4902700000000,49,27,"Millard County, UT",Dec-19,5773,5647,126,2.2
31761,CN4902900000000,49,29,"Morgan County, UT",Dec-19,5589,5480,109,2.0
31762,CN4903100000000,49,31,"Piute County, UT",Dec-19,475,452,23,4.8
31763,CN4903300000000,49,33,"Rich County, UT",Dec-19,973,938,35,3.6
31764,CN4903500000000,49,35,"Salt Lake County, UT",Dec-19,645033,631786,13247,2.1
31765,CN4903700000000,49,37,"San Juan County, UT",Dec-19,5431,5136,295,5.4
31766,CN4903900000000,49,39,"Sanpete County, UT",Dec-19,12349,12002,347,2.8
31767,CN4904100000000,49,41,"Sevier County, UT",Dec-19,9619,9353,266,2.8
31768,CN4904300000000,49,43,"Summit County, UT",Dec-19,26909,26434,475,1.8
31769,CN4904500000000,49,45,"Tooele County, UT",Dec-19,34574,33758,816,2.4
31770,CN4904700000000,49,47,"Uintah County, UT",Dec-19,13551,12979,572,4.2
31771,CN4904900000000,49,49,"Utah County, UT",Dec-19,313739,307545,6194,2.0
31772,CN4905100000000,49,51,"Wasatch County, UT",Dec-19,16791,16413,378,2.3
31773,CN4905300000000,49,53,"Washington County, UT",Dec-19,76389,74466,1923,2.5
31774,CN4905500000000,49,55,"Wayne County, UT",Dec-19,1305,1193,112,8.6
31775,CN4905700000000,49,57,"Weber County, UT",Dec-19,128336,125299,3037,2.4
31776,CN5000100000000,50,1,"Addison County, VT",Dec-19,20180,19752,428,2.1
31777,CN5000300000000,50,3,"Bennington County, VT",Dec-19,17892,17370,522,2.9
31778,CN5000500000000,50,5,"Caledonia County, VT",Dec-19,14234,13864,370,2.6
31779,CN5000700000000,50,7,"Chittenden County, VT",Dec-19,94900,93396,1504,1.6
31780,CN5000900000000,50,9,"Essex County, VT",Dec-19,2631,2549,82,3.1
31781,CN5001100000000,50,11,"Franklin County, VT",Dec-19,26804,26240,564,2.1
31782,CN5001300000000,50,13,"Grand Isle County, VT",Dec-19,4013,3871,142,3.5
31783,CN5001500000000,50,15,"Lamoille County, VT",Dec-19,13782,13398,384,2.8
31784,CN5001700000000,50,17,"Orange County, VT",Dec-19,15724,15387,337,2.1
31785,CN5001900000000,50,19,"Orleans County, VT",Dec-19,13305,12780,525,3.9
31786,CN5002100000000,50,21,"Rutland County, VT",Dec-19,30231,29520,711,2.4
31787,CN5002300000000,50,23,"Washington County, VT",Dec-19,34304,33623,681,2.0
31788,CN5002500000000,50,25,"Windham County, VT",Dec-19,21896,21414,482,2.2
31789,CN5002700000000,50,27,"Windsor County, VT",Dec-19,28723,28210,513,1.8
31790,CN5100100000000,51,1,"Accomack County, VA",Dec-19,16588,15996,592,3.6
31791,CN5100300000000,51,3,"Albemarle County, VA",Dec-19,57881,56748,1133,2.0
31792,CN5100500000000,51,5,"Alleghany County, VA",Dec-19,6902,6665,237,3.4
31793,CN5100700000000,51,7,"Amelia County, VA",Dec-19,6403,6224,179,2.8
31794,CN5100900000000,51,9,"Amherst County, VA",Dec-19,15060,14623,437,2.9
31795,CN5101100000000,51,11,"Appomattox County, VA",Dec-19,7190,6960,230,3.2
31796,CN5101300000000,51,13,"Arlington County, VA",Dec-19,156564,154142,2422,1.5
31797,CN5101500000000,51,15,"Augusta County, VA",Dec-19,38007,37254,753,2.0
31798,CN5101700000000,51,17,"Bath County, VA",Dec-19,2515,2459,56,2.2
31799,CN5101900000000,51,19,"Bedford County, VA",Dec-19,38503,37530,973,2.5
31800,CN5102100000000,51,21,"Bland County, VA",Dec-19,2882,2793,89,3.1
31801,CN5102300000000,51,23,"Botetourt County, VA",Dec-19,17447,17068,379,2.2
31802,CN5102500000000,51,25,"Brunswick County, VA",Dec-19,5996,5759,237,4.0
31803,CN5102700000000,51,27,"Buchanan County, VA",Dec-19,6701,6295,406,6.1
31804,CN5102900000000,51,29,"Buckingham County, VA",Dec-19,6563,6275,288,4.4
31805,CN5103100000000,51,31,"Campbell County, VA",Dec-19,25970,25277,693,2.7
31806,CN5103300000000,51,33,"Caroline County, VA",Dec-19,15486,15044,442,2.9
31807,CN5103500000000,51,35,"Carroll County, VA",Dec-19,13337,12781,556,4.2
31808,CN5103600000000,51,36,"Charles City County, VA",Dec-19,3729,3620,109,2.9
31809,CN5103700000000,51,37,"Charlotte County, VA",Dec-19,5335,5146,189,3.5
31810,CN5104100000000,51,41,"Chesterfield County, VA",Dec-19,190107,185622,4485,2.4
31811,CN5104300000000,51,43,"Clarke County, VA",Dec-19,7747,7595,152,2.0
31812,CN5104500000000,51,45,"Craig County, VA",Dec-19,2301,2243,58,2.5
31813,CN5104700000000,51,47,"Culpeper County, VA",Dec-19,25029,24490,539,2.2
31814,CN5104900000000,51,49,"Cumberland County, VA",Dec-19,4635,4514,121,2.6
31815,CN5105100000000,51,51,"Dickenson County, VA",Dec-19,4799,4540,259,5.4
31816,CN5105300000000,51,53,"Dinwiddie County, VA",Dec-19,13876,13497,379,2.7
31817,CN5105700000000,51,57,"Essex County, VA",Dec-19,5513,5334,179,3.2
31818,CN5105900000000,51,59,"Fairfax County, VA",Dec-19,644145,632136,12009,1.9
31819,CN5106100000000,51,61,"Fauquier County, VA",Dec-19,37909,37179,730,1.9
31820,CN5106300000000,51,63,"Floyd County, VA",Dec-19,8455,8216,239,2.8
31821,CN5106500000000,51,65,"Fluvanna County, VA",Dec-19,14053,13794,259,1.8
31822,CN5106700000000,51,67,"Franklin County, VA",Dec-19,26551,25827,724,2.7
31823,CN5106900000000,51,69,"Frederick County, VA",Dec-19,48791,47825,966,2.0
31824,CN5107100000000,51,71,"Giles County, VA",Dec-19,8153,7807,346,4.2
31825,CN5107300000000,51,73,"Gloucester County, VA",Dec-19,19721,19287,434,2.2
31826,CN5107500000000,51,75,"Goochland County, VA",Dec-19,11382,11131,251,2.2
31827,CN5107700000000,51,77,"Grayson County, VA",Dec-19,8068,7821,247,3.1
31828,CN5107900000000,51,79,"Greene County, VA",Dec-19,10629,10421,208,2.0
31829,CN5108100000000,51,81,"Greensville County, VA",Dec-19,4299,4171,128,3.0
31830,CN5108300000000,51,83,"Halifax County, VA",Dec-19,15494,14934,560,3.6
31831,CN5108500000000,51,85,"Hanover County, VA",Dec-19,60102,58892,1210,2.0
31832,CN5108700000000,51,87,"Henrico County, VA",Dec-19,184449,180049,4400,2.4
31833,CN5108900000000,51,89,"Henry County, VA",Dec-19,23667,22942,725,3.1
31834,CN5109100000000,51,91,"Highland County, VA",Dec-19,1264,1223,41,3.2
31835,CN5109300000000,51,93,"Isle of Wight County, VA",Dec-19,19617,19117,500,2.5
31836,CN5109500000000,51,95,"James City County, VA",Dec-19,36763,35957,806,2.2
31837,CN5109700000000,51,97,"King and Queen County, VA",Dec-19,3923,3829,94,2.4
31838,CN5109900000000,51,99,"King George County, VA",Dec-19,13579,13267,312,2.3
31839,CN5110100000000,51,101,"King William County, VA",Dec-19,9311,9091,220,2.4
31840,CN5110300000000,51,103,"Lancaster County, VA",Dec-19,5503,5298,205,3.7
31841,CN5110500000000,51,105,"Lee County, VA",Dec-19,8303,7970,333,4.0
31842,CN5110700000000,51,107,"Loudoun County, VA",Dec-19,225748,221462,4286,1.9
31843,CN5110900000000,51,109,"Louisa County, VA",Dec-19,20087,19619,468,2.3
31844,CN5111100000000,51,111,"Lunenburg County, VA",Dec-19,5330,5182,148,2.8
31845,CN5111300000000,51,113,"Madison County, VA",Dec-19,7596,7463,133,1.8
31846,CN5111500000000,51,115,"Mathews County, VA",Dec-19,4158,4064,94,2.3
31847,CN5111700000000,51,117,"Mecklenburg County, VA",Dec-19,12439,11951,488,3.9
31848,CN5111900000000,51,119,"Middlesex County, VA",Dec-19,5300,5179,121,2.3
31849,CN5112100000000,51,121,"Montgomery County, VA",Dec-19,50945,49677,1268,2.5
31850,CN5112500000000,51,125,"Nelson County, VA",Dec-19,7567,7405,162,2.1
31851,CN5112700000000,51,127,"New Kent County, VA",Dec-19,12662,12415,247,2.0
31852,CN5113100000000,51,131,"Northampton County, VA",Dec-19,5525,5288,237,4.3
31853,CN5113300000000,51,133,"Northumberland County, VA",Dec-19,5792,5584,208,3.6
31854,CN5113500000000,51,135,"Nottoway County, VA",Dec-19,7360,7177,183,2.5
31855,CN5113700000000,51,137,"Orange County, VA",Dec-19,17585,17150,435,2.5
31856,CN5113900000000,51,139,"Page County, VA",Dec-19,12043,11522,521,4.3
31857,CN5114100000000,51,141,"Patrick County, VA",Dec-19,7160,6952,208,2.9
31858,CN5114300000000,51,143,"Pittsylvania County, VA",Dec-19,30315,29429,886,2.9
31859,CN5114500000000,51,145,"Powhatan County, VA",Dec-19,14366,14043,323,2.2
31860,CN5114700000000,51,147,"Prince Edward County, VA",Dec-19,10245,9895,350,3.4
31861,CN5114900000000,51,149,"Prince George County, VA",Dec-19,15289,14845,444,2.9
31862,CN5115300000000,51,153,"Prince William County, VA",Dec-19,248978,243685,5293,2.1
31863,CN5115500000000,51,155,"Pulaski County, VA",Dec-19,16803,15832,971,5.8
31864,CN5115700000000,51,157,"Rappahannock County, VA",Dec-19,3772,3700,72,1.9
31865,CN5115900000000,51,159,"Richmond County, VA",Dec-19,4130,4024,106,2.6
31866,CN5116100000000,51,161,"Roanoke County, VA",Dec-19,49438,48306,1132,2.3
31867,CN5116300000000,51,163,"Rockbridge County, VA",Dec-19,10729,10483,246,2.3
31868,CN5116500000000,51,165,"Rockingham County, VA",Dec-19,42928,42129,799,1.9
31869,CN5116700000000,51,167,"Russell County, VA",Dec-19,11238,10789,449,4.0
31870,CN5116900000000,51,169,"Scott County, VA",Dec-19,9159,8925,234,2.6
31871,CN5117100000000,51,171,"Shenandoah County, VA",Dec-19,22454,21986,468,2.1
31872,CN5117300000000,51,173,"Smyth County, VA",Dec-19,13846,13353,493,3.6
31873,CN5117500000000,51,175,"Southampton County, VA",Dec-19,9224,8992,232,2.5
31874,CN5117700000000,51,177,"Spotsylvania County, VA",Dec-19,67981,66327,1654,2.4
31875,CN5117900000000,51,179,"Stafford County, VA",Dec-19,73004,71316,1688,2.3
31876,CN5118100000000,51,181,"Surry County, VA",Dec-19,3666,3553,113,3.1
31877,CN5118300000000,51,183,"Sussex County, VA",Dec-19,3917,3757,160,4.1
31878,CN5118500000000,51,185,"Tazewell County, VA",Dec-19,15644,14970,674,4.3
31879,CN5118700000000,51,187,"Warren County, VA",Dec-19,20727,20247,480,2.3
31880,CN5119100000000,51,191,"Washington County, VA",Dec-19,26848,26070,778,2.9
31881,CN5119300000000,51,193,"Westmoreland County, VA",Dec-19,9616,9288,328,3.4
31882,CN5119500000000,51,195,"Wise County, VA",Dec-19,13409,12837,572,4.3
31883,CN5119700000000,51,197,"Wythe County, VA",Dec-19,14086,13379,707,5.0
31884,CN5119900000000,51,199,"York County, VA",Dec-19,32891,32159,732,2.2
31885,CN5151000000000,51,510,"Alexandria city, VA",Dec-19,102848,100983,1865,1.8
31886,CN5152000000000,51,520,"Bristol city, VA",Dec-19,7217,6978,239,3.3
31887,CN5153000000000,51,530,"Buena Vista city, VA",Dec-19,3506,3422,84,2.4
31888,CN5154000000000,51,540,"Charlottesville city, VA",Dec-19,26660,26170,490,1.8
31889,CN5155000000000,51,550,"Chesapeake city, VA",Dec-19,123210,120143,3067,2.5
31890,CN5157000000000,51,570,"Colonial Heights city, VA",Dec-19,8921,8675,246,2.8
31891,CN5158000000000,51,580,"Covington city, VA",Dec-19,2396,2288,108,4.5
31892,CN5159000000000,51,590,"Danville city, VA",Dec-19,19368,18510,858,4.4
31893,CN5159500000000,51,595,"Emporia city, VA",Dec-19,2287,2191,96,4.2
31894,CN5160000000000,51,600,"Fairfax city, VA",Dec-19,13641,13405,236,1.7
31895,CN5161000000000,51,610,"Falls Church city, VA",Dec-19,8723,8576,147,1.7
31896,CN5162000000000,51,620,"Franklin city, VA",Dec-19,3599,3456,143,4.0
31897,CN5163000000000,51,630,"Fredericksburg city, VA",Dec-19,14322,13916,406,2.8
31898,CN5164000000000,51,640,"Galax city, VA",Dec-19,2907,2822,85,2.9
31899,CN5165000000000,51,650,"Hampton city, VA",Dec-19,64646,62436,2210,3.4
31900,CN5166000000000,51,660,"Harrisonburg city, VA",Dec-19,25439,24804,635,2.5
31901,CN5167000000000,51,670,"Hopewell city, VA",Dec-19,9838,9427,411,4.2
31902,CN5167800000000,51,678,"Lexington city, VA",Dec-19,2063,1981,82,4.0
31903,CN5168000000000,51,680,"Lynchburg city, VA",Dec-19,36265,35091,1174,3.2
31904,CN5168300000000,51,683,"Manassas city, VA",Dec-19,22339,21888,451,2.0
31905,CN5168500000000,51,685,"Manassas Park city, VA",Dec-19,9502,9316,186,2.0
31906,CN5169000000000,51,690,"Martinsville city, VA",Dec-19,5487,5265,222,4.0
31907,CN5170000000000,51,700,"Newport News city, VA",Dec-19,89151,86393,2758,3.1
31908,CN5171000000000,51,710,"Norfolk city, VA",Dec-19,111990,108587,3403,3.0
31909,CN5172000000000,51,720,"Norton city, VA",Dec-19,1684,1628,56,3.3
31910,CN5173000000000,51,730,"Petersburg city, VA",Dec-19,13190,12514,676,5.1
31911,CN5173500000000,51,735,"Poquoson city, VA",Dec-19,6443,6306,137,2.1
31912,CN5174000000000,51,740,"Portsmouth city, VA",Dec-19,44488,42877,1611,3.6
31913,CN5175000000000,51,750,"Radford city, VA",Dec-19,8784,8494,290,3.3
31914,CN5176000000000,51,760,"Richmond city, VA",Dec-19,119856,116483,3373,2.8
31915,CN5177000000000,51,770,"Roanoke city, VA",Dec-19,49181,47848,1333,2.7
31916,CN5177500000000,51,775,"Salem city, VA",Dec-19,12962,12655,307,2.4
31917,CN5179000000000,51,790,"Staunton city, VA",Dec-19,12361,12083,278,2.2
31918,CN5180000000000,51,800,"Suffolk city, VA",Dec-19,44826,43636,1190,2.7
31919,CN5181000000000,51,810,"Virginia Beach city, VA",Dec-19,234164,228643,5521,2.4
31920,CN5182000000000,51,820,"Waynesboro city, VA",Dec-19,10793,10527,266,2.5
31921,CN5183000000000,51,830,"Williamsburg city, VA",Dec-19,6687,6484,203,3.0
31922,CN5184000000000,51,840,"Winchester city, VA",Dec-19,15023,14673,350,2.3
31923,CN5300100000000,53,1,"Adams County, WA",Dec-19,8916,8238,678,7.6
31924,CN5300300000000,53,3,"Asotin County, WA",Dec-19,10718,10305,413,3.9
31925,CN5300500000000,53,5,"Benton County, WA",Dec-19,104514,99030,5484,5.2
31926,CN5300700000000,53,7,"Chelan County, WA",Dec-19,43733,41462,2271,5.2
31927,CN5300900000000,53,9,"Clallam County, WA",Dec-19,29222,27467,1755,6.0
31928,CN5301100000000,53,11,"Clark County, WA",Dec-19,248649,238263,10386,4.2
31929,CN5301300000000,53,13,"Columbia County, WA",Dec-19,1872,1769,103,5.5
31930,CN5301500000000,53,15,"Cowlitz County, WA",Dec-19,48780,46121,2659,5.5
31931,CN5301700000000,53,17,"Douglas County, WA",Dec-19,21388,20127,1261,5.9
31932,CN5301900000000,53,19,"Ferry County, WA",Dec-19,2415,2143,272,11.3
31933,CN5302100000000,53,21,"Franklin County, WA",Dec-19,42375,39338,3037,7.2
31934,CN5302300000000,53,23,"Garfield County, WA",Dec-19,906,854,52,5.7
31935,CN5302500000000,53,25,"Grant County, WA",Dec-19,44287,40334,3953,8.9
31936,CN5302700000000,53,27,"Grays Harbor County, WA",Dec-19,29407,27344,2063,7.0
31937,CN5302900000000,53,29,"Island County, WA",Dec-19,37517,35849,1668,4.4
31938,CN5303100000000,53,31,"Jefferson County, WA",Dec-19,13335,12673,662,5.0
31939,CN5303300000000,53,33,"King County, WA",Dec-19,1287339,1255653,31686,2.5
31940,CN5303500000000,53,35,"Kitsap County, WA",Dec-19,133330,128105,5225,3.9
31941,CN5303700000000,53,37,"Kittitas County, WA",Dec-19,23687,22459,1228,5.2
31942,CN5303900000000,53,39,"Klickitat County, WA",Dec-19,9826,9253,573,5.8
31943,CN5304100000000,53,41,"Lewis County, WA",Dec-19,35394,33329,2065,5.8
31944,CN5304300000000,53,43,"Lincoln County, WA",Dec-19,5003,4755,248,5.0
31945,CN5304500000000,53,45,"Mason County, WA",Dec-19,26437,24974,1463,5.5
31946,CN5304700000000,53,47,"Okanogan County, WA",Dec-19,19101,17564,1537,8.0
31947,CN5304900000000,53,49,"Pacific County, WA",Dec-19,8596,8008,588,6.8
31948,CN5305100000000,53,51,"Pend Oreille County, WA",Dec-19,5262,4824,438,8.3
31949,CN5305300000000,53,53,"Pierce County, WA",Dec-19,454337,433261,21076,4.6
31950,CN5305500000000,53,55,"San Juan County, WA",Dec-19,8396,8096,300,3.6
31951,CN5305700000000,53,57,"Skagit County, WA",Dec-19,64046,60677,3369,5.3
31952,CN5305900000000,53,59,"Skamania County, WA",Dec-19,5684,5404,280,4.9
31953,CN5306100000000,53,61,"Snohomish County, WA",Dec-19,438317,426131,12186,2.8
31954,CN5306300000000,53,63,"Spokane County, WA",Dec-19,262855,250149,12706,4.8
31955,CN5306500000000,53,65,"Stevens County, WA",Dec-19,19605,18238,1367,7.0
31956,CN5306700000000,53,67,"Thurston County, WA",Dec-19,146960,140647,6313,4.3
31957,CN5306900000000,53,69,"Wahkiakum County, WA",Dec-19,1387,1296,91,6.6
31958,CN5307100000000,53,71,"Walla Walla County, WA",Dec-19,30288,28840,1448,4.8
31959,CN5307300000000,53,73,"Whatcom County, WA",Dec-19,117044,111560,5484,4.7
31960,CN5307500000000,53,75,"Whitman County, WA",Dec-19,24593,23662,931,3.8
31961,CN5307700000000,53,77,"Yakima County, WA",Dec-19,128962,118684,10278,8.0
31962,CN5400100000000,54,1,"Barbour County, WV",Dec-19,7374,6914,460,6.2
31963,CN5400300000000,54,3,"Berkeley County, WV",Dec-19,59885,58109,1776,3.0
31964,CN5400500000000,54,5,"Boone County, WV",Dec-19,7421,6989,432,5.8
31965,CN5400700000000,54,7,"Braxton County, WV",Dec-19,5262,4780,482,9.2
31966,CN5400900000000,54,9,"Brooke County, WV",Dec-19,9986,9453,533,5.3
31967,CN5401100000000,54,11,"Cabell County, WV",Dec-19,41681,40109,1572,3.8
31968,CN5401300000000,54,13,"Calhoun County, WV",Dec-19,2660,2198,462,17.4
31969,CN5401500000000,54,15,"Clay County, WV",Dec-19,3175,2848,327,10.3
31970,CN5401700000000,54,17,"Doddridge County, WV",Dec-19,4012,3812,200,5.0
31971,CN5401900000000,54,19,"Fayette County, WV",Dec-19,16246,15228,1018,6.3
31972,CN5402100000000,54,21,"Gilmer County, WV",Dec-19,2458,2259,199,8.1
31973,CN5402300000000,54,23,"Grant County, WV",Dec-19,5835,5509,326,5.6
31974,CN5402500000000,54,25,"Greenbrier County, WV",Dec-19,15702,14968,734,4.7
31975,CN5402700000000,54,27,"Hampshire County, WV",Dec-19,10736,10345,391,3.6
31976,CN5402900000000,54,29,"Hancock County, WV",Dec-19,13091,12403,688,5.3
31977,CN5403100000000,54,31,"Hardy County, WV",Dec-19,5757,5452,305,5.3
31978,CN5403300000000,54,33,"Harrison County, WV",Dec-19,34841,33243,1598,4.6
31979,CN5403500000000,54,35,"Jackson County, WV",Dec-19,13288,12576,712,5.4
31980,CN5403700000000,54,37,"Jefferson County, WV",Dec-19,30087,29259,828,2.8
31981,CN5403900000000,54,39,"Kanawha County, WV",Dec-19,81728,78124,3604,4.4
31982,CN5404100000000,54,41,"Lewis County, WV",Dec-19,6648,6138,510,7.7
31983,CN5404300000000,54,43,"Lincoln County, WV",Dec-19,7265,6796,469,6.5
31984,CN5404500000000,54,45,"Logan County, WV",Dec-19,11234,10517,717,6.4
31985,CN5404700000000,54,47,"McDowell County, WV",Dec-19,4461,4048,413,9.3
31986,CN5404900000000,54,49,"Marion County, WV",Dec-19,25632,24357,1275,5.0
31987,CN5405100000000,54,51,"Marshall County, WV",Dec-19,14369,13388,981,6.8
31988,CN5405300000000,54,53,"Mason County, WV",Dec-19,10183,9589,594,5.8
31989,CN5405500000000,54,55,"Mercer County, WV",Dec-19,21118,19963,1155,5.5
31990,CN5405700000000,54,57,"Mineral County, WV",Dec-19,12625,11878,747,5.9
31991,CN5405900000000,54,59,"Mingo County, WV",Dec-19,6919,6388,531,7.7
31992,CN5406100000000,54,61,"Monongalia County, WV",Dec-19,55312,53466,1846,3.3
31993,CN5406300000000,54,63,"Monroe County, WV",Dec-19,5978,5673,305,5.1
31994,CN5406500000000,54,65,"Morgan County, WV",Dec-19,8105,7829,276,3.4
31995,CN5406700000000,54,67,"Nicholas County, WV",Dec-19,9608,8854,754,7.8
31996,CN5406900000000,54,69,"Ohio County, WV",Dec-19,21417,20447,970,4.5
31997,CN5407100000000,54,71,"Pendleton County, WV",Dec-19,3664,3506,158,4.3
31998,CN5407300000000,54,73,"Pleasants County, WV",Dec-19,2974,2741,233,7.8
31999,CN5407500000000,54,75,"Pocahontas County, WV",Dec-19,4053,3844,209,5.2
32000,CN5407700000000,54,77,"Preston County, WV",Dec-19,15687,14967,720,4.6
32001,CN5407900000000,54,79,"Putnam County, WV",Dec-19,26846,25759,1087,4.0
32002,CN5408100000000,54,81,"Raleigh County, WV",Dec-19,30292,28870,1422,4.7
32003,CN5408300000000,54,83,"Randolph County, WV",Dec-19,12313,11506,807,6.6
32004,CN5408500000000,54,85,"Ritchie County, WV",Dec-19,4406,4118,288,6.5
32005,CN5408700000000,54,87,"Roane County, WV",Dec-19,5203,4654,549,10.6
32006,CN5408900000000,54,89,"Summers County, WV",Dec-19,4281,4032,249,5.8
32007,CN5409100000000,54,91,"Taylor County, WV",Dec-19,7938,7556,382,4.8
32008,CN5409300000000,54,93,"Tucker County, WV",Dec-19,3354,3146,208,6.2
32009,CN5409500000000,54,95,"Tyler County, WV",Dec-19,3122,2868,254,8.1
32010,CN5409700000000,54,97,"Upshur County, WV",Dec-19,9454,8835,619,6.5
32011,CN5409900000000,54,99,"Wayne County, WV",Dec-19,15931,15071,860,5.4
32012,CN5410100000000,54,101,"Webster County, WV",Dec-19,3351,3059,292,8.7
32013,CN5410300000000,54,103,"Wetzel County, WV",Dec-19,6732,6195,537,8.0
32014,CN5410500000000,54,105,"Wirt County, WV",Dec-19,2332,2121,211,9.0
32015,CN5410700000000,54,107,"Wood County, WV",Dec-19,37041,35194,1847,5.0
32016,CN5410900000000,54,109,"Wyoming County, WV",Dec-19,6654,6206,448,6.7
32017,CN5500100000000,55,1,"Adams County, WI",Dec-19,8056,7590,466,5.8
32018,CN5500300000000,55,3,"Ashland County, WI",Dec-19,7794,7427,367,4.7
32019,CN5500500000000,55,5,"Barron County, WI",Dec-19,24352,23227,1125,4.6
32020,CN5500700000000,55,7,"Bayfield County, WI",Dec-19,7615,7101,514,6.7
32021,CN5500900000000,55,9,"Brown County, WI",Dec-19,141028,136950,4078,2.9
32022,CN5501100000000,55,11,"Buffalo County, WI",Dec-19,6527,6203,324,5.0
32023,CN5501300000000,55,13,"Burnett County, WI",Dec-19,7048,6639,409,5.8
32024,CN5501500000000,55,15,"Calumet County, WI",Dec-19,27410,26694,716,2.6
32025,CN5501700000000,55,17,"Chippewa County, WI",Dec-19,33535,32023,1512,4.5
32026,CN5501900000000,55,19,"Clark County, WI",Dec-19,17952,17341,611,3.4
32027,CN5502100000000,55,21,"Columbia County, WI",Dec-19,31850,30902,948,3.0
32028,CN5502300000000,55,23,"Crawford County, WI",Dec-19,7716,7342,374,4.8
32029,CN5502500000000,55,25,"Dane County, WI",Dec-19,323111,316196,6915,2.1
32030,CN5502700000000,55,27,"Dodge County, WI",Dec-19,47286,45843,1443,3.1
32031,CN5502900000000,55,29,"Door County, WI",Dec-19,14243,13601,642,4.5
32032,CN5503100000000,55,31,"Douglas County, WI",Dec-19,22800,21776,1024,4.5
32033,CN5503300000000,55,33,"Dunn County, WI",Dec-19,24581,23707,874,3.6
32034,CN5503500000000,55,35,"Eau Claire County, WI",Dec-19,58787,57080,1707,2.9
32035,CN5503700000000,55,37,"Florence County, WI",Dec-19,2211,2096,115,5.2
32036,CN5503900000000,55,39,"Fond du Lac County, WI",Dec-19,56847,55325,1522,2.7
32037,CN5504100000000,55,41,"Forest County, WI",Dec-19,4020,3795,225,5.6
32038,CN5504300000000,55,43,"Grant County, WI",Dec-19,28579,27670,909,3.2
32039,CN5504500000000,55,45,"Green County, WI",Dec-19,21282,20713,569,2.7
32040,CN5504700000000,55,47,"Green Lake County, WI",Dec-19,9209,8821,388,4.2
32041,CN5504900000000,55,49,"Iowa County, WI",Dec-19,13949,13559,390,2.8
32042,CN5505100000000,55,51,"Iron County, WI",Dec-19,2551,2390,161,6.3
32043,CN5505300000000,55,53,"Jackson County, WI",Dec-19,10159,9691,468,4.6
32044,CN5505500000000,55,55,"Jefferson County, WI",Dec-19,45666,44340,1326,2.9
32045,CN5505700000000,55,57,"Juneau County, WI",Dec-19,13367,12880,487,3.6
32046,CN5505900000000,55,59,"Kenosha County, WI",Dec-19,87938,84718,3220,3.7
32047,CN5506100000000,55,61,"Kewaunee County, WI",Dec-19,11093,10751,342,3.1
32048,CN5506300000000,55,63,"La Crosse County, WI",Dec-19,66275,64492,1783,2.7
32049,CN5506500000000,55,65,"Lafayette County, WI",Dec-19,10269,10005,264,2.6
32050,CN5506700000000,55,67,"Langlade County, WI",Dec-19,9299,8859,440,4.7
32051,CN5506900000000,55,69,"Lincoln County, WI",Dec-19,15014,14442,572,3.8
32052,CN5507100000000,55,71,"Manitowoc County, WI",Dec-19,40589,39099,1490,3.7
32053,CN5507300000000,55,73,"Marathon County, WI",Dec-19,73837,71815,2022,2.7
32054,CN5507500000000,55,75,"Marinette County, WI",Dec-19,19429,18392,1037,5.3
32055,CN5507700000000,55,77,"Marquette County, WI",Dec-19,7766,7420,346,4.5
32056,CN5507800000000,55,78,"Menominee County, WI",Dec-19,1602,1497,105,6.6
32057,CN5507900000000,55,79,"Milwaukee County, WI",Dec-19,462660,445927,16733,3.6
32058,CN5508100000000,55,81,"Monroe County, WI",Dec-19,23224,22515,709,3.1
32059,CN5508300000000,55,83,"Oconto County, WI",Dec-19,20673,19874,799,3.9
32060,CN5508500000000,55,85,"Oneida County, WI",Dec-19,17381,16484,897,5.2
32061,CN5508700000000,55,87,"Outagamie County, WI",Dec-19,102182,99313,2869,2.8
32062,CN5508900000000,55,89,"Ozaukee County, WI",Dec-19,48770,47560,1210,2.5
32063,CN5509100000000,55,91,"Pepin County, WI",Dec-19,4088,3925,163,4.0
32064,CN5509300000000,55,93,"Pierce County, WI",Dec-19,25345,24422,923,3.6
32065,CN5509500000000,55,95,"Polk County, WI",Dec-19,24608,23422,1186,4.8
32066,CN5509700000000,55,97,"Portage County, WI",Dec-19,38944,37680,1264,3.2
32067,CN5509900000000,55,99,"Price County, WI",Dec-19,6522,6217,305,4.7
32068,CN5510100000000,55,101,"Racine County, WI",Dec-19,97092,93408,3684,3.8
32069,CN5510300000000,55,103,"Richland County, WI",Dec-19,9223,8952,271,2.9
32070,CN5510500000000,55,105,"Rock County, WI",Dec-19,84511,81527,2984,3.5
32071,CN5510700000000,55,107,"Rusk County, WI",Dec-19,6734,6401,333,4.9
32072,CN5510900000000,55,109,"St. Croix County, WI",Dec-19,50308,48493,1815,3.6
32073,CN5511100000000,55,111,"Sauk County, WI",Dec-19,35126,34052,1074,3.1
32074,CN5511300000000,55,113,"Sawyer County, WI",Dec-19,7785,7353,432,5.5
32075,CN5511500000000,55,115,"Shawano County, WI",Dec-19,21071,20394,677,3.2
32076,CN5511700000000,55,117,"Sheboygan County, WI",Dec-19,60696,59078,1618,2.7
32077,CN5511900000000,55,119,"Taylor County, WI",Dec-19,11041,10561,480,4.3
32078,CN5512100000000,55,121,"Trempealeau County, WI",Dec-19,15977,15353,624,3.9
32079,CN5512300000000,55,123,"Vernon County, WI",Dec-19,15365,14821,544,3.5
32080,CN5512500000000,55,125,"Vilas County, WI",Dec-19,9822,9273,549,5.6
32081,CN5512700000000,55,127,"Walworth County, WI",Dec-19,57596,55872,1724,3.0
32082,CN5512900000000,55,129,"Washburn County, WI",Dec-19,7757,7426,331,4.3
32083,CN5513100000000,55,131,"Washington County, WI",Dec-19,76628,74666,1962,2.6
32084,CN5513300000000,55,133,"Waukesha County, WI",Dec-19,223011,217182,5829,2.6
32085,CN5513500000000,55,135,"Waupaca County, WI",Dec-19,25627,24778,849,3.3
32086,CN5513700000000,55,137,"Waushara County, WI",Dec-19,11422,10952,470,4.1
32087,CN5513900000000,55,139,"Winnebago County, WI",Dec-19,91003,88444,2559,2.8
32088,CN5514100000000,55,141,"Wood County, WI",Dec-19,35122,33812,1310,3.7
32089,CN5600100000000,56,1,"Albany County, WY",Dec-19,20632,20072,560,2.7
32090,CN5600300000000,56,3,"Big Horn County, WY",Dec-19,5262,5066,196,3.7
32091,CN5600500000000,56,5,"Campbell County, WY",Dec-19,23483,22744,739,3.1
32092,CN5600700000000,56,7,"Carbon County, WY",Dec-19,7891,7605,286,3.6
32093,CN5600900000000,56,9,"Converse County, WY",Dec-19,8928,8662,266,3.0
32094,CN5601100000000,56,11,"Crook County, WY",Dec-19,3660,3551,109,3.0
32095,CN5601300000000,56,13,"Fremont County, WY",Dec-19,18735,17841,894,4.8
32096,CN5601500000000,56,15,"Goshen County, WY",Dec-19,6680,6453,227,3.4
32097,CN5601700000000,56,17,"Hot Springs County, WY",Dec-19,2137,2051,86,4.0
32098,CN5601900000000,56,19,"Johnson County, WY",Dec-19,4073,3921,152,3.7
32099,CN5602100000000,56,21,"Laramie County, WY",Dec-19,48232,46586,1646,3.4
32100,CN5602300000000,56,23,"Lincoln County, WY",Dec-19,8707,8400,307,3.5
32101,CN5602500000000,56,25,"Natrona County, WY",Dec-19,39229,37593,1636,4.2
32102,CN5602700000000,56,27,"Niobrara County, WY",Dec-19,1217,1176,41,3.4
32103,CN5602900000000,56,29,"Park County, WY",Dec-19,14721,14074,647,4.4
32104,CN5603100000000,56,31,"Platte County, WY",Dec-19,4486,4303,183,4.1
32105,CN5603300000000,56,33,"Sheridan County, WY",Dec-19,15540,15011,529,3.4
32106,CN5603500000000,56,35,"Sublette County, WY",Dec-19,4098,3892,206,5.0
32107,CN5603700000000,56,37,"Sweetwater County, WY",Dec-19,21232,20272,960,4.5
32108,CN5603900000000,56,39,"Teton County, WY",Dec-19,14971,14530,441,2.9
32109,CN5604100000000,56,41,"Uinta County, WY",Dec-19,8880,8528,352,4.0
32110,CN5604300000000,56,43,"Washakie County, WY",Dec-19,3953,3811,142,3.6
32111,CN5604500000000,56,45,"Weston County, WY",Dec-19,3793,3696,97,2.6
32112,CN7200100000000,72,1,"Adjuntas Municipio, PR",Dec-19,4154,3399,755,18.2
32113,CN7200300000000,72,3,"Aguada Municipio, PR",Dec-19,11355,10086,1269,11.2
32114,CN7200500000000,72,5,"Aguadilla Municipio, PR",Dec-19,13870,12317,1553,11.2
32115,CN7200700000000,72,7,"Aguas Buenas Municipio, PR",Dec-19,6261,5647,614,9.8
32116,CN7200900000000,72,9,"Aibonito Municipio, PR",Dec-19,6238,5542,696,11.2
32117,CN7201100000000,72,11,"Anasco Municipio, PR",Dec-19,8405,7607,798,9.5
32118,CN7201300000000,72,13,"Arecibo Municipio, PR",Dec-19,23317,20754,2563,11.0
32119,CN7201500000000,72,15,"Arroyo Municipio, PR",Dec-19,4503,3791,712,15.8
32120,CN7201700000000,72,17,"Barceloneta Municipio, PR",Dec-19,5696,5002,694,12.2
32121,CN7201900000000,72,19,"Barranquitas Municipio, PR",Dec-19,7136,6454,682,9.6
32122,CN7202100000000,72,21,"Bayamon Municipio, PR",Dec-19,62242,57905,4337,7.0
32123,CN7202300000000,72,23,"Cabo Rojo Municipio, PR",Dec-19,13057,11842,1215,9.3
32124,CN7202500000000,72,25,"Caguas Municipio, PR",Dec-19,45476,42158,3318,7.3
32125,CN7202700000000,72,27,"Camuy Municipio, PR",Dec-19,9212,8323,889,9.7
32126,CN7202900000000,72,29,"Canovanas Municipio, PR",Dec-19,15289,14190,1099,7.2
32127,CN7203100000000,72,31,"Carolina Municipio, PR",Dec-19,58554,54744,3810,6.5
32128,CN7203300000000,72,33,"Catano Municipio, PR",Dec-19,7469,6873,596,8.0
32129,CN7203500000000,72,35,"Cayey Municipio, PR",Dec-19,15386,14181,1205,7.8
32130,CN7203700000000,72,37,"Ceiba Municipio, PR",Dec-19,3503,3157,346,9.9
32131,CN7203900000000,72,39,"Ciales Municipio, PR",Dec-19,3597,3151,446,12.4
32132,CN7204100000000,72,41,"Cidra Municipio, PR",Dec-19,14728,13684,1044,7.1
32133,CN7204300000000,72,43,"Coamo Municipio, PR",Dec-19,9759,8435,1324,13.6
32134,CN7204500000000,72,45,"Comerio Municipio, PR",Dec-19,4720,4247,473,10.0
32135,CN7204700000000,72,47,"Corozal Municipio, PR",Dec-19,8577,7749,828,9.7
32136,CN7204900000000,72,49,"Culebra Municipio, PR",Dec-19,878,844,34,3.9
32137,CN7205100000000,72,51,"Dorado Municipio, PR",Dec-19,12591,11777,814,6.5
32138,CN7205300000000,72,53,"Fajardo Municipio, PR",Dec-19,10413,9289,1124,10.8
32139,CN7205400000000,72,54,"Florida Municipio, PR",Dec-19,3169,2812,357,11.3
32140,CN7205500000000,72,55,"Guanica Municipio, PR",Dec-19,4011,3361,650,16.2
32141,CN7205700000000,72,57,"Guayama Municipio, PR",Dec-19,10533,9155,1378,13.1
32142,CN7205900000000,72,59,"Guayanilla Municipio, PR",Dec-19,4782,4045,737,15.4
32143,CN7206100000000,72,61,"Guaynabo Municipio, PR",Dec-19,35754,34085,1669,4.7
32144,CN7206300000000,72,63,"Gurabo Municipio, PR",Dec-19,17146,16125,1021,6.0
32145,CN7206500000000,72,65,"Hatillo Municipio, PR",Dec-19,13585,11463,2122,15.6
32146,CN7206700000000,72,67,"Hormigueros Municipio, PR",Dec-19,5139,4648,491,9.6
32147,CN7206900000000,72,69,"Humacao Municipio, PR",Dec-19,16402,14671,1731,10.6
32148,CN7207100000000,72,71,"Isabela Municipio, PR",Dec-19,11947,10769,1178,9.9
32149,CN7207300000000,72,73,"Jayuya Municipio, PR",Dec-19,4117,3492,625,15.2
32150,CN7207500000000,72,75,"Juana Diaz Municipio, PR",Dec-19,14465,12941,1524,10.5
32151,CN7207700000000,72,77,"Juncos Municipio, PR",Dec-19,11752,10669,1083,9.2
32152,CN7207900000000,72,79,"Lajas Municipio, PR",Dec-19,5051,4394,657,13.0
32153,CN7208100000000,72,81,"Lares Municipio, PR",Dec-19,7021,5845,1176,16.7
32154,CN7208300000000,72,83,"Las Marias Municipio, PR",Dec-19,2531,2206,325,12.8
32155,CN7208500000000,72,85,"Las Piedras Municipio, PR",Dec-19,10807,9752,1055,9.8
32156,CN7208700000000,72,87,"Loiza Municipio, PR",Dec-19,8116,7368,748,9.2
32157,CN7208900000000,72,89,"Luquillo Municipio, PR",Dec-19,5920,5310,610,10.3
32158,CN7209100000000,72,91,"Manati Municipio, PR",Dec-19,11122,10149,973,8.7
32159,CN7209300000000,72,93,"Maricao Municipio, PR",Dec-19,1872,1592,280,15.0
32160,CN7209500000000,72,95,"Maunabo Municipio, PR",Dec-19,2830,2375,455,16.1
32161,CN7209700000000,72,97,"Mayaguez Municipio, PR",Dec-19,20723,18467,2256,10.9
32162,CN7209900000000,72,99,"Moca Municipio, PR",Dec-19,10007,8858,1149,11.5
32163,CN7210100000000,72,101,"Morovis Municipio, PR",Dec-19,7634,6881,753,9.9
32164,CN7210300000000,72,103,"Naguabo Municipio, PR",Dec-19,7798,7052,746,9.6
32165,CN7210500000000,72,105,"Naranjito Municipio, PR",Dec-19,6791,6138,653,9.6
32166,CN7210700000000,72,107,"Orocovis Municipio, PR",Dec-19,4791,4236,555,11.6
32167,CN7210900000000,72,109,"Patillas Municipio, PR",Dec-19,4176,3437,739,17.7
32168,CN7211100000000,72,111,"Penuelas Municipio, PR",Dec-19,5723,4847,876,15.3
32169,CN7211300000000,72,113,"Ponce Municipio, PR",Dec-19,43811,39310,4501,10.3
32170,CN7211500000000,72,115,"Quebradillas Municipio, PR",Dec-19,5876,5130,746,12.7
32171,CN7211700000000,72,117,"Rincon Municipio, PR",Dec-19,4700,3858,842,17.9
32172,CN7211900000000,72,119,"Rio Grande Municipio, PR",Dec-19,16134,14867,1267,7.9
32173,CN7212100000000,72,121,"Sabana Grande Municipio, PR",Dec-19,5897,5124,773,13.1
32174,CN7212300000000,72,123,"Salinas Municipio, PR",Dec-19,6892,5782,1110,16.1
32175,CN7212500000000,72,125,"San German Municipio, PR",Dec-19,9305,8231,1074,11.5
32176,CN7212700000000,72,127,"San Juan Municipio, PR",Dec-19,127695,119714,7981,6.3
32177,CN7212900000000,72,129,"San Lorenzo Municipio, PR",Dec-19,11193,10124,1069,9.6
32178,CN7213100000000,72,131,"San Sebastian Municipio, PR",Dec-19,10166,8599,1567,15.4
32179,CN7213300000000,72,133,"Santa Isabel Municipio, PR",Dec-19,8670,7519,1151,13.3
32180,CN7213500000000,72,135,"Toa Alta Municipio, PR",Dec-19,25770,24182,1588,6.2
32181,CN7213700000000,72,137,"Toa Baja Municipio, PR",Dec-19,27811,26032,1779,6.4
32182,CN7213900000000,72,139,"Trujillo Alto Municipio, PR",Dec-19,25706,24353,1353,5.3
32183,CN7214100000000,72,141,"Utuado Municipio, PR",Dec-19,6447,5605,842,13.1
32184,CN7214300000000,72,143,"Vega Alta Municipio, PR",Dec-19,9356,8462,894,9.6
32185,CN7214500000000,72,145,"Vega Baja Municipio, PR",Dec-19,12680,11363,1317,10.4
32186,CN7214700000000,72,147,"Vieques Municipio, PR",Dec-19,2494,2321,173,6.9
32187,CN7214900000000,72,149,"Villalba Municipio, PR",Dec-19,7372,6048,1324,18.0
32188,CN7215100000000,72,151,"Yabucoa Municipio, PR",Dec-19,8539,7284,1255,14.7
32189,CN7215300000000,72,153,"Yauco Municipio, PR",Dec-19,9719,8152,1567,16.1
32190,CN0100100000000,01,1,"Autauga County, AL",Jan-20,25912,25125,787,3.0
32191,CN0100300000000,01,3,"Baldwin County, AL",Jan-20,95316,92389,2927,3.1
32192,CN0100500000000,01,5,"Barbour County, AL",Jan-20,8509,8186,323,3.8
32193,CN0100700000000,01,7,"Bibb County, AL",Jan-20,8629,8342,287,3.3
32194,CN0100900000000,01,9,"Blount County, AL",Jan-20,25098,24352,746,3.0
32195,CN0101100000000,01,11,"Bullock County, AL",Jan-20,4674,4480,194,4.2
32196,CN0101300000000,01,13,"Butler County, AL",Jan-20,9155,8772,383,4.2
32197,CN0101500000000,01,15,"Calhoun County, AL",Jan-20,46059,44315,1744,3.8
32198,CN0101700000000,01,17,"Chambers County, AL",Jan-20,15698,15187,511,3.3
32199,CN0101900000000,01,19,"Cherokee County, AL",Jan-20,11373,10991,382,3.4
32200,CN0102100000000,01,21,"Chilton County, AL",Jan-20,19591,19032,559,2.9
32201,CN0102300000000,01,23,"Choctaw County, AL",Jan-20,4511,4269,242,5.4
32202,CN0102500000000,01,25,"Clarke County, AL",Jan-20,7406,6947,459,6.2
32203,CN0102700000000,01,27,"Clay County, AL",Jan-20,6065,5867,198,3.3
32204,CN0102900000000,01,29,"Cleburne County, AL",Jan-20,5682,5490,192,3.4
32205,CN0103100000000,01,31,"Coffee County, AL",Jan-20,21004,20349,655,3.1
32206,CN0103300000000,01,33,"Colbert County, AL",Jan-20,23275,22298,977,4.2
32207,CN0103500000000,01,35,"Conecuh County, AL",Jan-20,4440,4248,192,4.3
32208,CN0103700000000,01,37,"Coosa County, AL",Jan-20,4452,4297,155,3.5
32209,CN0103900000000,01,39,"Covington County, AL",Jan-20,15313,14758,555,3.6
32210,CN0104100000000,01,41,"Crenshaw County, AL",Jan-20,6257,6040,217,3.5
32211,CN0104300000000,01,43,"Cullman County, AL",Jan-20,38433,37341,1092,2.8
32212,CN0104500000000,01,45,"Dale County, AL",Jan-20,20496,19837,659,3.2
32213,CN0104700000000,01,47,"Dallas County, AL",Jan-20,14490,13687,803,5.5
32214,CN0104900000000,01,49,"DeKalb County, AL",Jan-20,30600,29625,975,3.2
32215,CN0105100000000,01,51,"Elmore County, AL",Jan-20,37258,36157,1101,3.0
32216,CN0105300000000,01,53,"Escambia County, AL",Jan-20,14629,14071,558,3.8
32217,CN0105500000000,01,55,"Etowah County, AL",Jan-20,42809,41025,1784,4.2
32218,CN0105700000000,01,57,"Fayette County, AL",Jan-20,6517,6290,227,3.5
32219,CN0105900000000,01,59,"Franklin County, AL",Jan-20,14531,14077,454,3.1
32220,CN0106100000000,01,61,"Geneva County, AL",Jan-20,10869,10522,347,3.2
32221,CN0106300000000,01,63,"Greene County, AL",Jan-20,2848,2681,167,5.9
32222,CN0106500000000,01,65,"Hale County, AL",Jan-20,6055,5792,263,4.3
32223,CN0106700000000,01,67,"Henry County, AL",Jan-20,6878,6619,259,3.8
32224,CN0106900000000,01,69,"Houston County, AL",Jan-20,46058,44592,1466,3.2
32225,CN0107100000000,01,71,"Jackson County, AL",Jan-20,23006,22148,858,3.7
32226,CN0107300000000,01,73,"Jefferson County, AL",Jan-20,317192,307572,9620,3.0
32227,CN0107500000000,01,75,"Lamar County, AL",Jan-20,5796,5603,193,3.3
32228,CN0107700000000,01,77,"Lauderdale County, AL",Jan-20,41767,40315,1452,3.5
32229,CN0107900000000,01,79,"Lawrence County, AL",Jan-20,14238,13762,476,3.3
32230,CN0108100000000,01,81,"Lee County, AL",Jan-20,76569,74372,2197,2.9
32231,CN0108300000000,01,83,"Limestone County, AL",Jan-20,43891,42673,1218,2.8
32232,CN0108500000000,01,85,"Lowndes County, AL",Jan-20,3523,3325,198,5.6
32233,CN0108700000000,01,87,"Macon County, AL",Jan-20,7761,7427,334,4.3
32234,CN0108900000000,01,89,"Madison County, AL",Jan-20,185774,180806,4968,2.7
32235,CN0109100000000,01,91,"Marengo County, AL",Jan-20,7580,7278,302,4.0
32236,CN0109300000000,01,93,"Marion County, AL",Jan-20,12661,12163,498,3.9
32237,CN0109500000000,01,95,"Marshall County, AL",Jan-20,43607,42436,1171,2.7
32238,CN0109700000000,01,97,"Mobile County, AL",Jan-20,188015,180522,7493,4.0
32239,CN0109900000000,01,99,"Monroe County, AL",Jan-20,7392,6993,399,5.4
32240,CN0110100000000,01,101,"Montgomery County, AL",Jan-20,104878,101390,3488,3.3
32241,CN0110300000000,01,103,"Morgan County, AL",Jan-20,58214,56599,1615,2.8
32242,CN0110500000000,01,105,"Perry County, AL",Jan-20,3329,3155,174,5.2
32243,CN0110700000000,01,107,"Pickens County, AL",Jan-20,7902,7616,286,3.6
32244,CN0110900000000,01,109,"Pike County, AL",Jan-20,15361,14824,537,3.5
32245,CN0111100000000,01,111,"Randolph County, AL",Jan-20,9530,9216,314,3.3
32246,CN0111300000000,01,113,"Russell County, AL",Jan-20,23690,22940,750,3.2
32247,CN0111500000000,01,115,"St. Clair County, AL",Jan-20,40279,39119,1160,2.9
32248,CN0111700000000,01,117,"Shelby County, AL",Jan-20,115350,112620,2730,2.4
32249,CN0111900000000,01,119,"Sumter County, AL",Jan-20,4709,4504,205,4.4
32250,CN0112100000000,01,121,"Talladega County, AL",Jan-20,35396,34082,1314,3.7
32251,CN0112300000000,01,123,"Tallapoosa County, AL",Jan-20,18248,17625,623,3.4
32252,CN0112500000000,01,125,"Tuscaloosa County, AL",Jan-20,105582,102633,2949,2.8
32253,CN0112700000000,01,127,"Walker County, AL",Jan-20,25271,24297,974,3.9
32254,CN0112900000000,01,129,"Washington County, AL",Jan-20,6737,6402,335,5.0
32255,CN0113100000000,01,131,"Wilcox County, AL",Jan-20,2758,2512,246,8.9
32256,CN0113300000000,01,133,"Winston County, AL",Jan-20,10008,9631,377,3.8
32257,CN0201300000000,02,13,"Aleutians East Borough, AK",Jan-20,1810,1734,76,4.2
32258,CN0201600000000,02,16,"Aleutians West Census Area, AK",Jan-20,3963,3830,133,3.4
32259,CN0202000000000,02,20,"Anchorage Borough/municipality, AK",Jan-20,144538,137112,7426,5.1
32260,CN0205000000000,02,50,"Bethel Census Area, AK",Jan-20,6866,5990,876,12.8
32261,CN0206000000000,02,60,"Bristol Bay Borough, AK",Jan-20,243,209,34,14.0
32262,CN0206800000000,02,68,"Denali Borough, AK",Jan-20,547,439,108,19.7
32263,CN0207000000000,02,70,"Dillingham Census Area, AK",Jan-20,1765,1611,154,8.7
32264,CN0209000000000,02,90,"Fairbanks North Star Borough, AK",Jan-20,43217,40674,2543,5.9
32265,CN0210000000000,02,100,"Haines Borough, AK",Jan-20,889,747,142,16.0
32266,CN0210500000000,02,105,"Hoonah-Angoon Census Area, AK",Jan-20,1046,878,168,16.1
32267,CN0211000000000,02,110,"Juneau Borough/city, AK",Jan-20,16310,15541,769,4.7
32268,CN0212200000000,02,122,"Kenai Peninsula Borough, AK",Jan-20,25758,23758,2000,7.8
32269,CN0213000000000,02,130,"Ketchikan Gateway Borough, AK",Jan-20,6322,5826,496,7.8
32270,CN0215000000000,02,150,"Kodiak Island Borough, AK",Jan-20,5744,5306,438,7.6
32271,CN0215800000000,02,158,"Kusilvak Census Area, AK",Jan-20,2642,2156,486,18.4
32272,CN0216400000000,02,164,"Lake and Peninsula Borough, AK",Jan-20,606,539,67,11.1
32273,CN0217000000000,02,170,"Matanuska-Susitna Borough, AK",Jan-20,46577,43126,3451,7.4
32274,CN0218000000000,02,180,"Nome Census Area, AK",Jan-20,4137,3717,420,10.2
32275,CN0218500000000,02,185,"North Slope Borough, AK",Jan-20,3592,3380,212,5.9
32276,CN0218800000000,02,188,"Northwest Arctic Borough, AK",Jan-20,2828,2447,381,13.5
32277,CN0219500000000,02,195,"Petersburg Borough, AK",Jan-20,1615,1466,149,9.2
32278,CN0219800000000,02,198,"Prince of Wales-Hyder Census Area, AK",Jan-20,3004,2722,282,9.4
32279,CN0222000000000,02,220,"Sitka Borough/city, AK",Jan-20,4111,3910,201,4.9
32280,CN0223000000000,02,230,"Skagway Municipality, AK",Jan-20,597,477,120,20.1
32281,CN0224000000000,02,240,"Southeast Fairbanks Census Area, AK",Jan-20,2814,2537,277,9.8
32282,CN0226100000000,02,261,"Valdez-Cordova Census Area, AK",Jan-20,4242,3787,455,10.7
32283,CN0227500000000,02,275,"Wrangell Borough/city, AK",Jan-20,1036,953,83,8.0
32284,CN0228200000000,02,282,"Yakutat Borough/city, AK",Jan-20,261,230,31,11.9
32285,CN0229000000000,02,290,"Yukon-Koyukuk Census Area, AK",Jan-20,2362,2037,325,13.8
32286,CN0400100000000,04,1,"Apache County, AZ",Jan-20,20785,18490,2295,11.0
32287,CN0400300000000,04,3,"Cochise County, AZ",Jan-20,51901,48897,3004,5.8
32288,CN0400500000000,04,5,"Coconino County, AZ",Jan-20,77687,72788,4899,6.3
32289,CN0400700000000,04,7,"Gila County, AZ",Jan-20,21565,20325,1240,5.8
32290,CN0400900000000,04,9,"Graham County, AZ",Jan-20,15417,14640,777,5.0
32291,CN0401100000000,04,11,"Greenlee County, AZ",Jan-20,4585,4413,172,3.8
32292,CN0401200000000,04,12,"La Paz County, AZ",Jan-20,9751,9168,583,6.0
32293,CN0401300000000,04,13,"Maricopa County, AZ",Jan-20,2360096,2266177,93919,4.0
32294,CN0401500000000,04,15,"Mohave County, AZ",Jan-20,89027,83775,5252,5.9
32295,CN0401700000000,04,17,"Navajo County, AZ",Jan-20,40989,37667,3322,8.1
32296,CN0401900000000,04,19,"Pima County, AZ",Jan-20,504206,481622,22584,4.5
32297,CN0402100000000,04,21,"Pinal County, AZ",Jan-20,192010,182584,9426,4.9
32298,CN0402300000000,04,23,"Santa Cruz County, AZ",Jan-20,20067,18466,1601,8.0
32299,CN0402500000000,04,25,"Yavapai County, AZ",Jan-20,107379,102552,4827,4.5
32300,CN0402700000000,04,27,"Yuma County, AZ",Jan-20,100806,87020,13786,13.7
32301,CN0500100000000,05,1,"Arkansas County, AR",Jan-20,9260,8924,336,3.6
32302,CN0500300000000,05,3,"Ashley County, AR",Jan-20,7675,7131,544,7.1
32303,CN0500500000000,05,5,"Baxter County, AR",Jan-20,16005,15255,750,4.7
32304,CN0500700000000,05,7,"Benton County, AR",Jan-20,137257,133215,4042,2.9
32305,CN0500900000000,05,9,"Boone County, AR",Jan-20,15882,15266,616,3.9
32306,CN0501100000000,05,11,"Bradley County, AR",Jan-20,4491,4284,207,4.6
32307,CN0501300000000,05,13,"Calhoun County, AR",Jan-20,2436,2312,124,5.1
32308,CN0501500000000,05,15,"Carroll County, AR",Jan-20,12291,11744,547,4.5
32309,CN0501700000000,05,17,"Chicot County, AR",Jan-20,3244,2959,285,8.8
32310,CN0501900000000,05,19,"Clark County, AR",Jan-20,9520,9124,396,4.2
32311,CN0502100000000,05,21,"Clay County, AR",Jan-20,5581,5247,334,6.0
32312,CN0502300000000,05,23,"Cleburne County, AR",Jan-20,8993,8478,515,5.7
32313,CN0502500000000,05,25,"Cleveland County, AR",Jan-20,3179,3015,164,5.2
32314,CN0502700000000,05,27,"Columbia County, AR",Jan-20,9109,8658,451,5.0
32315,CN0502900000000,05,29,"Conway County, AR",Jan-20,8256,7846,410,5.0
32316,CN0503100000000,05,31,"Craighead County, AR",Jan-20,55856,54045,1811,3.2
32317,CN0503300000000,05,33,"Crawford County, AR",Jan-20,26619,25597,1022,3.8
32318,CN0503500000000,05,35,"Crittenden County, AR",Jan-20,21248,20242,1006,4.7
32319,CN0503700000000,05,37,"Cross County, AR",Jan-20,7326,6968,358,4.9
32320,CN0503900000000,05,39,"Dallas County, AR",Jan-20,2815,2675,140,5.0
32321,CN0504100000000,05,41,"Desha County, AR",Jan-20,5309,5028,281,5.3
32322,CN0504300000000,05,43,"Drew County, AR",Jan-20,7883,7402,481,6.1
32323,CN0504500000000,05,45,"Faulkner County, AR",Jan-20,61559,59407,2152,3.5
32324,CN0504700000000,05,47,"Franklin County, AR",Jan-20,7394,7108,286,3.9
32325,CN0504900000000,05,49,"Fulton County, AR",Jan-20,4918,4697,221,4.5
32326,CN0505100000000,05,51,"Garland County, AR",Jan-20,40802,39115,1687,4.1
32327,CN0505300000000,05,53,"Grant County, AR",Jan-20,8319,7996,323,3.9
32328,CN0505500000000,05,55,"Greene County, AR",Jan-20,20018,19194,824,4.1
32329,CN0505700000000,05,57,"Hempstead County, AR",Jan-20,9816,9376,440,4.5
32330,CN0505900000000,05,59,"Hot Spring County, AR",Jan-20,13840,13294,546,3.9
32331,CN0506100000000,05,61,"Howard County, AR",Jan-20,5726,5493,233,4.1
32332,CN0506300000000,05,63,"Independence County, AR",Jan-20,16491,15736,755,4.6
32333,CN0506500000000,05,65,"Izard County, AR",Jan-20,4787,4474,313,6.5
32334,CN0506700000000,05,67,"Jackson County, AR",Jan-20,5813,5380,433,7.4
32335,CN0506900000000,05,69,"Jefferson County, AR",Jan-20,27208,25509,1699,6.2
32336,CN0507100000000,05,71,"Johnson County, AR",Jan-20,10172,9681,491,4.8
32337,CN0507300000000,05,73,"Lafayette County, AR",Jan-20,2452,2318,134,5.5
32338,CN0507500000000,05,75,"Lawrence County, AR",Jan-20,6834,6510,324,4.7
32339,CN0507700000000,05,77,"Lee County, AR",Jan-20,2845,2664,181,6.4
32340,CN0507900000000,05,79,"Lincoln County, AR",Jan-20,3897,3683,214,5.5
32341,CN0508100000000,05,81,"Little River County, AR",Jan-20,5528,5254,274,5.0
32342,CN0508300000000,05,83,"Logan County, AR",Jan-20,8487,8034,453,5.3
32343,CN0508500000000,05,85,"Lonoke County, AR",Jan-20,33986,32760,1226,3.6
32344,CN0508700000000,05,87,"Madison County, AR",Jan-20,7432,7223,209,2.8
32345,CN0508900000000,05,89,"Marion County, AR",Jan-20,6596,6274,322,4.9
32346,CN0509100000000,05,91,"Miller County, AR",Jan-20,19707,18830,877,4.5
32347,CN0509300000000,05,93,"Mississippi County, AR",Jan-20,17055,16062,993,5.8
32348,CN0509500000000,05,95,"Monroe County, AR",Jan-20,2768,2630,138,5.0
32349,CN0509700000000,05,97,"Montgomery County, AR",Jan-20,2877,2701,176,6.1
32350,CN0509900000000,05,99,"Nevada County, AR",Jan-20,3588,3440,148,4.1
32351,CN0510100000000,05,101,"Newton County, AR",Jan-20,3326,3165,161,4.8
32352,CN0510300000000,05,103,"Ouachita County, AR",Jan-20,9739,9181,558,5.7
32353,CN0510500000000,05,105,"Perry County, AR",Jan-20,4227,4024,203,4.8
32354,CN0510700000000,05,107,"Phillips County, AR",Jan-20,6335,5868,467,7.4
32355,CN0510900000000,05,109,"Pike County, AR",Jan-20,4209,4010,199,4.7
32356,CN0511100000000,05,111,"Poinsett County, AR",Jan-20,10379,9929,450,4.3
32357,CN0511300000000,05,113,"Polk County, AR",Jan-20,8152,7667,485,5.9
32358,CN0511500000000,05,115,"Pope County, AR",Jan-20,28533,27127,1406,4.9
32359,CN0511700000000,05,117,"Prairie County, AR",Jan-20,3537,3383,154,4.4
32360,CN0511900000000,05,119,"Pulaski County, AR",Jan-20,187545,180280,7265,3.9
32361,CN0512100000000,05,121,"Randolph County, AR",Jan-20,7356,7006,350,4.8
32362,CN0512300000000,05,123,"St. Francis County, AR",Jan-20,8076,7611,465,5.8
32363,CN0512500000000,05,125,"Saline County, AR",Jan-20,58243,56352,1891,3.2
32364,CN0512700000000,05,127,"Scott County, AR",Jan-20,4301,4129,172,4.0
32365,CN0512900000000,05,129,"Searcy County, AR",Jan-20,2794,2618,176,6.3
32366,CN0513100000000,05,131,"Sebastian County, AR",Jan-20,56107,53894,2213,3.9
32367,CN0513300000000,05,133,"Sevier County, AR",Jan-20,5479,5174,305,5.6
32368,CN0513500000000,05,135,"Sharp County, AR",Jan-20,5666,5325,341,6.0
32369,CN0513700000000,05,137,"Stone County, AR",Jan-20,4556,4284,272,6.0
32370,CN0513900000000,05,139,"Union County, AR",Jan-20,15801,14781,1020,6.5
32371,CN0514100000000,05,141,"Van Buren County, AR",Jan-20,5652,5311,341,6.0
32372,CN0514300000000,05,143,"Washington County, AR",Jan-20,124899,121521,3378,2.7
32373,CN0514500000000,05,145,"White County, AR",Jan-20,33578,31757,1821,5.4
32374,CN0514700000000,05,147,"Woodruff County, AR",Jan-20,2749,2584,165,6.0
32375,CN0514900000000,05,149,"Yell County, AR",Jan-20,8320,7956,364,4.4
32376,CN0600100000000,06,1,"Alameda County, CA",Jan-20,841256,815549,25707,3.1
32377,CN0600300000000,06,3,"Alpine County, CA",Jan-20,652,622,30,4.6
32378,CN0600500000000,06,5,"Amador County, CA",Jan-20,14858,14158,700,4.7
32379,CN0600700000000,06,7,"Butte County, CA",Jan-20,97828,92380,5448,5.6
32380,CN0600900000000,06,9,"Calaveras County, CA",Jan-20,21564,20634,930,4.3
32381,CN0601100000000,06,11,"Colusa County, CA",Jan-20,10872,8786,2086,19.2
32382,CN0601300000000,06,13,"Contra Costa County, CA",Jan-20,559573,541551,18022,3.2
32383,CN0601500000000,06,15,"Del Norte County, CA",Jan-20,9637,9007,630,6.5
32384,CN0601700000000,06,17,"El Dorado County, CA",Jan-20,92211,88755,3456,3.7
32385,CN0601900000000,06,19,"Fresno County, CA",Jan-20,452463,415814,36649,8.1
32386,CN0602100000000,06,21,"Glenn County, CA",Jan-20,13224,12256,968,7.3
32387,CN0602300000000,06,23,"Humboldt County, CA",Jan-20,61835,59314,2521,4.1
32388,CN0602500000000,06,25,"Imperial County, CA",Jan-20,72432,59415,13017,18.0
32389,CN0602700000000,06,27,"Inyo County, CA",Jan-20,8703,8364,339,3.9
32390,CN0602900000000,06,29,"Kern County, CA",Jan-20,396113,362164,33949,8.6
32391,CN0603100000000,06,31,"Kings County, CA",Jan-20,58130,52666,5464,9.4
32392,CN0603300000000,06,33,"Lake County, CA",Jan-20,29119,27369,1750,6.0
32393,CN0603500000000,06,35,"Lassen County, CA",Jan-20,9890,9333,557,5.6
32394,CN0603700000000,06,37,"Los Angeles County, CA",Jan-20,5189152,4956929,232223,4.5
32395,CN0603900000000,06,39,"Madera County, CA",Jan-20,63353,58229,5124,8.1
32396,CN0604100000000,06,41,"Marin County, CA",Jan-20,139813,136458,3355,2.4
32397,CN0604300000000,06,43,"Mariposa County, CA",Jan-20,7037,6595,442,6.3
32398,CN0604500000000,06,45,"Mendocino County, CA",Jan-20,38310,36465,1845,4.8
32399,CN0604700000000,06,47,"Merced County, CA",Jan-20,115164,103893,11271,9.8
32400,CN0604900000000,06,49,"Modoc County, CA",Jan-20,3086,2786,300,9.7
32401,CN0605100000000,06,51,"Mono County, CA",Jan-20,9120,8798,322,3.5
32402,CN0605300000000,06,53,"Monterey County, CA",Jan-20,214066,193310,20756,9.7
32403,CN0605500000000,06,55,"Napa County, CA",Jan-20,72496,69957,2539,3.5
32404,CN0605700000000,06,57,"Nevada County, CA",Jan-20,49120,47324,1796,3.7
32405,CN0605900000000,06,59,"Orange County, CA",Jan-20,1622060,1575486,46574,2.9
32406,CN0606100000000,06,61,"Placer County, CA",Jan-20,188371,182162,6209,3.3
32407,CN0606300000000,06,63,"Plumas County, CA",Jan-20,7494,6705,789,10.5
32408,CN0606500000000,06,65,"Riverside County, CA",Jan-20,1106119,1059280,46839,4.2
32409,CN0606700000000,06,67,"Sacramento County, CA",Jan-20,714155,686476,27679,3.9
32410,CN0606900000000,06,69,"San Benito County, CA",Jan-20,31509,29552,1957,6.2
32411,CN0607100000000,06,71,"San Bernardino County, CA",Jan-20,969995,932074,37921,3.9
32412,CN0607300000000,06,73,"San Diego County, CA",Jan-20,1592880,1540005,52875,3.3
32413,CN0607500000000,06,75,"San Francisco County/city, CA",Jan-20,586524,573037,13487,2.3
32414,CN0607700000000,06,77,"San Joaquin County, CA",Jan-20,325129,303299,21830,6.7
32415,CN0607900000000,06,79,"San Luis Obispo County, CA",Jan-20,141151,136743,4408,3.1
32416,CN0608100000000,06,81,"San Mateo County, CA",Jan-20,462412,452570,9842,2.1
32417,CN0608300000000,06,83,"Santa Barbara County, CA",Jan-20,214297,204278,10019,4.7
32418,CN0608500000000,06,85,"Santa Clara County, CA",Jan-20,1055619,1027950,27669,2.6
32419,CN0608700000000,06,87,"Santa Cruz County, CA",Jan-20,139625,131047,8578,6.1
32420,CN0608900000000,06,89,"Shasta County, CA",Jan-20,74561,70562,3999,5.4
32421,CN0609100000000,06,91,"Sierra County, CA",Jan-20,1316,1234,82,6.2
32422,CN0609300000000,06,93,"Siskiyou County, CA",Jan-20,17063,15645,1418,8.3
32423,CN0609500000000,06,95,"Solano County, CA",Jan-20,208963,200517,8446,4.0
32424,CN0609700000000,06,97,"Sonoma County, CA",Jan-20,258202,250592,7610,2.9
32425,CN0609900000000,06,99,"Stanislaus County, CA",Jan-20,243344,227272,16072,6.6
32426,CN0610100000000,06,101,"Sutter County, CA",Jan-20,46474,42413,4061,8.7
32427,CN0610300000000,06,103,"Tehama County, CA",Jan-20,25712,24083,1629,6.3
32428,CN0610500000000,06,105,"Trinity County, CA",Jan-20,4434,4128,306,6.9
32429,CN0610700000000,06,107,"Tulare County, CA",Jan-20,204455,182017,22438,11.0
32430,CN0610900000000,06,109,"Tuolumne County, CA",Jan-20,21457,20405,1052,4.9
32431,CN0611100000000,06,111,"Ventura County, CA",Jan-20,423012,406575,16437,3.9
32432,CN0611300000000,06,113,"Yolo County, CA",Jan-20,108995,103603,5392,4.9
32433,CN0611500000000,06,115,"Yuba County, CA",Jan-20,30949,28776,2173,7.0
32434,CN0800100000000,08,1,"Adams County, CO",Jan-20,278584,270063,8521,3.1
32435,CN0800300000000,08,3,"Alamosa County, CO",Jan-20,8428,8097,331,3.9
32436,CN0800500000000,08,5,"Arapahoe County, CO",Jan-20,372450,362251,10199,2.7
32437,CN0800700000000,08,7,"Archuleta County, CO",Jan-20,6673,6435,238,3.6
32438,CN0800900000000,08,9,"Baca County, CO",Jan-20,2086,2044,42,2.0
32439,CN0801100000000,08,11,"Bent County, CO",Jan-20,1839,1785,54,2.9
32440,CN0801300000000,08,13,"Boulder County, CO",Jan-20,196326,191678,4648,2.4
32441,CN0801400000000,08,14,"Broomfield County/city, CO",Jan-20,40970,39968,1002,2.4
32442,CN0801500000000,08,15,"Chaffee County, CO",Jan-20,9533,9270,263,2.8
32443,CN0801700000000,08,17,"Cheyenne County, CO",Jan-20,1178,1159,19,1.6
32444,CN0801900000000,08,19,"Clear Creek County, CO",Jan-20,6155,6015,140,2.3
32445,CN0802100000000,08,21,"Conejos County, CO",Jan-20,4010,3847,163,4.1
32446,CN0802300000000,08,23,"Costilla County, CO",Jan-20,1846,1770,76,4.1
32447,CN0802500000000,08,25,"Crowley County, CO",Jan-20,1514,1442,72,4.8
32448,CN0802700000000,08,27,"Custer County, CO",Jan-20,1988,1924,64,3.2
32449,CN0802900000000,08,29,"Delta County, CO",Jan-20,14247,13662,585,4.1
32450,CN0803100000000,08,31,"Denver County/city, CO",Jan-20,426054,414195,11859,2.8
32451,CN0803300000000,08,33,"Dolores County, CO",Jan-20,1119,1075,44,3.9
32452,CN0803500000000,08,35,"Douglas County, CO",Jan-20,198184,193584,4600,2.3
32453,CN0803700000000,08,37,"Eagle County, CO",Jan-20,39414,38614,800,2.0
32454,CN0803900000000,08,39,"Elbert County, CO",Jan-20,15418,15060,358,2.3
32455,CN0804100000000,08,41,"El Paso County, CO",Jan-20,343516,332208,11308,3.3
32456,CN0804300000000,08,43,"Fremont County, CO",Jan-20,14862,14131,731,4.9
32457,CN0804500000000,08,45,"Garfield County, CO",Jan-20,33557,32496,1061,3.2
32458,CN0804700000000,08,47,"Gilpin County, CO",Jan-20,3854,3764,90,2.3
32459,CN0804900000000,08,49,"Grand County, CO",Jan-20,10470,10234,236,2.3
32460,CN0805100000000,08,51,"Gunnison County, CO",Jan-20,11766,11514,252,2.1
32461,CN0805300000000,08,53,"Hinsdale County, CO",Jan-20,352,338,14,4.0
32462,CN0805500000000,08,55,"Huerfano County, CO",Jan-20,2414,2235,179,7.4
32463,CN0805700000000,08,57,"Jackson County, CO",Jan-20,918,894,24,2.6
32464,CN0805900000000,08,59,"Jefferson County, CO",Jan-20,342203,333361,8842,2.6
32465,CN0806100000000,08,61,"Kiowa County, CO",Jan-20,936,923,13,1.4
32466,CN0806300000000,08,63,"Kit Carson County, CO",Jan-20,4277,4197,80,1.9
32467,CN0806500000000,08,65,"Lake County, CO",Jan-20,5363,5257,106,2.0
32468,CN0806700000000,08,67,"La Plata County, CO",Jan-20,31340,30448,892,2.8
32469,CN0806900000000,08,69,"Larimer County, CO",Jan-20,207424,202150,5274,2.5
32470,CN0807100000000,08,71,"Las Animas County, CO",Jan-20,6434,6189,245,3.8
32471,CN0807300000000,08,73,"Lincoln County, CO",Jan-20,2317,2248,69,3.0
32472,CN0807500000000,08,75,"Logan County, CO",Jan-20,10851,10565,286,2.6
32473,CN0807700000000,08,77,"Mesa County, CO",Jan-20,75380,72294,3086,4.1
32474,CN0807900000000,08,79,"Mineral County, CO",Jan-20,566,553,13,2.3
32475,CN0808100000000,08,81,"Moffat County, CO",Jan-20,7401,7105,296,4.0
32476,CN0808300000000,08,83,"Montezuma County, CO",Jan-20,12512,11834,678,5.4
32477,CN0808500000000,08,85,"Montrose County, CO",Jan-20,21684,20951,733,3.4
32478,CN0808700000000,08,87,"Morgan County, CO",Jan-20,16310,15879,431,2.6
32479,CN0808900000000,08,89,"Otero County, CO",Jan-20,8356,8010,346,4.1
32480,CN0809100000000,08,91,"Ouray County, CO",Jan-20,2334,2258,76,3.3
32481,CN0809300000000,08,93,"Park County, CO",Jan-20,11350,11065,285,2.5
32482,CN0809500000000,08,95,"Phillips County, CO",Jan-20,2505,2462,43,1.7
32483,CN0809700000000,08,97,"Pitkin County, CO",Jan-20,11476,11198,278,2.4
32484,CN0809900000000,08,99,"Prowers County, CO",Jan-20,6237,6074,163,2.6
32485,CN0810100000000,08,101,"Pueblo County, CO",Jan-20,76303,73071,3232,4.2
32486,CN0810300000000,08,103,"Rio Blanco County, CO",Jan-20,2940,2830,110,3.7
32487,CN0810500000000,08,105,"Rio Grande County, CO",Jan-20,5330,5055,275,5.2
32488,CN0810700000000,08,107,"Routt County, CO",Jan-20,17397,17036,361,2.1
32489,CN0810900000000,08,109,"Saguache County, CO",Jan-20,3539,3374,165,4.7
32490,CN0811100000000,08,111,"San Juan County, CO",Jan-20,525,508,17,3.2
32491,CN0811300000000,08,113,"San Miguel County, CO",Jan-20,6613,6497,116,1.8
32492,CN0811500000000,08,115,"Sedgwick County, CO",Jan-20,1240,1211,29,2.3
32493,CN0811700000000,08,117,"Summit County, CO",Jan-20,26192,25777,415,1.6
32494,CN0811900000000,08,119,"Teller County, CO",Jan-20,12831,12433,398,3.1
32495,CN0812100000000,08,121,"Washington County, CO",Jan-20,2814,2752,62,2.2
32496,CN0812300000000,08,123,"Weld County, CO",Jan-20,171078,166391,4687,2.7
32497,CN0812500000000,08,125,"Yuma County, CO",Jan-20,5700,5593,107,1.9
32498,CN0900100000000,09,1,"Fairfield County, CT",Jan-20,482608,461524,21084,4.4
32499,CN0900300000000,09,3,"Hartford County, CT",Jan-20,485367,463800,21567,4.4
32500,CN0900500000000,09,5,"Litchfield County, CT",Jan-20,105903,101206,4697,4.4
32501,CN0900700000000,09,7,"Middlesex County, CT",Jan-20,94519,90691,3828,4.0
32502,CN0900900000000,09,9,"New Haven County, CT",Jan-20,463126,441901,21225,4.6
32503,CN0901100000000,09,11,"New London County, CT",Jan-20,137222,131116,6106,4.4
32504,CN0901300000000,09,13,"Tolland County, CT",Jan-20,87656,84116,3540,4.0
32505,CN0901500000000,09,15,"Windham County, CT",Jan-20,64413,61304,3109,4.8
32506,CN1000100000000,10,1,"Kent County, DE",Jan-20,80865,77207,3658,4.5
32507,CN1000300000000,10,3,"New Castle County, DE",Jan-20,299783,287848,11935,4.0
32508,CN1000500000000,10,5,"Sussex County, DE",Jan-20,105892,100843,5049,4.8
32509,CN1100100000000,11,1,District of Columbia,Jan-20,414238,393157,21081,5.1
32510,CN1200100000000,12,1,"Alachua County, FL",Jan-20,141104,136947,4157,2.9
32511,CN1200300000000,12,3,"Baker County, FL",Jan-20,11981,11597,384,3.2
32512,CN1200500000000,12,5,"Bay County, FL",Jan-20,81787,78840,2947,3.6
32513,CN1200700000000,12,7,"Bradford County, FL",Jan-20,11232,10870,362,3.2
32514,CN1200900000000,12,9,"Brevard County, FL",Jan-20,286381,277148,9233,3.2
32515,CN1201100000000,12,11,"Broward County, FL",Jan-20,1044194,1012687,31507,3.0
32516,CN1201300000000,12,13,"Calhoun County, FL",Jan-20,4792,4607,185,3.9
32517,CN1201500000000,12,15,"Charlotte County, FL",Jan-20,73176,70541,2635,3.6
32518,CN1201700000000,12,17,"Citrus County, FL",Jan-20,47294,44963,2331,4.9
32519,CN1201900000000,12,19,"Clay County, FL",Jan-20,108777,105444,3333,3.1
32520,CN1202100000000,12,21,"Collier County, FL",Jan-20,184804,179273,5531,3.0
32521,CN1202300000000,12,23,"Columbia County, FL",Jan-20,30163,29202,961,3.2
32522,CN1202700000000,12,27,"DeSoto County, FL",Jan-20,15023,14503,520,3.5
32523,CN1202900000000,12,29,"Dixie County, FL",Jan-20,5885,5653,232,3.9
32524,CN1203100000000,12,31,"Duval County, FL",Jan-20,496515,480562,15953,3.2
32525,CN1203300000000,12,33,"Escambia County, FL",Jan-20,146089,141184,4905,3.4
32526,CN1203500000000,12,35,"Flagler County, FL",Jan-20,47182,45380,1802,3.8
32527,CN1203700000000,12,37,"Franklin County, FL",Jan-20,4479,4341,138,3.1
32528,CN1203900000000,12,39,"Gadsden County, FL",Jan-20,18874,18112,762,4.0
32529,CN1204100000000,12,41,"Gilchrist County, FL",Jan-20,7232,6983,249,3.4
32530,CN1204300000000,12,43,"Glades County, FL",Jan-20,5569,5361,208,3.7
32531,CN1204500000000,12,45,"Gulf County, FL",Jan-20,5587,5356,231,4.1
32532,CN1204700000000,12,47,"Hamilton County, FL",Jan-20,4208,4011,197,4.7
32533,CN1204900000000,12,49,"Hardee County, FL",Jan-20,8992,8596,396,4.4
32534,CN1205100000000,12,51,"Hendry County, FL",Jan-20,16087,15264,823,5.1
32535,CN1205300000000,12,53,"Hernando County, FL",Jan-20,72560,69515,3045,4.2
32536,CN1205500000000,12,55,"Highlands County, FL",Jan-20,36540,34884,1656,4.5
32537,CN1205700000000,12,57,"Hillsborough County, FL",Jan-20,757966,734996,22970,3.0
32538,CN1205900000000,12,59,"Holmes County, FL",Jan-20,6998,6733,265,3.8
32539,CN1206100000000,12,61,"Indian River County, FL",Jan-20,66238,63779,2459,3.7
32540,CN1206300000000,12,63,"Jackson County, FL",Jan-20,17117,16498,619,3.6
32541,CN1206500000000,12,65,"Jefferson County, FL",Jan-20,5643,5458,185,3.3
32542,CN1206700000000,12,67,"Lafayette County, FL",Jan-20,2885,2798,87,3.0
32543,CN1206900000000,12,69,"Lake County, FL",Jan-20,160209,154961,5248,3.3
32544,CN1207100000000,12,71,"Lee County, FL",Jan-20,354113,343111,11002,3.1
32545,CN1207300000000,12,73,"Leon County, FL",Jan-20,156161,151293,4868,3.1
32546,CN1207500000000,12,75,"Levy County, FL",Jan-20,16808,16192,616,3.7
32547,CN1207700000000,12,77,"Liberty County, FL",Jan-20,2651,2561,90,3.4
32548,CN1207900000000,12,79,"Madison County, FL",Jan-20,7494,7225,269,3.6
32549,CN1208100000000,12,81,"Manatee County, FL",Jan-20,182288,176612,5676,3.1
32550,CN1208300000000,12,83,"Marion County, FL",Jan-20,138389,133040,5349,3.9
32551,CN1208500000000,12,85,"Martin County, FL",Jan-20,74972,72636,2336,3.1
32552,CN1208600000000,12,86,"Miami-Dade County, FL",Jan-20,1402897,1381396,21501,1.5
32553,CN1208700000000,12,87,"Monroe County, FL",Jan-20,47890,46897,993,2.1
32554,CN1208900000000,12,89,"Nassau County, FL",Jan-20,41645,40389,1256,3.0
32555,CN1209100000000,12,91,"Okaloosa County, FL",Jan-20,95461,92745,2716,2.8
32556,CN1209300000000,12,93,"Okeechobee County, FL",Jan-20,18158,17592,566,3.1
32557,CN1209500000000,12,95,"Orange County, FL",Jan-20,767583,745197,22386,2.9
32558,CN1209700000000,12,97,"Osceola County, FL",Jan-20,185467,179322,6145,3.3
32559,CN1209900000000,12,99,"Palm Beach County, FL",Jan-20,737808,714271,23537,3.2
32560,CN1210100000000,12,101,"Pasco County, FL",Jan-20,240208,231759,8449,3.5
32561,CN1210300000000,12,103,"Pinellas County, FL",Jan-20,498586,483666,14920,3.0
32562,CN1210500000000,12,105,"Polk County, FL",Jan-20,308117,296848,11269,3.7
32563,CN1210700000000,12,107,"Putnam County, FL",Jan-20,26578,25368,1210,4.6
32564,CN1210900000000,12,109,"St. Johns County, FL",Jan-20,133919,130325,3594,2.7
32565,CN1211100000000,12,111,"St. Lucie County, FL",Jan-20,146507,140839,5668,3.9
32566,CN1211300000000,12,113,"Santa Rosa County, FL",Jan-20,82993,80463,2530,3.0
32567,CN1211500000000,12,115,"Sarasota County, FL",Jan-20,191451,185521,5930,3.1
32568,CN1211700000000,12,117,"Seminole County, FL",Jan-20,257223,249675,7548,2.9
32569,CN1211900000000,12,119,"Sumter County, FL",Jan-20,33067,31530,1537,4.6
32570,CN1212100000000,12,121,"Suwannee County, FL",Jan-20,17961,17326,635,3.5
32571,CN1212300000000,12,123,"Taylor County, FL",Jan-20,8125,7839,286,3.5
32572,CN1212500000000,12,125,"Union County, FL",Jan-20,4680,4538,142,3.0
32573,CN1212700000000,12,127,"Volusia County, FL",Jan-20,255325,246362,8963,3.5
32574,CN1212900000000,12,129,"Wakulla County, FL",Jan-20,14992,14552,440,2.9
32575,CN1213100000000,12,131,"Walton County, FL",Jan-20,31164,30229,935,3.0
32576,CN1213300000000,12,133,"Washington County, FL",Jan-20,9573,9226,347,3.6
32577,CN1300100000000,13,1,"Appling County, GA",Jan-20,9933,9556,377,3.8
32578,CN1300300000000,13,3,"Atkinson County, GA",Jan-20,5093,4954,139,2.7
32579,CN1300500000000,13,5,"Bacon County, GA",Jan-20,5069,4880,189,3.7
32580,CN1300700000000,13,7,"Baker County, GA",Jan-20,1240,1188,52,4.2
32581,CN1300900000000,13,9,"Baldwin County, GA",Jan-20,17600,16795,805,4.6
32582,CN1301100000000,13,11,"Banks County, GA",Jan-20,9862,9577,285,2.9
32583,CN1301300000000,13,13,"Barrow County, GA",Jan-20,40897,39719,1178,2.9
32584,CN1301500000000,13,15,"Bartow County, GA",Jan-20,51285,49518,1767,3.4
32585,CN1301700000000,13,17,"Ben Hill County, GA",Jan-20,5328,5021,307,5.8
32586,CN1301900000000,13,19,"Berrien County, GA",Jan-20,7707,7354,353,4.6
32587,CN1302100000000,13,21,"Bibb County, GA",Jan-20,68066,65486,2580,3.8
32588,CN1302300000000,13,23,"Bleckley County, GA",Jan-20,4514,4292,222,4.9
32589,CN1302500000000,13,25,"Brantley County, GA",Jan-20,7230,6937,293,4.1
32590,CN1302700000000,13,27,"Brooks County, GA",Jan-20,7163,6903,260,3.6
32591,CN1302900000000,13,29,"Bryan County, GA",Jan-20,18213,17646,567,3.1
32592,CN1303100000000,13,31,"Bulloch County, GA",Jan-20,36430,35049,1381,3.8
32593,CN1303300000000,13,33,"Burke County, GA",Jan-20,9315,8819,496,5.3
32594,CN1303500000000,13,35,"Butts County, GA",Jan-20,10882,10518,364,3.3
32595,CN1303700000000,13,37,"Calhoun County, GA",Jan-20,2425,2338,87,3.6
32596,CN1303900000000,13,39,"Camden County, GA",Jan-20,20901,20132,769,3.7
32597,CN1304300000000,13,43,"Candler County, GA",Jan-20,5713,5554,159,2.8
32598,CN1304500000000,13,45,"Carroll County, GA",Jan-20,55925,53953,1972,3.5
32599,CN1304700000000,13,47,"Catoosa County, GA",Jan-20,33725,32707,1018,3.0
32600,CN1304900000000,13,49,"Charlton County, GA",Jan-20,4875,4689,186,3.8
32601,CN1305100000000,13,51,"Chatham County, GA",Jan-20,138885,134229,4656,3.4
32602,CN1305300000000,13,53,"Chattahoochee County, GA",Jan-20,2009,1923,86,4.3
32603,CN1305500000000,13,55,"Chattooga County, GA",Jan-20,10320,9822,498,4.8
32604,CN1305700000000,13,57,"Cherokee County, GA",Jan-20,137076,133387,3689,2.7
32605,CN1305900000000,13,59,"Clarke County, GA",Jan-20,59317,57259,2058,3.5
32606,CN1306100000000,13,61,"Clay County, GA",Jan-20,924,855,69,7.5
32607,CN1306300000000,13,63,"Clayton County, GA",Jan-20,139442,133537,5905,4.2
32608,CN1306500000000,13,65,"Clinch County, GA",Jan-20,2642,2536,106,4.0
32609,CN1306700000000,13,67,"Cobb County, GA",Jan-20,429391,416642,12749,3.0
32610,CN1306900000000,13,69,"Coffee County, GA",Jan-20,19155,18353,802,4.2
32611,CN1307100000000,13,71,"Colquitt County, GA",Jan-20,22076,21410,666,3.0
32612,CN1307300000000,13,73,"Columbia County, GA",Jan-20,75359,73021,2338,3.1
32613,CN1307500000000,13,75,"Cook County, GA",Jan-20,8182,7902,280,3.4
32614,CN1307700000000,13,77,"Coweta County, GA",Jan-20,75465,73252,2213,2.9
32615,CN1307900000000,13,79,"Crawford County, GA",Jan-20,5652,5471,181,3.2
32616,CN1308100000000,13,81,"Crisp County, GA",Jan-20,9632,9232,400,4.2
32617,CN1308300000000,13,83,"Dade County, GA",Jan-20,8229,7954,275,3.3
32618,CN1308500000000,13,85,"Dawson County, GA",Jan-20,12452,12102,350,2.8
32619,CN1308700000000,13,87,"Decatur County, GA",Jan-20,11921,11468,453,3.8
32620,CN1308900000000,13,89,"DeKalb County, GA",Jan-20,403372,389576,13796,3.4
32621,CN1309100000000,13,91,"Dodge County, GA",Jan-20,7043,6646,397,5.6
32622,CN1309300000000,13,93,"Dooly County, GA",Jan-20,5234,5035,199,3.8
32623,CN1309500000000,13,95,"Dougherty County, GA",Jan-20,38804,36948,1856,4.8
32624,CN1309700000000,13,97,"Douglas County, GA",Jan-20,73950,71347,2603,3.5
32625,CN1309900000000,13,99,"Early County, GA",Jan-20,4537,4345,192,4.2
32626,CN1310100000000,13,101,"Echols County, GA",Jan-20,2021,1962,59,2.9
32627,CN1310300000000,13,103,"Effingham County, GA",Jan-20,30772,29864,908,3.0
32628,CN1310500000000,13,105,"Elbert County, GA",Jan-20,7697,7367,330,4.3
32629,CN1310700000000,13,107,"Emanuel County, GA",Jan-20,8484,8051,433,5.1
32630,CN1310900000000,13,109,"Evans County, GA",Jan-20,4969,4797,172,3.5
32631,CN1311100000000,13,111,"Fannin County, GA",Jan-20,11402,11013,389,3.4
32632,CN1311300000000,13,113,"Fayette County, GA",Jan-20,58579,56872,1707,2.9
32633,CN1311500000000,13,115,"Floyd County, GA",Jan-20,44580,42857,1723,3.9
32634,CN1311700000000,13,117,"Forsyth County, GA",Jan-20,123329,120053,3276,2.7
32635,CN1311900000000,13,119,"Franklin County, GA",Jan-20,10054,9675,379,3.8
32636,CN1312100000000,13,121,"Fulton County, GA",Jan-20,562727,543329,19398,3.4
32637,CN1312300000000,13,123,"Gilmer County, GA",Jan-20,11802,11383,419,3.6
32638,CN1312500000000,13,125,"Glascock County, GA",Jan-20,1304,1252,52,4.0
32639,CN1312700000000,13,127,"Glynn County, GA",Jan-20,38821,37499,1322,3.4
32640,CN1312900000000,13,129,"Gordon County, GA",Jan-20,28449,27419,1030,3.6
32641,CN1313100000000,13,131,"Grady County, GA",Jan-20,10594,10234,360,3.4
32642,CN1313300000000,13,133,"Greene County, GA",Jan-20,6959,6684,275,4.0
32643,CN1313500000000,13,135,"Gwinnett County, GA",Jan-20,494212,479378,14834,3.0
32644,CN1313700000000,13,137,"Habersham County, GA",Jan-20,19171,18411,760,4.0
32645,CN1313900000000,13,139,"Hall County, GA",Jan-20,103144,100274,2870,2.8
32646,CN1314100000000,13,141,"Hancock County, GA",Jan-20,2546,2398,148,5.8
32647,CN1314300000000,13,143,"Haralson County, GA",Jan-20,12681,12255,426,3.4
32648,CN1314500000000,13,145,"Harris County, GA",Jan-20,16663,16147,516,3.1
32649,CN1314700000000,13,147,"Hart County, GA",Jan-20,11149,10690,459,4.1
32650,CN1314900000000,13,149,"Heard County, GA",Jan-20,5338,5146,192,3.6
32651,CN1315100000000,13,151,"Henry County, GA",Jan-20,116829,112777,4052,3.5
32652,CN1315300000000,13,153,"Houston County, GA",Jan-20,70799,68490,2309,3.3
32653,CN1315500000000,13,155,"Irwin County, GA",Jan-20,3451,3279,172,5.0
32654,CN1315700000000,13,157,"Jackson County, GA",Jan-20,36695,35700,995,2.7
32655,CN1315900000000,13,159,"Jasper County, GA",Jan-20,7050,6829,221,3.1
32656,CN1316100000000,13,161,"Jeff Davis County, GA",Jan-20,6119,5831,288,4.7
32657,CN1316300000000,13,163,"Jefferson County, GA",Jan-20,6774,6430,344,5.1
32658,CN1316500000000,13,165,"Jenkins County, GA",Jan-20,3112,2967,145,4.7
32659,CN1316700000000,13,167,"Johnson County, GA",Jan-20,4042,3881,161,4.0
32660,CN1316900000000,13,169,"Jones County, GA",Jan-20,13801,13362,439,3.2
32661,CN1317100000000,13,171,"Lamar County, GA",Jan-20,8316,7983,333,4.0
32662,CN1317300000000,13,173,"Lanier County, GA",Jan-20,3796,3641,155,4.1
32663,CN1317500000000,13,175,"Laurens County, GA",Jan-20,19031,18083,948,5.0
32664,CN1317700000000,13,177,"Lee County, GA",Jan-20,14921,14449,472,3.2
32665,CN1317900000000,13,179,"Liberty County, GA",Jan-20,26403,25393,1010,3.8
32666,CN1318100000000,13,181,"Lincoln County, GA",Jan-20,3649,3485,164,4.5
32667,CN1318300000000,13,183,"Long County, GA",Jan-20,8295,8004,291,3.5
32668,CN1318500000000,13,185,"Lowndes County, GA",Jan-20,51677,49776,1901,3.7
32669,CN1318700000000,13,187,"Lumpkin County, GA",Jan-20,16713,16204,509,3.0
32670,CN1318900000000,13,189,"McDuffie County, GA",Jan-20,8905,8442,463,5.2
32671,CN1319100000000,13,191,"McIntosh County, GA",Jan-20,6169,5964,205,3.3
32672,CN1319300000000,13,193,"Macon County, GA",Jan-20,4869,4650,219,4.5
32673,CN1319500000000,13,195,"Madison County, GA",Jan-20,13351,12928,423,3.2
32674,CN1319700000000,13,197,"Marion County, GA",Jan-20,3316,3171,145,4.4
32675,CN1319900000000,13,199,"Meriwether County, GA",Jan-20,9009,8636,373,4.1
32676,CN1320100000000,13,201,"Miller County, GA",Jan-20,2850,2752,98,3.4
32677,CN1320500000000,13,205,"Mitchell County, GA",Jan-20,8851,8431,420,4.7
32678,CN1320700000000,13,207,"Monroe County, GA",Jan-20,13086,12659,427,3.3
32679,CN1320900000000,13,209,"Montgomery County, GA",Jan-20,3838,3659,179,4.7
32680,CN1321100000000,13,211,"Morgan County, GA",Jan-20,9407,9116,291,3.1
32681,CN1321300000000,13,213,"Murray County, GA",Jan-20,15559,14696,863,5.5
32682,CN1321500000000,13,215,"Muscogee County, GA",Jan-20,77121,73701,3420,4.4
32683,CN1321700000000,13,217,"Newton County, GA",Jan-20,52779,50804,1975,3.7
32684,CN1321900000000,13,219,"Oconee County, GA",Jan-20,19571,19088,483,2.5
32685,CN1322100000000,13,221,"Oglethorpe County, GA",Jan-20,7038,6809,229,3.3
32686,CN1322300000000,13,223,"Paulding County, GA",Jan-20,87006,84398,2608,3.0
32687,CN1322500000000,13,225,"Peach County, GA",Jan-20,11986,11520,466,3.9
32688,CN1322700000000,13,227,"Pickens County, GA",Jan-20,15440,14975,465,3.0
32689,CN1322900000000,13,229,"Pierce County, GA",Jan-20,8835,8541,294,3.3
32690,CN1323100000000,13,231,"Pike County, GA",Jan-20,9024,8737,287,3.2
32691,CN1323300000000,13,233,"Polk County, GA",Jan-20,18602,17895,707,3.8
32692,CN1323500000000,13,235,"Pulaski County, GA",Jan-20,4120,3965,155,3.8
32693,CN1323700000000,13,237,"Putnam County, GA",Jan-20,8253,7896,357,4.3
32694,CN1323900000000,13,239,"Quitman County, GA",Jan-20,793,757,36,4.5
32695,CN1324100000000,13,241,"Rabun County, GA",Jan-20,6893,6641,252,3.7
32696,CN1324300000000,13,243,"Randolph County, GA",Jan-20,2612,2496,116,4.4
32697,CN1324500000000,13,245,"Richmond County, GA",Jan-20,85540,81508,4032,4.7
32698,CN1324700000000,13,247,"Rockdale County, GA",Jan-20,45219,43508,1711,3.8
32699,CN1324900000000,13,249,"Schley County, GA",Jan-20,2243,2161,82,3.7
32700,CN1325100000000,13,251,"Screven County, GA",Jan-20,5090,4868,222,4.4
32701,CN1325300000000,13,253,"Seminole County, GA",Jan-20,3092,2960,132,4.3
32702,CN1325500000000,13,255,"Spalding County, GA",Jan-20,29018,27859,1159,4.0
32703,CN1325700000000,13,257,"Stephens County, GA",Jan-20,10622,10199,423,4.0
32704,CN1325900000000,13,259,"Stewart County, GA",Jan-20,2468,2369,99,4.0
32705,CN1326100000000,13,261,"Sumter County, GA",Jan-20,13068,12401,667,5.1
32706,CN1326300000000,13,263,"Talbot County, GA",Jan-20,2800,2691,109,3.9
32707,CN1326500000000,13,265,"Taliaferro County, GA",Jan-20,571,537,34,6.0
32708,CN1326700000000,13,267,"Tattnall County, GA",Jan-20,9851,9461,390,4.0
32709,CN1326900000000,13,269,"Taylor County, GA",Jan-20,3209,3099,110,3.4
32710,CN1327100000000,13,271,"Telfair County, GA",Jan-20,4149,3746,403,9.7
32711,CN1327300000000,13,273,"Terrell County, GA",Jan-20,3555,3390,165,4.6
32712,CN1327500000000,13,275,"Thomas County, GA",Jan-20,16406,15748,658,4.0
32713,CN1327700000000,13,277,"Tift County, GA",Jan-20,20236,19563,673,3.3
32714,CN1327900000000,13,279,"Toombs County, GA",Jan-20,11799,11215,584,4.9
32715,CN1328100000000,13,281,"Towns County, GA",Jan-20,3801,3609,192,5.1
32716,CN1328300000000,13,283,"Treutlen County, GA",Jan-20,2649,2501,148,5.6
32717,CN1328500000000,13,285,"Troup County, GA",Jan-20,37502,36360,1142,3.0
32718,CN1328700000000,13,287,"Turner County, GA",Jan-20,3242,3090,152,4.7
32719,CN1328900000000,13,289,"Twiggs County, GA",Jan-20,2925,2749,176,6.0
32720,CN1329100000000,13,291,"Union County, GA",Jan-20,10360,10011,349,3.4
32721,CN1329300000000,13,293,"Upson County, GA",Jan-20,11501,11071,430,3.7
32722,CN1329500000000,13,295,"Walker County, GA",Jan-20,31544,30488,1056,3.3
32723,CN1329700000000,13,297,"Walton County, GA",Jan-20,46568,45135,1433,3.1
32724,CN1329900000000,13,299,"Ware County, GA",Jan-20,15816,15216,600,3.8
32725,CN1330100000000,13,301,"Warren County, GA",Jan-20,2890,2768,122,4.2
32726,CN1330300000000,13,303,"Washington County, GA",Jan-20,7052,6732,320,4.5
32727,CN1330500000000,13,305,"Wayne County, GA",Jan-20,11311,10848,463,4.1
32728,CN1330700000000,13,307,"Webster County, GA",Jan-20,1047,998,49,4.7
32729,CN1330900000000,13,309,"Wheeler County, GA",Jan-20,1666,1541,125,7.5
32730,CN1331100000000,13,311,"White County, GA",Jan-20,16271,15842,429,2.6
32731,CN1331300000000,13,313,"Whitfield County, GA",Jan-20,43889,41408,2481,5.7
32732,CN1331500000000,13,315,"Wilcox County, GA",Jan-20,2782,2664,118,4.2
32733,CN1331700000000,13,317,"Wilkes County, GA",Jan-20,3871,3673,198,5.1
32734,CN1331900000000,13,319,"Wilkinson County, GA",Jan-20,4022,3871,151,3.8
32735,CN1332100000000,13,321,"Worth County, GA",Jan-20,9089,8753,336,3.7
32736,CN1500100000000,15,1,"Hawaii County, HI",Jan-20,91811,88567,3244,3.5
32737,CN1500300000000,15,3,"Honolulu County/city, HI",Jan-20,457022,444395,12627,2.8
32738,CN1500700000000,15,7,"Kauai County, HI",Jan-20,36927,35833,1094,3.0
32739,CN1500900000000,15,9,"Maui County, HI",Jan-20,87694,85215,2479,2.8
32740,CN1600100000000,16,1,"Ada County, ID",Jan-20,258097,250900,7197,2.8
32741,CN1600300000000,16,3,"Adams County, ID",Jan-20,1667,1542,125,7.5
32742,CN1600500000000,16,5,"Bannock County, ID",Jan-20,42944,41477,1467,3.4
32743,CN1600700000000,16,7,"Bear Lake County, ID",Jan-20,2901,2780,121,4.2
32744,CN1600900000000,16,9,"Benewah County, ID",Jan-20,4132,3898,234,5.7
32745,CN1601100000000,16,11,"Bingham County, ID",Jan-20,23329,22536,793,3.4
32746,CN1601300000000,16,13,"Blaine County, ID",Jan-20,12656,12279,377,3.0
32747,CN1601500000000,16,15,"Boise County, ID",Jan-20,3600,3414,186,5.2
32748,CN1601700000000,16,17,"Bonner County, ID",Jan-20,20433,19377,1056,5.2
32749,CN1601900000000,16,19,"Bonneville County, ID",Jan-20,58116,56412,1704,2.9
32750,CN1602100000000,16,21,"Boundary County, ID",Jan-20,5245,4952,293,5.6
32751,CN1602300000000,16,23,"Butte County, ID",Jan-20,1396,1345,51,3.7
32752,CN1602500000000,16,25,"Camas County, ID",Jan-20,685,663,22,3.2
32753,CN1602700000000,16,27,"Canyon County, ID",Jan-20,105469,101366,4103,3.9
32754,CN1602900000000,16,29,"Caribou County, ID",Jan-20,4046,3897,149,3.7
32755,CN1603100000000,16,31,"Cassia County, ID",Jan-20,12051,11707,344,2.9
32756,CN1603300000000,16,33,"Clark County, ID",Jan-20,357,338,19,5.3
32757,CN1603500000000,16,35,"Clearwater County, ID",Jan-20,2804,2621,183,6.5
32758,CN1603700000000,16,37,"Custer County, ID",Jan-20,1997,1884,113,5.7
32759,CN1603900000000,16,39,"Elmore County, ID",Jan-20,11431,10995,436,3.8
32760,CN1604100000000,16,41,"Franklin County, ID",Jan-20,6999,6815,184,2.6
32761,CN1604300000000,16,43,"Fremont County, ID",Jan-20,7742,7453,289,3.7
32762,CN1604500000000,16,45,"Gem County, ID",Jan-20,8369,8033,336,4.0
32763,CN1604700000000,16,47,"Gooding County, ID",Jan-20,8118,7837,281,3.5
32764,CN1604900000000,16,49,"Idaho County, ID",Jan-20,6401,6046,355,5.5
32765,CN1605100000000,16,51,"Jefferson County, ID",Jan-20,14101,13676,425,3.0
32766,CN1605300000000,16,53,"Jerome County, ID",Jan-20,12105,11708,397,3.3
32767,CN1605500000000,16,55,"Kootenai County, ID",Jan-20,80656,76901,3755,4.7
32768,CN1605700000000,16,57,"Latah County, ID",Jan-20,20908,20308,600,2.9
32769,CN1605900000000,16,59,"Lemhi County, ID",Jan-20,3459,3233,226,6.5
32770,CN1606100000000,16,61,"Lewis County, ID",Jan-20,1570,1461,109,6.9
32771,CN1606300000000,16,63,"Lincoln County, ID",Jan-20,2718,2591,127,4.7
32772,CN1606500000000,16,65,"Madison County, ID",Jan-20,21741,21291,450,2.1
32773,CN1606700000000,16,67,"Minidoka County, ID",Jan-20,11236,10874,362,3.2
32774,CN1606900000000,16,69,"Nez Perce County, ID",Jan-20,21446,20670,776,3.6
32775,CN1607100000000,16,71,"Oneida County, ID",Jan-20,2286,2219,67,2.9
32776,CN1607300000000,16,73,"Owyhee County, ID",Jan-20,5196,4953,243,4.7
32777,CN1607500000000,16,75,"Payette County, ID",Jan-20,11497,11016,481,4.2
32778,CN1607700000000,16,77,"Power County, ID",Jan-20,3802,3623,179,4.7
32779,CN1607900000000,16,79,"Shoshone County, ID",Jan-20,5153,4787,366,7.1
32780,CN1608100000000,16,81,"Teton County, ID",Jan-20,6318,6174,144,2.3
32781,CN1608300000000,16,83,"Twin Falls County, ID",Jan-20,41560,40090,1470,3.5
32782,CN1608500000000,16,85,"Valley County, ID",Jan-20,5624,5371,253,4.5
32783,CN1608700000000,16,87,"Washington County, ID",Jan-20,4578,4368,210,4.6
32784,CN1700100000000,17,1,"Adams County, IL",Jan-20,31648,30590,1058,3.3
32785,CN1700300000000,17,3,"Alexander County, IL",Jan-20,2036,1922,114,5.6
32786,CN1700500000000,17,5,"Bond County, IL",Jan-20,7666,7378,288,3.8
32787,CN1700700000000,17,7,"Boone County, IL",Jan-20,26142,23607,2535,9.7
32788,CN1700900000000,17,9,"Brown County, IL",Jan-20,2944,2878,66,2.2
32789,CN1701100000000,17,11,"Bureau County, IL",Jan-20,16793,15862,931,5.5
32790,CN1701300000000,17,13,"Calhoun County, IL",Jan-20,2289,2182,107,4.7
32791,CN1701500000000,17,15,"Carroll County, IL",Jan-20,7125,6788,337,4.7
32792,CN1701700000000,17,17,"Cass County, IL",Jan-20,6002,5751,251,4.2
32793,CN1701900000000,17,19,"Champaign County, IL",Jan-20,105273,101731,3542,3.4
32794,CN1702100000000,17,21,"Christian County, IL",Jan-20,13963,13256,707,5.1
32795,CN1702300000000,17,23,"Clark County, IL",Jan-20,7441,7095,346,4.6
32796,CN1702500000000,17,25,"Clay County, IL",Jan-20,6309,5998,311,4.9
32797,CN1702700000000,17,27,"Clinton County, IL",Jan-20,20280,19626,654,3.2
32798,CN1702900000000,17,29,"Coles County, IL",Jan-20,23909,23084,825,3.5
32799,CN1703100000000,17,31,"Cook County, IL",Jan-20,2537056,2444539,92517,3.6
32800,CN1703300000000,17,33,"Crawford County, IL",Jan-20,8498,8136,362,4.3
32801,CN1703500000000,17,35,"Cumberland County, IL",Jan-20,6081,5872,209,3.4
32802,CN1703700000000,17,37,"DeKalb County, IL",Jan-20,54922,52458,2464,4.5
32803,CN1703900000000,17,39,"De Witt County, IL",Jan-20,7250,6949,301,4.2
32804,CN1704100000000,17,41,"Douglas County, IL",Jan-20,9936,9612,324,3.3
32805,CN1704300000000,17,43,"DuPage County, IL",Jan-20,496735,482721,14014,2.8
32806,CN1704500000000,17,45,"Edgar County, IL",Jan-20,8525,8179,346,4.1
32807,CN1704700000000,17,47,"Edwards County, IL",Jan-20,2619,2503,116,4.4
32808,CN1704900000000,17,49,"Effingham County, IL",Jan-20,19217,18595,622,3.2
32809,CN1705100000000,17,51,"Fayette County, IL",Jan-20,9626,9175,451,4.7
32810,CN1705300000000,17,53,"Ford County, IL",Jan-20,6127,5847,280,4.6
32811,CN1705500000000,17,55,"Franklin County, IL",Jan-20,15998,15167,831,5.2
32812,CN1705700000000,17,57,"Fulton County, IL",Jan-20,14852,13962,890,6.0
32813,CN1705900000000,17,59,"Gallatin County, IL",Jan-20,2309,2193,116,5.0
32814,CN1706100000000,17,61,"Greene County, IL",Jan-20,5827,5581,246,4.2
32815,CN1706300000000,17,63,"Grundy County, IL",Jan-20,24982,23719,1263,5.1
32816,CN1706500000000,17,65,"Hamilton County, IL",Jan-20,4335,4187,148,3.4
32817,CN1706700000000,17,67,"Hancock County, IL",Jan-20,8063,7679,384,4.8
32818,CN1706900000000,17,69,"Hardin County, IL",Jan-20,1287,1201,86,6.7
32819,CN1707100000000,17,71,"Henderson County, IL",Jan-20,3465,3293,172,5.0
32820,CN1707300000000,17,73,"Henry County, IL",Jan-20,24574,23333,1241,5.1
32821,CN1707500000000,17,75,"Iroquois County, IL",Jan-20,13822,13132,690,5.0
32822,CN1707700000000,17,77,"Jackson County, IL",Jan-20,27376,26425,951,3.5
32823,CN1707900000000,17,79,"Jasper County, IL",Jan-20,4661,4460,201,4.3
32824,CN1708100000000,17,81,"Jefferson County, IL",Jan-20,17240,16521,719,4.2
32825,CN1708300000000,17,83,"Jersey County, IL",Jan-20,10934,10457,477,4.4
32826,CN1708500000000,17,85,"Jo Daviess County, IL",Jan-20,10356,9790,566,5.5
32827,CN1708700000000,17,87,"Johnson County, IL",Jan-20,4170,3927,243,5.8
32828,CN1708900000000,17,89,"Kane County, IL",Jan-20,272714,259845,12869,4.7
32829,CN1709100000000,17,91,"Kankakee County, IL",Jan-20,55939,52918,3021,5.4
32830,CN1709300000000,17,93,"Kendall County, IL",Jan-20,67283,64940,2343,3.5
32831,CN1709500000000,17,95,"Knox County, IL",Jan-20,21038,20025,1013,4.8
32832,CN1709700000000,17,97,"Lake County, IL",Jan-20,371213,354917,16296,4.4
32833,CN1709900000000,17,99,"LaSalle County, IL",Jan-20,54389,51196,3193,5.9
32834,CN1710100000000,17,101,"Lawrence County, IL",Jan-20,5811,5520,291,5.0
32835,CN1710300000000,17,103,"Lee County, IL",Jan-20,17604,16886,718,4.1
32836,CN1710500000000,17,105,"Livingston County, IL",Jan-20,16040,15342,698,4.4
32837,CN1710700000000,17,107,"Logan County, IL",Jan-20,12293,11792,501,4.1
32838,CN1710900000000,17,109,"McDonough County, IL",Jan-20,12999,12492,507,3.9
32839,CN1711100000000,17,111,"McHenry County, IL",Jan-20,162258,156451,5807,3.6
32840,CN1711300000000,17,113,"McLean County, IL",Jan-20,86598,83713,2885,3.3
32841,CN1711500000000,17,115,"Macon County, IL",Jan-20,47733,45306,2427,5.1
32842,CN1711700000000,17,117,"Macoupin County, IL",Jan-20,22780,21825,955,4.2
32843,CN1711900000000,17,119,"Madison County, IL",Jan-20,134051,129205,4846,3.6
32844,CN1712100000000,17,121,"Marion County, IL",Jan-20,17205,16473,732,4.3
32845,CN1712300000000,17,123,"Marshall County, IL",Jan-20,5169,4893,276,5.3
32846,CN1712500000000,17,125,"Mason County, IL",Jan-20,6166,5811,355,5.8
32847,CN1712700000000,17,127,"Massac County, IL",Jan-20,5629,5328,301,5.3
32848,CN1712900000000,17,129,"Menard County, IL",Jan-20,6395,6124,271,4.2
32849,CN1713100000000,17,131,"Mercer County, IL",Jan-20,7973,7486,487,6.1
32850,CN1713300000000,17,133,"Monroe County, IL",Jan-20,18735,18205,530,2.8
32851,CN1713500000000,17,135,"Montgomery County, IL",Jan-20,11484,10792,692,6.0
32852,CN1713700000000,17,137,"Morgan County, IL",Jan-20,16091,15416,675,4.2
32853,CN1713900000000,17,139,"Moultrie County, IL",Jan-20,7468,7240,228,3.1
32854,CN1714100000000,17,141,"Ogle County, IL",Jan-20,24225,22772,1453,6.0
32855,CN1714300000000,17,143,"Peoria County, IL",Jan-20,83643,79142,4501,5.4
32856,CN1714500000000,17,145,"Perry County, IL",Jan-20,8225,7854,371,4.5
32857,CN1714700000000,17,147,"Piatt County, IL",Jan-20,8240,7947,293,3.6
32858,CN1714900000000,17,149,"Pike County, IL",Jan-20,6667,6343,324,4.9
32859,CN1715100000000,17,151,"Pope County, IL",Jan-20,1657,1570,87,5.3
32860,CN1715300000000,17,153,"Pulaski County, IL",Jan-20,1923,1803,120,6.2
32861,CN1715500000000,17,155,"Putnam County, IL",Jan-20,3095,2901,194,6.3
32862,CN1715700000000,17,157,"Randolph County, IL",Jan-20,14146,13629,517,3.7
32863,CN1715900000000,17,159,"Richland County, IL",Jan-20,7111,6836,275,3.9
32864,CN1716100000000,17,161,"Rock Island County, IL",Jan-20,70708,67171,3537,5.0
32865,CN1716300000000,17,163,"St. Clair County, IL",Jan-20,126396,121306,5090,4.0
32866,CN1716500000000,17,165,"Saline County, IL",Jan-20,9525,9004,521,5.5
32867,CN1716700000000,17,167,"Sangamon County, IL",Jan-20,99493,95679,3814,3.8
32868,CN1716900000000,17,169,"Schuyler County, IL",Jan-20,3105,2959,146,4.7
32869,CN1717100000000,17,171,"Scott County, IL",Jan-20,2462,2327,135,5.5
32870,CN1717300000000,17,173,"Shelby County, IL",Jan-20,10371,9947,424,4.1
32871,CN1717500000000,17,175,"Stark County, IL",Jan-20,2421,2280,141,5.8
32872,CN1717700000000,17,177,"Stephenson County, IL",Jan-20,21225,20181,1044,4.9
32873,CN1717900000000,17,179,"Tazewell County, IL",Jan-20,62654,59675,2979,4.8
32874,CN1718100000000,17,181,"Union County, IL",Jan-20,7371,6929,442,6.0
32875,CN1718300000000,17,183,"Vermilion County, IL",Jan-20,32407,30821,1586,4.9
32876,CN1718500000000,17,185,"Wabash County, IL",Jan-20,5865,5681,184,3.1
32877,CN1718700000000,17,187,"Warren County, IL",Jan-20,8168,7850,318,3.9
32878,CN1718900000000,17,189,"Washington County, IL",Jan-20,9680,9447,233,2.4
32879,CN1719100000000,17,191,"Wayne County, IL",Jan-20,6775,6480,295,4.4
32880,CN1719300000000,17,193,"White County, IL",Jan-20,6454,6219,235,3.6
32881,CN1719500000000,17,195,"Whiteside County, IL",Jan-20,28191,26936,1255,4.5
32882,CN1719700000000,17,197,"Will County, IL",Jan-20,350497,336465,14032,4.0
32883,CN1719900000000,17,199,"Williamson County, IL",Jan-20,31505,30172,1333,4.2
32884,CN1720100000000,17,201,"Winnebago County, IL",Jan-20,136441,125915,10526,7.7
32885,CN1720300000000,17,203,"Woodford County, IL",Jan-20,18285,17601,684,3.7
32886,CN1800100000000,18,1,"Adams County, IN",Jan-20,16917,16413,504,3.0
32887,CN1800300000000,18,3,"Allen County, IN",Jan-20,186225,179876,6349,3.4
32888,CN1800500000000,18,5,"Bartholomew County, IN",Jan-20,45195,43941,1254,2.8
32889,CN1800700000000,18,7,"Benton County, IN",Jan-20,4556,4408,148,3.2
32890,CN1800900000000,18,9,"Blackford County, IN",Jan-20,4824,4600,224,4.6
32891,CN1801100000000,18,11,"Boone County, IN",Jan-20,36390,35421,969,2.7
32892,CN1801300000000,18,13,"Brown County, IN",Jan-20,7785,7509,276,3.5
32893,CN1801500000000,18,15,"Carroll County, IN",Jan-20,10366,10013,353,3.4
32894,CN1801700000000,18,17,"Cass County, IN",Jan-20,17707,16983,724,4.1
32895,CN1801900000000,18,19,"Clark County, IN",Jan-20,62053,59922,2131,3.4
32896,CN1802100000000,18,21,"Clay County, IN",Jan-20,12010,11537,473,3.9
32897,CN1802300000000,18,23,"Clinton County, IN",Jan-20,17016,16514,502,3.0
32898,CN1802500000000,18,25,"Crawford County, IN",Jan-20,4901,4601,300,6.1
32899,CN1802700000000,18,27,"Daviess County, IN",Jan-20,16749,16245,504,3.0
32900,CN1802900000000,18,29,"Dearborn County, IN",Jan-20,25884,24853,1031,4.0
32901,CN1803100000000,18,31,"Decatur County, IN",Jan-20,14805,14319,486,3.3
32902,CN1803300000000,18,33,"DeKalb County, IN",Jan-20,22750,22054,696,3.1
32903,CN1803500000000,18,35,"Delaware County, IN",Jan-20,54379,52115,2264,4.2
32904,CN1803700000000,18,37,"Dubois County, IN",Jan-20,22959,22345,614,2.7
32905,CN1803900000000,18,39,"Elkhart County, IN",Jan-20,111926,108538,3388,3.0
32906,CN1804100000000,18,41,"Fayette County, IN",Jan-20,8546,8115,431,5.0
32907,CN1804300000000,18,43,"Floyd County, IN",Jan-20,41909,40511,1398,3.3
32908,CN1804500000000,18,45,"Fountain County, IN",Jan-20,7905,7601,304,3.8
32909,CN1804700000000,18,47,"Franklin County, IN",Jan-20,11161,10730,431,3.9
32910,CN1804900000000,18,49,"Fulton County, IN",Jan-20,9555,9153,402,4.2
32911,CN1805100000000,18,51,"Gibson County, IN",Jan-20,19652,19091,561,2.9
32912,CN1805300000000,18,53,"Grant County, IN",Jan-20,30661,29410,1251,4.1
32913,CN1805500000000,18,55,"Greene County, IN",Jan-20,13699,13061,638,4.7
32914,CN1805700000000,18,57,"Hamilton County, IN",Jan-20,184725,179840,4885,2.6
32915,CN1805900000000,18,59,"Hancock County, IN",Jan-20,40457,39212,1245,3.1
32916,CN1806100000000,18,61,"Harrison County, IN",Jan-20,20448,19729,719,3.5
32917,CN1806300000000,18,63,"Hendricks County, IN",Jan-20,90451,87898,2553,2.8
32918,CN1806500000000,18,65,"Henry County, IN",Jan-20,22040,21229,811,3.7
32919,CN1806700000000,18,67,"Howard County, IN",Jan-20,37113,35559,1554,4.2
32920,CN1806900000000,18,69,"Huntington County, IN",Jan-20,18088,17447,641,3.5
32921,CN1807100000000,18,71,"Jackson County, IN",Jan-20,22973,22323,650,2.8
32922,CN1807300000000,18,73,"Jasper County, IN",Jan-20,16285,15495,790,4.9
32923,CN1807500000000,18,75,"Jay County, IN",Jan-20,9329,9003,326,3.5
32924,CN1807700000000,18,77,"Jefferson County, IN",Jan-20,14997,14427,570,3.8
32925,CN1807900000000,18,79,"Jennings County, IN",Jan-20,13601,13075,526,3.9
32926,CN1808100000000,18,81,"Johnson County, IN",Jan-20,83411,80968,2443,2.9
32927,CN1808300000000,18,83,"Knox County, IN",Jan-20,18274,17651,623,3.4
32928,CN1808500000000,18,85,"Kosciusko County, IN",Jan-20,41858,40566,1292,3.1
32929,CN1808700000000,18,87,"LaGrange County, IN",Jan-20,19642,19104,538,2.7
32930,CN1808900000000,18,89,"Lake County, IN",Jan-20,230994,218654,12340,5.3
32931,CN1809100000000,18,91,"LaPorte County, IN",Jan-20,47539,45262,2277,4.8
32932,CN1809300000000,18,93,"Lawrence County, IN",Jan-20,21292,20397,895,4.2
32933,CN1809500000000,18,95,"Madison County, IN",Jan-20,59676,57103,2573,4.3
32934,CN1809700000000,18,97,"Marion County, IN",Jan-20,493512,476853,16659,3.4
32935,CN1809900000000,18,99,"Marshall County, IN",Jan-20,22762,21956,806,3.5
32936,CN1810100000000,18,101,"Martin County, IN",Jan-20,5380,5223,157,2.9
32937,CN1810300000000,18,103,"Miami County, IN",Jan-20,15051,14401,650,4.3
32938,CN1810500000000,18,105,"Monroe County, IN",Jan-20,71425,68947,2478,3.5
32939,CN1810700000000,18,107,"Montgomery County, IN",Jan-20,18662,18046,616,3.3
32940,CN1810900000000,18,109,"Morgan County, IN",Jan-20,36615,35326,1289,3.5
32941,CN1811100000000,18,111,"Newton County, IN",Jan-20,6930,6596,334,4.8
32942,CN1811300000000,18,113,"Noble County, IN",Jan-20,23218,22415,803,3.5
32943,CN1811500000000,18,115,"Ohio County, IN",Jan-20,3208,3078,130,4.1
32944,CN1811700000000,18,117,"Orange County, IN",Jan-20,8814,8476,338,3.8
32945,CN1811900000000,18,119,"Owen County, IN",Jan-20,9526,9113,413,4.3
32946,CN1812100000000,18,121,"Parke County, IN",Jan-20,6851,6556,295,4.3
32947,CN1812300000000,18,123,"Perry County, IN",Jan-20,9195,8861,334,3.6
32948,CN1812500000000,18,125,"Pike County, IN",Jan-20,6177,5927,250,4.0
32949,CN1812700000000,18,127,"Porter County, IN",Jan-20,87134,83349,3785,4.3
32950,CN1812900000000,18,129,"Posey County, IN",Jan-20,13546,13134,412,3.0
32951,CN1813100000000,18,131,"Pulaski County, IN",Jan-20,6410,6150,260,4.1
32952,CN1813300000000,18,133,"Putnam County, IN",Jan-20,16834,16206,628,3.7
32953,CN1813500000000,18,135,"Randolph County, IN",Jan-20,10917,10427,490,4.5
32954,CN1813700000000,18,137,"Ripley County, IN",Jan-20,14163,13636,527,3.7
32955,CN1813900000000,18,139,"Rush County, IN",Jan-20,8763,8497,266,3.0
32956,CN1814100000000,18,141,"St. Joseph County, IN",Jan-20,135921,130498,5423,4.0
32957,CN1814300000000,18,143,"Scott County, IN",Jan-20,10604,10224,380,3.6
32958,CN1814500000000,18,145,"Shelby County, IN",Jan-20,23272,22523,749,3.2
32959,CN1814700000000,18,147,"Spencer County, IN",Jan-20,10169,9772,397,3.9
32960,CN1814900000000,18,149,"Starke County, IN",Jan-20,9662,9169,493,5.1
32961,CN1815100000000,18,151,"Steuben County, IN",Jan-20,20826,20221,605,2.9
32962,CN1815300000000,18,153,"Sullivan County, IN",Jan-20,8333,7934,399,4.8
32963,CN1815500000000,18,155,"Switzerland County, IN",Jan-20,4931,4748,183,3.7
32964,CN1815700000000,18,157,"Tippecanoe County, IN",Jan-20,101370,98217,3153,3.1
32965,CN1815900000000,18,159,"Tipton County, IN",Jan-20,9069,8802,267,2.9
32966,CN1816100000000,18,161,"Union County, IN",Jan-20,3540,3413,127,3.6
32967,CN1816300000000,18,163,"Vanderburgh County, IN",Jan-20,94529,91401,3128,3.3
32968,CN1816500000000,18,165,"Vermillion County, IN",Jan-20,6964,6561,403,5.8
32969,CN1816700000000,18,167,"Vigo County, IN",Jan-20,48161,45958,2203,4.6
32970,CN1816900000000,18,169,"Wabash County, IN",Jan-20,14820,14296,524,3.5
32971,CN1817100000000,18,171,"Warren County, IN",Jan-20,4164,4028,136,3.3
32972,CN1817300000000,18,173,"Warrick County, IN",Jan-20,33074,32015,1059,3.2
32973,CN1817500000000,18,175,"Washington County, IN",Jan-20,13693,13175,518,3.8
32974,CN1817700000000,18,177,"Wayne County, IN",Jan-20,30578,29403,1175,3.8
32975,CN1817900000000,18,179,"Wells County, IN",Jan-20,14393,13935,458,3.2
32976,CN1818100000000,18,181,"White County, IN",Jan-20,13298,12896,402,3.0
32977,CN1818300000000,18,183,"Whitley County, IN",Jan-20,17750,17193,557,3.1
32978,CN1900100000000,19,1,"Adair County, IA",Jan-20,4253,4128,125,2.9
32979,CN1900300000000,19,3,"Adams County, IA",Jan-20,2190,2138,52,2.4
32980,CN1900500000000,19,5,"Allamakee County, IA",Jan-20,7600,7168,432,5.7
32981,CN1900700000000,19,7,"Appanoose County, IA",Jan-20,6047,5780,267,4.4
32982,CN1900900000000,19,9,"Audubon County, IA",Jan-20,3153,3045,108,3.4
32983,CN1901100000000,19,11,"Benton County, IA",Jan-20,13785,13243,542,3.9
32984,CN1901300000000,19,13,"Black Hawk County, IA",Jan-20,69649,66532,3117,4.5
32985,CN1901500000000,19,15,"Boone County, IA",Jan-20,15083,14604,479,3.2
32986,CN1901700000000,19,17,"Bremer County, IA",Jan-20,13982,13523,459,3.3
32987,CN1901900000000,19,19,"Buchanan County, IA",Jan-20,11424,10956,468,4.1
32988,CN1902100000000,19,21,"Buena Vista County, IA",Jan-20,12117,11807,310,2.6
32989,CN1902300000000,19,23,"Butler County, IA",Jan-20,8069,7697,372,4.6
32990,CN1902500000000,19,25,"Calhoun County, IA",Jan-20,4309,4166,143,3.3
32991,CN1902700000000,19,27,"Carroll County, IA",Jan-20,11131,10875,256,2.3
32992,CN1902900000000,19,29,"Cass County, IA",Jan-20,6986,6720,266,3.8
32993,CN1903100000000,19,31,"Cedar County, IA",Jan-20,11038,10631,407,3.7
32994,CN1903300000000,19,33,"Cerro Gordo County, IA",Jan-20,23943,23114,829,3.5
32995,CN1903500000000,19,35,"Cherokee County, IA",Jan-20,6320,6088,232,3.7
32996,CN1903700000000,19,37,"Chickasaw County, IA",Jan-20,6679,6373,306,4.6
32997,CN1903900000000,19,39,"Clarke County, IA",Jan-20,5016,4799,217,4.3
32998,CN1904100000000,19,41,"Clay County, IA",Jan-20,8693,8352,341,3.9
32999,CN1904300000000,19,43,"Clayton County, IA",Jan-20,10242,9535,707,6.9
33000,CN1904500000000,19,45,"Clinton County, IA",Jan-20,23145,22006,1139,4.9
33001,CN1904700000000,19,47,"Crawford County, IA",Jan-20,8430,7946,484,5.7
33002,CN1904900000000,19,49,"Dallas County, IA",Jan-20,50286,49049,1237,2.5
33003,CN1905100000000,19,51,"Davis County, IA",Jan-20,4302,4151,151,3.5
33004,CN1905300000000,19,53,"Decatur County, IA",Jan-20,4528,4393,135,3.0
33005,CN1905500000000,19,55,"Delaware County, IA",Jan-20,10791,10419,372,3.4
33006,CN1905700000000,19,57,"Des Moines County, IA",Jan-20,19268,18235,1033,5.4
33007,CN1905900000000,19,59,"Dickinson County, IA",Jan-20,9788,9300,488,5.0
33008,CN1906100000000,19,61,"Dubuque County, IA",Jan-20,57536,55181,2355,4.1
33009,CN1906300000000,19,63,"Emmet County, IA",Jan-20,5294,5115,179,3.4
33010,CN1906500000000,19,65,"Fayette County, IA",Jan-20,10991,10410,581,5.3
33011,CN1906700000000,19,67,"Floyd County, IA",Jan-20,8832,8367,465,5.3
33012,CN1906900000000,19,69,"Franklin County, IA",Jan-20,5752,5542,210,3.7
33013,CN1907100000000,19,71,"Fremont County, IA",Jan-20,3745,3652,93,2.5
33014,CN1907300000000,19,73,"Greene County, IA",Jan-20,5555,5414,141,2.5
33015,CN1907500000000,19,75,"Grundy County, IA",Jan-20,6587,6353,234,3.6
33016,CN1907700000000,19,77,"Guthrie County, IA",Jan-20,5767,5531,236,4.1
33017,CN1907900000000,19,79,"Hamilton County, IA",Jan-20,6965,6725,240,3.4
33018,CN1908100000000,19,81,"Hancock County, IA",Jan-20,6032,5840,192,3.2
33019,CN1908300000000,19,83,"Hardin County, IA",Jan-20,8124,7772,352,4.3
33020,CN1908500000000,19,85,"Harrison County, IA",Jan-20,7600,7361,239,3.1
33021,CN1908700000000,19,87,"Henry County, IA",Jan-20,9838,9463,375,3.8
33022,CN1908900000000,19,89,"Howard County, IA",Jan-20,5345,5122,223,4.2
33023,CN1909100000000,19,91,"Humboldt County, IA",Jan-20,5198,4997,201,3.9
33024,CN1909300000000,19,93,"Ida County, IA",Jan-20,4284,4146,138,3.2
33025,CN1909500000000,19,95,"Iowa County, IA",Jan-20,10691,10325,366,3.4
33026,CN1909700000000,19,97,"Jackson County, IA",Jan-20,11197,10635,562,5.0
33027,CN1909900000000,19,99,"Jasper County, IA",Jan-20,20134,19348,786,3.9
33028,CN1910100000000,19,101,"Jefferson County, IA",Jan-20,10389,10089,300,2.9
33029,CN1910300000000,19,103,"Johnson County, IA",Jan-20,86454,84375,2079,2.4
33030,CN1910500000000,19,105,"Jones County, IA",Jan-20,11049,10475,574,5.2
33031,CN1910700000000,19,107,"Keokuk County, IA",Jan-20,5302,5066,236,4.5
33032,CN1910900000000,19,109,"Kossuth County, IA",Jan-20,8532,8274,258,3.0
33033,CN1911100000000,19,111,"Lee County, IA",Jan-20,16341,15542,799,4.9
33034,CN1911300000000,19,113,"Linn County, IA",Jan-20,123949,119392,4557,3.7
33035,CN1911500000000,19,115,"Louisa County, IA",Jan-20,6156,5884,272,4.4
33036,CN1911700000000,19,117,"Lucas County, IA",Jan-20,4739,4617,122,2.6
33037,CN1911900000000,19,119,"Lyon County, IA",Jan-20,7177,6984,193,2.7
33038,CN1912100000000,19,121,"Madison County, IA",Jan-20,8812,8363,449,5.1
33039,CN1912300000000,19,123,"Mahaska County, IA",Jan-20,11996,11603,393,3.3
33040,CN1912500000000,19,125,"Marion County, IA",Jan-20,18489,17931,558,3.0
33041,CN1912700000000,19,127,"Marshall County, IA",Jan-20,18439,17032,1407,7.6
33042,CN1912900000000,19,129,"Mills County, IA",Jan-20,7602,7388,214,2.8
33043,CN1913100000000,19,131,"Mitchell County, IA",Jan-20,7231,7065,166,2.3
33044,CN1913300000000,19,133,"Monona County, IA",Jan-20,4523,4334,189,4.2
33045,CN1913500000000,19,135,"Monroe County, IA",Jan-20,4157,3984,173,4.2
33046,CN1913700000000,19,137,"Montgomery County, IA",Jan-20,5105,4936,169,3.3
33047,CN1913900000000,19,139,"Muscatine County, IA",Jan-20,22208,21409,799,3.6
33048,CN1914100000000,19,141,"O'Brien County, IA",Jan-20,8457,8213,244,2.9
33049,CN1914300000000,19,143,"Osceola County, IA",Jan-20,3592,3497,95,2.6
33050,CN1914500000000,19,145,"Page County, IA",Jan-20,6477,6264,213,3.3
33051,CN1914700000000,19,147,"Palo Alto County, IA",Jan-20,4839,4701,138,2.9
33052,CN1914900000000,19,149,"Plymouth County, IA",Jan-20,15095,14669,426,2.8
33053,CN1915100000000,19,151,"Pocahontas County, IA",Jan-20,4601,4482,119,2.6
33054,CN1915300000000,19,153,"Polk County, IA",Jan-20,273739,263889,9850,3.6
33055,CN1915500000000,19,155,"Pottawattamie County, IA",Jan-20,49931,48375,1556,3.1
33056,CN1915700000000,19,157,"Poweshiek County, IA",Jan-20,9769,9347,422,4.3
33057,CN1915900000000,19,159,"Ringgold County, IA",Jan-20,2501,2424,77,3.1
33058,CN1916100000000,19,161,"Sac County, IA",Jan-20,5323,5139,184,3.5
33059,CN1916300000000,19,163,"Scott County, IA",Jan-20,89821,85932,3889,4.3
33060,CN1916500000000,19,165,"Shelby County, IA",Jan-20,6810,6606,204,3.0
33061,CN1916700000000,19,167,"Sioux County, IA",Jan-20,21663,21035,628,2.9
33062,CN1916900000000,19,169,"Story County, IA",Jan-20,59036,57712,1324,2.2
33063,CN1917100000000,19,171,"Tama County, IA",Jan-20,9641,9147,494,5.1
33064,CN1917300000000,19,173,"Taylor County, IA",Jan-20,3266,3188,78,2.4
33065,CN1917500000000,19,175,"Union County, IA",Jan-20,6429,6157,272,4.2
33066,CN1917700000000,19,177,"Van Buren County, IA",Jan-20,3713,3570,143,3.9
33067,CN1917900000000,19,179,"Wapello County, IA",Jan-20,18044,17252,792,4.4
33068,CN1918100000000,19,181,"Warren County, IA",Jan-20,28853,27854,999,3.5
33069,CN1918300000000,19,183,"Washington County, IA",Jan-20,12231,11757,474,3.9
33070,CN1918500000000,19,185,"Wayne County, IA",Jan-20,2878,2791,87,3.0
33071,CN1918700000000,19,187,"Webster County, IA",Jan-20,19753,19013,740,3.7
33072,CN1918900000000,19,189,"Winnebago County, IA",Jan-20,5258,5088,170,3.2
33073,CN1919100000000,19,191,"Winneshiek County, IA",Jan-20,11888,11279,609,5.1
33074,CN1919300000000,19,193,"Woodbury County, IA",Jan-20,56694,54650,2044,3.6
33075,CN1919500000000,19,195,"Worth County, IA",Jan-20,4331,4147,184,4.2
33076,CN1919700000000,19,197,"Wright County, IA",Jan-20,7142,6924,218,3.1
33077,CN2000100000000,20,1,"Allen County, KS",Jan-20,6282,6045,237,3.8
33078,CN2000300000000,20,3,"Anderson County, KS",Jan-20,4159,4003,156,3.8
33079,CN2000500000000,20,5,"Atchison County, KS",Jan-20,6951,6583,368,5.3
33080,CN2000700000000,20,7,"Barber County, KS",Jan-20,2294,2225,69,3.0
33081,CN2000900000000,20,9,"Barton County, KS",Jan-20,13134,12633,501,3.8
33082,CN2001100000000,20,11,"Bourbon County, KS",Jan-20,6585,6282,303,4.6
33083,CN2001300000000,20,13,"Brown County, KS",Jan-20,5352,5176,176,3.3
33084,CN2001500000000,20,15,"Butler County, KS",Jan-20,32722,31559,1163,3.6
33085,CN2001700000000,20,17,"Chase County, KS",Jan-20,1536,1491,45,2.9
33086,CN2001900000000,20,19,"Chautauqua County, KS",Jan-20,1425,1373,52,3.6
33087,CN2002100000000,20,21,"Cherokee County, KS",Jan-20,10107,9784,323,3.2
33088,CN2002300000000,20,23,"Cheyenne County, KS",Jan-20,1301,1269,32,2.5
33089,CN2002500000000,20,25,"Clark County, KS",Jan-20,1080,1053,27,2.5
33090,CN2002700000000,20,27,"Clay County, KS",Jan-20,3747,3621,126,3.4
33091,CN2002900000000,20,29,"Cloud County, KS",Jan-20,3735,3609,126,3.4
33092,CN2003100000000,20,31,"Coffey County, KS",Jan-20,4161,3944,217,5.2
33093,CN2003300000000,20,33,"Comanche County, KS",Jan-20,832,807,25,3.0
33094,CN2003500000000,20,35,"Cowley County, KS",Jan-20,16109,15536,573,3.6
33095,CN2003700000000,20,37,"Crawford County, KS",Jan-20,18582,17800,782,4.2
33096,CN2003900000000,20,39,"Decatur County, KS",Jan-20,1178,1139,39,3.3
33097,CN2004100000000,20,41,"Dickinson County, KS",Jan-20,8759,8367,392,4.5
33098,CN2004300000000,20,43,"Doniphan County, KS",Jan-20,4118,3963,155,3.8
33099,CN2004500000000,20,45,"Douglas County, KS",Jan-20,65869,63756,2113,3.2
33100,CN2004700000000,20,47,"Edwards County, KS",Jan-20,1362,1327,35,2.6
33101,CN2004900000000,20,49,"Elk County, KS",Jan-20,1154,1117,37,3.2
33102,CN2005100000000,20,51,"Ellis County, KS",Jan-20,16918,16530,388,2.3
33103,CN2005300000000,20,53,"Ellsworth County, KS",Jan-20,2696,2622,74,2.7
33104,CN2005500000000,20,55,"Finney County, KS",Jan-20,20753,20292,461,2.2
33105,CN2005700000000,20,57,"Ford County, KS",Jan-20,16858,16431,427,2.5
33106,CN2005900000000,20,59,"Franklin County, KS",Jan-20,14167,13644,523,3.7
33107,CN2006100000000,20,61,"Geary County, KS",Jan-20,11275,10741,534,4.7
33108,CN2006300000000,20,63,"Gove County, KS",Jan-20,1470,1435,35,2.4
33109,CN2006500000000,20,65,"Graham County, KS",Jan-20,1080,1046,34,3.1
33110,CN2006700000000,20,67,"Grant County, KS",Jan-20,3099,3020,79,2.5
33111,CN2006900000000,20,69,"Gray County, KS",Jan-20,3121,3049,72,2.3
33112,CN2007100000000,20,71,"Greeley County, KS",Jan-20,767,752,15,2.0
33113,CN2007300000000,20,73,"Greenwood County, KS",Jan-20,3285,3162,123,3.7
33114,CN2007500000000,20,75,"Hamilton County, KS",Jan-20,1608,1578,30,1.9
33115,CN2007700000000,20,77,"Harper County, KS",Jan-20,2987,2905,82,2.7
33116,CN2007900000000,20,79,"Harvey County, KS",Jan-20,17082,16541,541,3.2
33117,CN2008100000000,20,81,"Haskell County, KS",Jan-20,2146,2101,45,2.1
33118,CN2008300000000,20,83,"Hodgeman County, KS",Jan-20,974,942,32,3.3
33119,CN2008500000000,20,85,"Jackson County, KS",Jan-20,7201,6937,264,3.7
33120,CN2008700000000,20,87,"Jefferson County, KS",Jan-20,10126,9746,380,3.8
33121,CN2008900000000,20,89,"Jewell County, KS",Jan-20,1247,1213,34,2.7
33122,CN2009100000000,20,91,"Johnson County, KS",Jan-20,341859,332373,9486,2.8
33123,CN2009300000000,20,93,"Kearny County, KS",Jan-20,1994,1949,45,2.3
33124,CN2009500000000,20,95,"Kingman County, KS",Jan-20,3424,3305,119,3.5
33125,CN2009700000000,20,97,"Kiowa County, KS",Jan-20,1268,1238,30,2.4
33126,CN2009900000000,20,99,"Labette County, KS",Jan-20,9861,9461,400,4.1
33127,CN2010100000000,20,101,"Lane County, KS",Jan-20,733,715,18,2.5
33128,CN2010300000000,20,103,"Leavenworth County, KS",Jan-20,36973,35543,1430,3.9
33129,CN2010500000000,20,105,"Lincoln County, KS",Jan-20,1726,1677,49,2.8
33130,CN2010700000000,20,107,"Linn County, KS",Jan-20,4491,4190,301,6.7
33131,CN2010900000000,20,109,"Logan County, KS",Jan-20,1596,1562,34,2.1
33132,CN2011100000000,20,111,"Lyon County, KS",Jan-20,16610,15997,613,3.7
33133,CN2011300000000,20,113,"McPherson County, KS",Jan-20,17054,16642,412,2.4
33134,CN2011500000000,20,115,"Marion County, KS",Jan-20,5871,5705,166,2.8
33135,CN2011700000000,20,117,"Marshall County, KS",Jan-20,5434,5274,160,2.9
33136,CN2011900000000,20,119,"Meade County, KS",Jan-20,2049,2000,49,2.4
33137,CN2012100000000,20,121,"Miami County, KS",Jan-20,17755,17042,713,4.0
33138,CN2012300000000,20,123,"Mitchell County, KS",Jan-20,3252,3178,74,2.3
33139,CN2012500000000,20,125,"Montgomery County, KS",Jan-20,14537,13814,723,5.0
33140,CN2012700000000,20,127,"Morris County, KS",Jan-20,3020,2917,103,3.4
33141,CN2012900000000,20,129,"Morton County, KS",Jan-20,1103,1071,32,2.9
33142,CN2013100000000,20,131,"Nemaha County, KS",Jan-20,5254,5103,151,2.9
33143,CN2013300000000,20,133,"Neosho County, KS",Jan-20,6153,5864,289,4.7
33144,CN2013500000000,20,135,"Ness County, KS",Jan-20,1312,1277,35,2.7
33145,CN2013700000000,20,137,"Norton County, KS",Jan-20,2641,2587,54,2.0
33146,CN2013900000000,20,139,"Osage County, KS",Jan-20,7984,7646,338,4.2
33147,CN2014100000000,20,141,"Osborne County, KS",Jan-20,2051,2009,42,2.0
33148,CN2014300000000,20,143,"Ottawa County, KS",Jan-20,2975,2888,87,2.9
33149,CN2014500000000,20,145,"Pawnee County, KS",Jan-20,2820,2721,99,3.5
33150,CN2014700000000,20,147,"Phillips County, KS",Jan-20,2593,2524,69,2.7
33151,CN2014900000000,20,149,"Pottawatomie County, KS",Jan-20,12306,11913,393,3.2
33152,CN2015100000000,20,151,"Pratt County, KS",Jan-20,4878,4738,140,2.9
33153,CN2015300000000,20,153,"Rawlins County, KS",Jan-20,1462,1428,34,2.3
33154,CN2015500000000,20,155,"Reno County, KS",Jan-20,29380,28383,997,3.4
33155,CN2015700000000,20,157,"Republic County, KS",Jan-20,2169,2110,59,2.7
33156,CN2015900000000,20,159,"Rice County, KS",Jan-20,5160,5017,143,2.8
33157,CN2016100000000,20,161,"Riley County, KS",Jan-20,34731,33723,1008,2.9
33158,CN2016300000000,20,163,"Rooks County, KS",Jan-20,2464,2382,82,3.3
33159,CN2016500000000,20,165,"Rush County, KS",Jan-20,1604,1554,50,3.1
33160,CN2016700000000,20,167,"Russell County, KS",Jan-20,3214,3115,99,3.1
33161,CN2016900000000,20,169,"Saline County, KS",Jan-20,30169,29122,1047,3.5
33162,CN2017100000000,20,171,"Scott County, KS",Jan-20,2783,2728,55,2.0
33163,CN2017300000000,20,173,"Sedgwick County, KS",Jan-20,253382,243656,9726,3.8
33164,CN2017500000000,20,175,"Seward County, KS",Jan-20,9184,8887,297,3.2
33165,CN2017700000000,20,177,"Shawnee County, KS",Jan-20,90603,87289,3314,3.7
33166,CN2017900000000,20,179,"Sheridan County, KS",Jan-20,1374,1337,37,2.7
33167,CN2018100000000,20,181,"Sherman County, KS",Jan-20,2731,2654,77,2.8
33168,CN2018300000000,20,183,"Smith County, KS",Jan-20,1939,1887,52,2.7
33169,CN2018500000000,20,185,"Stafford County, KS",Jan-20,2012,1948,64,3.2
33170,CN2018700000000,20,187,"Stanton County, KS",Jan-20,959,929,30,3.1
33171,CN2018900000000,20,189,"Stevens County, KS",Jan-20,2451,2379,72,2.9
33172,CN2019100000000,20,191,"Sumner County, KS",Jan-20,10923,10552,371,3.4
33173,CN2019300000000,20,193,"Thomas County, KS",Jan-20,4225,4128,97,2.3
33174,CN2019500000000,20,195,"Trego County, KS",Jan-20,1411,1364,47,3.3
33175,CN2019700000000,20,197,"Wabaunsee County, KS",Jan-20,3646,3501,145,4.0
33176,CN2019900000000,20,199,"Wallace County, KS",Jan-20,775,753,22,2.8
33177,CN2020100000000,20,201,"Washington County, KS",Jan-20,2876,2797,79,2.7
33178,CN2020300000000,20,203,"Wichita County, KS",Jan-20,1173,1144,29,2.5
33179,CN2020500000000,20,205,"Wilson County, KS",Jan-20,3945,3770,175,4.4
33180,CN2020700000000,20,207,"Woodson County, KS",Jan-20,1545,1479,66,4.3
33181,CN2020900000000,20,209,"Wyandotte County, KS",Jan-20,78141,74623,3518,4.5
33182,CN2100100000000,21,1,"Adair County, KY",Jan-20,7060,6608,452,6.4
33183,CN2100300000000,21,3,"Allen County, KY",Jan-20,9011,8608,403,4.5
33184,CN2100500000000,21,5,"Anderson County, KY",Jan-20,12152,11628,524,4.3
33185,CN2100700000000,21,7,"Ballard County, KY",Jan-20,3530,3304,226,6.4
33186,CN2100900000000,21,9,"Barren County, KY",Jan-20,18811,17835,976,5.2
33187,CN2101100000000,21,11,"Bath County, KY",Jan-20,4702,4302,400,8.5
33188,CN2101300000000,21,13,"Bell County, KY",Jan-20,8522,7859,663,7.8
33189,CN2101500000000,21,15,"Boone County, KY",Jan-20,71203,68510,2693,3.8
33190,CN2101700000000,21,17,"Bourbon County, KY",Jan-20,9766,9338,428,4.4
33191,CN2101900000000,21,19,"Boyd County, KY",Jan-20,17913,16699,1214,6.8
33192,CN2102100000000,21,21,"Boyle County, KY",Jan-20,12409,11796,613,4.9
33193,CN2102300000000,21,23,"Bracken County, KY",Jan-20,3892,3642,250,6.4
33194,CN2102500000000,21,25,"Breathitt County, KY",Jan-20,3524,3142,382,10.8
33195,CN2102700000000,21,27,"Breckinridge County, KY",Jan-20,7979,7472,507,6.4
33196,CN2102900000000,21,29,"Bullitt County, KY",Jan-20,43132,41265,1867,4.3
33197,CN2103100000000,21,31,"Butler County, KY",Jan-20,5160,4863,297,5.8
33198,CN2103300000000,21,33,"Caldwell County, KY",Jan-20,5525,5221,304,5.5
33199,CN2103500000000,21,35,"Calloway County, KY",Jan-20,18450,17632,818,4.4
33200,CN2103700000000,21,37,"Campbell County, KY",Jan-20,50985,49018,1967,3.9
33201,CN2103900000000,21,39,"Carlisle County, KY",Jan-20,2324,2215,109,4.7
33202,CN2104100000000,21,41,"Carroll County, KY",Jan-20,5261,5011,250,4.8
33203,CN2104300000000,21,43,"Carter County, KY",Jan-20,9909,8920,989,10.0
33204,CN2104500000000,21,45,"Casey County, KY",Jan-20,6760,6444,316,4.7
33205,CN2104700000000,21,47,"Christian County, KY",Jan-20,25328,23850,1478,5.8
33206,CN2104900000000,21,49,"Clark County, KY",Jan-20,17190,16393,797,4.6
33207,CN2105100000000,21,51,"Clay County, KY",Jan-20,5225,4828,397,7.6
33208,CN2105300000000,21,53,"Clinton County, KY",Jan-20,4040,3796,244,6.0
33209,CN2105500000000,21,55,"Crittenden County, KY",Jan-20,3867,3663,204,5.3
33210,CN2105700000000,21,57,"Cumberland County, KY",Jan-20,3192,3031,161,5.0
33211,CN2105900000000,21,59,"Daviess County, KY",Jan-20,47731,45639,2092,4.4
33212,CN2106100000000,21,61,"Edmonson County, KY",Jan-20,4829,4559,270,5.6
33213,CN2106300000000,21,63,"Elliott County, KY",Jan-20,2129,1888,241,11.3
33214,CN2106500000000,21,65,"Estill County, KY",Jan-20,5442,5111,331,6.1
33215,CN2106700000000,21,67,"Fayette County, KY",Jan-20,174100,167944,6156,3.5
33216,CN2106900000000,21,69,"Fleming County, KY",Jan-20,6169,5779,390,6.3
33217,CN2107100000000,21,71,"Floyd County, KY",Jan-20,11000,10136,864,7.9
33218,CN2107300000000,21,73,"Franklin County, KY",Jan-20,25410,24373,1037,4.1
33219,CN2107500000000,21,75,"Fulton County, KY",Jan-20,2045,1936,109,5.3
33220,CN2107700000000,21,77,"Gallatin County, KY",Jan-20,4105,3923,182,4.4
33221,CN2107900000000,21,79,"Garrard County, KY",Jan-20,7640,7229,411,5.4
33222,CN2108100000000,21,81,"Grant County, KY",Jan-20,11831,11246,585,4.9
33223,CN2108300000000,21,83,"Graves County, KY",Jan-20,15954,15145,809,5.1
33224,CN2108500000000,21,85,"Grayson County, KY",Jan-20,11113,10484,629,5.7
33225,CN2108700000000,21,87,"Green County, KY",Jan-20,5064,4840,224,4.4
33226,CN2108900000000,21,89,"Greenup County, KY",Jan-20,13539,12430,1109,8.2
33227,CN2109100000000,21,91,"Hancock County, KY",Jan-20,3985,3831,154,3.9
33228,CN2109300000000,21,93,"Hardin County, KY",Jan-20,49156,46920,2236,4.5
33229,CN2109500000000,21,95,"Harlan County, KY",Jan-20,6711,5883,828,12.3
33230,CN2109700000000,21,97,"Harrison County, KY",Jan-20,8853,8445,408,4.6
33231,CN2109900000000,21,99,"Hart County, KY",Jan-20,8060,7515,545,6.8
33232,CN2110100000000,21,101,"Henderson County, KY",Jan-20,22023,21116,907,4.1
33233,CN2110300000000,21,103,"Henry County, KY",Jan-20,8310,7972,338,4.1
33234,CN2110500000000,21,105,"Hickman County, KY",Jan-20,1767,1674,93,5.3
33235,CN2110700000000,21,107,"Hopkins County, KY",Jan-20,18514,17564,950,5.1
33236,CN2110900000000,21,109,"Jackson County, KY",Jan-20,4087,3790,297,7.3
33237,CN2111100000000,21,111,"Jefferson County, KY",Jan-20,402833,386328,16505,4.1
33238,CN2111300000000,21,113,"Jessamine County, KY",Jan-20,26453,25418,1035,3.9
33239,CN2111500000000,21,115,"Johnson County, KY",Jan-20,6732,6218,514,7.6
33240,CN2111700000000,21,117,"Kenton County, KY",Jan-20,88149,84652,3497,4.0
33241,CN2111900000000,21,119,"Knott County, KY",Jan-20,4482,4123,359,8.0
33242,CN2112100000000,21,121,"Knox County, KY",Jan-20,9887,9267,620,6.3
33243,CN2112300000000,21,123,"Larue County, KY",Jan-20,6017,5719,298,5.0
33244,CN2112500000000,21,125,"Laurel County, KY",Jan-20,24547,23273,1274,5.2
33245,CN2112700000000,21,127,"Lawrence County, KY",Jan-20,5301,4846,455,8.6
33246,CN2112900000000,21,129,"Lee County, KY",Jan-20,2107,1968,139,6.6
33247,CN2113100000000,21,131,"Leslie County, KY",Jan-20,2780,2445,335,12.1
33248,CN2113300000000,21,133,"Letcher County, KY",Jan-20,6439,5834,605,9.4
33249,CN2113500000000,21,135,"Lewis County, KY",Jan-20,4761,4249,512,10.8
33250,CN2113700000000,21,137,"Lincoln County, KY",Jan-20,9231,8722,509,5.5
33251,CN2113900000000,21,139,"Livingston County, KY",Jan-20,3671,3433,238,6.5
33252,CN2114100000000,21,141,"Logan County, KY",Jan-20,12659,12092,567,4.5
33253,CN2114300000000,21,143,"Lyon County, KY",Jan-20,3037,2872,165,5.4
33254,CN2114500000000,21,145,"McCracken County, KY",Jan-20,29263,27646,1617,5.5
33255,CN2114700000000,21,147,"McCreary County, KY",Jan-20,4714,4370,344,7.3
33256,CN2114900000000,21,149,"McLean County, KY",Jan-20,4248,4038,210,4.9
33257,CN2115100000000,21,151,"Madison County, KY",Jan-20,47255,45321,1934,4.1
33258,CN2115300000000,21,153,"Magoffin County, KY",Jan-20,3360,2864,496,14.8
33259,CN2115500000000,21,155,"Marion County, KY",Jan-20,9718,9336,382,3.9
33260,CN2115700000000,21,157,"Marshall County, KY",Jan-20,15022,14214,808,5.4
33261,CN2115900000000,21,159,"Martin County, KY",Jan-20,2791,2540,251,9.0
33262,CN2116100000000,21,161,"Mason County, KY",Jan-20,7102,6637,465,6.5
33263,CN2116300000000,21,163,"Meade County, KY",Jan-20,12324,11682,642,5.2
33264,CN2116500000000,21,165,"Menifee County, KY",Jan-20,2352,2136,216,9.2
33265,CN2116700000000,21,167,"Mercer County, KY",Jan-20,9931,9410,521,5.2
33266,CN2116900000000,21,169,"Metcalfe County, KY",Jan-20,4136,3885,251,6.1
33267,CN2117100000000,21,171,"Monroe County, KY",Jan-20,4748,4535,213,4.5
33268,CN2117300000000,21,173,"Montgomery County, KY",Jan-20,11677,10949,728,6.2
33269,CN2117500000000,21,175,"Morgan County, KY",Jan-20,4656,4316,340,7.3
33270,CN2117700000000,21,177,"Muhlenberg County, KY",Jan-20,10419,9651,768,7.4
33271,CN2117900000000,21,179,"Nelson County, KY",Jan-20,23346,22253,1093,4.7
33272,CN2118100000000,21,181,"Nicholas County, KY",Jan-20,3332,3152,180,5.4
33273,CN2118300000000,21,183,"Ohio County, KY",Jan-20,9906,9293,613,6.2
33274,CN2118500000000,21,185,"Oldham County, KY",Jan-20,33539,32406,1133,3.4
33275,CN2118700000000,21,187,"Owen County, KY",Jan-20,5120,4870,250,4.9
33276,CN2118900000000,21,189,"Owsley County, KY",Jan-20,1147,1066,81,7.1
33277,CN2119100000000,21,191,"Pendleton County, KY",Jan-20,7065,6728,337,4.8
33278,CN2119300000000,21,193,"Perry County, KY",Jan-20,8367,7674,693,8.3
33279,CN2119500000000,21,195,"Pike County, KY",Jan-20,19892,18404,1488,7.5
33280,CN2119700000000,21,197,"Powell County, KY",Jan-20,5059,4715,344,6.8
33281,CN2119900000000,21,199,"Pulaski County, KY",Jan-20,26813,25418,1395,5.2
33282,CN2120100000000,21,201,"Robertson County, KY",Jan-20,831,782,49,5.9
33283,CN2120300000000,21,203,"Rockcastle County, KY",Jan-20,6702,6340,362,5.4
33284,CN2120500000000,21,205,"Rowan County, KY",Jan-20,10525,9893,632,6.0
33285,CN2120700000000,21,207,"Russell County, KY",Jan-20,6247,5845,402,6.4
33286,CN2120900000000,21,209,"Scott County, KY",Jan-20,29015,27907,1108,3.8
33287,CN2121100000000,21,211,"Shelby County, KY",Jan-20,25662,24779,883,3.4
33288,CN2121300000000,21,213,"Simpson County, KY",Jan-20,8982,8548,434,4.8
33289,CN2121500000000,21,215,"Spencer County, KY",Jan-20,10295,9907,388,3.8
33290,CN2121700000000,21,217,"Taylor County, KY",Jan-20,12538,11971,567,4.5
33291,CN2121900000000,21,219,"Todd County, KY",Jan-20,5501,5248,253,4.6
33292,CN2122100000000,21,221,"Trigg County, KY",Jan-20,6108,5774,334,5.5
33293,CN2122300000000,21,223,"Trimble County, KY",Jan-20,3917,3731,186,4.7
33294,CN2122500000000,21,225,"Union County, KY",Jan-20,6214,5911,303,4.9
33295,CN2122700000000,21,227,"Warren County, KY",Jan-20,64948,62173,2775,4.3
33296,CN2122900000000,21,229,"Washington County, KY",Jan-20,6314,6050,264,4.2
33297,CN2123100000000,21,231,"Wayne County, KY",Jan-20,7509,7038,471,6.3
33298,CN2123300000000,21,233,"Webster County, KY",Jan-20,5608,5336,272,4.9
33299,CN2123500000000,21,235,"Whitley County, KY",Jan-20,13640,12891,749,5.5
33300,CN2123700000000,21,237,"Wolfe County, KY",Jan-20,2013,1827,186,9.2
33301,CN2123900000000,21,239,"Woodford County, KY",Jan-20,14862,14336,526,3.5
33302,CN2200100000000,22,1,"Acadia Parish, LA",Jan-20,23619,22161,1458,6.2
33303,CN2200300000000,22,3,"Allen Parish, LA",Jan-20,8968,8322,646,7.2
33304,CN2200500000000,22,5,"Ascension Parish, LA",Jan-20,64241,61136,3105,4.8
33305,CN2200700000000,22,7,"Assumption Parish, LA",Jan-20,8921,8251,670,7.5
33306,CN2200900000000,22,9,"Avoyelles Parish, LA",Jan-20,14984,13897,1087,7.3
33307,CN2201100000000,22,11,"Beauregard Parish, LA",Jan-20,14567,13630,937,6.4
33308,CN2201300000000,22,13,"Bienville Parish, LA",Jan-20,5493,5112,381,6.9
33309,CN2201500000000,22,15,"Bossier Parish, LA",Jan-20,57460,54562,2898,5.0
33310,CN2201700000000,22,17,"Caddo Parish, LA",Jan-20,103314,96887,6427,6.2
33311,CN2201900000000,22,19,"Calcasieu Parish, LA",Jan-20,103482,98016,5466,5.3
33312,CN2202100000000,22,21,"Caldwell Parish, LA",Jan-20,3781,3462,319,8.4
33313,CN2202300000000,22,23,"Cameron Parish, LA",Jan-20,3832,3643,189,4.9
33314,CN2202500000000,22,25,"Catahoula Parish, LA",Jan-20,3355,3110,245,7.3
33315,CN2202700000000,22,27,"Claiborne Parish, LA",Jan-20,5863,5447,416,7.1
33316,CN2202900000000,22,29,"Concordia Parish, LA",Jan-20,7099,6546,553,7.8
33317,CN2203100000000,22,31,"De Soto Parish, LA",Jan-20,10880,10081,799,7.3
33318,CN2203300000000,22,33,"East Baton Rouge Parish, LA",Jan-20,231590,219712,11878,5.1
33319,CN2203500000000,22,35,"East Carroll Parish, LA",Jan-20,1862,1627,235,12.6
33320,CN2203700000000,22,37,"East Feliciana Parish, LA",Jan-20,7976,7563,413,5.2
33321,CN2203900000000,22,39,"Evangeline Parish, LA",Jan-20,11712,10890,822,7.0
33322,CN2204100000000,22,41,"Franklin Parish, LA",Jan-20,7319,6675,644,8.8
33323,CN2204300000000,22,43,"Grant Parish, LA",Jan-20,8181,7602,579,7.1
33324,CN2204500000000,22,45,"Iberia Parish, LA",Jan-20,27913,26100,1813,6.5
33325,CN2204700000000,22,47,"Iberville Parish, LA",Jan-20,14119,13131,988,7.0
33326,CN2204900000000,22,49,"Jackson Parish, LA",Jan-20,6782,6403,379,5.6
33327,CN2205100000000,22,51,"Jefferson Parish, LA",Jan-20,215328,205031,10297,4.8
33328,CN2205300000000,22,53,"Jefferson Davis Parish, LA",Jan-20,13064,12310,754,5.8
33329,CN2205500000000,22,55,"Lafayette Parish, LA",Jan-20,113183,107282,5901,5.2
33330,CN2205700000000,22,57,"Lafourche Parish, LA",Jan-20,41763,39552,2211,5.3
33331,CN2205900000000,22,59,"LaSalle Parish, LA",Jan-20,6808,6468,340,5.0
33332,CN2206100000000,22,61,"Lincoln Parish, LA",Jan-20,21986,20617,1369,6.2
33333,CN2206300000000,22,63,"Livingston Parish, LA",Jan-20,68910,65622,3288,4.8
33334,CN2206500000000,22,65,"Madison Parish, LA",Jan-20,3453,3121,332,9.6
33335,CN2206700000000,22,67,"Morehouse Parish, LA",Jan-20,10109,9028,1081,10.7
33336,CN2206900000000,22,69,"Natchitoches Parish, LA",Jan-20,16000,14874,1126,7.0
33337,CN2207100000000,22,71,"Orleans Parish, LA",Jan-20,180237,170249,9988,5.5
33338,CN2207300000000,22,73,"Ouachita Parish, LA",Jan-20,70168,65733,4435,6.3
33339,CN2207500000000,22,75,"Plaquemines Parish, LA",Jan-20,10078,9564,514,5.1
33340,CN2207700000000,22,77,"Pointe Coupee Parish, LA",Jan-20,9836,9233,603,6.1
33341,CN2207900000000,22,79,"Rapides Parish, LA",Jan-20,55019,51708,3311,6.0
33342,CN2208100000000,22,81,"Red River Parish, LA",Jan-20,3722,3479,243,6.5
33343,CN2208300000000,22,83,"Richland Parish, LA",Jan-20,8142,7457,685,8.4
33344,CN2208500000000,22,85,"Sabine Parish, LA",Jan-20,9067,8525,542,6.0
33345,CN2208700000000,22,87,"St. Bernard Parish, LA",Jan-20,19997,18843,1154,5.8
33346,CN2208900000000,22,89,"St. Charles Parish, LA",Jan-20,25369,24079,1290,5.1
33347,CN2209100000000,22,91,"St. Helena Parish, LA",Jan-20,4285,3988,297,6.9
33348,CN2209300000000,22,93,"St. James Parish, LA",Jan-20,9363,8681,682,7.3
33349,CN2209500000000,22,95,"St. John the Baptist Parish, LA",Jan-20,19928,18589,1339,6.7
33350,CN2209700000000,22,97,"St. Landry Parish, LA",Jan-20,31903,29464,2439,7.6
33351,CN2209900000000,22,99,"St. Martin Parish, LA",Jan-20,22096,20761,1335,6.0
33352,CN2210100000000,22,101,"St. Mary Parish, LA",Jan-20,19761,18426,1335,6.8
33353,CN2210300000000,22,103,"St. Tammany Parish, LA",Jan-20,120112,114340,5772,4.8
33354,CN2210500000000,22,105,"Tangipahoa Parish, LA",Jan-20,54687,51077,3610,6.6
33355,CN2210700000000,22,107,"Tensas Parish, LA",Jan-20,1327,1185,142,10.7
33356,CN2210900000000,22,109,"Terrebonne Parish, LA",Jan-20,46005,43469,2536,5.5
33357,CN2211100000000,22,111,"Union Parish, LA",Jan-20,9077,8429,648,7.1
33358,CN2211300000000,22,113,"Vermilion Parish, LA",Jan-20,23921,22472,1449,6.1
33359,CN2211500000000,22,115,"Vernon Parish, LA",Jan-20,16167,15015,1152,7.1
33360,CN2211700000000,22,117,"Washington Parish, LA",Jan-20,16749,15629,1120,6.7
33361,CN2211900000000,22,119,"Webster Parish, LA",Jan-20,14518,13467,1051,7.2
33362,CN2212100000000,22,121,"West Baton Rouge Parish, LA",Jan-20,13712,12999,713,5.2
33363,CN2212300000000,22,123,"West Carroll Parish, LA",Jan-20,3654,3090,564,15.4
33364,CN2212500000000,22,125,"West Feliciana Parish, LA",Jan-20,5392,5121,271,5.0
33365,CN2212700000000,22,127,"Winn Parish, LA",Jan-20,4834,4468,366,7.6
33366,CN2300100000000,23,1,"Androscoggin County, ME",Jan-20,55499,53497,2002,3.6
33367,CN2300300000000,23,3,"Aroostook County, ME",Jan-20,30171,28451,1720,5.7
33368,CN2300500000000,23,5,"Cumberland County, ME",Jan-20,162842,158060,4782,2.9
33369,CN2300700000000,23,7,"Franklin County, ME",Jan-20,14359,13674,685,4.8
33370,CN2300900000000,23,9,"Hancock County, ME",Jan-20,26972,25298,1674,6.2
33371,CN2301100000000,23,11,"Kennebec County, ME",Jan-20,61847,59451,2396,3.9
33372,CN2301300000000,23,13,"Knox County, ME",Jan-20,19449,18596,853,4.4
33373,CN2301500000000,23,15,"Lincoln County, ME",Jan-20,16030,15331,699,4.4
33374,CN2301700000000,23,17,"Oxford County, ME",Jan-20,26841,25630,1211,4.5
33375,CN2301900000000,23,19,"Penobscot County, ME",Jan-20,76732,73411,3321,4.3
33376,CN2302100000000,23,21,"Piscataquis County, ME",Jan-20,7259,6888,371,5.1
33377,CN2302300000000,23,23,"Sagadahoc County, ME",Jan-20,19174,18592,582,3.0
33378,CN2302500000000,23,25,"Somerset County, ME",Jan-20,22186,20793,1393,6.3
33379,CN2302700000000,23,27,"Waldo County, ME",Jan-20,20302,19362,940,4.6
33380,CN2302900000000,23,29,"Washington County, ME",Jan-20,13475,12470,1005,7.5
33381,CN2303100000000,23,31,"York County, ME",Jan-20,112147,107687,4460,4.0
33382,CN2400100000000,24,1,"Allegany County, MD",Jan-20,32137,30343,1794,5.6
33383,CN2400300000000,24,3,"Anne Arundel County, MD",Jan-20,319375,309895,9480,3.0
33384,CN2400500000000,24,5,"Baltimore County, MD",Jan-20,459764,443134,16630,3.6
33385,CN2400900000000,24,9,"Calvert County, MD",Jan-20,50608,49090,1518,3.0
33386,CN2401100000000,24,11,"Caroline County, MD",Jan-20,18196,17508,688,3.8
33387,CN2401300000000,24,13,"Carroll County, MD",Jan-20,97531,94656,2875,2.9
33388,CN2401500000000,24,15,"Cecil County, MD",Jan-20,53675,51532,2143,4.0
33389,CN2401700000000,24,17,"Charles County, MD",Jan-20,88369,85264,3105,3.5
33390,CN2401900000000,24,19,"Dorchester County, MD",Jan-20,15310,14526,784,5.1
33391,CN2402100000000,24,21,"Frederick County, MD",Jan-20,136187,131847,4340,3.2
33392,CN2402300000000,24,23,"Garrett County, MD",Jan-20,15590,14757,833,5.3
33393,CN2402500000000,24,25,"Harford County, MD",Jan-20,143039,138293,4746,3.3
33394,CN2402700000000,24,27,"Howard County, MD",Jan-20,189856,184937,4919,2.6
33395,CN2402900000000,24,29,"Kent County, MD",Jan-20,10286,9756,530,5.2
33396,CN2403100000000,24,31,"Montgomery County, MD",Jan-20,564746,548671,16075,2.8
33397,CN2403300000000,24,33,"Prince George's County, MD",Jan-20,515346,496719,18627,3.6
33398,CN2403500000000,24,35,"Queen Anne's County, MD",Jan-20,28636,27693,943,3.3
33399,CN2403700000000,24,37,"St. Mary's County, MD",Jan-20,57957,56104,1853,3.2
33400,CN2403900000000,24,39,"Somerset County, MD",Jan-20,9301,8671,630,6.8
33401,CN2404100000000,24,41,"Talbot County, MD",Jan-20,18927,18199,728,3.8
33402,CN2404300000000,24,43,"Washington County, MD",Jan-20,75898,72844,3054,4.0
33403,CN2404500000000,24,45,"Wicomico County, MD",Jan-20,50671,48052,2619,5.2
33404,CN2404700000000,24,47,"Worcester County, MD",Jan-20,26225,23377,2848,10.9
33405,CN2451000000000,24,510,"Baltimore city, MD",Jan-20,291738,277376,14362,4.9
33406,CN2500100000000,25,1,"Barnstable County, MA",Jan-20,109469,102821,6648,6.1
33407,CN2500300000000,25,3,"Berkshire County, MA",Jan-20,64661,61830,2831,4.4
33408,CN2500500000000,25,5,"Bristol County, MA",Jan-20,305670,291691,13979,4.6
33409,CN2500700000000,25,7,"Dukes County, MA",Jan-20,8507,7891,616,7.2
33410,CN2500900000000,25,9,"Essex County, MA",Jan-20,428998,414612,14386,3.4
33411,CN2501100000000,25,11,"Franklin County, MA",Jan-20,41258,39910,1348,3.3
33412,CN2501300000000,25,13,"Hampden County, MA",Jan-20,229917,219537,10380,4.5
33413,CN2501500000000,25,15,"Hampshire County, MA",Jan-20,90770,87975,2795,3.1
33414,CN2501700000000,25,17,"Middlesex County, MA",Jan-20,928861,905023,23838,2.6
33415,CN2501900000000,25,19,"Nantucket County/town, MA",Jan-20,6217,5529,688,11.1
33416,CN2502100000000,25,21,"Norfolk County, MA",Jan-20,395637,384555,11082,2.8
33417,CN2502300000000,25,23,"Plymouth County, MA",Jan-20,286436,275988,10448,3.6
33418,CN2502500000000,25,25,"Suffolk County, MA",Jan-20,461085,448069,13016,2.8
33419,CN2502700000000,25,27,"Worcester County, MA",Jan-20,451331,435049,16282,3.6
33420,CN2600100000000,26,1,"Alcona County, MI",Jan-20,3826,3493,333,8.7
33421,CN2600300000000,26,3,"Alger County, MI",Jan-20,3080,2808,272,8.8
33422,CN2600500000000,26,5,"Allegan County, MI",Jan-20,61851,59751,2100,3.4
33423,CN2600700000000,26,7,"Alpena County, MI",Jan-20,13312,12602,710,5.3
33424,CN2600900000000,26,9,"Antrim County, MI",Jan-20,10079,9442,637,6.3
33425,CN2601100000000,26,11,"Arenac County, MI",Jan-20,5994,5477,517,8.6
33426,CN2601300000000,26,13,"Baraga County, MI",Jan-20,3274,3036,238,7.3
33427,CN2601500000000,26,15,"Barry County, MI",Jan-20,31632,30494,1138,3.6
33428,CN2601700000000,26,17,"Bay County, MI",Jan-20,49693,46979,2714,5.5
33429,CN2601900000000,26,19,"Benzie County, MI",Jan-20,8776,8173,603,6.9
33430,CN2602100000000,26,21,"Berrien County, MI",Jan-20,73025,69728,3297,4.5
33431,CN2602300000000,26,23,"Branch County, MI",Jan-20,19104,18337,767,4.0
33432,CN2602500000000,26,25,"Calhoun County, MI",Jan-20,61929,59396,2533,4.1
33433,CN2602700000000,26,27,"Cass County, MI",Jan-20,24433,23297,1136,4.6
33434,CN2602900000000,26,29,"Charlevoix County, MI",Jan-20,12510,11759,751,6.0
33435,CN2603100000000,26,31,"Cheboygan County, MI",Jan-20,10201,8556,1645,16.1
33436,CN2603300000000,26,33,"Chippewa County, MI",Jan-20,16164,14922,1242,7.7
33437,CN2603500000000,26,35,"Clare County, MI",Jan-20,11714,10803,911,7.8
33438,CN2603700000000,26,37,"Clinton County, MI",Jan-20,41046,39826,1220,3.0
33439,CN2603900000000,26,39,"Crawford County, MI",Jan-20,5661,5261,400,7.1
33440,CN2604100000000,26,41,"Delta County, MI",Jan-20,17141,16064,1077,6.3
33441,CN2604300000000,26,43,"Dickinson County, MI",Jan-20,12349,11745,604,4.9
33442,CN2604500000000,26,45,"Eaton County, MI",Jan-20,57338,55453,1885,3.3
33443,CN2604700000000,26,47,"Emmet County, MI",Jan-20,17374,16122,1252,7.2
33444,CN2604900000000,26,49,"Genesee County, MI",Jan-20,183289,174176,9113,5.0
33445,CN2605100000000,26,51,"Gladwin County, MI",Jan-20,9792,9108,684,7.0
33446,CN2605300000000,26,53,"Gogebic County, MI",Jan-20,6133,5733,400,6.5
33447,CN2605500000000,26,55,"Grand Traverse County, MI",Jan-20,48687,46722,1965,4.0
33448,CN2605700000000,26,57,"Gratiot County, MI",Jan-20,18104,17216,888,4.9
33449,CN2605900000000,26,59,"Hillsdale County, MI",Jan-20,20245,19346,899,4.4
33450,CN2606100000000,26,61,"Houghton County, MI",Jan-20,15530,14703,827,5.3
33451,CN2606300000000,26,63,"Huron County, MI",Jan-20,15140,14294,846,5.6
33452,CN2606500000000,26,65,"Ingham County, MI",Jan-20,151209,146421,4788,3.2
33453,CN2606700000000,26,67,"Ionia County, MI",Jan-20,30211,29098,1113,3.7
33454,CN2606900000000,26,69,"Iosco County, MI",Jan-20,10199,9331,868,8.5
33455,CN2607100000000,26,71,"Iron County, MI",Jan-20,5177,4818,359,6.9
33456,CN2607300000000,26,73,"Isabella County, MI",Jan-20,34862,33418,1444,4.1
33457,CN2607500000000,26,75,"Jackson County, MI",Jan-20,74238,71341,2897,3.9
33458,CN2607700000000,26,77,"Kalamazoo County, MI",Jan-20,133818,129586,4232,3.2
33459,CN2607900000000,26,79,"Kalkaska County, MI",Jan-20,7860,7275,585,7.4
33460,CN2608100000000,26,81,"Kent County, MI",Jan-20,359770,349608,10162,2.8
33461,CN2608300000000,26,83,"Keweenaw County, MI",Jan-20,841,783,58,6.9
33462,CN2608500000000,26,85,"Lake County, MI",Jan-20,3850,3576,274,7.1
33463,CN2608700000000,26,87,"Lapeer County, MI",Jan-20,41673,38951,2722,6.5
33464,CN2608900000000,26,89,"Leelanau County, MI",Jan-20,10227,9778,449,4.4
33465,CN2609100000000,26,91,"Lenawee County, MI",Jan-20,46087,44121,1966,4.3
33466,CN2609300000000,26,93,"Livingston County, MI",Jan-20,103408,100134,3274,3.2
33467,CN2609500000000,26,95,"Luce County, MI",Jan-20,2285,2126,159,7.0
33468,CN2609700000000,26,97,"Mackinac County, MI",Jan-20,4351,3469,882,20.3
33469,CN2609900000000,26,99,"Macomb County, MI",Jan-20,451659,430494,21165,4.7
33470,CN2610100000000,26,101,"Manistee County, MI",Jan-20,10259,9582,677,6.6
33471,CN2610300000000,26,103,"Marquette County, MI",Jan-20,31983,30266,1717,5.4
33472,CN2610500000000,26,105,"Mason County, MI",Jan-20,13137,12321,816,6.2
33473,CN2610700000000,26,107,"Mecosta County, MI",Jan-20,18186,17184,1002,5.5
33474,CN2610900000000,26,109,"Menominee County, MI",Jan-20,11017,10515,502,4.6
33475,CN2611100000000,26,111,"Midland County, MI",Jan-20,39919,38204,1715,4.3
33476,CN2611300000000,26,113,"Missaukee County, MI",Jan-20,6900,6471,429,6.2
33477,CN2611500000000,26,115,"Monroe County, MI",Jan-20,75402,72192,3210,4.3
33478,CN2611700000000,26,117,"Montcalm County, MI",Jan-20,28325,27073,1252,4.4
33479,CN2611900000000,26,119,"Montmorency County, MI",Jan-20,3014,2652,362,12.0
33480,CN2612100000000,26,121,"Muskegon County, MI",Jan-20,77162,73795,3367,4.4
33481,CN2612300000000,26,123,"Newaygo County, MI",Jan-20,23410,22321,1089,4.7
33482,CN2612500000000,26,125,"Oakland County, MI",Jan-20,675945,653907,22038,3.3
33483,CN2612700000000,26,127,"Oceana County, MI",Jan-20,11574,10690,884,7.6
33484,CN2612900000000,26,129,"Ogemaw County, MI",Jan-20,7867,7150,717,9.1
33485,CN2613100000000,26,131,"Ontonagon County, MI",Jan-20,2096,1943,153,7.3
33486,CN2613300000000,26,133,"Osceola County, MI",Jan-20,11379,10849,530,4.7
33487,CN2613500000000,26,135,"Oscoda County, MI",Jan-20,2936,2700,236,8.0
33488,CN2613700000000,26,137,"Otsego County, MI",Jan-20,11627,10931,696,6.0
33489,CN2613900000000,26,139,"Ottawa County, MI",Jan-20,160556,156291,4265,2.7
33490,CN2614100000000,26,141,"Presque Isle County, MI",Jan-20,4886,4328,558,11.4
33491,CN2614300000000,26,143,"Roscommon County, MI",Jan-20,7473,6741,732,9.8
33492,CN2614500000000,26,145,"Saginaw County, MI",Jan-20,86377,82014,4363,5.1
33493,CN2614700000000,26,147,"St. Clair County, MI",Jan-20,76163,72079,4084,5.4
33494,CN2614900000000,26,149,"St. Joseph County, MI",Jan-20,27601,26409,1192,4.3
33495,CN2615100000000,26,151,"Sanilac County, MI",Jan-20,19426,18253,1173,6.0
33496,CN2615300000000,26,153,"Schoolcraft County, MI",Jan-20,3323,3013,310,9.3
33497,CN2615500000000,26,155,"Shiawassee County, MI",Jan-20,33519,32030,1489,4.4
33498,CN2615700000000,26,157,"Tuscola County, MI",Jan-20,23985,22545,1440,6.0
33499,CN2615900000000,26,159,"Van Buren County, MI",Jan-20,35131,33258,1873,5.3
33500,CN2616100000000,26,161,"Washtenaw County, MI",Jan-20,198766,193808,4958,2.5
33501,CN2616300000000,26,163,"Wayne County, MI",Jan-20,810007,768869,41138,5.1
33502,CN2616500000000,26,165,"Wexford County, MI",Jan-20,14914,14107,807,5.4
33503,CN2700100000000,27,1,"Aitkin County, MN",Jan-20,7280,6621,659,9.1
33504,CN2700300000000,27,3,"Anoka County, MN",Jan-20,199485,192916,6569,3.3
33505,CN2700500000000,27,5,"Becker County, MN",Jan-20,18564,17506,1058,5.7
33506,CN2700700000000,27,7,"Beltrami County, MN",Jan-20,24503,23186,1317,5.4
33507,CN2700900000000,27,9,"Benton County, MN",Jan-20,22323,21131,1192,5.3
33508,CN2701100000000,27,11,"Big Stone County, MN",Jan-20,2409,2234,175,7.3
33509,CN2701300000000,27,13,"Blue Earth County, MN",Jan-20,41307,40122,1185,2.9
33510,CN2701500000000,27,15,"Brown County, MN",Jan-20,14157,13444,713,5.0
33511,CN2701700000000,27,17,"Carlton County, MN",Jan-20,17924,16911,1013,5.7
33512,CN2701900000000,27,19,"Carver County, MN",Jan-20,58814,57164,1650,2.8
33513,CN2702100000000,27,21,"Cass County, MN",Jan-20,14004,12846,1158,8.3
33514,CN2702300000000,27,23,"Chippewa County, MN",Jan-20,6916,6568,348,5.0
33515,CN2702500000000,27,25,"Chisago County, MN",Jan-20,30552,28977,1575,5.2
33516,CN2702700000000,27,27,"Clay County, MN",Jan-20,36247,34927,1320,3.6
33517,CN2702900000000,27,29,"Clearwater County, MN",Jan-20,4682,4045,637,13.6
33518,CN2703100000000,27,31,"Cook County, MN",Jan-20,2908,2731,177,6.1
33519,CN2703300000000,27,33,"Cottonwood County, MN",Jan-20,5873,5630,243,4.1
33520,CN2703500000000,27,35,"Crow Wing County, MN",Jan-20,31920,29951,1969,6.2
33521,CN2703700000000,27,37,"Dakota County, MN",Jan-20,243412,236340,7072,2.9
33522,CN2703900000000,27,39,"Dodge County, MN",Jan-20,11877,11359,518,4.4
33523,CN2704100000000,27,41,"Douglas County, MN",Jan-20,20895,20059,836,4.0
33524,CN2704300000000,27,43,"Faribault County, MN",Jan-20,6867,6470,397,5.8
33525,CN2704500000000,27,45,"Fillmore County, MN",Jan-20,11480,10933,547,4.8
33526,CN2704700000000,27,47,"Freeborn County, MN",Jan-20,16130,15475,655,4.1
33527,CN2704900000000,27,49,"Goodhue County, MN",Jan-20,27162,26087,1075,4.0
33528,CN2705100000000,27,51,"Grant County, MN",Jan-20,3225,3014,211,6.5
33529,CN2705300000000,27,53,"Hennepin County, MN",Jan-20,709425,691948,17477,2.5
33530,CN2705500000000,27,55,"Houston County, MN",Jan-20,10282,9833,449,4.4
33531,CN2705700000000,27,57,"Hubbard County, MN",Jan-20,9789,9020,769,7.9
33532,CN2705900000000,27,59,"Isanti County, MN",Jan-20,21783,20546,1237,5.7
33533,CN2706100000000,27,61,"Itasca County, MN",Jan-20,22242,20595,1647,7.4
33534,CN2706300000000,27,63,"Jackson County, MN",Jan-20,5636,5412,224,4.0
33535,CN2706500000000,27,65,"Kanabec County, MN",Jan-20,9407,8443,964,10.2
33536,CN2706700000000,27,67,"Kandiyohi County, MN",Jan-20,24028,22892,1136,4.7
33537,CN2706900000000,27,69,"Kittson County, MN",Jan-20,2299,2197,102,4.4
33538,CN2707100000000,27,71,"Koochiching County, MN",Jan-20,5757,5359,398,6.9
33539,CN2707300000000,27,73,"Lac qui Parle County, MN",Jan-20,3479,3289,190,5.5
33540,CN2707500000000,27,75,"Lake County, MN",Jan-20,5352,5096,256,4.8
33541,CN2707700000000,27,77,"Lake of the Woods County, MN",Jan-20,2596,2494,102,3.9
33542,CN2707900000000,27,79,"Le Sueur County, MN",Jan-20,16538,15395,1143,6.9
33543,CN2708100000000,27,81,"Lincoln County, MN",Jan-20,3165,2962,203,6.4
33544,CN2708300000000,27,83,"Lyon County, MN",Jan-20,14160,13555,605,4.3
33545,CN2708500000000,27,85,"McLeod County, MN",Jan-20,19237,18282,955,5.0
33546,CN2708700000000,27,87,"Mahnomen County, MN",Jan-20,2295,2122,173,7.5
33547,CN2708900000000,27,89,"Marshall County, MN",Jan-20,5383,4846,537,10.0
33548,CN2709100000000,27,91,"Martin County, MN",Jan-20,9708,9319,389,4.0
33549,CN2709300000000,27,93,"Meeker County, MN",Jan-20,13403,12628,775,5.8
33550,CN2709500000000,27,95,"Mille Lacs County, MN",Jan-20,13366,12267,1099,8.2
33551,CN2709700000000,27,97,"Morrison County, MN",Jan-20,17536,16081,1455,8.3
33552,CN2709900000000,27,99,"Mower County, MN",Jan-20,20200,19505,695,3.4
33553,CN2710100000000,27,101,"Murray County, MN",Jan-20,4652,4333,319,6.9
33554,CN2710300000000,27,103,"Nicollet County, MN",Jan-20,21240,20688,552,2.6
33555,CN2710500000000,27,105,"Nobles County, MN",Jan-20,11068,10698,370,3.3
33556,CN2710700000000,27,107,"Norman County, MN",Jan-20,3129,2915,214,6.8
33557,CN2710900000000,27,109,"Olmsted County, MN",Jan-20,88745,86480,2265,2.6
33558,CN2711100000000,27,111,"Otter Tail County, MN",Jan-20,31110,29230,1880,6.0
33559,CN2711300000000,27,113,"Pennington County, MN",Jan-20,8863,8159,704,7.9
33560,CN2711500000000,27,115,"Pine County, MN",Jan-20,15281,14007,1274,8.3
33561,CN2711700000000,27,117,"Pipestone County, MN",Jan-20,4782,4541,241,5.0
33562,CN2711900000000,27,119,"Polk County, MN",Jan-20,16582,15831,751,4.5
33563,CN2712100000000,27,121,"Pope County, MN",Jan-20,6456,6201,255,3.9
33564,CN2712300000000,27,123,"Ramsey County, MN",Jan-20,291202,282944,8258,2.8
33565,CN2712500000000,27,125,"Red Lake County, MN",Jan-20,2230,2035,195,8.7
33566,CN2712700000000,27,127,"Redwood County, MN",Jan-20,7402,7076,326,4.4
33567,CN2712900000000,27,129,"Renville County, MN",Jan-20,8253,7740,513,6.2
33568,CN2713100000000,27,131,"Rice County, MN",Jan-20,37319,35919,1400,3.8
33569,CN2713300000000,27,133,"Rock County, MN",Jan-20,5514,5367,147,2.7
33570,CN2713500000000,27,135,"Roseau County, MN",Jan-20,7837,7469,368,4.7
33571,CN2713700000000,27,137,"St. Louis County, MN",Jan-20,101786,97240,4546,4.5
33572,CN2713900000000,27,139,"Scott County, MN",Jan-20,84197,81790,2407,2.9
33573,CN2714100000000,27,141,"Sherburne County, MN",Jan-20,53292,50888,2404,4.5
33574,CN2714300000000,27,143,"Sibley County, MN",Jan-20,8475,8047,428,5.1
33575,CN2714500000000,27,145,"Stearns County, MN",Jan-20,91052,87438,3614,4.0
33576,CN2714700000000,27,147,"Steele County, MN",Jan-20,21589,20813,776,3.6
33577,CN2714900000000,27,149,"Stevens County, MN",Jan-20,5137,4958,179,3.5
33578,CN2715100000000,27,151,"Swift County, MN",Jan-20,4790,4493,297,6.2
33579,CN2715300000000,27,153,"Todd County, MN",Jan-20,13504,12724,780,5.8
33580,CN2715500000000,27,155,"Traverse County, MN",Jan-20,1702,1607,95,5.6
33581,CN2715700000000,27,157,"Wabasha County, MN",Jan-20,12235,11691,544,4.4
33582,CN2715900000000,27,159,"Wadena County, MN",Jan-20,6048,5512,536,8.9
33583,CN2716100000000,27,161,"Waseca County, MN",Jan-20,8906,8401,505,5.7
33584,CN2716300000000,27,163,"Washington County, MN",Jan-20,144425,140187,4238,2.9
33585,CN2716500000000,27,165,"Watonwan County, MN",Jan-20,6309,5995,314,5.0
33586,CN2716700000000,27,167,"Wilkin County, MN",Jan-20,3329,3206,123,3.7
33587,CN2716900000000,27,169,"Winona County, MN",Jan-20,28475,27580,895,3.1
33588,CN2717100000000,27,171,"Wright County, MN",Jan-20,76692,73542,3150,4.1
33589,CN2717300000000,27,173,"Yellow Medicine County, MN",Jan-20,5250,5025,225,4.3
33590,CN2800100000000,28,1,"Adams County, MS",Jan-20,11192,10420,772,6.9
33591,CN2800300000000,28,3,"Alcorn County, MS",Jan-20,16116,15365,751,4.7
33592,CN2800500000000,28,5,"Amite County, MS",Jan-20,4340,4019,321,7.4
33593,CN2800700000000,28,7,"Attala County, MS",Jan-20,6972,6509,463,6.6
33594,CN2800900000000,28,9,"Benton County, MS",Jan-20,3024,2841,183,6.1
33595,CN2801100000000,28,11,"Bolivar County, MS",Jan-20,11876,10949,927,7.8
33596,CN2801300000000,28,13,"Calhoun County, MS",Jan-20,5487,5166,321,5.9
33597,CN2801500000000,28,15,"Carroll County, MS",Jan-20,3422,3202,220,6.4
33598,CN2801700000000,28,17,"Chickasaw County, MS",Jan-20,6727,6376,351,5.2
33599,CN2801900000000,28,19,"Choctaw County, MS",Jan-20,3593,3393,200,5.6
33600,CN2802100000000,28,21,"Claiborne County, MS",Jan-20,2958,2649,309,10.4
33601,CN2802300000000,28,23,"Clarke County, MS",Jan-20,5908,5522,386,6.5
33602,CN2802500000000,28,25,"Clay County, MS",Jan-20,7612,7031,581,7.6
33603,CN2802700000000,28,27,"Coahoma County, MS",Jan-20,8212,7505,707,8.6
33604,CN2802900000000,28,29,"Copiah County, MS",Jan-20,11005,10303,702,6.4
33605,CN2803100000000,28,31,"Covington County, MS",Jan-20,8010,7610,400,5.0
33606,CN2803300000000,28,33,"DeSoto County, MS",Jan-20,90445,86625,3820,4.2
33607,CN2803500000000,28,35,"Forrest County, MS",Jan-20,33196,31599,1597,4.8
33608,CN2803700000000,28,37,"Franklin County, MS",Jan-20,2727,2529,198,7.3
33609,CN2803900000000,28,39,"George County, MS",Jan-20,8723,8003,720,8.3
33610,CN2804100000000,28,41,"Greene County, MS",Jan-20,4362,3951,411,9.4
33611,CN2804300000000,28,43,"Grenada County, MS",Jan-20,9312,8845,467,5.0
33612,CN2804500000000,28,45,"Hancock County, MS",Jan-20,18546,17532,1014,5.5
33613,CN2804700000000,28,47,"Harrison County, MS",Jan-20,85452,81145,4307,5.0
33614,CN2804900000000,28,49,"Hinds County, MS",Jan-20,105298,100102,5196,4.9
33615,CN2805100000000,28,51,"Holmes County, MS",Jan-20,5639,5065,574,10.2
33616,CN2805300000000,28,53,"Humphreys County, MS",Jan-20,2207,1928,279,12.6
33617,CN2805500000000,28,55,"Issaquena County, MS",Jan-20,371,329,42,11.3
33618,CN2805700000000,28,57,"Itawamba County, MS",Jan-20,10423,9956,467,4.5
33619,CN2805900000000,28,59,"Jackson County, MS",Jan-20,57905,54471,3434,5.9
33620,CN2806100000000,28,61,"Jasper County, MS",Jan-20,6158,5646,512,8.3
33621,CN2806300000000,28,63,"Jefferson County, MS",Jan-20,2025,1674,351,17.3
33622,CN2806500000000,28,65,"Jefferson Davis County, MS",Jan-20,4078,3806,272,6.7
33623,CN2806700000000,28,67,"Jones County, MS",Jan-20,25798,24403,1395,5.4
33624,CN2806900000000,28,69,"Kemper County, MS",Jan-20,3496,3232,264,7.6
33625,CN2807100000000,28,71,"Lafayette County, MS",Jan-20,27426,26279,1147,4.2
33626,CN2807300000000,28,73,"Lamar County, MS",Jan-20,30757,29481,1276,4.1
33627,CN2807500000000,28,75,"Lauderdale County, MS",Jan-20,30329,28794,1535,5.1
33628,CN2807700000000,28,77,"Lawrence County, MS",Jan-20,4515,4214,301,6.7
33629,CN2807900000000,28,79,"Leake County, MS",Jan-20,7771,7341,430,5.5
33630,CN2808100000000,28,81,"Lee County, MS",Jan-20,40942,39221,1721,4.2
33631,CN2808300000000,28,83,"Leflore County, MS",Jan-20,9918,9134,784,7.9
33632,CN2808500000000,28,85,"Lincoln County, MS",Jan-20,14403,13568,835,5.8
33633,CN2808700000000,28,87,"Lowndes County, MS",Jan-20,24925,23622,1303,5.2
33634,CN2808900000000,28,89,"Madison County, MS",Jan-20,52484,50286,2198,4.2
33635,CN2809100000000,28,91,"Marion County, MS",Jan-20,9905,9342,563,5.7
33636,CN2809300000000,28,93,"Marshall County, MS",Jan-20,14334,13540,794,5.5
33637,CN2809500000000,28,95,"Monroe County, MS",Jan-20,15511,14688,823,5.3
33638,CN2809700000000,28,97,"Montgomery County, MS",Jan-20,3873,3636,237,6.1
33639,CN2809900000000,28,99,"Neshoba County, MS",Jan-20,9997,9376,621,6.2
33640,CN2810100000000,28,101,"Newton County, MS",Jan-20,8803,8313,490,5.6
33641,CN2810300000000,28,103,"Noxubee County, MS",Jan-20,3707,3432,275,7.4
33642,CN2810500000000,28,105,"Oktibbeha County, MS",Jan-20,21544,20424,1120,5.2
33643,CN2810700000000,28,107,"Panola County, MS",Jan-20,12329,11536,793,6.4
33644,CN2810900000000,28,109,"Pearl River County, MS",Jan-20,23652,22492,1160,4.9
33645,CN2811100000000,28,111,"Perry County, MS",Jan-20,4307,3998,309,7.2
33646,CN2811300000000,28,113,"Pike County, MS",Jan-20,14265,13357,908,6.4
33647,CN2811500000000,28,115,"Pontotoc County, MS",Jan-20,14659,14044,615,4.2
33648,CN2811700000000,28,117,"Prentiss County, MS",Jan-20,11144,10612,532,4.8
33649,CN2811900000000,28,119,"Quitman County, MS",Jan-20,2298,2102,196,8.5
33650,CN2812100000000,28,121,"Rankin County, MS",Jan-20,75102,72193,2909,3.9
33651,CN2812300000000,28,123,"Scott County, MS",Jan-20,12430,11874,556,4.5
33652,CN2812500000000,28,125,"Sharkey County, MS",Jan-20,1577,1426,151,9.6
33653,CN2812700000000,28,127,"Simpson County, MS",Jan-20,10592,10033,559,5.3
33654,CN2812900000000,28,129,"Smith County, MS",Jan-20,6779,6403,376,5.5
33655,CN2813100000000,28,131,"Stone County, MS",Jan-20,6743,6316,427,6.3
33656,CN2813300000000,28,133,"Sunflower County, MS",Jan-20,7549,6775,774,10.3
33657,CN2813500000000,28,135,"Tallahatchie County, MS",Jan-20,5210,4844,366,7.0
33658,CN2813700000000,28,137,"Tate County, MS",Jan-20,12197,11554,643,5.3
33659,CN2813900000000,28,139,"Tippah County, MS",Jan-20,9359,8917,442,4.7
33660,CN2814100000000,28,141,"Tishomingo County, MS",Jan-20,8485,8011,474,5.6
33661,CN2814300000000,28,143,"Tunica County, MS",Jan-20,4401,4112,289,6.6
33662,CN2814500000000,28,145,"Union County, MS",Jan-20,14273,13680,593,4.2
33663,CN2814700000000,28,147,"Walthall County, MS",Jan-20,4772,4436,336,7.0
33664,CN2814900000000,28,149,"Warren County, MS",Jan-20,19851,18754,1097,5.5
33665,CN2815100000000,28,151,"Washington County, MS",Jan-20,16706,15393,1313,7.9
33666,CN2815300000000,28,153,"Wayne County, MS",Jan-20,7333,6853,480,6.5
33667,CN2815500000000,28,155,"Webster County, MS",Jan-20,3896,3666,230,5.9
33668,CN2815700000000,28,157,"Wilkinson County, MS",Jan-20,2809,2503,306,10.9
33669,CN2815900000000,28,159,"Winston County, MS",Jan-20,7338,6900,438,6.0
33670,CN2816100000000,28,161,"Yalobusha County, MS",Jan-20,4852,4597,255,5.3
33671,CN2816300000000,28,163,"Yazoo County, MS",Jan-20,9225,8636,589,6.4
33672,CN2900100000000,29,1,"Adair County, MO",Jan-20,10240,9794,446,4.4
33673,CN2900300000000,29,3,"Andrew County, MO",Jan-20,9798,9452,346,3.5
33674,CN2900500000000,29,5,"Atchison County, MO",Jan-20,2710,2610,100,3.7
33675,CN2900700000000,29,7,"Audrain County, MO",Jan-20,10759,10308,451,4.2
33676,CN2900900000000,29,9,"Barry County, MO",Jan-20,15864,15056,808,5.1
33677,CN2901100000000,29,11,"Barton County, MO",Jan-20,5335,5126,209,3.9
33678,CN2901300000000,29,13,"Bates County, MO",Jan-20,7990,7605,385,4.8
33679,CN2901500000000,29,15,"Benton County, MO",Jan-20,7253,6818,435,6.0
33680,CN2901700000000,29,17,"Bollinger County, MO",Jan-20,5592,5318,274,4.9
33681,CN2901900000000,29,19,"Boone County, MO",Jan-20,97338,94248,3090,3.2
33682,CN2902100000000,29,21,"Buchanan County, MO",Jan-20,44618,42874,1744,3.9
33683,CN2902300000000,29,23,"Butler County, MO",Jan-20,18095,17170,925,5.1
33684,CN2902500000000,29,25,"Caldwell County, MO",Jan-20,4416,4243,173,3.9
33685,CN2902700000000,29,27,"Callaway County, MO",Jan-20,21452,20634,818,3.8
33686,CN2902900000000,29,29,"Camden County, MO",Jan-20,17850,16492,1358,7.6
33687,CN2903100000000,29,31,"Cape Girardeau County, MO",Jan-20,41213,39747,1466,3.6
33688,CN2903300000000,29,33,"Carroll County, MO",Jan-20,4872,4684,188,3.9
33689,CN2903500000000,29,35,"Carter County, MO",Jan-20,2569,2411,158,6.2
33690,CN2903700000000,29,37,"Cass County, MO",Jan-20,55160,52948,2212,4.0
33691,CN2903900000000,29,39,"Cedar County, MO",Jan-20,5875,5615,260,4.4
33692,CN2904100000000,29,41,"Chariton County, MO",Jan-20,3802,3644,158,4.2
33693,CN2904300000000,29,43,"Christian County, MO",Jan-20,45496,43784,1712,3.8
33694,CN2904500000000,29,45,"Clark County, MO",Jan-20,3264,3103,161,4.9
33695,CN2904700000000,29,47,"Clay County, MO",Jan-20,136418,131679,4739,3.5
33696,CN2904900000000,29,49,"Clinton County, MO",Jan-20,10783,10366,417,3.9
33697,CN2905100000000,29,51,"Cole County, MO",Jan-20,39126,37783,1343,3.4
33698,CN2905300000000,29,53,"Cooper County, MO",Jan-20,7490,7173,317,4.2
33699,CN2905500000000,29,55,"Crawford County, MO",Jan-20,11035,10501,534,4.8
33700,CN2905700000000,29,57,"Dade County, MO",Jan-20,3595,3447,148,4.1
33701,CN2905900000000,29,59,"Dallas County, MO",Jan-20,7170,6787,383,5.3
33702,CN2906100000000,29,61,"Daviess County, MO",Jan-20,4175,4002,173,4.1
33703,CN2906300000000,29,63,"DeKalb County, MO",Jan-20,4881,4671,210,4.3
33704,CN2906500000000,29,65,"Dent County, MO",Jan-20,6377,6067,310,4.9
33705,CN2906700000000,29,67,"Douglas County, MO",Jan-20,5475,4859,616,11.3
33706,CN2906900000000,29,69,"Dunklin County, MO",Jan-20,11736,10959,777,6.6
33707,CN2907100000000,29,71,"Franklin County, MO",Jan-20,53547,51246,2301,4.3
33708,CN2907300000000,29,73,"Gasconade County, MO",Jan-20,7699,7393,306,4.0
33709,CN2907500000000,29,75,"Gentry County, MO",Jan-20,3548,3433,115,3.2
33710,CN2907700000000,29,77,"Greene County, MO",Jan-20,152665,147141,5524,3.6
33711,CN2907900000000,29,79,"Grundy County, MO",Jan-20,4448,4258,190,4.3
33712,CN2908100000000,29,81,"Harrison County, MO",Jan-20,3892,3700,192,4.9
33713,CN2908300000000,29,83,"Henry County, MO",Jan-20,9791,9306,485,5.0
33714,CN2908500000000,29,85,"Hickory County, MO",Jan-20,3827,3610,217,5.7
33715,CN2908700000000,29,87,"Holt County, MO",Jan-20,2601,2505,96,3.7
33716,CN2908900000000,29,89,"Howard County, MO",Jan-20,4908,4709,199,4.1
33717,CN2909100000000,29,91,"Howell County, MO",Jan-20,16978,16021,957,5.6
33718,CN2909300000000,29,93,"Iron County, MO",Jan-20,3565,3348,217,6.1
33719,CN2909500000000,29,95,"Jackson County, MO",Jan-20,363222,347539,15683,4.3
33720,CN2909700000000,29,97,"Jasper County, MO",Jan-20,58193,56049,2144,3.7
33721,CN2909900000000,29,99,"Jefferson County, MO",Jan-20,118858,113892,4966,4.2
33722,CN2910100000000,29,101,"Johnson County, MO",Jan-20,23487,22385,1102,4.7
33723,CN2910300000000,29,103,"Knox County, MO",Jan-20,1803,1734,69,3.8
33724,CN2910500000000,29,105,"Laclede County, MO",Jan-20,17442,16174,1268,7.3
33725,CN2910700000000,29,107,"Lafayette County, MO",Jan-20,16961,16256,705,4.2
33726,CN2910900000000,29,109,"Lawrence County, MO",Jan-20,18343,17445,898,4.9
33727,CN2911100000000,29,111,"Lewis County, MO",Jan-20,5011,4808,203,4.1
33728,CN2911300000000,29,113,"Lincoln County, MO",Jan-20,28983,27361,1622,5.6
33729,CN2911500000000,29,115,"Linn County, MO",Jan-20,5188,4877,311,6.0
33730,CN2911700000000,29,117,"Livingston County, MO",Jan-20,7431,7161,270,3.6
33731,CN2911900000000,29,119,"McDonald County, MO",Jan-20,10931,10500,431,3.9
33732,CN2912100000000,29,121,"Macon County, MO",Jan-20,7688,7352,336,4.4
33733,CN2912300000000,29,123,"Madison County, MO",Jan-20,5543,5288,255,4.6
33734,CN2912500000000,29,125,"Maries County, MO",Jan-20,3942,3774,168,4.3
33735,CN2912700000000,29,127,"Marion County, MO",Jan-20,14539,13982,557,3.8
33736,CN2912900000000,29,129,"Mercer County, MO",Jan-20,1944,1858,86,4.4
33737,CN2913100000000,29,131,"Miller County, MO",Jan-20,12318,11595,723,5.9
33738,CN2913300000000,29,133,"Mississippi County, MO",Jan-20,5867,5587,280,4.8
33739,CN2913500000000,29,135,"Moniteau County, MO",Jan-20,7375,7083,292,4.0
33740,CN2913700000000,29,137,"Monroe County, MO",Jan-20,3898,3693,205,5.3
33741,CN2913900000000,29,139,"Montgomery County, MO",Jan-20,5842,5575,267,4.6
33742,CN2914100000000,29,141,"Morgan County, MO",Jan-20,8196,7670,526,6.4
33743,CN2914300000000,29,143,"New Madrid County, MO",Jan-20,8440,8005,435,5.2
33744,CN2914500000000,29,145,"Newton County, MO",Jan-20,27860,26753,1107,4.0
33745,CN2914700000000,29,147,"Nodaway County, MO",Jan-20,10999,10586,413,3.8
33746,CN2914900000000,29,149,"Oregon County, MO",Jan-20,4129,3895,234,5.7
33747,CN2915100000000,29,151,"Osage County, MO",Jan-20,7155,6932,223,3.1
33748,CN2915300000000,29,153,"Ozark County, MO",Jan-20,3439,3136,303,8.8
33749,CN2915500000000,29,155,"Pemiscot County, MO",Jan-20,6455,6059,396,6.1
33750,CN2915700000000,29,157,"Perry County, MO",Jan-20,10077,9746,331,3.3
33751,CN2915900000000,29,159,"Pettis County, MO",Jan-20,21245,20356,889,4.2
33752,CN2916100000000,29,161,"Phelps County, MO",Jan-20,19922,19033,889,4.5
33753,CN2916300000000,29,163,"Pike County, MO",Jan-20,7428,7068,360,4.8
33754,CN2916500000000,29,165,"Platte County, MO",Jan-20,58694,56795,1899,3.2
33755,CN2916700000000,29,167,"Polk County, MO",Jan-20,14782,14191,591,4.0
33756,CN2916900000000,29,169,"Pulaski County, MO",Jan-20,14787,14056,731,4.9
33757,CN2917100000000,29,171,"Putnam County, MO",Jan-20,2306,2195,111,4.8
33758,CN2917300000000,29,173,"Ralls County, MO",Jan-20,5677,5451,226,4.0
33759,CN2917500000000,29,175,"Randolph County, MO",Jan-20,10442,9939,503,4.8
33760,CN2917700000000,29,177,"Ray County, MO",Jan-20,11050,10572,478,4.3
33761,CN2917900000000,29,179,"Reynolds County, MO",Jan-20,3031,2883,148,4.9
33762,CN2918100000000,29,181,"Ripley County, MO",Jan-20,5046,4768,278,5.5
33763,CN2918300000000,29,183,"St. Charles County, MO",Jan-20,228350,219683,8667,3.8
33764,CN2918500000000,29,185,"St. Clair County, MO",Jan-20,3831,3611,220,5.7
33765,CN2918600000000,29,186,"Ste. Genevieve County, MO",Jan-20,9200,8850,350,3.8
33766,CN2918700000000,29,187,"St. Francois County, MO",Jan-20,26833,25429,1404,5.2
33767,CN2918900000000,29,189,"St. Louis County, MO",Jan-20,534164,513607,20557,3.8
33768,CN2919500000000,29,195,"Saline County, MO",Jan-20,10731,10270,461,4.3
33769,CN2919700000000,29,197,"Schuyler County, MO",Jan-20,1965,1860,105,5.3
33770,CN2919900000000,29,199,"Scotland County, MO",Jan-20,2451,2357,94,3.8
33771,CN2920100000000,29,201,"Scott County, MO",Jan-20,20122,19258,864,4.3
33772,CN2920300000000,29,203,"Shannon County, MO",Jan-20,3251,3032,219,6.7
33773,CN2920500000000,29,205,"Shelby County, MO",Jan-20,3173,3029,144,4.5
33774,CN2920700000000,29,207,"Stoddard County, MO",Jan-20,13263,12482,781,5.9
33775,CN2920900000000,29,209,"Stone County, MO",Jan-20,13335,11923,1412,10.6
33776,CN2921100000000,29,211,"Sullivan County, MO",Jan-20,2754,2616,138,5.0
33777,CN2921300000000,29,213,"Taney County, MO",Jan-20,26278,23059,3219,12.2
33778,CN2921500000000,29,215,"Texas County, MO",Jan-20,9218,8713,505,5.5
33779,CN2921700000000,29,217,"Vernon County, MO",Jan-20,9610,9215,395,4.1
33780,CN2921900000000,29,219,"Warren County, MO",Jan-20,18251,17366,885,4.8
33781,CN2922100000000,29,221,"Washington County, MO",Jan-20,10348,9715,633,6.1
33782,CN2922300000000,29,223,"Wayne County, MO",Jan-20,5296,5016,280,5.3
33783,CN2922500000000,29,225,"Webster County, MO",Jan-20,17530,16744,786,4.5
33784,CN2922700000000,29,227,"Worth County, MO",Jan-20,1188,1151,37,3.1
33785,CN2922900000000,29,229,"Wright County, MO",Jan-20,7800,7205,595,7.6
33786,CN2951000000000,29,510,"St. Louis city, MO",Jan-20,153083,146125,6958,4.5
33787,CN3000100000000,30,1,"Beaverhead County, MT",Jan-20,4981,4798,183,3.7
33788,CN3000300000000,30,3,"Big Horn County, MT",Jan-20,4657,4318,339,7.3
33789,CN3000500000000,30,5,"Blaine County, MT",Jan-20,2495,2376,119,4.8
33790,CN3000700000000,30,7,"Broadwater County, MT",Jan-20,2582,2442,140,5.4
33791,CN3000900000000,30,9,"Carbon County, MT",Jan-20,5519,5245,274,5.0
33792,CN3001100000000,30,11,"Carter County, MT",Jan-20,614,599,15,2.4
33793,CN3001300000000,30,13,"Cascade County, MT",Jan-20,38343,36720,1623,4.2
33794,CN3001500000000,30,15,"Chouteau County, MT",Jan-20,2401,2314,87,3.6
33795,CN3001700000000,30,17,"Custer County, MT",Jan-20,6094,5839,255,4.2
33796,CN3001900000000,30,19,"Daniels County, MT",Jan-20,888,862,26,2.9
33797,CN3002100000000,30,21,"Dawson County, MT",Jan-20,4548,4398,150,3.3
33798,CN3002300000000,30,23,"Deer Lodge County, MT",Jan-20,4989,4797,192,3.8
33799,CN3002500000000,30,25,"Fallon County, MT",Jan-20,1672,1634,38,2.3
33800,CN3002700000000,30,27,"Fergus County, MT",Jan-20,6040,5753,287,4.8
33801,CN3002900000000,30,29,"Flathead County, MT",Jan-20,47869,44736,3133,6.5
33802,CN3003100000000,30,31,"Gallatin County, MT",Jan-20,69025,67266,1759,2.5
33803,CN3003300000000,30,33,"Garfield County, MT",Jan-20,720,693,27,3.8
33804,CN3003500000000,30,35,"Glacier County, MT",Jan-20,5445,4981,464,8.5
33805,CN3003700000000,30,37,"Golden Valley County, MT",Jan-20,365,347,18,4.9
33806,CN3003900000000,30,39,"Granite County, MT",Jan-20,1747,1600,147,8.4
33807,CN3004100000000,30,41,"Hill County, MT",Jan-20,7584,7275,309,4.1
33808,CN3004300000000,30,43,"Jefferson County, MT",Jan-20,5700,5453,247,4.3
33809,CN3004500000000,30,45,"Judith Basin County, MT",Jan-20,964,918,46,4.8
33810,CN3004700000000,30,47,"Lake County, MT",Jan-20,13195,12432,763,5.8
33811,CN3004900000000,30,49,"Lewis and Clark County, MT",Jan-20,35798,34450,1348,3.8
33812,CN3005100000000,30,51,"Liberty County, MT",Jan-20,933,902,31,3.3
33813,CN3005300000000,30,53,"Lincoln County, MT",Jan-20,8098,7260,838,10.3
33814,CN3005500000000,30,55,"McCone County, MT",Jan-20,930,908,22,2.4
33815,CN3005700000000,30,57,"Madison County, MT",Jan-20,5524,5324,200,3.6
33816,CN3005900000000,30,59,"Meagher County, MT",Jan-20,995,955,40,4.0
33817,CN3006100000000,30,61,"Mineral County, MT",Jan-20,1770,1577,193,10.9
33818,CN3006300000000,30,63,"Missoula County, MT",Jan-20,64234,61591,2643,4.1
33819,CN3006500000000,30,65,"Musselshell County, MT",Jan-20,2296,2151,145,6.3
33820,CN3006700000000,30,67,"Park County, MT",Jan-20,8618,8234,384,4.5
33821,CN3006900000000,30,69,"Petroleum County, MT",Jan-20,273,263,10,3.7
33822,CN3007100000000,30,71,"Phillips County, MT",Jan-20,1866,1767,99,5.3
33823,CN3007300000000,30,73,"Pondera County, MT",Jan-20,2602,2503,99,3.8
33824,CN3007500000000,30,75,"Powder River County, MT",Jan-20,939,911,28,3.0
33825,CN3007700000000,30,77,"Powell County, MT",Jan-20,2891,2762,129,4.5
33826,CN3007900000000,30,79,"Prairie County, MT",Jan-20,473,449,24,5.1
33827,CN3008100000000,30,81,"Ravalli County, MT",Jan-20,20261,19217,1044,5.2
33828,CN3008300000000,30,83,"Richland County, MT",Jan-20,5900,5712,188,3.2
33829,CN3008500000000,30,85,"Roosevelt County, MT",Jan-20,4461,4245,216,4.8
33830,CN3008700000000,30,87,"Rosebud County, MT",Jan-20,3732,3546,186,5.0
33831,CN3008900000000,30,89,"Sanders County, MT",Jan-20,4811,4405,406,8.4
33832,CN3009100000000,30,91,"Sheridan County, MT",Jan-20,1722,1666,56,3.3
33833,CN3009300000000,30,93,"Silver Bow County, MT",Jan-20,17201,16390,811,4.7
33834,CN3009500000000,30,95,"Stillwater County, MT",Jan-20,5315,5114,201,3.8
33835,CN3009700000000,30,97,"Sweet Grass County, MT",Jan-20,1794,1729,65,3.6
33836,CN3009900000000,30,99,"Teton County, MT",Jan-20,2723,2586,137,5.0
33837,CN3010100000000,30,101,"Toole County, MT",Jan-20,2079,2011,68,3.3
33838,CN3010300000000,30,103,"Treasure County, MT",Jan-20,331,323,8,2.4
33839,CN3010500000000,30,105,"Valley County, MT",Jan-20,4022,3852,170,4.2
33840,CN3010700000000,30,107,"Wheatland County, MT",Jan-20,775,728,47,6.1
33841,CN3010900000000,30,109,"Wibaux County, MT",Jan-20,451,437,14,3.1
33842,CN3011100000000,30,111,"Yellowstone County, MT",Jan-20,81833,78700,3133,3.8
33843,CN3100100000000,31,1,"Adams County, NE",Jan-20,16719,16119,600,3.6
33844,CN3100300000000,31,3,"Antelope County, NE",Jan-20,3611,3513,98,2.7
33845,CN3100500000000,31,5,"Arthur County, NE",Jan-20,234,222,12,5.1
33846,CN3100700000000,31,7,"Banner County, NE",Jan-20,386,376,10,2.6
33847,CN3100900000000,31,9,"Blaine County, NE",Jan-20,275,259,16,5.8
33848,CN3101100000000,31,11,"Boone County, NE",Jan-20,3019,2921,98,3.2
33849,CN3101300000000,31,13,"Box Butte County, NE",Jan-20,5326,5152,174,3.3
33850,CN3101500000000,31,15,"Boyd County, NE",Jan-20,1108,1071,37,3.3
33851,CN3101700000000,31,17,"Brown County, NE",Jan-20,1411,1370,41,2.9
33852,CN3101900000000,31,19,"Buffalo County, NE",Jan-20,27716,26997,719,2.6
33853,CN3102100000000,31,21,"Burt County, NE",Jan-20,3481,3338,143,4.1
33854,CN3102300000000,31,23,"Butler County, NE",Jan-20,4495,4370,125,2.8
33855,CN3102500000000,31,25,"Cass County, NE",Jan-20,13670,13168,502,3.7
33856,CN3102700000000,31,27,"Cedar County, NE",Jan-20,4507,4392,115,2.6
33857,CN3102900000000,31,29,"Chase County, NE",Jan-20,2309,2264,45,1.9
33858,CN3103100000000,31,31,"Cherry County, NE",Jan-20,3407,3319,88,2.6
33859,CN3103300000000,31,33,"Cheyenne County, NE",Jan-20,4305,4153,152,3.5
33860,CN3103500000000,31,35,"Clay County, NE",Jan-20,3310,3199,111,3.4
33861,CN3103700000000,31,37,"Colfax County, NE",Jan-20,5569,5413,156,2.8
33862,CN3103900000000,31,39,"Cuming County, NE",Jan-20,4730,4595,135,2.9
33863,CN3104100000000,31,41,"Custer County, NE",Jan-20,6473,6326,147,2.3
33864,CN3104300000000,31,43,"Dakota County, NE",Jan-20,10799,10268,531,4.9
33865,CN3104500000000,31,45,"Dawes County, NE",Jan-20,4888,4769,119,2.4
33866,CN3104700000000,31,47,"Dawson County, NE",Jan-20,13131,12717,414,3.2
33867,CN3104900000000,31,49,"Deuel County, NE",Jan-20,965,934,31,3.2
33868,CN3105100000000,31,51,"Dixon County, NE",Jan-20,3058,2962,96,3.1
33869,CN3105300000000,31,53,"Dodge County, NE",Jan-20,19411,18805,606,3.1
33870,CN3105500000000,31,55,"Douglas County, NE",Jan-20,300008,289847,10161,3.4
33871,CN3105700000000,31,57,"Dundy County, NE",Jan-20,1195,1168,27,2.3
33872,CN3105900000000,31,59,"Fillmore County, NE",Jan-20,3147,3067,80,2.5
33873,CN3106100000000,31,61,"Franklin County, NE",Jan-20,1469,1424,45,3.1
33874,CN3106300000000,31,63,"Frontier County, NE",Jan-20,1657,1594,63,3.8
33875,CN3106500000000,31,65,"Furnas County, NE",Jan-20,2546,2478,68,2.7
33876,CN3106700000000,31,67,"Gage County, NE",Jan-20,10993,10591,402,3.7
33877,CN3106900000000,31,69,"Garden County, NE",Jan-20,1098,1057,41,3.7
33878,CN3107100000000,31,71,"Garfield County, NE",Jan-20,1163,1134,29,2.5
33879,CN3107300000000,31,73,"Gosper County, NE",Jan-20,1105,1082,23,2.1
33880,CN3107500000000,31,75,"Grant County, NE",Jan-20,440,430,10,2.3
33881,CN3107700000000,31,77,"Greeley County, NE",Jan-20,1244,1205,39,3.1
33882,CN3107900000000,31,79,"Hall County, NE",Jan-20,32184,30500,1684,5.2
33883,CN3108100000000,31,81,"Hamilton County, NE",Jan-20,4825,4632,193,4.0
33884,CN3108300000000,31,83,"Harlan County, NE",Jan-20,1770,1719,51,2.9
33885,CN3108500000000,31,85,"Hayes County, NE",Jan-20,643,623,20,3.1
33886,CN3108700000000,31,87,"Hitchcock County, NE",Jan-20,1268,1219,49,3.9
33887,CN3108900000000,31,89,"Holt County, NE",Jan-20,5848,5700,148,2.5
33888,CN3109100000000,31,91,"Hooker County, NE",Jan-20,383,367,16,4.2
33889,CN3109300000000,31,93,"Howard County, NE",Jan-20,3440,3247,193,5.6
33890,CN3109500000000,31,95,"Jefferson County, NE",Jan-20,4172,4067,105,2.5
33891,CN3109700000000,31,97,"Johnson County, NE",Jan-20,2070,2000,70,3.4
33892,CN3109900000000,31,99,"Kearney County, NE",Jan-20,3814,3732,82,2.1
33893,CN3110100000000,31,101,"Keith County, NE",Jan-20,4491,4339,152,3.4
33894,CN3110300000000,31,103,"Keya Paha County, NE",Jan-20,627,613,14,2.2
33895,CN3110500000000,31,105,"Kimball County, NE",Jan-20,2021,1962,59,2.9
33896,CN3110700000000,31,107,"Knox County, NE",Jan-20,4671,4503,168,3.6
33897,CN3110900000000,31,109,"Lancaster County, NE",Jan-20,177911,173050,4861,2.7
33898,CN3111100000000,31,111,"Lincoln County, NE",Jan-20,18089,17446,643,3.6
33899,CN3111300000000,31,113,"Logan County, NE",Jan-20,482,470,12,2.5
33900,CN3111500000000,31,115,"Loup County, NE",Jan-20,420,400,20,4.8
33901,CN3111700000000,31,117,"McPherson County, NE",Jan-20,446,430,16,3.6
33902,CN3111900000000,31,119,"Madison County, NE",Jan-20,19572,18976,596,3.0
33903,CN3112100000000,31,121,"Merrick County, NE",Jan-20,4061,3889,172,4.2
33904,CN3112300000000,31,123,"Morrill County, NE",Jan-20,2646,2552,94,3.6
33905,CN3112500000000,31,125,"Nance County, NE",Jan-20,1999,1938,61,3.1
33906,CN3112700000000,31,127,"Nemaha County, NE",Jan-20,3571,3440,131,3.7
33907,CN3112900000000,31,129,"Nuckolls County, NE",Jan-20,2464,2378,86,3.5
33908,CN3113100000000,31,131,"Otoe County, NE",Jan-20,8473,8209,264,3.1
33909,CN3113300000000,31,133,"Pawnee County, NE",Jan-20,1497,1458,39,2.6
33910,CN3113500000000,31,135,"Perkins County, NE",Jan-20,1841,1802,39,2.1
33911,CN3113700000000,31,137,"Phelps County, NE",Jan-20,5020,4899,121,2.4
33912,CN3113900000000,31,139,"Pierce County, NE",Jan-20,4056,3945,111,2.7
33913,CN3114100000000,31,141,"Platte County, NE",Jan-20,17630,17116,514,2.9
33914,CN3114300000000,31,143,"Polk County, NE",Jan-20,2982,2894,88,3.0
33915,CN3114500000000,31,145,"Red Willow County, NE",Jan-20,5835,5677,158,2.7
33916,CN3114700000000,31,147,"Richardson County, NE",Jan-20,4208,4061,147,3.5
33917,CN3114900000000,31,149,"Rock County, NE",Jan-20,898,875,23,2.6
33918,CN3115100000000,31,151,"Saline County, NE",Jan-20,7379,7125,254,3.4
33919,CN3115300000000,31,153,"Sarpy County, NE",Jan-20,96611,93772,2839,2.9
33920,CN3115500000000,31,155,"Saunders County, NE",Jan-20,11272,10944,328,2.9
33921,CN3115700000000,31,157,"Scotts Bluff County, NE",Jan-20,17919,17270,649,3.6
33922,CN3115900000000,31,159,"Seward County, NE",Jan-20,9064,8792,272,3.0
33923,CN3116100000000,31,161,"Sheridan County, NE",Jan-20,2705,2633,72,2.7
33924,CN3116300000000,31,163,"Sherman County, NE",Jan-20,1701,1646,55,3.2
33925,CN3116500000000,31,165,"Sioux County, NE",Jan-20,757,737,20,2.6
33926,CN3116700000000,31,167,"Stanton County, NE",Jan-20,3512,3408,104,3.0
33927,CN3116900000000,31,169,"Thayer County, NE",Jan-20,2777,2709,68,2.4
33928,CN3117100000000,31,171,"Thomas County, NE",Jan-20,439,419,20,4.6
33929,CN3117300000000,31,173,"Thurston County, NE",Jan-20,3088,2965,123,4.0
33930,CN3117500000000,31,175,"Valley County, NE",Jan-20,2138,2072,66,3.1
33931,CN3117700000000,31,177,"Washington County, NE",Jan-20,11339,10993,346,3.1
33932,CN3117900000000,31,179,"Wayne County, NE",Jan-20,5810,5663,147,2.5
33933,CN3118100000000,31,181,"Webster County, NE",Jan-20,1704,1645,59,3.5
33934,CN3118300000000,31,183,"Wheeler County, NE",Jan-20,589,575,14,2.4
33935,CN3118500000000,31,185,"York County, NE",Jan-20,7201,7019,182,2.5
33936,CN3200100000000,32,1,"Churchill County, NV",Jan-20,11385,10962,423,3.7
33937,CN3200300000000,32,3,"Clark County, NV",Jan-20,1145940,1101158,44782,3.9
33938,CN3200500000000,32,5,"Douglas County, NV",Jan-20,23345,22409,936,4.0
33939,CN3200700000000,32,7,"Elko County, NV",Jan-20,27050,26160,890,3.3
33940,CN3200900000000,32,9,"Esmeralda County, NV",Jan-20,473,455,18,3.8
33941,CN3201100000000,32,11,"Eureka County, NV",Jan-20,1153,1128,25,2.2
33942,CN3201300000000,32,13,"Humboldt County, NV",Jan-20,8397,8130,267,3.2
33943,CN3201500000000,32,15,"Lander County, NV",Jan-20,3271,3144,127,3.9
33944,CN3201700000000,32,17,"Lincoln County, NV",Jan-20,2187,2105,82,3.7
33945,CN3201900000000,32,19,"Lyon County, NV",Jan-20,23491,22320,1171,5.0
33946,CN3202100000000,32,21,"Mineral County, NV",Jan-20,2010,1927,83,4.1
33947,CN3202300000000,32,23,"Nye County, NV",Jan-20,17843,16953,890,5.0
33948,CN3202700000000,32,27,"Pershing County, NV",Jan-20,2630,2525,105,4.0
33949,CN3202900000000,32,29,"Storey County, NV",Jan-20,2053,1974,79,3.8
33950,CN3203100000000,32,31,"Washoe County, NV",Jan-20,258405,249635,8770,3.4
33951,CN3203300000000,32,33,"White Pine County, NV",Jan-20,4687,4547,140,3.0
33952,CN3251000000000,32,510,"Carson City, NV",Jan-20,26581,25490,1091,4.1
33953,CN3300100000000,33,1,"Belknap County, NH",Jan-20,31233,30241,992,3.2
33954,CN3300300000000,33,3,"Carroll County, NH",Jan-20,23990,23234,756,3.2
33955,CN3300500000000,33,5,"Cheshire County, NH",Jan-20,41022,39721,1301,3.2
33956,CN3300700000000,33,7,"Coos County, NH",Jan-20,14859,14245,614,4.1
33957,CN3300900000000,33,9,"Grafton County, NH",Jan-20,50136,48854,1282,2.6
33958,CN3301100000000,33,11,"Hillsborough County, NH",Jan-20,246879,239107,7772,3.1
33959,CN3301300000000,33,13,"Merrimack County, NH",Jan-20,84928,82668,2260,2.7
33960,CN3301500000000,33,15,"Rockingham County, NH",Jan-20,190571,184322,6249,3.3
33961,CN3301700000000,33,17,"Strafford County, NH",Jan-20,74161,72140,2021,2.7
33962,CN3301900000000,33,19,"Sullivan County, NH",Jan-20,23212,22551,661,2.8
33963,CN3400100000000,34,1,"Atlantic County, NJ",Jan-20,120234,112050,8184,6.8
33964,CN3400300000000,34,3,"Bergen County, NJ",Jan-20,490131,472964,17167,3.5
33965,CN3400500000000,34,5,"Burlington County, NJ",Jan-20,233388,224376,9012,3.9
33966,CN3400700000000,34,7,"Camden County, NJ",Jan-20,257095,244660,12435,4.8
33967,CN3400900000000,34,9,"Cape May County, NJ",Jan-20,41701,36016,5685,13.6
33968,CN3401100000000,34,11,"Cumberland County, NJ",Jan-20,65969,61178,4791,7.3
33969,CN3401300000000,34,13,"Essex County, NJ",Jan-20,375637,355821,19816,5.3
33970,CN3401500000000,34,15,"Gloucester County, NJ",Jan-20,152227,145250,6977,4.6
33971,CN3401700000000,34,17,"Hudson County, NJ",Jan-20,367370,353318,14052,3.8
33972,CN3401900000000,34,19,"Hunterdon County, NJ",Jan-20,65304,63030,2274,3.5
33973,CN3402100000000,34,21,"Mercer County, NJ",Jan-20,206303,198355,7948,3.9
33974,CN3402300000000,34,23,"Middlesex County, NJ",Jan-20,444908,428529,16379,3.7
33975,CN3402500000000,34,25,"Monmouth County, NJ",Jan-20,333155,320031,13124,3.9
33976,CN3402700000000,34,27,"Morris County, NJ",Jan-20,260660,251812,8848,3.4
33977,CN3402900000000,34,29,"Ocean County, NJ",Jan-20,280055,266544,13511,4.8
33978,CN3403100000000,34,31,"Passaic County, NJ",Jan-20,247563,234262,13301,5.4
33979,CN3403300000000,34,33,"Salem County, NJ",Jan-20,29369,27543,1826,6.2
33980,CN3403500000000,34,35,"Somerset County, NJ",Jan-20,174069,167772,6297,3.6
33981,CN3403700000000,34,37,"Sussex County, NJ",Jan-20,75368,71895,3473,4.6
33982,CN3403900000000,34,39,"Union County, NJ",Jan-20,281661,268896,12765,4.5
33983,CN3404100000000,34,41,"Warren County, NJ",Jan-20,56768,54297,2471,4.4
33984,CN3500100000000,35,1,"Bernalillo County, NM",Jan-20,335089,320161,14928,4.5
33985,CN3500300000000,35,3,"Catron County, NM",Jan-20,1151,1059,92,8.0
33986,CN3500500000000,35,5,"Chaves County, NM",Jan-20,27445,26072,1373,5.0
33987,CN3500600000000,35,6,"Cibola County, NM",Jan-20,9035,8449,586,6.5
33988,CN3500700000000,35,7,"Colfax County, NM",Jan-20,5385,5141,244,4.5
33989,CN3500900000000,35,9,"Curry County, NM",Jan-20,21654,20757,897,4.1
33990,CN3501100000000,35,11,"De Baca County, NM",Jan-20,708,676,32,4.5
33991,CN3501300000000,35,13,"Dona Ana County, NM",Jan-20,97381,91429,5952,6.1
33992,CN3501500000000,35,15,"Eddy County, NM",Jan-20,36339,35235,1104,3.0
33993,CN3501700000000,35,17,"Grant County, NM",Jan-20,12125,11513,612,5.0
33994,CN3501900000000,35,19,"Guadalupe County, NM",Jan-20,1459,1385,74,5.1
33995,CN3502100000000,35,21,"Harding County, NM",Jan-20,284,272,12,4.2
33996,CN3502300000000,35,23,"Hidalgo County, NM",Jan-20,2004,1912,92,4.6
33997,CN3502500000000,35,25,"Lea County, NM",Jan-20,32611,31270,1341,4.1
33998,CN3502700000000,35,27,"Lincoln County, NM",Jan-20,8739,8304,435,5.0
33999,CN3502800000000,35,28,"Los Alamos County, NM",Jan-20,9471,9159,312,3.3
34000,CN3502900000000,35,29,"Luna County, NM",Jan-20,9691,8137,1554,16.0
34001,CN3503100000000,35,31,"McKinley County, NM",Jan-20,24431,22704,1727,7.1
34002,CN3503300000000,35,33,"Mora County, NM",Jan-20,2094,1943,151,7.2
34003,CN3503500000000,35,35,"Otero County, NM",Jan-20,25124,23867,1257,5.0
34004,CN3503700000000,35,37,"Quay County, NM",Jan-20,3128,2965,163,5.2
34005,CN3503900000000,35,39,"Rio Arriba County, NM",Jan-20,16596,15665,931,5.6
34006,CN3504100000000,35,41,"Roosevelt County, NM",Jan-20,7832,7479,353,4.5
34007,CN3504300000000,35,43,"Sandoval County, NM",Jan-20,66332,63159,3173,4.8
34008,CN3504500000000,35,45,"San Juan County, NM",Jan-20,51455,48262,3193,6.2
34009,CN3504700000000,35,47,"San Miguel County, NM",Jan-20,10873,10228,645,5.9
34010,CN3504900000000,35,49,"Santa Fe County, NM",Jan-20,76265,73235,3030,4.0
34011,CN3505100000000,35,51,"Sierra County, NM",Jan-20,3783,3496,287,7.6
34012,CN3505300000000,35,53,"Socorro County, NM",Jan-20,6309,5942,367,5.8
34013,CN3505500000000,35,55,"Taos County, NM",Jan-20,15748,14836,912,5.8
34014,CN3505700000000,35,57,"Torrance County, NM",Jan-20,5427,5042,385,7.1
34015,CN3505900000000,35,59,"Union County, NM",Jan-20,1666,1595,71,4.3
34016,CN3506100000000,35,61,"Valencia County, NM",Jan-20,30658,29043,1615,5.3
34017,CN3600100000000,36,1,"Albany County, NY",Jan-20,159663,153480,6183,3.9
34018,CN3600300000000,36,3,"Allegany County, NY",Jan-20,19797,18462,1335,6.7
34019,CN3600500000000,36,5,"Bronx County, NY",Jan-20,591286,562402,28884,4.9
34020,CN3600700000000,36,7,"Broome County, NY",Jan-20,84055,79265,4790,5.7
34021,CN3600900000000,36,9,"Cattaraugus County, NY",Jan-20,35247,32951,2296,6.5
34022,CN3601100000000,36,11,"Cayuga County, NY",Jan-20,36114,34199,1915,5.3
34023,CN3601300000000,36,13,"Chautauqua County, NY",Jan-20,54780,51554,3226,5.9
34024,CN3601500000000,36,15,"Chemung County, NY",Jan-20,35748,33977,1771,5.0
34025,CN3601700000000,36,17,"Chenango County, NY",Jan-20,22448,21206,1242,5.5
34026,CN3601900000000,36,19,"Clinton County, NY",Jan-20,36754,34694,2060,5.6
34027,CN3602100000000,36,21,"Columbia County, NY",Jan-20,31222,30031,1191,3.8
34028,CN3602300000000,36,23,"Cortland County, NY",Jan-20,23144,21624,1520,6.6
34029,CN3602500000000,36,25,"Delaware County, NY",Jan-20,19148,18079,1069,5.6
34030,CN3602700000000,36,27,"Dutchess County, NY",Jan-20,145436,139650,5786,4.0
34031,CN3602900000000,36,29,"Erie County, NY",Jan-20,445150,423222,21928,4.9
34032,CN3603100000000,36,31,"Essex County, NY",Jan-20,17719,16654,1065,6.0
34033,CN3603300000000,36,33,"Franklin County, NY",Jan-20,19923,18746,1177,5.9
34034,CN3603500000000,36,35,"Fulton County, NY",Jan-20,23037,21690,1347,5.8
34035,CN3603700000000,36,37,"Genesee County, NY",Jan-20,29995,28475,1520,5.1
34036,CN3603900000000,36,39,"Greene County, NY",Jan-20,21318,20231,1087,5.1
34037,CN3604100000000,36,41,"Hamilton County, NY",Jan-20,2155,1965,190,8.8
34038,CN3604300000000,36,43,"Herkimer County, NY",Jan-20,28285,26547,1738,6.1
34039,CN3604500000000,36,45,"Jefferson County, NY",Jan-20,44224,40903,3321,7.5
34040,CN3604700000000,36,47,"Kings County, NY",Jan-20,1185568,1142694,42874,3.6
34041,CN3604900000000,36,49,"Lewis County, NY",Jan-20,12160,11242,918,7.5
34042,CN3605100000000,36,51,"Livingston County, NY",Jan-20,31246,29616,1630,5.2
34043,CN3605300000000,36,53,"Madison County, NY",Jan-20,33351,31513,1838,5.5
34044,CN3605500000000,36,55,"Monroe County, NY",Jan-20,364121,347586,16535,4.5
34045,CN3605700000000,36,57,"Montgomery County, NY",Jan-20,22764,21343,1421,6.2
34046,CN3605900000000,36,59,"Nassau County, NY",Jan-20,714487,688512,25975,3.6
34047,CN3606100000000,36,61,"New York County, NY",Jan-20,902956,874458,28498,3.2
34048,CN3606300000000,36,63,"Niagara County, NY",Jan-20,100143,94092,6051,6.0
34049,CN3606500000000,36,65,"Oneida County, NY",Jan-20,101635,96682,4953,4.9
34050,CN3606700000000,36,67,"Onondaga County, NY",Jan-20,222687,212912,9775,4.4
34051,CN3606900000000,36,69,"Ontario County, NY",Jan-20,56116,53489,2627,4.7
34052,CN3607100000000,36,71,"Orange County, NY",Jan-20,185860,178171,7689,4.1
34053,CN3607300000000,36,73,"Orleans County, NY",Jan-20,17906,16869,1037,5.8
34054,CN3607500000000,36,75,"Oswego County, NY",Jan-20,53988,50355,3633,6.7
34055,CN3607700000000,36,77,"Otsego County, NY",Jan-20,27920,26376,1544,5.5
34056,CN3607900000000,36,79,"Putnam County, NY",Jan-20,51691,49600,2091,4.0
34057,CN3608100000000,36,81,"Queens County, NY",Jan-20,1128582,1093585,34997,3.1
34058,CN3608300000000,36,83,"Rensselaer County, NY",Jan-20,82456,78958,3498,4.2
34059,CN3608500000000,36,85,"Richmond County, NY",Jan-20,220077,212504,7573,3.4
34060,CN3608700000000,36,87,"Rockland County, NY",Jan-20,155635,149813,5822,3.7
34061,CN3608900000000,36,89,"St. Lawrence County, NY",Jan-20,43687,40810,2877,6.6
34062,CN3609100000000,36,91,"Saratoga County, NY",Jan-20,120821,116284,4537,3.8
34063,CN3609300000000,36,93,"Schenectady County, NY",Jan-20,77164,73967,3197,4.1
34064,CN3609500000000,36,95,"Schoharie County, NY",Jan-20,15076,14151,925,6.1
34065,CN3609700000000,36,97,"Schuyler County, NY",Jan-20,8073,7539,534,6.6
34066,CN3609900000000,36,99,"Seneca County, NY",Jan-20,16313,15501,812,5.0
34067,CN3610100000000,36,101,"Steuben County, NY",Jan-20,43375,40955,2420,5.6
34068,CN3610300000000,36,103,"Suffolk County, NY",Jan-20,787677,754715,32962,4.2
34069,CN3610500000000,36,105,"Sullivan County, NY",Jan-20,37082,35346,1736,4.7
34070,CN3610700000000,36,107,"Tioga County, NY",Jan-20,22878,21698,1180,5.2
34071,CN3610900000000,36,109,"Tompkins County, NY",Jan-20,48698,46835,1863,3.8
34072,CN3611100000000,36,111,"Ulster County, NY",Jan-20,88437,84706,3731,4.2
34073,CN3611300000000,36,113,"Warren County, NY",Jan-20,31369,29531,1838,5.9
34074,CN3611500000000,36,115,"Washington County, NY",Jan-20,27902,26483,1419,5.1
34075,CN3611700000000,36,117,"Wayne County, NY",Jan-20,44597,42342,2255,5.1
34076,CN3611900000000,36,119,"Westchester County, NY",Jan-20,485998,466524,19474,4.0
34077,CN3612100000000,36,121,"Wyoming County, NY",Jan-20,18455,17292,1163,6.3
34078,CN3612300000000,36,123,"Yates County, NY",Jan-20,12125,11529,596,4.9
34079,CN3700100000000,37,1,"Alamance County, NC",Jan-20,82489,79307,3182,3.9
34080,CN3700300000000,37,3,"Alexander County, NC",Jan-20,18185,17588,597,3.3
34081,CN3700500000000,37,5,"Alleghany County, NC",Jan-20,4351,4109,242,5.6
34082,CN3700700000000,37,7,"Anson County, NC",Jan-20,11061,10528,533,4.8
34083,CN3700900000000,37,9,"Ashe County, NC",Jan-20,12889,12347,542,4.2
34084,CN3701100000000,37,11,"Avery County, NC",Jan-20,7242,6932,310,4.3
34085,CN3701300000000,37,13,"Beaufort County, NC",Jan-20,19445,18500,945,4.9
34086,CN3701500000000,37,15,"Bertie County, NC",Jan-20,7888,7449,439,5.6
34087,CN3701700000000,37,17,"Bladen County, NC",Jan-20,14806,14011,795,5.4
34088,CN3701900000000,37,19,"Brunswick County, NC",Jan-20,53137,49899,3238,6.1
34089,CN3702100000000,37,21,"Buncombe County, NC",Jan-20,141488,136976,4512,3.2
34090,CN3702300000000,37,23,"Burke County, NC",Jan-20,41396,39796,1600,3.9
34091,CN3702500000000,37,25,"Cabarrus County, NC",Jan-20,110655,106548,4107,3.7
34092,CN3702700000000,37,27,"Caldwell County, NC",Jan-20,36828,35363,1465,4.0
34093,CN3702900000000,37,29,"Camden County, NC",Jan-20,4649,4449,200,4.3
34094,CN3703100000000,37,31,"Carteret County, NC",Jan-20,31300,29835,1465,4.7
34095,CN3703300000000,37,33,"Caswell County, NC",Jan-20,9979,9507,472,4.7
34096,CN3703500000000,37,35,"Catawba County, NC",Jan-20,79609,76630,2979,3.7
34097,CN3703700000000,37,37,"Chatham County, NC",Jan-20,36241,34980,1261,3.5
34098,CN3703900000000,37,39,"Cherokee County, NC",Jan-20,11028,10482,546,5.0
34099,CN3704100000000,37,41,"Chowan County, NC",Jan-20,5563,5304,259,4.7
34100,CN3704300000000,37,43,"Clay County, NC",Jan-20,4117,3912,205,5.0
34101,CN3704500000000,37,45,"Cleveland County, NC",Jan-20,49145,46976,2169,4.4
34102,CN3704700000000,37,47,"Columbus County, NC",Jan-20,23129,21851,1278,5.5
34103,CN3704900000000,37,49,"Craven County, NC",Jan-20,41953,40209,1744,4.2
34104,CN3705100000000,37,51,"Cumberland County, NC",Jan-20,128035,121164,6871,5.4
34105,CN3705300000000,37,53,"Currituck County, NC",Jan-20,14038,13456,582,4.1
34106,CN3705500000000,37,55,"Dare County, NC",Jan-20,17690,16193,1497,8.5
34107,CN3705700000000,37,57,"Davidson County, NC",Jan-20,81777,78545,3232,4.0
34108,CN3705900000000,37,59,"Davie County, NC",Jan-20,20888,20131,757,3.6
34109,CN3706100000000,37,61,"Duplin County, NC",Jan-20,26004,24897,1107,4.3
34110,CN3706300000000,37,63,"Durham County, NC",Jan-20,173514,167530,5984,3.4
34111,CN3706500000000,37,65,"Edgecombe County, NC",Jan-20,21472,20222,1250,5.8
34112,CN3706700000000,37,67,"Forsyth County, NC",Jan-20,189471,182136,7335,3.9
34113,CN3706900000000,37,69,"Franklin County, NC",Jan-20,31784,30483,1301,4.1
34114,CN3707100000000,37,71,"Gaston County, NC",Jan-20,112853,108128,4725,4.2
34115,CN3707300000000,37,73,"Gates County, NC",Jan-20,5332,5104,228,4.3
34116,CN3707500000000,37,75,"Graham County, NC",Jan-20,3116,2878,238,7.6
34117,CN3707700000000,37,77,"Granville County, NC",Jan-20,30368,29288,1080,3.6
34118,CN3707900000000,37,79,"Greene County, NC",Jan-20,9668,9299,369,3.8
34119,CN3708100000000,37,81,"Guilford County, NC",Jan-20,264044,252825,11219,4.2
34120,CN3708300000000,37,83,"Halifax County, NC",Jan-20,20563,19245,1318,6.4
34121,CN3708500000000,37,85,"Harnett County, NC",Jan-20,53710,51269,2441,4.5
34122,CN3708700000000,37,87,"Haywood County, NC",Jan-20,30249,29108,1141,3.8
34123,CN3708900000000,37,89,"Henderson County, NC",Jan-20,55583,53643,1940,3.5
34124,CN3709100000000,37,91,"Hertford County, NC",Jan-20,9187,8687,500,5.4
34125,CN3709300000000,37,93,"Hoke County, NC",Jan-20,20230,19157,1073,5.3
34126,CN3709500000000,37,95,"Hyde County, NC",Jan-20,1826,1563,263,14.4
34127,CN3709700000000,37,97,"Iredell County, NC",Jan-20,90901,87420,3481,3.8
34128,CN3709900000000,37,99,"Jackson County, NC",Jan-20,19219,18352,867,4.5
34129,CN3710100000000,37,101,"Johnston County, NC",Jan-20,100749,97002,3747,3.7
34130,CN3710300000000,37,103,"Jones County, NC",Jan-20,4456,4287,169,3.8
34131,CN3710500000000,37,105,"Lee County, NC",Jan-20,26011,24839,1172,4.5
34132,CN3710700000000,37,107,"Lenoir County, NC",Jan-20,28040,26899,1141,4.1
34133,CN3710900000000,37,109,"Lincoln County, NC",Jan-20,44174,42510,1664,3.8
34134,CN3711100000000,37,111,"McDowell County, NC",Jan-20,20489,19616,873,4.3
34135,CN3711300000000,37,113,"Macon County, NC",Jan-20,15181,14496,685,4.5
34136,CN3711500000000,37,115,"Madison County, NC",Jan-20,10253,9865,388,3.8
34137,CN3711700000000,37,117,"Martin County, NC",Jan-20,9099,8631,468,5.1
34138,CN3711900000000,37,119,"Mecklenburg County, NC",Jan-20,630139,606620,23519,3.7
34139,CN3712100000000,37,121,"Mitchell County, NC",Jan-20,5946,5625,321,5.4
34140,CN3712300000000,37,123,"Montgomery County, NC",Jan-20,11612,11127,485,4.2
34141,CN3712500000000,37,125,"Moore County, NC",Jan-20,42602,40907,1695,4.0
34142,CN3712700000000,37,127,"Nash County, NC",Jan-20,43687,41541,2146,4.9
34143,CN3712900000000,37,129,"New Hanover County, NC",Jan-20,124946,120316,4630,3.7
34144,CN3713100000000,37,131,"Northampton County, NC",Jan-20,7867,7376,491,6.2
34145,CN3713300000000,37,133,"Onslow County, NC",Jan-20,66118,63010,3108,4.7
34146,CN3713500000000,37,135,"Orange County, NC",Jan-20,79865,77276,2589,3.2
34147,CN3713700000000,37,137,"Pamlico County, NC",Jan-20,5399,5175,224,4.1
34148,CN3713900000000,37,139,"Pasquotank County, NC",Jan-20,16691,15845,846,5.1
34149,CN3714100000000,37,141,"Pender County, NC",Jan-20,29248,28004,1244,4.3
34150,CN3714300000000,37,143,"Perquimans County, NC",Jan-20,4990,4722,268,5.4
34151,CN3714500000000,37,145,"Person County, NC",Jan-20,18761,17937,824,4.4
34152,CN3714700000000,37,147,"Pitt County, NC",Jan-20,90280,86417,3863,4.3
34153,CN3714900000000,37,149,"Polk County, NC",Jan-20,8975,8619,356,4.0
34154,CN3715100000000,37,151,"Randolph County, NC",Jan-20,66775,64133,2642,4.0
34155,CN3715300000000,37,153,"Richmond County, NC",Jan-20,16794,15845,949,5.7
34156,CN3715500000000,37,155,"Robeson County, NC",Jan-20,50981,48109,2872,5.6
34157,CN3715700000000,37,157,"Rockingham County, NC",Jan-20,40509,38586,1923,4.7
34158,CN3715900000000,37,159,"Rowan County, NC",Jan-20,67358,64425,2933,4.4
34159,CN3716100000000,37,161,"Rutherford County, NC",Jan-20,25439,24035,1404,5.5
34160,CN3716300000000,37,163,"Sampson County, NC",Jan-20,30122,28884,1238,4.1
34161,CN3716500000000,37,165,"Scotland County, NC",Jan-20,11764,10912,852,7.2
34162,CN3716700000000,37,167,"Stanly County, NC",Jan-20,30524,29293,1231,4.0
34163,CN3716900000000,37,169,"Stokes County, NC",Jan-20,21979,21104,875,4.0
34164,CN3717100000000,37,171,"Surry County, NC",Jan-20,34023,32650,1373,4.0
34165,CN3717300000000,37,173,"Swain County, NC",Jan-20,6649,6288,361,5.4
34166,CN3717500000000,37,175,"Transylvania County, NC",Jan-20,14456,13891,565,3.9
34167,CN3717700000000,37,177,"Tyrrell County, NC",Jan-20,1342,1226,116,8.6
34168,CN3717900000000,37,179,"Union County, NC",Jan-20,125629,121206,4423,3.5
34169,CN3718100000000,37,181,"Vance County, NC",Jan-20,17469,16394,1075,6.2
34170,CN3718300000000,37,183,"Wake County, NC",Jan-20,604293,583593,20700,3.4
34171,CN3718500000000,37,185,"Warren County, NC",Jan-20,6680,6267,413,6.2
34172,CN3718700000000,37,187,"Washington County, NC",Jan-20,4427,4115,312,7.0
34173,CN3718900000000,37,189,"Watauga County, NC",Jan-20,29219,28226,993,3.4
34174,CN3719100000000,37,191,"Wayne County, NC",Jan-20,52599,50326,2273,4.3
34175,CN3719300000000,37,193,"Wilkes County, NC",Jan-20,29280,27985,1295,4.4
34176,CN3719500000000,37,195,"Wilson County, NC",Jan-20,35014,32954,2060,5.9
34177,CN3719700000000,37,197,"Yadkin County, NC",Jan-20,17989,17312,677,3.8
34178,CN3719900000000,37,199,"Yancey County, NC",Jan-20,8431,8062,369,4.4
34179,CN3800100000000,38,1,"Adams County, ND",Jan-20,1046,1018,28,2.7
34180,CN3800300000000,38,3,"Barnes County, ND",Jan-20,5095,4952,143,2.8
34181,CN3800500000000,38,5,"Benson County, ND",Jan-20,2301,2194,107,4.7
34182,CN3800700000000,38,7,"Billings County, ND",Jan-20,352,340,12,3.4
34183,CN3800900000000,38,9,"Bottineau County, ND",Jan-20,2828,2722,106,3.7
34184,CN3801100000000,38,11,"Bowman County, ND",Jan-20,1675,1642,33,2.0
34185,CN3801300000000,38,13,"Burke County, ND",Jan-20,1039,1005,34,3.3
34186,CN3801500000000,38,15,"Burleigh County, ND",Jan-20,49079,47676,1403,2.9
34187,CN3801700000000,38,17,"Cass County, ND",Jan-20,102111,99549,2562,2.5
34188,CN3801900000000,38,19,"Cavalier County, ND",Jan-20,1837,1780,57,3.1
34189,CN3802100000000,38,21,"Dickey County, ND",Jan-20,2230,2185,45,2.0
34190,CN3802300000000,38,23,"Divide County, ND",Jan-20,1344,1323,21,1.6
34191,CN3802500000000,38,25,"Dunn County, ND",Jan-20,3123,3075,48,1.5
34192,CN3802700000000,38,27,"Eddy County, ND",Jan-20,1179,1121,58,4.9
34193,CN3802900000000,38,29,"Emmons County, ND",Jan-20,1417,1332,85,6.0
34194,CN3803100000000,38,31,"Foster County, ND",Jan-20,1448,1400,48,3.3
34195,CN3803300000000,38,33,"Golden Valley County, ND",Jan-20,804,790,14,1.7
34196,CN3803500000000,38,35,"Grand Forks County, ND",Jan-20,37330,36498,832,2.2
34197,CN3803700000000,38,37,"Grant County, ND",Jan-20,1181,1149,32,2.7
34198,CN3803900000000,38,39,"Griggs County, ND",Jan-20,986,963,23,2.3
34199,CN3804100000000,38,41,"Hettinger County, ND",Jan-20,1333,1289,44,3.3
34200,CN3804300000000,38,43,"Kidder County, ND",Jan-20,1240,1167,73,5.9
34201,CN3804500000000,38,45,"LaMoure County, ND",Jan-20,1973,1930,43,2.2
34202,CN3804700000000,38,47,"Logan County, ND",Jan-20,870,842,28,3.2
34203,CN3804900000000,38,49,"McHenry County, ND",Jan-20,2988,2842,146,4.9
34204,CN3805100000000,38,51,"McIntosh County, ND",Jan-20,1083,1048,35,3.2
34205,CN3805300000000,38,53,"McKenzie County, ND",Jan-20,10274,10065,209,2.0
34206,CN3805500000000,38,55,"McLean County, ND",Jan-20,4530,4333,197,4.3
34207,CN3805700000000,38,57,"Mercer County, ND",Jan-20,3330,3151,179,5.4
34208,CN3805900000000,38,59,"Morton County, ND",Jan-20,16216,15581,635,3.9
34209,CN3806100000000,38,61,"Mountrail County, ND",Jan-20,7343,7225,118,1.6
34210,CN3806300000000,38,63,"Nelson County, ND",Jan-20,1342,1292,50,3.7
34211,CN3806500000000,38,65,"Oliver County, ND",Jan-20,858,817,41,4.8
34212,CN3806700000000,38,67,"Pembina County, ND",Jan-20,3213,3074,139,4.3
34213,CN3806900000000,38,69,"Pierce County, ND",Jan-20,1658,1597,61,3.7
34214,CN3807100000000,38,71,"Ramsey County, ND",Jan-20,5401,5217,184,3.4
34215,CN3807300000000,38,73,"Ransom County, ND",Jan-20,2787,2715,72,2.6
34216,CN3807500000000,38,75,"Renville County, ND",Jan-20,1203,1161,42,3.5
34217,CN3807700000000,38,77,"Richland County, ND",Jan-20,8333,8121,212,2.5
34218,CN3807900000000,38,79,"Rolette County, ND",Jan-20,4530,4138,392,8.7
34219,CN3808100000000,38,81,"Sargent County, ND",Jan-20,2623,2576,47,1.8
34220,CN3808300000000,38,83,"Sheridan County, ND",Jan-20,656,606,50,7.6
34221,CN3808500000000,38,85,"Sioux County, ND",Jan-20,1201,1170,31,2.6
34222,CN3808700000000,38,87,"Slope County, ND",Jan-20,389,380,9,2.3
34223,CN3808900000000,38,89,"Stark County, ND",Jan-20,18103,17651,452,2.5
34224,CN3809100000000,38,91,"Steele County, ND",Jan-20,942,925,17,1.8
34225,CN3809300000000,38,93,"Stutsman County, ND",Jan-20,10049,9776,273,2.7
34226,CN3809500000000,38,95,"Towner County, ND",Jan-20,1030,1001,29,2.8
34227,CN3809700000000,38,97,"Traill County, ND",Jan-20,4304,4184,120,2.8
34228,CN3809900000000,38,99,"Walsh County, ND",Jan-20,4940,4766,174,3.5
34229,CN3810100000000,38,101,"Ward County, ND",Jan-20,30849,29918,931,3.0
34230,CN3810300000000,38,103,"Wells County, ND",Jan-20,1837,1745,92,5.0
34231,CN3810500000000,38,105,"Williams County, ND",Jan-20,23747,23259,488,2.1
34232,CN3900100000000,39,1,"Adams County, OH",Jan-20,10707,9664,1043,9.7
34233,CN3900300000000,39,3,"Allen County, OH",Jan-20,47775,45264,2511,5.3
34234,CN3900500000000,39,5,"Ashland County, OH",Jan-20,26690,25280,1410,5.3
34235,CN3900700000000,39,7,"Ashtabula County, OH",Jan-20,44205,41303,2902,6.6
34236,CN3900900000000,39,9,"Athens County, OH",Jan-20,27326,25515,1811,6.6
34237,CN3901100000000,39,11,"Auglaize County, OH",Jan-20,24870,23945,925,3.7
34238,CN3901300000000,39,13,"Belmont County, OH",Jan-20,29934,27393,2541,8.5
34239,CN3901500000000,39,15,"Brown County, OH",Jan-20,19814,18481,1333,6.7
34240,CN3901700000000,39,17,"Butler County, OH",Jan-20,195694,186889,8805,4.5
34241,CN3901900000000,39,19,"Carroll County, OH",Jan-20,13012,12107,905,7.0
34242,CN3902100000000,39,21,"Champaign County, OH",Jan-20,20002,19034,968,4.8
34243,CN3902300000000,39,23,"Clark County, OH",Jan-20,63519,59921,3598,5.7
34244,CN3902500000000,39,25,"Clermont County, OH",Jan-20,107187,102288,4899,4.6
34245,CN3902700000000,39,27,"Clinton County, OH",Jan-20,17940,16882,1058,5.9
34246,CN3902900000000,39,29,"Columbiana County, OH",Jan-20,47218,44229,2989,6.3
34247,CN3903100000000,39,31,"Coshocton County, OH",Jan-20,14189,13135,1054,7.4
34248,CN3903300000000,39,33,"Crawford County, OH",Jan-20,18087,17030,1057,5.8
34249,CN3903500000000,39,35,"Cuyahoga County, OH",Jan-20,605754,577341,28413,4.7
34250,CN3903700000000,39,37,"Darke County, OH",Jan-20,25659,24405,1254,4.9
34251,CN3903900000000,39,39,"Defiance County, OH",Jan-20,17934,17050,884,4.9
34252,CN3904100000000,39,41,"Delaware County, OH",Jan-20,110856,106821,4035,3.6
34253,CN3904300000000,39,43,"Erie County, OH",Jan-20,35359,32914,2445,6.9
34254,CN3904500000000,39,45,"Fairfield County, OH",Jan-20,78719,75109,3610,4.6
34255,CN3904700000000,39,47,"Fayette County, OH",Jan-20,13873,13199,674,4.9
34256,CN3904900000000,39,49,"Franklin County, OH",Jan-20,701548,673237,28311,4.0
34257,CN3905100000000,39,51,"Fulton County, OH",Jan-20,22470,21149,1321,5.9
34258,CN3905300000000,39,53,"Gallia County, OH",Jan-20,12299,11362,937,7.6
34259,CN3905500000000,39,55,"Geauga County, OH",Jan-20,48585,46517,2068,4.3
34260,CN3905700000000,39,57,"Greene County, OH",Jan-20,83528,79850,3678,4.4
34261,CN3905900000000,39,59,"Guernsey County, OH",Jan-20,18522,17040,1482,8.0
34262,CN3906100000000,39,61,"Hamilton County, OH",Jan-20,416541,398335,18206,4.4
34263,CN3906300000000,39,63,"Hancock County, OH",Jan-20,41614,40027,1587,3.8
34264,CN3906500000000,39,65,"Hardin County, OH",Jan-20,13555,12832,723,5.3
34265,CN3906700000000,39,67,"Harrison County, OH",Jan-20,6642,6114,528,7.9
34266,CN3906900000000,39,69,"Henry County, OH",Jan-20,13129,12276,853,6.5
34267,CN3907100000000,39,71,"Highland County, OH",Jan-20,17037,15869,1168,6.9
34268,CN3907300000000,39,73,"Hocking County, OH",Jan-20,13302,12472,830,6.2
34269,CN3907500000000,39,75,"Holmes County, OH",Jan-20,20488,19699,789,3.9
34270,CN3907700000000,39,77,"Huron County, OH",Jan-20,27614,25215,2399,8.7
34271,CN3907900000000,39,79,"Jackson County, OH",Jan-20,12741,11637,1104,8.7
34272,CN3908100000000,39,81,"Jefferson County, OH",Jan-20,27445,25359,2086,7.6
34273,CN3908300000000,39,83,"Knox County, OH",Jan-20,31228,29665,1563,5.0
34274,CN3908500000000,39,85,"Lake County, OH",Jan-20,125299,119656,5643,4.5
34275,CN3908700000000,39,87,"Lawrence County, OH",Jan-20,23842,22296,1546,6.5
34276,CN3908900000000,39,89,"Licking County, OH",Jan-20,91259,87071,4188,4.6
34277,CN3909100000000,39,91,"Logan County, OH",Jan-20,22883,21813,1070,4.7
34278,CN3909300000000,39,93,"Lorain County, OH",Jan-20,152588,144713,7875,5.2
34279,CN3909500000000,39,95,"Lucas County, OH",Jan-20,208653,197004,11649,5.6
34280,CN3909700000000,39,97,"Madison County, OH",Jan-20,20970,20082,888,4.2
34281,CN3909900000000,39,99,"Mahoning County, OH",Jan-20,101692,94675,7017,6.9
34282,CN3910100000000,39,101,"Marion County, OH",Jan-20,28179,26791,1388,4.9
34283,CN3910300000000,39,103,"Medina County, OH",Jan-20,96538,92638,3900,4.0
34284,CN3910500000000,39,105,"Meigs County, OH",Jan-20,9000,8125,875,9.7
34285,CN3910700000000,39,107,"Mercer County, OH",Jan-20,23036,22276,760,3.3
34286,CN3910900000000,39,109,"Miami County, OH",Jan-20,54479,51977,2502,4.6
34287,CN3911100000000,39,111,"Monroe County, OH",Jan-20,5385,4724,661,12.3
34288,CN3911300000000,39,113,"Montgomery County, OH",Jan-20,253462,241186,12276,4.8
34289,CN3911500000000,39,115,"Morgan County, OH",Jan-20,6763,6098,665,9.8
34290,CN3911700000000,39,117,"Morrow County, OH",Jan-20,17071,16098,973,5.7
34291,CN3911900000000,39,119,"Muskingum County, OH",Jan-20,39501,36791,2710,6.9
34292,CN3912100000000,39,121,"Noble County, OH",Jan-20,4692,4247,445,9.5
34293,CN3912300000000,39,123,"Ottawa County, OH",Jan-20,20078,18271,1807,9.0
34294,CN3912500000000,39,125,"Paulding County, OH",Jan-20,8492,8085,407,4.8
34295,CN3912700000000,39,127,"Perry County, OH",Jan-20,16261,15087,1174,7.2
34296,CN3912900000000,39,129,"Pickaway County, OH",Jan-20,26758,25386,1372,5.1
34297,CN3913100000000,39,131,"Pike County, OH",Jan-20,10796,9898,898,8.3
34298,CN3913300000000,39,133,"Portage County, OH",Jan-20,86648,81940,4708,5.4
34299,CN3913500000000,39,135,"Preble County, OH",Jan-20,21005,19976,1029,4.9
34300,CN3913700000000,39,137,"Putnam County, OH",Jan-20,18546,17755,791,4.3
34301,CN3913900000000,39,139,"Richland County, OH",Jan-20,51680,48703,2977,5.8
34302,CN3914100000000,39,141,"Ross County, OH",Jan-20,35452,33406,2046,5.8
34303,CN3914300000000,39,143,"Sandusky County, OH",Jan-20,30158,28401,1757,5.8
34304,CN3914500000000,39,145,"Scioto County, OH",Jan-20,28876,26506,2370,8.2
34305,CN3914700000000,39,147,"Seneca County, OH",Jan-20,27080,25649,1431,5.3
34306,CN3914900000000,39,149,"Shelby County, OH",Jan-20,23787,22727,1060,4.5
34307,CN3915100000000,39,151,"Stark County, OH",Jan-20,185229,174499,10730,5.8
34308,CN3915300000000,39,153,"Summit County, OH",Jan-20,269755,255532,14223,5.3
34309,CN3915500000000,39,155,"Trumbull County, OH",Jan-20,85736,79314,6422,7.5
34310,CN3915700000000,39,157,"Tuscarawas County, OH",Jan-20,44563,41931,2632,5.9
34311,CN3915900000000,39,159,"Union County, OH",Jan-20,29107,27982,1125,3.9
34312,CN3916100000000,39,161,"Van Wert County, OH",Jan-20,15066,14421,645,4.3
34313,CN3916300000000,39,163,"Vinton County, OH",Jan-20,5611,5134,477,8.5
34314,CN3916500000000,39,165,"Warren County, OH",Jan-20,119369,114422,4947,4.1
34315,CN3916700000000,39,167,"Washington County, OH",Jan-20,27425,25411,2014,7.3
34316,CN3916900000000,39,169,"Wayne County, OH",Jan-20,62401,59855,2546,4.1
34317,CN3917100000000,39,171,"Williams County, OH",Jan-20,18803,18005,798,4.2
34318,CN3917300000000,39,173,"Wood County, OH",Jan-20,70591,67386,3205,4.5
34319,CN3917500000000,39,175,"Wyandot County, OH",Jan-20,12969,12441,528,4.1
34320,CN4000100000000,40,1,"Adair County, OK",Jan-20,8027,7680,347,4.3
34321,CN4000300000000,40,3,"Alfalfa County, OK",Jan-20,2848,2786,62,2.2
34322,CN4000500000000,40,5,"Atoka County, OK",Jan-20,4964,4714,250,5.0
34323,CN4000700000000,40,7,"Beaver County, OK",Jan-20,2886,2833,53,1.8
34324,CN4000900000000,40,9,"Beckham County, OK",Jan-20,9848,9403,445,4.5
34325,CN4001100000000,40,11,"Blaine County, OK",Jan-20,4690,4579,111,2.4
34326,CN4001300000000,40,13,"Bryan County, OK",Jan-20,21313,20679,634,3.0
34327,CN4001500000000,40,15,"Caddo County, OK",Jan-20,11776,11337,439,3.7
34328,CN4001700000000,40,17,"Canadian County, OK",Jan-20,73926,71743,2183,3.0
34329,CN4001900000000,40,19,"Carter County, OK",Jan-20,21260,20503,757,3.6
34330,CN4002100000000,40,21,"Cherokee County, OK",Jan-20,18692,17967,725,3.9
34331,CN4002300000000,40,23,"Choctaw County, OK",Jan-20,5478,5191,287,5.2
34332,CN4002500000000,40,25,"Cimarron County, OK",Jan-20,1342,1320,22,1.6
34333,CN4002700000000,40,27,"Cleveland County, OK",Jan-20,141807,138001,3806,2.7
34334,CN4002900000000,40,29,"Coal County, OK",Jan-20,2506,2400,106,4.2
34335,CN4003100000000,40,31,"Comanche County, OK",Jan-20,48164,46595,1569,3.3
34336,CN4003300000000,40,33,"Cotton County, OK",Jan-20,2727,2651,76,2.8
34337,CN4003500000000,40,35,"Craig County, OK",Jan-20,5851,5621,230,3.9
34338,CN4003700000000,40,37,"Creek County, OK",Jan-20,31378,30211,1167,3.7
34339,CN4003900000000,40,39,"Custer County, OK",Jan-20,15826,15363,463,2.9
34340,CN4004100000000,40,41,"Delaware County, OK",Jan-20,17955,17282,673,3.7
34341,CN4004300000000,40,43,"Dewey County, OK",Jan-20,2902,2839,63,2.2
34342,CN4004500000000,40,45,"Ellis County, OK",Jan-20,2143,2083,60,2.8
34343,CN4004700000000,40,47,"Garfield County, OK",Jan-20,26628,25778,850,3.2
34344,CN4004900000000,40,49,"Garvin County, OK",Jan-20,12505,12038,467,3.7
34345,CN4005100000000,40,51,"Grady County, OK",Jan-20,26483,25567,916,3.5
34346,CN4005300000000,40,53,"Grant County, OK",Jan-20,2619,2557,62,2.4
34347,CN4005500000000,40,55,"Greer County, OK",Jan-20,1814,1740,74,4.1
34348,CN4005700000000,40,57,"Harmon County, OK",Jan-20,1166,1135,31,2.7
34349,CN4005900000000,40,59,"Harper County, OK",Jan-20,1751,1702,49,2.8
34350,CN4006100000000,40,61,"Haskell County, OK",Jan-20,4260,4013,247,5.8
34351,CN4006300000000,40,63,"Hughes County, OK",Jan-20,5333,5046,287,5.4
34352,CN4006500000000,40,65,"Jackson County, OK",Jan-20,10717,10404,313,2.9
34353,CN4006700000000,40,67,"Jefferson County, OK",Jan-20,2540,2448,92,3.6
34354,CN4006900000000,40,69,"Johnston County, OK",Jan-20,3297,3120,177,5.4
34355,CN4007100000000,40,71,"Kay County, OK",Jan-20,17963,17245,718,4.0
34356,CN4007300000000,40,73,"Kingfisher County, OK",Jan-20,9180,8985,195,2.1
34357,CN4007500000000,40,75,"Kiowa County, OK",Jan-20,3479,3365,114,3.3
34358,CN4007700000000,40,77,"Latimer County, OK",Jan-20,3097,2872,225,7.3
34359,CN4007900000000,40,79,"Le Flore County, OK",Jan-20,18946,18075,871,4.6
34360,CN4008100000000,40,81,"Lincoln County, OK",Jan-20,15737,15177,560,3.6
34361,CN4008300000000,40,83,"Logan County, OK",Jan-20,21996,21353,643,2.9
34362,CN4008500000000,40,85,"Love County, OK",Jan-20,6169,6023,146,2.4
34363,CN4008700000000,40,87,"McClain County, OK",Jan-20,19597,19042,555,2.8
34364,CN4008900000000,40,89,"McCurtain County, OK",Jan-20,14787,13926,861,5.8
34365,CN4009100000000,40,91,"McIntosh County, OK",Jan-20,7182,6701,481,6.7
34366,CN4009300000000,40,93,"Major County, OK",Jan-20,3866,3781,85,2.2
34367,CN4009500000000,40,95,"Marshall County, OK",Jan-20,6893,6652,241,3.5
34368,CN4009700000000,40,97,"Mayes County, OK",Jan-20,19298,18701,597,3.1
34369,CN4009900000000,40,99,"Murray County, OK",Jan-20,6298,6092,206,3.3
34370,CN4010100000000,40,101,"Muskogee County, OK",Jan-20,29630,28520,1110,3.7
34371,CN4010300000000,40,103,"Noble County, OK",Jan-20,5604,5458,146,2.6
34372,CN4010500000000,40,105,"Nowata County, OK",Jan-20,4577,4429,148,3.2
34373,CN4010700000000,40,107,"Okfuskee County, OK",Jan-20,4609,4375,234,5.1
34374,CN4010900000000,40,109,"Oklahoma County, OK",Jan-20,381970,370694,11276,3.0
34375,CN4011100000000,40,111,"Okmulgee County, OK",Jan-20,15565,14823,742,4.8
34376,CN4011300000000,40,113,"Osage County, OK",Jan-20,20498,19747,751,3.7
34377,CN4011500000000,40,115,"Ottawa County, OK",Jan-20,13925,13491,434,3.1
34378,CN4011700000000,40,117,"Pawnee County, OK",Jan-20,7313,7028,285,3.9
34379,CN4011900000000,40,119,"Payne County, OK",Jan-20,37160,36103,1057,2.8
34380,CN4012100000000,40,121,"Pittsburg County, OK",Jan-20,16970,16209,761,4.5
34381,CN4012300000000,40,123,"Pontotoc County, OK",Jan-20,19305,18737,568,2.9
34382,CN4012500000000,40,125,"Pottawatomie County, OK",Jan-20,32241,31100,1141,3.5
34383,CN4012700000000,40,127,"Pushmataha County, OK",Jan-20,4317,4079,238,5.5
34384,CN4012900000000,40,129,"Roger Mills County, OK",Jan-20,1842,1782,60,3.3
34385,CN4013100000000,40,131,"Rogers County, OK",Jan-20,44693,43322,1371,3.1
34386,CN4013300000000,40,133,"Seminole County, OK",Jan-20,9481,9010,471,5.0
34387,CN4013500000000,40,135,"Sequoyah County, OK",Jan-20,16148,15456,692,4.3
34388,CN4013700000000,40,137,"Stephens County, OK",Jan-20,18458,17595,863,4.7
34389,CN4013900000000,40,139,"Texas County, OK",Jan-20,11618,11386,232,2.0
34390,CN4014100000000,40,141,"Tillman County, OK",Jan-20,2961,2861,100,3.4
34391,CN4014300000000,40,143,"Tulsa County, OK",Jan-20,320546,310610,9936,3.1
34392,CN4014500000000,40,145,"Wagoner County, OK",Jan-20,37677,36473,1204,3.2
34393,CN4014700000000,40,147,"Washington County, OK",Jan-20,21969,21258,711,3.2
34394,CN4014900000000,40,149,"Washita County, OK",Jan-20,5176,4966,210,4.1
34395,CN4015100000000,40,151,"Woods County, OK",Jan-20,4575,4486,89,1.9
34396,CN4015300000000,40,153,"Woodward County, OK",Jan-20,8816,8496,320,3.6
34397,CN4100100000000,41,1,"Baker County, OR",Jan-20,7010,6601,409,5.8
34398,CN4100300000000,41,3,"Benton County, OR",Jan-20,48517,47268,1249,2.6
34399,CN4100500000000,41,5,"Clackamas County, OR",Jan-20,218686,211458,7228,3.3
34400,CN4100700000000,41,7,"Clatsop County, OR",Jan-20,18656,17888,768,4.1
34401,CN4100900000000,41,9,"Columbia County, OR",Jan-20,24516,23353,1163,4.7
34402,CN4101100000000,41,11,"Coos County, OR",Jan-20,25770,24517,1253,4.9
34403,CN4101300000000,41,13,"Crook County, OR",Jan-20,9516,8909,607,6.4
34404,CN4101500000000,41,15,"Curry County, OR",Jan-20,8617,8108,509,5.9
34405,CN4101700000000,41,17,"Deschutes County, OR",Jan-20,95424,91416,4008,4.2
34406,CN4101900000000,41,19,"Douglas County, OR",Jan-20,46206,43840,2366,5.1
34407,CN4102100000000,41,21,"Gilliam County, OR",Jan-20,886,840,46,5.2
34408,CN4102300000000,41,23,"Grant County, OR",Jan-20,3062,2773,289,9.4
34409,CN4102500000000,41,25,"Harney County, OR",Jan-20,3453,3221,232,6.7
34410,CN4102700000000,41,27,"Hood River County, OR",Jan-20,13683,13215,468,3.4
34411,CN4102900000000,41,29,"Jackson County, OR",Jan-20,101275,96756,4519,4.5
34412,CN4103100000000,41,31,"Jefferson County, OR",Jan-20,9973,9373,600,6.0
34413,CN4103300000000,41,33,"Josephine County, OR",Jan-20,35505,33639,1866,5.3
34414,CN4103500000000,41,35,"Klamath County, OR",Jan-20,28671,26319,2352,8.2
34415,CN4103700000000,41,37,"Lake County, OR",Jan-20,3474,3282,192,5.5
34416,CN4103900000000,41,39,"Lane County, OR",Jan-20,181113,174094,7019,3.9
34417,CN4104100000000,41,41,"Lincoln County, OR",Jan-20,20081,19150,931,4.6
34418,CN4104300000000,41,43,"Linn County, OR",Jan-20,58702,56167,2535,4.3
34419,CN4104500000000,41,45,"Malheur County, OR",Jan-20,12013,11461,552,4.6
34420,CN4104700000000,41,47,"Marion County, OR",Jan-20,159628,153121,6507,4.1
34421,CN4104900000000,41,49,"Morrow County, OR",Jan-20,5518,5255,263,4.8
34422,CN4105100000000,41,51,"Multnomah County, OR",Jan-20,454571,440011,14560,3.2
34423,CN4105300000000,41,53,"Polk County, OR",Jan-20,39448,37867,1581,4.0
34424,CN4105500000000,41,55,"Sherman County, OR",Jan-20,937,888,49,5.2
34425,CN4105700000000,41,57,"Tillamook County, OR",Jan-20,11572,11083,489,4.2
34426,CN4105900000000,41,59,"Umatilla County, OR",Jan-20,35585,33625,1960,5.5
34427,CN4106100000000,41,61,"Union County, OR",Jan-20,11744,11053,691,5.9
34428,CN4106300000000,41,63,"Wallowa County, OR",Jan-20,3233,3011,222,6.9
34429,CN4106500000000,41,65,"Wasco County, OR",Jan-20,12230,11634,596,4.9
34430,CN4106700000000,41,67,"Washington County, OR",Jan-20,324407,314939,9468,2.9
34431,CN4106900000000,41,69,"Wheeler County, OR",Jan-20,729,698,31,4.3
34432,CN4107100000000,41,71,"Yamhill County, OR",Jan-20,54483,52706,1777,3.3
34433,CN4200100000000,42,1,"Adams County, PA",Jan-20,54601,52465,2136,3.9
34434,CN4200300000000,42,3,"Allegheny County, PA",Jan-20,650897,620001,30896,4.7
34435,CN4200500000000,42,5,"Armstrong County, PA",Jan-20,32816,30423,2393,7.3
34436,CN4200700000000,42,7,"Beaver County, PA",Jan-20,84680,79921,4759,5.6
34437,CN4200900000000,42,9,"Bedford County, PA",Jan-20,23787,22234,1553,6.5
34438,CN4201100000000,42,11,"Berks County, PA",Jan-20,216819,205959,10860,5.0
34439,CN4201300000000,42,13,"Blair County, PA",Jan-20,59597,56394,3203,5.4
34440,CN4201500000000,42,15,"Bradford County, PA",Jan-20,28876,27251,1625,5.6
34441,CN4201700000000,42,17,"Bucks County, PA",Jan-20,346279,330948,15331,4.4
34442,CN4201900000000,42,19,"Butler County, PA",Jan-20,100402,95457,4945,4.9
34443,CN4202100000000,42,21,"Cambria County, PA",Jan-20,58186,54389,3797,6.5
34444,CN4202300000000,42,23,"Cameron County, PA",Jan-20,2032,1866,166,8.2
34445,CN4202500000000,42,25,"Carbon County, PA",Jan-20,32470,30484,1986,6.1
34446,CN4202700000000,42,27,"Centre County, PA",Jan-20,81792,78700,3092,3.8
34447,CN4202900000000,42,29,"Chester County, PA",Jan-20,284708,274602,10106,3.5
34448,CN4203100000000,42,31,"Clarion County, PA",Jan-20,17037,15865,1172,6.9
34449,CN4203300000000,42,33,"Clearfield County, PA",Jan-20,36694,34068,2626,7.2
34450,CN4203500000000,42,35,"Clinton County, PA",Jan-20,18282,17012,1270,6.9
34451,CN4203700000000,42,37,"Columbia County, PA",Jan-20,33490,31425,2065,6.2
34452,CN4203900000000,42,39,"Crawford County, PA",Jan-20,38371,36064,2307,6.0
34453,CN4204100000000,42,41,"Cumberland County, PA",Jan-20,133181,128139,5042,3.8
34454,CN4204300000000,42,43,"Dauphin County, PA",Jan-20,145725,139224,6501,4.5
34455,CN4204500000000,42,45,"Delaware County, PA",Jan-20,300975,287606,13369,4.4
34456,CN4204700000000,42,47,"Elk County, PA",Jan-20,15579,14507,1072,6.9
34457,CN4204900000000,42,49,"Erie County, PA",Jan-20,128958,121453,7505,5.8
34458,CN4205100000000,42,51,"Fayette County, PA",Jan-20,58177,53511,4666,8.0
34459,CN4205300000000,42,53,"Forest County, PA",Jan-20,1805,1632,173,9.6
34460,CN4205500000000,42,55,"Franklin County, PA",Jan-20,78824,75317,3507,4.4
34461,CN4205700000000,42,57,"Fulton County, PA",Jan-20,8153,7631,522,6.4
34462,CN4205900000000,42,59,"Greene County, PA",Jan-20,16758,15653,1105,6.6
34463,CN4206100000000,42,61,"Huntingdon County, PA",Jan-20,19859,18196,1663,8.4
34464,CN4206300000000,42,63,"Indiana County, PA",Jan-20,38754,36162,2592,6.7
34465,CN4206500000000,42,65,"Jefferson County, PA",Jan-20,20703,19365,1338,6.5
34466,CN4206700000000,42,67,"Juniata County, PA",Jan-20,12718,12022,696,5.5
34467,CN4206900000000,42,69,"Lackawanna County, PA",Jan-20,105566,99496,6070,5.7
34468,CN4207100000000,42,71,"Lancaster County, PA",Jan-20,284386,273058,11328,4.0
34469,CN4207300000000,42,73,"Lawrence County, PA",Jan-20,40909,37869,3040,7.4
34470,CN4207500000000,42,75,"Lebanon County, PA",Jan-20,72389,69122,3267,4.5
34471,CN4207700000000,42,77,"Lehigh County, PA",Jan-20,194208,184652,9556,4.9
34472,CN4207900000000,42,79,"Luzerne County, PA",Jan-20,158558,147873,10685,6.7
34473,CN4208100000000,42,81,"Lycoming County, PA",Jan-20,57621,54151,3470,6.0
34474,CN4208300000000,42,83,"McKean County, PA",Jan-20,17424,16190,1234,7.1
34475,CN4208500000000,42,85,"Mercer County, PA",Jan-20,48628,45707,2921,6.0
34476,CN4208700000000,42,87,"Mifflin County, PA",Jan-20,21184,19970,1214,5.7
34477,CN4208900000000,42,89,"Monroe County, PA",Jan-20,84648,79346,5302,6.3
34478,CN4209100000000,42,91,"Montgomery County, PA",Jan-20,456960,439150,17810,3.9
34479,CN4209300000000,42,93,"Montour County, PA",Jan-20,9031,8647,384,4.3
34480,CN4209500000000,42,95,"Northampton County, PA",Jan-20,162920,154629,8291,5.1
34481,CN4209700000000,42,97,"Northumberland County, PA",Jan-20,42319,39347,2972,7.0
34482,CN4209900000000,42,99,"Perry County, PA",Jan-20,24659,23530,1129,4.6
34483,CN4210100000000,42,101,"Philadelphia County/city, PA",Jan-20,733945,690051,43894,6.0
34484,CN4210300000000,42,103,"Pike County, PA",Jan-20,25538,23820,1718,6.7
34485,CN4210500000000,42,105,"Potter County, PA",Jan-20,7257,6589,668,9.2
34486,CN4210700000000,42,107,"Schuylkill County, PA",Jan-20,66954,62868,4086,6.1
34487,CN4210900000000,42,109,"Snyder County, PA",Jan-20,19877,18661,1216,6.1
34488,CN4211100000000,42,111,"Somerset County, PA",Jan-20,34382,31933,2449,7.1
34489,CN4211300000000,42,113,"Sullivan County, PA",Jan-20,2644,2442,202,7.6
34490,CN4211500000000,42,115,"Susquehanna County, PA",Jan-20,20556,19338,1218,5.9
34491,CN4211700000000,42,117,"Tioga County, PA",Jan-20,19092,17784,1308,6.9
34492,CN4211900000000,42,119,"Union County, PA",Jan-20,19401,18498,903,4.7
34493,CN4212100000000,42,121,"Venango County, PA",Jan-20,22356,20940,1416,6.3
34494,CN4212300000000,42,123,"Warren County, PA",Jan-20,18898,17830,1068,5.7
34495,CN4212500000000,42,125,"Washington County, PA",Jan-20,107865,101857,6008,5.6
34496,CN4212700000000,42,127,"Wayne County, PA",Jan-20,22222,20704,1518,6.8
34497,CN4212900000000,42,129,"Westmoreland County, PA",Jan-20,182443,172285,10158,5.6
34498,CN4213100000000,42,131,"Wyoming County, PA",Jan-20,13686,12806,880,6.4
34499,CN4213300000000,42,133,"York County, PA",Jan-20,237799,227405,10394,4.4
34500,CN4400100000000,44,1,"Bristol County, RI",Jan-20,26011,25123,888,3.4
34501,CN4400300000000,44,3,"Kent County, RI",Jan-20,90878,87458,3420,3.8
34502,CN4400500000000,44,5,"Newport County, RI",Jan-20,44548,42729,1819,4.1
34503,CN4400700000000,44,7,"Providence County, RI",Jan-20,325518,311654,13864,4.3
34504,CN4400900000000,44,9,"Washington County, RI",Jan-20,68922,66359,2563,3.7
34505,CN4500100000000,45,1,"Abbeville County, SC",Jan-20,10086,9721,365,3.6
34506,CN4500300000000,45,3,"Aiken County, SC",Jan-20,75364,73133,2231,3.0
34507,CN4500500000000,45,5,"Allendale County, SC",Jan-20,2698,2516,182,6.7
34508,CN4500700000000,45,7,"Anderson County, SC",Jan-20,91579,89048,2531,2.8
34509,CN4500900000000,45,9,"Bamberg County, SC",Jan-20,4990,4711,279,5.6
34510,CN4501100000000,45,11,"Barnwell County, SC",Jan-20,8264,7887,377,4.6
34511,CN4501300000000,45,13,"Beaufort County, SC",Jan-20,78253,76187,2066,2.6
34512,CN4501500000000,45,15,"Berkeley County, SC",Jan-20,105018,102326,2692,2.6
34513,CN4501700000000,45,17,"Calhoun County, SC",Jan-20,6649,6419,230,3.5
34514,CN4501900000000,45,19,"Charleston County, SC",Jan-20,213947,209054,4893,2.3
34515,CN4502100000000,45,21,"Cherokee County, SC",Jan-20,25115,24275,840,3.3
34516,CN4502300000000,45,23,"Chester County, SC",Jan-20,13575,12990,585,4.3
34517,CN4502500000000,45,25,"Chesterfield County, SC",Jan-20,22192,21507,685,3.1
34518,CN4502700000000,45,27,"Clarendon County, SC",Jan-20,12759,12240,519,4.1
34519,CN4502900000000,45,29,"Colleton County, SC",Jan-20,16847,16303,544,3.2
34520,CN4503100000000,45,31,"Darlington County, SC",Jan-20,30322,29287,1035,3.4
34521,CN4503300000000,45,33,"Dillon County, SC",Jan-20,13310,12757,553,4.2
34522,CN4503500000000,45,35,"Dorchester County, SC",Jan-20,78892,76922,1970,2.5
34523,CN4503700000000,45,37,"Edgefield County, SC",Jan-20,10821,10501,320,3.0
34524,CN4503900000000,45,39,"Fairfield County, SC",Jan-20,9710,9257,453,4.7
34525,CN4504100000000,45,41,"Florence County, SC",Jan-20,66852,64848,2004,3.0
34526,CN4504300000000,45,43,"Georgetown County, SC",Jan-20,25539,24456,1083,4.2
34527,CN4504500000000,45,45,"Greenville County, SC",Jan-20,255817,249477,6340,2.5
34528,CN4504700000000,45,47,"Greenwood County, SC",Jan-20,31397,30366,1031,3.3
34529,CN4504900000000,45,49,"Hampton County, SC",Jan-20,8426,8195,231,2.7
34530,CN4505100000000,45,51,"Horry County, SC",Jan-20,145671,139268,6403,4.4
34531,CN4505300000000,45,53,"Jasper County, SC",Jan-20,12831,12518,313,2.4
34532,CN4505500000000,45,55,"Kershaw County, SC",Jan-20,29582,28625,957,3.2
34533,CN4505700000000,45,57,"Lancaster County, SC",Jan-20,41771,40323,1448,3.5
34534,CN4505900000000,45,59,"Laurens County, SC",Jan-20,30354,29419,935,3.1
34535,CN4506100000000,45,61,"Lee County, SC",Jan-20,6701,6365,336,5.0
34536,CN4506300000000,45,63,"Lexington County, SC",Jan-20,151226,147730,3496,2.3
34537,CN4506500000000,45,65,"McCormick County, SC",Jan-20,3422,3287,135,3.9
34538,CN4506700000000,45,67,"Marion County, SC",Jan-20,12890,12333,557,4.3
34539,CN4506900000000,45,69,"Marlboro County, SC",Jan-20,9282,8869,413,4.4
34540,CN4507100000000,45,71,"Newberry County, SC",Jan-20,19187,18654,533,2.8
34541,CN4507300000000,45,73,"Oconee County, SC",Jan-20,35186,34203,983,2.8
34542,CN4507500000000,45,75,"Orangeburg County, SC",Jan-20,35411,33662,1749,4.9
34543,CN4507700000000,45,77,"Pickens County, SC",Jan-20,57714,56074,1640,2.8
34544,CN4507900000000,45,79,"Richland County, SC",Jan-20,200109,194552,5557,2.8
34545,CN4508100000000,45,81,"Saluda County, SC",Jan-20,8998,8757,241,2.7
34546,CN4508300000000,45,83,"Spartanburg County, SC",Jan-20,154278,150163,4115,2.7
34547,CN4508500000000,45,85,"Sumter County, SC",Jan-20,44265,42694,1571,3.5
34548,CN4508700000000,45,87,"Union County, SC",Jan-20,11742,11327,415,3.5
34549,CN4508900000000,45,89,"Williamsburg County, SC",Jan-20,12081,11479,602,5.0
34550,CN4509100000000,45,91,"York County, SC",Jan-20,141827,137886,3941,2.8
34551,CN4600300000000,46,3,"Aurora County, SD",Jan-20,1477,1431,46,3.1
34552,CN4600500000000,46,5,"Beadle County, SD",Jan-20,9483,9151,332,3.5
34553,CN4600700000000,46,7,"Bennett County, SD",Jan-20,1083,1020,63,5.8
34554,CN4600900000000,46,9,"Bon Homme County, SD",Jan-20,2836,2728,108,3.8
34555,CN4601100000000,46,11,"Brookings County, SD",Jan-20,19069,18351,718,3.8
34556,CN4601300000000,46,13,"Brown County, SD",Jan-20,20616,19886,730,3.5
34557,CN4601500000000,46,15,"Brule County, SD",Jan-20,2373,2287,86,3.6
34558,CN4601700000000,46,17,"Buffalo County, SD",Jan-20,665,624,41,6.2
34559,CN4601900000000,46,19,"Butte County, SD",Jan-20,4978,4776,202,4.1
34560,CN4602100000000,46,21,"Campbell County, SD",Jan-20,763,731,32,4.2
34561,CN4602300000000,46,23,"Charles Mix County, SD",Jan-20,3661,3517,144,3.9
34562,CN4602500000000,46,25,"Clark County, SD",Jan-20,1902,1807,95,5.0
34563,CN4602700000000,46,27,"Clay County, SD",Jan-20,7614,7355,259,3.4
34564,CN4602900000000,46,29,"Codington County, SD",Jan-20,15505,14963,542,3.5
34565,CN4603100000000,46,31,"Corson County, SD",Jan-20,1352,1281,71,5.3
34566,CN4603300000000,46,33,"Custer County, SD",Jan-20,3984,3764,220,5.5
34567,CN4603500000000,46,35,"Davison County, SD",Jan-20,10984,10608,376,3.4
34568,CN4603700000000,46,37,"Day County, SD",Jan-20,2746,2570,176,6.4
34569,CN4603900000000,46,39,"Deuel County, SD",Jan-20,2121,1950,171,8.1
34570,CN4604100000000,46,41,"Dewey County, SD",Jan-20,2177,2026,151,6.9
34571,CN4604300000000,46,43,"Douglas County, SD",Jan-20,1574,1518,56,3.6
34572,CN4604500000000,46,45,"Edmunds County, SD",Jan-20,2013,1944,69,3.4
34573,CN4604700000000,46,47,"Fall River County, SD",Jan-20,2868,2721,147,5.1
34574,CN4604900000000,46,49,"Faulk County, SD",Jan-20,1028,989,39,3.8
34575,CN4605100000000,46,51,"Grant County, SD",Jan-20,4428,4196,232,5.2
34576,CN4605300000000,46,53,"Gregory County, SD",Jan-20,1984,1899,85,4.3
34577,CN4605500000000,46,55,"Haakon County, SD",Jan-20,1036,1002,34,3.3
34578,CN4605700000000,46,57,"Hamlin County, SD",Jan-20,3285,3160,125,3.8
34579,CN4605900000000,46,59,"Hand County, SD",Jan-20,1756,1703,53,3.0
34580,CN4606100000000,46,61,"Hanson County, SD",Jan-20,1745,1635,110,6.3
34581,CN4606300000000,46,63,"Harding County, SD",Jan-20,717,697,20,2.8
34582,CN4606500000000,46,65,"Hughes County, SD",Jan-20,9984,9664,320,3.2
34583,CN4606700000000,46,67,"Hutchinson County, SD",Jan-20,3622,3475,147,4.1
34584,CN4606900000000,46,69,"Hyde County, SD",Jan-20,687,660,27,3.9
34585,CN4607100000000,46,71,"Jackson County, SD",Jan-20,1134,1059,75,6.6
34586,CN4607300000000,46,73,"Jerauld County, SD",Jan-20,1084,1059,25,2.3
34587,CN4607500000000,46,75,"Jones County, SD",Jan-20,506,487,19,3.8
34588,CN4607700000000,46,77,"Kingsbury County, SD",Jan-20,2598,2503,95,3.7
34589,CN4607900000000,46,79,"Lake County, SD",Jan-20,6585,6336,249,3.8
34590,CN4608100000000,46,81,"Lawrence County, SD",Jan-20,13270,12835,435,3.3
34591,CN4608300000000,46,83,"Lincoln County, SD",Jan-20,34643,33635,1008,2.9
34592,CN4608500000000,46,85,"Lyman County, SD",Jan-20,1618,1532,86,5.3
34593,CN4608700000000,46,87,"McCook County, SD",Jan-20,3073,2966,107,3.5
34594,CN4608900000000,46,89,"McPherson County, SD",Jan-20,1008,955,53,5.3
34595,CN4609100000000,46,91,"Marshall County, SD",Jan-20,2322,2205,117,5.0
34596,CN4609300000000,46,93,"Meade County, SD",Jan-20,14010,13458,552,3.9
34597,CN4609500000000,46,95,"Mellette County, SD",Jan-20,739,688,51,6.9
34598,CN4609700000000,46,97,"Miner County, SD",Jan-20,1168,1131,37,3.2
34599,CN4609900000000,46,99,"Minnehaha County, SD",Jan-20,113605,109661,3944,3.5
34600,CN4610100000000,46,101,"Moody County, SD",Jan-20,3955,3806,149,3.8
34601,CN4610200000000,46,102,"Oglala Lakota County, SD",Jan-20,3550,3225,325,9.2
34602,CN4610300000000,46,103,"Pennington County, SD",Jan-20,56372,54234,2138,3.8
34603,CN4610500000000,46,105,"Perkins County, SD",Jan-20,1393,1351,42,3.0
34604,CN4610700000000,46,107,"Potter County, SD",Jan-20,986,950,36,3.7
34605,CN4610900000000,46,109,"Roberts County, SD",Jan-20,4873,4570,303,6.2
34606,CN4611100000000,46,111,"Sanborn County, SD",Jan-20,1144,1102,42,3.7
34607,CN4611500000000,46,115,"Spink County, SD",Jan-20,3137,2993,144,4.6
34608,CN4611700000000,46,117,"Stanley County, SD",Jan-20,1847,1771,76,4.1
34609,CN4611900000000,46,119,"Sully County, SD",Jan-20,786,762,24,3.1
34610,CN4612100000000,46,121,"Todd County, SD",Jan-20,3149,2929,220,7.0
34611,CN4612300000000,46,123,"Tripp County, SD",Jan-20,3005,2908,97,3.2
34612,CN4612500000000,46,125,"Turner County, SD",Jan-20,4708,4511,197,4.2
34613,CN4612700000000,46,127,"Union County, SD",Jan-20,8541,8217,324,3.8
34614,CN4612900000000,46,129,"Walworth County, SD",Jan-20,2109,1958,151,7.2
34615,CN4613500000000,46,135,"Yankton County, SD",Jan-20,11875,11497,378,3.2
34616,CN4613700000000,46,137,"Ziebach County, SD",Jan-20,908,871,37,4.1
34617,CN4700100000000,47,1,"Anderson County, TN",Jan-20,34642,33332,1310,3.8
34618,CN4700300000000,47,3,"Bedford County, TN",Jan-20,21029,20197,832,4.0
34619,CN4700500000000,47,5,"Benton County, TN",Jan-20,6951,6566,385,5.5
34620,CN4700700000000,47,7,"Bledsoe County, TN",Jan-20,4394,4135,259,5.9
34621,CN4700900000000,47,9,"Blount County, TN",Jan-20,63860,61444,2416,3.8
34622,CN4701100000000,47,11,"Bradley County, TN",Jan-20,53419,51425,1994,3.7
34623,CN4701300000000,47,13,"Campbell County, TN",Jan-20,14926,14144,782,5.2
34624,CN4701500000000,47,15,"Cannon County, TN",Jan-20,6699,6486,213,3.2
34625,CN4701700000000,47,17,"Carroll County, TN",Jan-20,12087,11390,697,5.8
34626,CN4701900000000,47,19,"Carter County, TN",Jan-20,23926,22840,1086,4.5
34627,CN4702100000000,47,21,"Cheatham County, TN",Jan-20,22195,21556,639,2.9
34628,CN4702300000000,47,23,"Chester County, TN",Jan-20,8547,8243,304,3.6
34629,CN4702500000000,47,25,"Claiborne County, TN",Jan-20,13041,12387,654,5.0
34630,CN4702700000000,47,27,"Clay County, TN",Jan-20,2763,2562,201,7.3
34631,CN4702900000000,47,29,"Cocke County, TN",Jan-20,15111,14106,1005,6.7
34632,CN4703100000000,47,31,"Coffee County, TN",Jan-20,25794,24789,1005,3.9
34633,CN4703300000000,47,33,"Crockett County, TN",Jan-20,7106,6785,321,4.5
34634,CN4703500000000,47,35,"Cumberland County, TN",Jan-20,23906,22344,1562,6.5
34635,CN4703700000000,47,37,"Davidson County, TN",Jan-20,409615,398635,10980,2.7
34636,CN4703900000000,47,39,"Decatur County, TN",Jan-20,4646,4329,317,6.8
34637,CN4704100000000,47,41,"DeKalb County, TN",Jan-20,7758,7388,370,4.8
34638,CN4704300000000,47,43,"Dickson County, TN",Jan-20,27450,26569,881,3.2
34639,CN4704500000000,47,45,"Dyer County, TN",Jan-20,16506,15602,904,5.5
34640,CN4704700000000,47,47,"Fayette County, TN",Jan-20,19240,18493,747,3.9
34641,CN4704900000000,47,49,"Fentress County, TN",Jan-20,7604,7236,368,4.8
34642,CN4705100000000,47,51,"Franklin County, TN",Jan-20,20276,19459,817,4.0
34643,CN4705300000000,47,53,"Gibson County, TN",Jan-20,22294,21210,1084,4.9
34644,CN4705500000000,47,55,"Giles County, TN",Jan-20,15261,14469,792,5.2
34645,CN4705700000000,47,57,"Grainger County, TN",Jan-20,9619,9147,472,4.9
34646,CN4705900000000,47,59,"Greene County, TN",Jan-20,29489,27960,1529,5.2
34647,CN4706100000000,47,61,"Grundy County, TN",Jan-20,5069,4823,246,4.9
34648,CN4706300000000,47,63,"Hamblen County, TN",Jan-20,28456,27186,1270,4.5
34649,CN4706500000000,47,65,"Hamilton County, TN",Jan-20,184470,177711,6759,3.7
34650,CN4706700000000,47,67,"Hancock County, TN",Jan-20,2144,2001,143,6.7
34651,CN4706900000000,47,69,"Hardeman County, TN",Jan-20,9603,9042,561,5.8
34652,CN4707100000000,47,71,"Hardin County, TN",Jan-20,10546,10000,546,5.2
34653,CN4707300000000,47,73,"Hawkins County, TN",Jan-20,23856,22671,1185,5.0
34654,CN4707500000000,47,75,"Haywood County, TN",Jan-20,7808,7394,414,5.3
34655,CN4707700000000,47,77,"Henderson County, TN",Jan-20,12379,11742,637,5.1
34656,CN4707900000000,47,79,"Henry County, TN",Jan-20,14271,13518,753,5.3
34657,CN4708100000000,47,81,"Hickman County, TN",Jan-20,11623,11232,391,3.4
34658,CN4708300000000,47,83,"Houston County, TN",Jan-20,3330,3131,199,6.0
34659,CN4708500000000,47,85,"Humphreys County, TN",Jan-20,9044,8591,453,5.0
34660,CN4708700000000,47,87,"Jackson County, TN",Jan-20,4734,4469,265,5.6
34661,CN4708900000000,47,89,"Jefferson County, TN",Jan-20,24995,23787,1208,4.8
34662,CN4709100000000,47,91,"Johnson County, TN",Jan-20,7780,7434,346,4.4
34663,CN4709300000000,47,93,"Knox County, TN",Jan-20,244003,236503,7500,3.1
34664,CN4709500000000,47,95,"Lake County, TN",Jan-20,1782,1656,126,7.1
34665,CN4709700000000,47,97,"Lauderdale County, TN",Jan-20,9832,9263,569,5.8
34666,CN4709900000000,47,99,"Lawrence County, TN",Jan-20,19503,18653,850,4.4
34667,CN4710100000000,47,101,"Lewis County, TN",Jan-20,5215,4998,217,4.2
34668,CN4710300000000,47,103,"Lincoln County, TN",Jan-20,16404,15175,1229,7.5
34669,CN4710500000000,47,105,"Loudon County, TN",Jan-20,23647,22741,906,3.8
34670,CN4710700000000,47,107,"McMinn County, TN",Jan-20,24053,23039,1014,4.2
34671,CN4710900000000,47,109,"McNairy County, TN",Jan-20,8652,8120,532,6.1
34672,CN4711100000000,47,111,"Macon County, TN",Jan-20,11538,11157,381,3.3
34673,CN4711300000000,47,113,"Madison County, TN",Jan-20,48828,46974,1854,3.8
34674,CN4711500000000,47,115,"Marion County, TN",Jan-20,12582,11943,639,5.1
34675,CN4711700000000,47,117,"Marshall County, TN",Jan-20,15772,15141,631,4.0
34676,CN4711900000000,47,119,"Maury County, TN",Jan-20,50146,48528,1618,3.2
34677,CN4712100000000,47,121,"Meigs County, TN",Jan-20,5246,4960,286,5.5
34678,CN4712300000000,47,123,"Monroe County, TN",Jan-20,20255,19388,867,4.3
34679,CN4712500000000,47,125,"Montgomery County, TN",Jan-20,85871,82329,3542,4.1
34680,CN4712700000000,47,127,"Moore County, TN",Jan-20,3560,3438,122,3.4
34681,CN4712900000000,47,129,"Morgan County, TN",Jan-20,7957,7574,383,4.8
34682,CN4713100000000,47,131,"Obion County, TN",Jan-20,12576,11939,637,5.1
34683,CN4713300000000,47,133,"Overton County, TN",Jan-20,10194,9708,486,4.8
34684,CN4713500000000,47,135,"Perry County, TN",Jan-20,3100,2872,228,7.4
34685,CN4713700000000,47,137,"Pickett County, TN",Jan-20,2381,2244,137,5.8
34686,CN4713900000000,47,139,"Polk County, TN",Jan-20,7749,7389,360,4.6
34687,CN4714100000000,47,141,"Putnam County, TN",Jan-20,35178,33846,1332,3.8
34688,CN4714300000000,47,143,"Rhea County, TN",Jan-20,13485,12688,797,5.9
34689,CN4714500000000,47,145,"Roane County, TN",Jan-20,23556,22447,1109,4.7
34690,CN4714700000000,47,147,"Robertson County, TN",Jan-20,38702,37502,1200,3.1
34691,CN4714900000000,47,149,"Rutherford County, TN",Jan-20,186687,181653,5034,2.7
34692,CN4715100000000,47,151,"Scott County, TN",Jan-20,8280,7893,387,4.7
34693,CN4715300000000,47,153,"Sequatchie County, TN",Jan-20,6208,5933,275,4.4
34694,CN4715500000000,47,155,"Sevier County, TN",Jan-20,54369,50920,3449,6.3
34695,CN4715700000000,47,157,"Shelby County, TN",Jan-20,445108,425617,19491,4.4
34696,CN4715900000000,47,159,"Smith County, TN",Jan-20,9627,9308,319,3.3
34697,CN4716100000000,47,161,"Stewart County, TN",Jan-20,5551,5268,283,5.1
34698,CN4716300000000,47,163,"Sullivan County, TN",Jan-20,70246,67312,2934,4.2
34699,CN4716500000000,47,165,"Sumner County, TN",Jan-20,103850,100827,3023,2.9
34700,CN4716700000000,47,167,"Tipton County, TN",Jan-20,28280,27020,1260,4.5
34701,CN4716900000000,47,169,"Trousdale County, TN",Jan-20,5520,5338,182,3.3
34702,CN4717100000000,47,171,"Unicoi County, TN",Jan-20,7223,6741,482,6.7
34703,CN4717300000000,47,173,"Union County, TN",Jan-20,7630,7305,325,4.3
34704,CN4717500000000,47,175,"Van Buren County, TN",Jan-20,2045,1950,95,4.6
34705,CN4717700000000,47,177,"Warren County, TN",Jan-20,16600,15839,761,4.6
34706,CN4717900000000,47,179,"Washington County, TN",Jan-20,60166,57834,2332,3.9
34707,CN4718100000000,47,181,"Wayne County, TN",Jan-20,6276,5895,381,6.1
34708,CN4718300000000,47,183,"Weakley County, TN",Jan-20,16128,15474,654,4.1
34709,CN4718500000000,47,185,"White County, TN",Jan-20,12294,11775,519,4.2
34710,CN4718700000000,47,187,"Williamson County, TN",Jan-20,129991,126795,3196,2.5
34711,CN4718900000000,47,189,"Wilson County, TN",Jan-20,77813,75589,2224,2.9
34712,CN4800100000000,48,1,"Anderson County, TX",Jan-20,24080,23340,740,3.1
34713,CN4800300000000,48,3,"Andrews County, TX",Jan-20,9956,9705,251,2.5
34714,CN4800500000000,48,5,"Angelina County, TX",Jan-20,36033,34429,1604,4.5
34715,CN4800700000000,48,7,"Aransas County, TX",Jan-20,9393,8961,432,4.6
34716,CN4800900000000,48,9,"Archer County, TX",Jan-20,4141,4016,125,3.0
34717,CN4801100000000,48,11,"Armstrong County, TX",Jan-20,931,902,29,3.1
34718,CN4801300000000,48,13,"Atascosa County, TX",Jan-20,21972,21135,837,3.8
34719,CN4801500000000,48,15,"Austin County, TX",Jan-20,14199,13670,529,3.7
34720,CN4801700000000,48,17,"Bailey County, TX",Jan-20,2415,2319,96,4.0
34721,CN4801900000000,48,19,"Bandera County, TX",Jan-20,10182,9837,345,3.4
34722,CN4802100000000,48,21,"Bastrop County, TX",Jan-20,43422,42083,1339,3.1
34723,CN4802300000000,48,23,"Baylor County, TX",Jan-20,1781,1737,44,2.5
34724,CN4802500000000,48,25,"Bee County, TX",Jan-20,9777,9293,484,5.0
34725,CN4802700000000,48,27,"Bell County, TX",Jan-20,145694,140081,5613,3.9
34726,CN4802900000000,48,29,"Bexar County, TX",Jan-20,962162,930924,31238,3.2
34727,CN4803100000000,48,31,"Blanco County, TX",Jan-20,6591,6429,162,2.5
34728,CN4803300000000,48,33,"Borden County, TX",Jan-20,418,408,10,2.4
34729,CN4803500000000,48,35,"Bosque County, TX",Jan-20,8366,8042,324,3.9
34730,CN4803700000000,48,37,"Bowie County, TX",Jan-20,40092,38395,1697,4.2
34731,CN4803900000000,48,39,"Brazoria County, TX",Jan-20,181632,173088,8544,4.7
34732,CN4804100000000,48,41,"Brazos County, TX",Jan-20,119724,116358,3366,2.8
34733,CN4804300000000,48,43,"Brewster County, TX",Jan-20,4189,4071,118,2.8
34734,CN4804500000000,48,45,"Briscoe County, TX",Jan-20,563,539,24,4.3
34735,CN4804700000000,48,47,"Brooks County, TX",Jan-20,2697,2550,147,5.5
34736,CN4804900000000,48,49,"Brown County, TX",Jan-20,15570,14930,640,4.1
34737,CN4805100000000,48,51,"Burleson County, TX",Jan-20,8434,8127,307,3.6
34738,CN4805300000000,48,53,"Burnet County, TX",Jan-20,23617,22949,668,2.8
34739,CN4805500000000,48,55,"Caldwell County, TX",Jan-20,19898,19232,666,3.3
34740,CN4805700000000,48,57,"Calhoun County, TX",Jan-20,12251,11803,448,3.7
34741,CN4805900000000,48,59,"Callahan County, TX",Jan-20,6181,5970,211,3.4
34742,CN4806100000000,48,61,"Cameron County, TX",Jan-20,169038,158331,10707,6.3
34743,CN4806300000000,48,63,"Camp County, TX",Jan-20,5001,4774,227,4.5
34744,CN4806500000000,48,65,"Carson County, TX",Jan-20,3015,2927,88,2.9
34745,CN4806700000000,48,67,"Cass County, TX",Jan-20,12439,11863,576,4.6
34746,CN4806900000000,48,69,"Castro County, TX",Jan-20,3366,3272,94,2.8
34747,CN4807100000000,48,71,"Chambers County, TX",Jan-20,19722,18724,998,5.1
34748,CN4807300000000,48,73,"Cherokee County, TX",Jan-20,20910,20006,904,4.3
34749,CN4807500000000,48,75,"Childress County, TX",Jan-20,2919,2825,94,3.2
34750,CN4807700000000,48,77,"Clay County, TX",Jan-20,4925,4769,156,3.2
34751,CN4807900000000,48,79,"Cochran County, TX",Jan-20,1104,1061,43,3.9
34752,CN4808100000000,48,81,"Coke County, TX",Jan-20,1459,1418,41,2.8
34753,CN4808300000000,48,83,"Coleman County, TX",Jan-20,2859,2722,137,4.8
34754,CN4808500000000,48,85,"Collin County, TX",Jan-20,571454,553700,17754,3.1
34755,CN4808700000000,48,87,"Collingsworth County, TX",Jan-20,1124,1081,43,3.8
34756,CN4808900000000,48,89,"Colorado County, TX",Jan-20,9841,9502,339,3.4
34757,CN4809100000000,48,91,"Comal County, TX",Jan-20,74269,71976,2293,3.1
34758,CN4809300000000,48,93,"Comanche County, TX",Jan-20,5582,5370,212,3.8
34759,CN4809500000000,48,95,"Concho County, TX",Jan-20,1329,1291,38,2.9
34760,CN4809700000000,48,97,"Cooke County, TX",Jan-20,19723,19108,615,3.1
34761,CN4809900000000,48,99,"Coryell County, TX",Jan-20,24422,23453,969,4.0
34762,CN4810100000000,48,101,"Cottle County, TX",Jan-20,544,516,28,5.1
34763,CN4810300000000,48,103,"Crane County, TX",Jan-20,1547,1467,80,5.2
34764,CN4810500000000,48,105,"Crockett County, TX",Jan-20,1621,1550,71,4.4
34765,CN4810700000000,48,107,"Crosby County, TX",Jan-20,2466,2369,97,3.9
34766,CN4810900000000,48,109,"Culberson County, TX",Jan-20,1056,1013,43,4.1
34767,CN4811100000000,48,111,"Dallam County, TX",Jan-20,3845,3757,88,2.3
34768,CN4811300000000,48,113,"Dallas County, TX",Jan-20,1383174,1335283,47891,3.5
34769,CN4811500000000,48,115,"Dawson County, TX",Jan-20,4751,4540,211,4.4
34770,CN4811700000000,48,117,"Deaf Smith County, TX",Jan-20,8409,8173,236,2.8
34771,CN4811900000000,48,119,"Delta County, TX",Jan-20,2440,2352,88,3.6
34772,CN4812100000000,48,121,"Denton County, TX",Jan-20,501409,486523,14886,3.0
34773,CN4812300000000,48,123,"DeWitt County, TX",Jan-20,9922,9657,265,2.7
34774,CN4812500000000,48,125,"Dickens County, TX",Jan-20,671,639,32,4.8
34775,CN4812700000000,48,127,"Dimmit County, TX",Jan-20,7345,7140,205,2.8
34776,CN4812900000000,48,129,"Donley County, TX",Jan-20,1381,1329,52,3.8
34777,CN4813100000000,48,131,"Duval County, TX",Jan-20,4929,4664,265,5.4
34778,CN4813300000000,48,133,"Eastland County, TX",Jan-20,8120,7796,324,4.0
34779,CN4813500000000,48,135,"Ector County, TX",Jan-20,87996,85003,2993,3.4
34780,CN4813700000000,48,137,"Edwards County, TX",Jan-20,1138,1114,24,2.1
34781,CN4813900000000,48,139,"Ellis County, TX",Jan-20,93966,91001,2965,3.2
34782,CN4814100000000,48,141,"El Paso County, TX",Jan-20,366807,352086,14721,4.0
34783,CN4814300000000,48,143,"Erath County, TX",Jan-20,20642,19886,756,3.7
34784,CN4814500000000,48,145,"Falls County, TX",Jan-20,6577,6344,233,3.5
34785,CN4814700000000,48,147,"Fannin County, TX",Jan-20,17562,17075,487,2.8
34786,CN4814900000000,48,149,"Fayette County, TX",Jan-20,12082,11746,336,2.8
34787,CN4815100000000,48,151,"Fisher County, TX",Jan-20,1619,1570,49,3.0
34788,CN4815300000000,48,153,"Floyd County, TX",Jan-20,2545,2406,139,5.5
34789,CN4815500000000,48,155,"Foard County, TX",Jan-20,580,564,16,2.8
34790,CN4815700000000,48,157,"Fort Bend County, TX",Jan-20,395479,381076,14403,3.6
34791,CN4815900000000,48,159,"Franklin County, TX",Jan-20,4619,4451,168,3.6
34792,CN4816100000000,48,161,"Freestone County, TX",Jan-20,6402,6048,354,5.5
34793,CN4816300000000,48,163,"Frio County, TX",Jan-20,10452,10132,320,3.1
34794,CN4816500000000,48,165,"Gaines County, TX",Jan-20,9879,9614,265,2.7
34795,CN4816700000000,48,167,"Galveston County, TX",Jan-20,167082,159785,7297,4.4
34796,CN4816900000000,48,169,"Garza County, TX",Jan-20,2182,2107,75,3.4
34797,CN4817100000000,48,171,"Gillespie County, TX",Jan-20,13486,13134,352,2.6
34798,CN4817300000000,48,173,"Glasscock County, TX",Jan-20,773,757,16,2.1
34799,CN4817500000000,48,175,"Goliad County, TX",Jan-20,3265,3135,130,4.0
34800,CN4817700000000,48,177,"Gonzales County, TX",Jan-20,9640,9341,299,3.1
34801,CN4817900000000,48,179,"Gray County, TX",Jan-20,8065,7724,341,4.2
34802,CN4818100000000,48,181,"Grayson County, TX",Jan-20,63889,61756,2133,3.3
34803,CN4818300000000,48,183,"Gregg County, TX",Jan-20,58144,55702,2442,4.2
34804,CN4818500000000,48,185,"Grimes County, TX",Jan-20,11216,10706,510,4.5
34805,CN4818700000000,48,187,"Guadalupe County, TX",Jan-20,82501,80029,2472,3.0
34806,CN4818900000000,48,189,"Hale County, TX",Jan-20,11932,11369,563,4.7
34807,CN4819100000000,48,191,"Hall County, TX",Jan-20,1042,996,46,4.4
34808,CN4819300000000,48,193,"Hamilton County, TX",Jan-20,3658,3543,115,3.1
34809,CN4819500000000,48,195,"Hansford County, TX",Jan-20,2710,2642,68,2.5
34810,CN4819700000000,48,197,"Hardeman County, TX",Jan-20,1726,1673,53,3.1
34811,CN4819900000000,48,199,"Hardin County, TX",Jan-20,25445,24190,1255,4.9
34812,CN4820100000000,48,201,"Harris County, TX",Jan-20,2339258,2242908,96350,4.1
34813,CN4820300000000,48,203,"Harrison County, TX",Jan-20,29425,28125,1300,4.4
34814,CN4820500000000,48,205,"Hartley County, TX",Jan-20,2765,2713,52,1.9
34815,CN4820700000000,48,207,"Haskell County, TX",Jan-20,2265,2184,81,3.6
34816,CN4820900000000,48,209,"Hays County, TX",Jan-20,121491,118010,3481,2.9
34817,CN4821100000000,48,211,"Hemphill County, TX",Jan-20,1891,1823,68,3.6
34818,CN4821300000000,48,213,"Henderson County, TX",Jan-20,36711,35307,1404,3.8
34819,CN4821500000000,48,215,"Hidalgo County, TX",Jan-20,363350,335764,27586,7.6
34820,CN4821700000000,48,217,"Hill County, TX",Jan-20,16332,15742,590,3.6
34821,CN4821900000000,48,219,"Hockley County, TX",Jan-20,11216,10839,377,3.4
34822,CN4822100000000,48,221,"Hood County, TX",Jan-20,27908,26885,1023,3.7
34823,CN4822300000000,48,223,"Hopkins County, TX",Jan-20,17543,16975,568,3.2
34824,CN4822500000000,48,225,"Houston County, TX",Jan-20,10279,9915,364,3.5
34825,CN4822700000000,48,227,"Howard County, TX",Jan-20,14202,13721,481,3.4
34826,CN4822900000000,48,229,"Hudspeth County, TX",Jan-20,1828,1747,81,4.4
34827,CN4823100000000,48,231,"Hunt County, TX",Jan-20,44014,42405,1609,3.7
34828,CN4823300000000,48,233,"Hutchinson County, TX",Jan-20,8719,8287,432,5.0
34829,CN4823500000000,48,235,"Irion County, TX",Jan-20,756,737,19,2.5
34830,CN4823700000000,48,237,"Jack County, TX",Jan-20,3407,3264,143,4.2
34831,CN4823900000000,48,239,"Jackson County, TX",Jan-20,7678,7414,264,3.4
34832,CN4824100000000,48,241,"Jasper County, TX",Jan-20,12840,11910,930,7.2
34833,CN4824300000000,48,243,"Jeff Davis County, TX",Jan-20,982,950,32,3.3
34834,CN4824500000000,48,245,"Jefferson County, TX",Jan-20,107782,100867,6915,6.4
34835,CN4824700000000,48,247,"Jim Hogg County, TX",Jan-20,1859,1766,93,5.0
34836,CN4824900000000,48,249,"Jim Wells County, TX",Jan-20,16834,15899,935,5.6
34837,CN4825100000000,48,251,"Johnson County, TX",Jan-20,83206,80399,2807,3.4
34838,CN4825300000000,48,253,"Jones County, TX",Jan-20,5767,5519,248,4.3
34839,CN4825500000000,48,255,"Karnes County, TX",Jan-20,7404,7217,187,2.5
34840,CN4825700000000,48,257,"Kaufman County, TX",Jan-20,65566,63326,2240,3.4
34841,CN4825900000000,48,259,"Kendall County, TX",Jan-20,22363,21732,631,2.8
34842,CN4826100000000,48,261,"Kenedy County, TX",Jan-20,202,193,9,4.5
34843,CN4826300000000,48,263,"Kent County, TX",Jan-20,485,467,18,3.7
34844,CN4826500000000,48,265,"Kerr County, TX",Jan-20,22166,21411,755,3.4
34845,CN4826700000000,48,267,"Kimble County, TX",Jan-20,1811,1749,62,3.4
34846,CN4826900000000,48,269,"King County, TX",Jan-20,232,228,4,1.7
34847,CN4827100000000,48,271,"Kinney County, TX",Jan-20,1407,1336,71,5.0
34848,CN4827300000000,48,273,"Kleberg County, TX",Jan-20,13331,12700,631,4.7
34849,CN4827500000000,48,275,"Knox County, TX",Jan-20,1415,1360,55,3.9
34850,CN4827700000000,48,277,"Lamar County, TX",Jan-20,24252,23412,840,3.5
34851,CN4827900000000,48,279,"Lamb County, TX",Jan-20,5338,5121,217,4.1
34852,CN4828100000000,48,281,"Lampasas County, TX",Jan-20,9322,9002,320,3.4
34853,CN4828300000000,48,283,"La Salle County, TX",Jan-20,4384,4263,121,2.8
34854,CN4828500000000,48,285,"Lavaca County, TX",Jan-20,8413,8159,254,3.0
34855,CN4828700000000,48,287,"Lee County, TX",Jan-20,10004,9721,283,2.8
34856,CN4828900000000,48,289,"Leon County, TX",Jan-20,6320,6007,313,5.0
34857,CN4829100000000,48,291,"Liberty County, TX",Jan-20,33604,31605,1999,5.9
34858,CN4829300000000,48,293,"Limestone County, TX",Jan-20,8668,8304,364,4.2
34859,CN4829500000000,48,295,"Lipscomb County, TX",Jan-20,1645,1598,47,2.9
34860,CN4829700000000,48,297,"Live Oak County, TX",Jan-20,5699,5504,195,3.4
34861,CN4829900000000,48,299,"Llano County, TX",Jan-20,8685,8375,310,3.6
34862,CN4830100000000,48,301,"Loving County, TX",Jan-20,663,659,4,0.6
34863,CN4830300000000,48,303,"Lubbock County, TX",Jan-20,157875,153285,4590,2.9
34864,CN4830500000000,48,305,"Lynn County, TX",Jan-20,2756,2660,96,3.5
34865,CN4830700000000,48,307,"McCulloch County, TX",Jan-20,3320,3159,161,4.8
34866,CN4830900000000,48,309,"McLennan County, TX",Jan-20,119993,115860,4133,3.4
34867,CN4831100000000,48,311,"McMullen County, TX",Jan-20,896,883,13,1.5
34868,CN4831300000000,48,313,"Madison County, TX",Jan-20,4457,4262,195,4.4
34869,CN4831500000000,48,315,"Marion County, TX",Jan-20,4234,4013,221,5.2
34870,CN4831700000000,48,317,"Martin County, TX",Jan-20,2887,2801,86,3.0
34871,CN4831900000000,48,319,"Mason County, TX",Jan-20,1753,1690,63,3.6
34872,CN4832100000000,48,321,"Matagorda County, TX",Jan-20,16683,15558,1125,6.7
34873,CN4832300000000,48,323,"Maverick County, TX",Jan-20,24614,22212,2402,9.8
34874,CN4832500000000,48,325,"Medina County, TX",Jan-20,22080,21347,733,3.3
34875,CN4832700000000,48,327,"Menard County, TX",Jan-20,858,829,29,3.4
34876,CN4832900000000,48,329,"Midland County, TX",Jan-20,107926,105377,2549,2.4
34877,CN4833100000000,48,331,"Milam County, TX",Jan-20,9670,9197,473,4.9
34878,CN4833300000000,48,333,"Mills County, TX",Jan-20,1900,1838,62,3.3
34879,CN4833500000000,48,335,"Mitchell County, TX",Jan-20,2318,2240,78,3.4
34880,CN4833700000000,48,337,"Montague County, TX",Jan-20,9355,9059,296,3.2
34881,CN4833900000000,48,339,"Montgomery County, TX",Jan-20,286578,276119,10459,3.6
34882,CN4834100000000,48,341,"Moore County, TX",Jan-20,10793,10520,273,2.5
34883,CN4834300000000,48,343,"Morris County, TX",Jan-20,4849,4569,280,5.8
34884,CN4834500000000,48,345,"Motley County, TX",Jan-20,468,450,18,3.8
34885,CN4834700000000,48,347,"Nacogdoches County, TX",Jan-20,28012,26915,1097,3.9
34886,CN4834900000000,48,349,"Navarro County, TX",Jan-20,24195,23243,952,3.9
34887,CN4835100000000,48,351,"Newton County, TX",Jan-20,5246,4858,388,7.4
34888,CN4835300000000,48,353,"Nolan County, TX",Jan-20,7354,7123,231,3.1
34889,CN4835500000000,48,355,"Nueces County, TX",Jan-20,167148,159551,7597,4.5
34890,CN4835700000000,48,357,"Ochiltree County, TX",Jan-20,4311,4171,140,3.2
34891,CN4835900000000,48,359,"Oldham County, TX",Jan-20,916,887,29,3.2
34892,CN4836100000000,48,361,"Orange County, TX",Jan-20,36605,34573,2032,5.6
34893,CN4836300000000,48,363,"Palo Pinto County, TX",Jan-20,13498,13054,444,3.3
34894,CN4836500000000,48,365,"Panola County, TX",Jan-20,10050,9575,475,4.7
34895,CN4836700000000,48,367,"Parker County, TX",Jan-20,68197,66050,2147,3.1
34896,CN4836900000000,48,369,"Parmer County, TX",Jan-20,4828,4712,116,2.4
34897,CN4837100000000,48,371,"Pecos County, TX",Jan-20,6382,6130,252,3.9
34898,CN4837300000000,48,373,"Polk County, TX",Jan-20,18269,17274,995,5.4
34899,CN4837500000000,48,375,"Potter County, TX",Jan-20,55439,53866,1573,2.8
34900,CN4837700000000,48,377,"Presidio County, TX",Jan-20,3193,2895,298,9.3
34901,CN4837900000000,48,379,"Rains County, TX",Jan-20,6166,5977,189,3.1
34902,CN4838100000000,48,381,"Randall County, TX",Jan-20,72383,70536,1847,2.6
34903,CN4838300000000,48,383,"Reagan County, TX",Jan-20,1944,1881,63,3.2
34904,CN4838500000000,48,385,"Real County, TX",Jan-20,1009,965,44,4.4
34905,CN4838700000000,48,387,"Red River County, TX",Jan-20,5142,4888,254,4.9
34906,CN4838900000000,48,389,"Reeves County, TX",Jan-20,12406,12152,254,2.0
34907,CN4839100000000,48,391,"Refugio County, TX",Jan-20,3137,3009,128,4.1
34908,CN4839300000000,48,393,"Roberts County, TX",Jan-20,414,402,12,2.9
34909,CN4839500000000,48,395,"Robertson County, TX",Jan-20,7691,7396,295,3.8
34910,CN4839700000000,48,397,"Rockwall County, TX",Jan-20,52817,51155,1662,3.1
34911,CN4839900000000,48,399,"Runnels County, TX",Jan-20,4598,4455,143,3.1
34912,CN4840100000000,48,401,"Rusk County, TX",Jan-20,23036,22051,985,4.3
34913,CN4840300000000,48,403,"Sabine County, TX",Jan-20,3715,3423,292,7.9
34914,CN4840500000000,48,405,"San Augustine County, TX",Jan-20,3521,3326,195,5.5
34915,CN4840700000000,48,407,"San Jacinto County, TX",Jan-20,11865,11259,606,5.1
34916,CN4840900000000,48,409,"San Patricio County, TX",Jan-20,29929,28079,1850,6.2
34917,CN4841100000000,48,411,"San Saba County, TX",Jan-20,2570,2477,93,3.6
34918,CN4841300000000,48,413,"Schleicher County, TX",Jan-20,1308,1268,40,3.1
34919,CN4841500000000,48,415,"Scurry County, TX",Jan-20,6735,6478,257,3.8
34920,CN4841700000000,48,417,"Shackelford County, TX",Jan-20,1896,1844,52,2.7
34921,CN4841900000000,48,419,"Shelby County, TX",Jan-20,11141,10632,509,4.6
34922,CN4842100000000,48,421,"Sherman County, TX",Jan-20,1367,1330,37,2.7
34923,CN4842300000000,48,423,"Smith County, TX",Jan-20,106713,102843,3870,3.6
34924,CN4842500000000,48,425,"Somervell County, TX",Jan-20,4428,4253,175,4.0
34925,CN4842700000000,48,427,"Starr County, TX",Jan-20,26543,22882,3661,13.8
34926,CN4842900000000,48,429,"Stephens County, TX",Jan-20,4063,3923,140,3.4
34927,CN4843100000000,48,431,"Sterling County, TX",Jan-20,563,542,21,3.7
34928,CN4843300000000,48,433,"Stonewall County, TX",Jan-20,566,548,18,3.2
34929,CN4843500000000,48,435,"Sutton County, TX",Jan-20,1346,1286,60,4.5
34930,CN4843700000000,48,437,"Swisher County, TX",Jan-20,2577,2477,100,3.9
34931,CN4843900000000,48,439,"Tarrant County, TX",Jan-20,1095298,1058827,36471,3.3
34932,CN4844100000000,48,441,"Taylor County, TX",Jan-20,67604,65569,2035,3.0
34933,CN4844300000000,48,443,"Terrell County, TX",Jan-20,360,347,13,3.6
34934,CN4844500000000,48,445,"Terry County, TX",Jan-20,4876,4686,190,3.9
34935,CN4844700000000,48,447,"Throckmorton County, TX",Jan-20,632,608,24,3.8
34936,CN4844900000000,48,449,"Titus County, TX",Jan-20,13096,12505,591,4.5
34937,CN4845100000000,48,451,"Tom Green County, TX",Jan-20,54544,52785,1759,3.2
34938,CN4845300000000,48,453,"Travis County, TX",Jan-20,750910,731017,19893,2.6
34939,CN4845500000000,48,455,"Trinity County, TX",Jan-20,5329,5025,304,5.7
34940,CN4845700000000,48,457,"Tyler County, TX",Jan-20,7191,6702,489,6.8
34941,CN4845900000000,48,459,"Upshur County, TX",Jan-20,17883,17097,786,4.4
34942,CN4846100000000,48,461,"Upton County, TX",Jan-20,1698,1643,55,3.2
34943,CN4846300000000,48,463,"Uvalde County, TX",Jan-20,11367,10922,445,3.9
34944,CN4846500000000,48,465,"Val Verde County, TX",Jan-20,23292,22322,970,4.2
34945,CN4846700000000,48,467,"Van Zandt County, TX",Jan-20,26143,25205,938,3.6
34946,CN4846900000000,48,469,"Victoria County, TX",Jan-20,42759,41074,1685,3.9
34947,CN4847100000000,48,471,"Walker County, TX",Jan-20,24284,23315,969,4.0
34948,CN4847300000000,48,473,"Waller County, TX",Jan-20,23665,22705,960,4.1
34949,CN4847500000000,48,475,"Ward County, TX",Jan-20,7843,7634,209,2.7
34950,CN4847700000000,48,477,"Washington County, TX",Jan-20,15332,14810,522,3.4
34951,CN4847900000000,48,479,"Webb County, TX",Jan-20,119635,114720,4915,4.1
34952,CN4848100000000,48,481,"Wharton County, TX",Jan-20,21620,20774,846,3.9
34953,CN4848300000000,48,483,"Wheeler County, TX",Jan-20,2276,2199,77,3.4
34954,CN4848500000000,48,485,"Wichita County, TX",Jan-20,56473,54596,1877,3.3
34955,CN4848700000000,48,487,"Wilbarger County, TX",Jan-20,4977,4779,198,4.0
34956,CN4848900000000,48,489,"Willacy County, TX",Jan-20,6768,6205,563,8.3
34957,CN4849100000000,48,491,"Williamson County, TX",Jan-20,318094,308981,9113,2.9
34958,CN4849300000000,48,493,"Wilson County, TX",Jan-20,25200,24439,761,3.0
34959,CN4849500000000,48,495,"Winkler County, TX",Jan-20,4054,3905,149,3.7
34960,CN4849700000000,48,497,"Wise County, TX",Jan-20,32280,31165,1115,3.5
34961,CN4849900000000,48,499,"Wood County, TX",Jan-20,17810,17052,758,4.3
34962,CN4850100000000,48,501,"Yoakum County, TX",Jan-20,3759,3626,133,3.5
34963,CN4850300000000,48,503,"Young County, TX",Jan-20,7916,7664,252,3.2
34964,CN4850500000000,48,505,"Zapata County, TX",Jan-20,4906,4585,321,6.5
34965,CN4850700000000,48,507,"Zavala County, TX",Jan-20,3412,3099,313,9.2
34966,CN4900100000000,49,1,"Beaver County, UT",Jan-20,2722,2634,88,3.2
34967,CN4900300000000,49,3,"Box Elder County, UT",Jan-20,25946,25196,750,2.9
34968,CN4900500000000,49,5,"Cache County, UT",Jan-20,64926,63468,1458,2.2
34969,CN4900700000000,49,7,"Carbon County, UT",Jan-20,8487,8148,339,4.0
34970,CN4900900000000,49,9,"Daggett County, UT",Jan-20,321,300,21,6.5
34971,CN4901100000000,49,11,"Davis County, UT",Jan-20,175148,170823,4325,2.5
34972,CN4901300000000,49,13,"Duchesne County, UT",Jan-20,7831,7453,378,4.8
34973,CN4901500000000,49,15,"Emery County, UT",Jan-20,4238,4025,213,5.0
34974,CN4901700000000,49,17,"Garfield County, UT",Jan-20,2238,1934,304,13.6
34975,CN4901900000000,49,19,"Grand County, UT",Jan-20,5405,4849,556,10.3
34976,CN4902100000000,49,21,"Iron County, UT",Jan-20,24726,23985,741,3.0
34977,CN4902300000000,49,23,"Juab County, UT",Jan-20,5827,5654,173,3.0
34978,CN4902500000000,49,25,"Kane County, UT",Jan-20,3492,3354,138,4.0
34979,CN4902700000000,49,27,"Millard County, UT",Jan-20,5696,5526,170,3.0
34980,CN4902900000000,49,29,"Morgan County, UT",Jan-20,5590,5451,139,2.5
34981,CN4903100000000,49,31,"Piute County, UT",Jan-20,472,446,26,5.5
34982,CN4903300000000,49,33,"Rich County, UT",Jan-20,927,880,47,5.1
34983,CN4903500000000,49,35,"Salt Lake County, UT",Jan-20,644743,627767,16976,2.6
34984,CN4903700000000,49,37,"San Juan County, UT",Jan-20,5472,5033,439,8.0
34985,CN4903900000000,49,39,"Sanpete County, UT",Jan-20,12438,11988,450,3.6
34986,CN4904100000000,49,41,"Sevier County, UT",Jan-20,9614,9245,369,3.8
34987,CN4904300000000,49,43,"Summit County, UT",Jan-20,27724,27137,587,2.1
34988,CN4904500000000,49,45,"Tooele County, UT",Jan-20,34539,33523,1016,2.9
34989,CN4904700000000,49,47,"Uintah County, UT",Jan-20,13632,12896,736,5.4
34990,CN4904900000000,49,49,"Utah County, UT",Jan-20,312288,304402,7886,2.5
34991,CN4905100000000,49,51,"Wasatch County, UT",Jan-20,17052,16609,443,2.6
34992,CN4905300000000,49,53,"Washington County, UT",Jan-20,76741,74114,2627,3.4
34993,CN4905500000000,49,55,"Wayne County, UT",Jan-20,1263,1115,148,11.7
34994,CN4905700000000,49,57,"Weber County, UT",Jan-20,128559,124643,3916,3.0
34995,CN5000100000000,50,1,"Addison County, VT",Jan-20,20207,19605,602,3.0
34996,CN5000300000000,50,3,"Bennington County, VT",Jan-20,17952,17304,648,3.6
34997,CN5000500000000,50,5,"Caledonia County, VT",Jan-20,14264,13662,602,4.2
34998,CN5000700000000,50,7,"Chittenden County, VT",Jan-20,94012,92082,1930,2.1
34999,CN5000900000000,50,9,"Essex County, VT",Jan-20,2671,2540,131,4.9
35000,CN5001100000000,50,11,"Franklin County, VT",Jan-20,26667,25892,775,2.9
35001,CN5001300000000,50,13,"Grand Isle County, VT",Jan-20,3981,3817,164,4.1
35002,CN5001500000000,50,15,"Lamoille County, VT",Jan-20,13937,13354,583,4.2
35003,CN5001700000000,50,17,"Orange County, VT",Jan-20,15834,15229,605,3.8
35004,CN5001900000000,50,19,"Orleans County, VT",Jan-20,13510,12669,841,6.2
35005,CN5002100000000,50,21,"Rutland County, VT",Jan-20,30411,29433,978,3.2
35006,CN5002300000000,50,23,"Washington County, VT",Jan-20,34391,33294,1097,3.2
35007,CN5002500000000,50,25,"Windham County, VT",Jan-20,21966,21381,585,2.7
35008,CN5002700000000,50,27,"Windsor County, VT",Jan-20,29017,28376,641,2.2
35009,CN5100100000000,51,1,"Accomack County, VA",Jan-20,16471,15683,788,4.8
35010,CN5100300000000,51,3,"Albemarle County, VA",Jan-20,58100,56585,1515,2.6
35011,CN5100500000000,51,5,"Alleghany County, VA",Jan-20,7015,6685,330,4.7
35012,CN5100700000000,51,7,"Amelia County, VA",Jan-20,6417,6187,230,3.6
35013,CN5100900000000,51,9,"Amherst County, VA",Jan-20,15124,14587,537,3.6
35014,CN5101100000000,51,11,"Appomattox County, VA",Jan-20,7227,6929,298,4.1
35015,CN5101300000000,51,13,"Arlington County, VA",Jan-20,157319,154118,3201,2.0
35016,CN5101500000000,51,15,"Augusta County, VA",Jan-20,38242,37251,991,2.6
35017,CN5101700000000,51,17,"Bath County, VA",Jan-20,2562,2476,86,3.4
35018,CN5101900000000,51,19,"Bedford County, VA",Jan-20,38664,37428,1236,3.2
35019,CN5102100000000,51,21,"Bland County, VA",Jan-20,2853,2774,79,2.8
35020,CN5102300000000,51,23,"Botetourt County, VA",Jan-20,17571,17070,501,2.9
35021,CN5102500000000,51,25,"Brunswick County, VA",Jan-20,6034,5720,314,5.2
35022,CN5102700000000,51,27,"Buchanan County, VA",Jan-20,6808,6272,536,7.9
35023,CN5102900000000,51,29,"Buckingham County, VA",Jan-20,6577,6243,334,5.1
35024,CN5103100000000,51,31,"Campbell County, VA",Jan-20,26137,25234,903,3.5
35025,CN5103300000000,51,33,"Caroline County, VA",Jan-20,15597,15041,556,3.6
35026,CN5103500000000,51,35,"Carroll County, VA",Jan-20,13291,12763,528,4.0
35027,CN5103600000000,51,36,"Charles City County, VA",Jan-20,3747,3606,141,3.8
35028,CN5103700000000,51,37,"Charlotte County, VA",Jan-20,5310,5093,217,4.1
35029,CN5104100000000,51,41,"Chesterfield County, VA",Jan-20,191338,185840,5498,2.9
35030,CN5104300000000,51,43,"Clarke County, VA",Jan-20,7735,7537,198,2.6
35031,CN5104500000000,51,45,"Craig County, VA",Jan-20,2318,2240,78,3.4
35032,CN5104700000000,51,47,"Culpeper County, VA",Jan-20,25102,24360,742,3.0
35033,CN5104900000000,51,49,"Cumberland County, VA",Jan-20,4687,4513,174,3.7
35034,CN5105100000000,51,51,"Dickenson County, VA",Jan-20,4828,4522,306,6.3
35035,CN5105300000000,51,53,"Dinwiddie County, VA",Jan-20,13945,13454,491,3.5
35036,CN5105700000000,51,57,"Essex County, VA",Jan-20,5544,5313,231,4.2
35037,CN5105900000000,51,59,"Fairfax County, VA",Jan-20,647069,631589,15480,2.4
35038,CN5106100000000,51,61,"Fauquier County, VA",Jan-20,37933,36960,973,2.6
35039,CN5106300000000,51,63,"Floyd County, VA",Jan-20,8105,7839,266,3.3
35040,CN5106500000000,51,65,"Fluvanna County, VA",Jan-20,14134,13779,355,2.5
35041,CN5106700000000,51,67,"Franklin County, VA",Jan-20,26679,25768,911,3.4
35042,CN5106900000000,51,69,"Frederick County, VA",Jan-20,48968,47700,1268,2.6
35043,CN5107100000000,51,71,"Giles County, VA",Jan-20,7767,7485,282,3.6
35044,CN5107300000000,51,73,"Gloucester County, VA",Jan-20,19711,19140,571,2.9
35045,CN5107500000000,51,75,"Goochland County, VA",Jan-20,11434,11101,333,2.9
35046,CN5107700000000,51,77,"Grayson County, VA",Jan-20,8201,7922,279,3.4
35047,CN5107900000000,51,79,"Greene County, VA",Jan-20,10658,10389,269,2.5
35048,CN5108100000000,51,81,"Greensville County, VA",Jan-20,4290,4141,149,3.5
35049,CN5108300000000,51,83,"Halifax County, VA",Jan-20,15641,14914,727,4.6
35050,CN5108500000000,51,85,"Hanover County, VA",Jan-20,60459,58904,1555,2.6
35051,CN5108700000000,51,87,"Henrico County, VA",Jan-20,185734,180352,5382,2.9
35052,CN5108900000000,51,89,"Henry County, VA",Jan-20,24023,23091,932,3.9
35053,CN5109100000000,51,91,"Highland County, VA",Jan-20,1227,1181,46,3.7
35054,CN5109300000000,51,93,"Isle of Wight County, VA",Jan-20,19556,18960,596,3.0
35055,CN5109500000000,51,95,"James City County, VA",Jan-20,36895,35744,1151,3.1
35056,CN5109700000000,51,97,"King and Queen County, VA",Jan-20,3896,3783,113,2.9
35057,CN5109900000000,51,99,"King George County, VA",Jan-20,13756,13358,398,2.9
35058,CN5110100000000,51,101,"King William County, VA",Jan-20,9341,9065,276,3.0
35059,CN5110300000000,51,103,"Lancaster County, VA",Jan-20,5539,5168,371,6.7
35060,CN5110500000000,51,105,"Lee County, VA",Jan-20,8343,7942,401,4.8
35061,CN5110700000000,51,107,"Loudoun County, VA",Jan-20,226778,221331,5447,2.4
35062,CN5110900000000,51,109,"Louisa County, VA",Jan-20,20173,19528,645,3.2
35063,CN5111100000000,51,111,"Lunenburg County, VA",Jan-20,5359,5188,171,3.2
35064,CN5111300000000,51,113,"Madison County, VA",Jan-20,7516,7335,181,2.4
35065,CN5111500000000,51,115,"Mathews County, VA",Jan-20,4170,4035,135,3.2
35066,CN5111700000000,51,117,"Mecklenburg County, VA",Jan-20,12378,11806,572,4.6
35067,CN5111900000000,51,119,"Middlesex County, VA",Jan-20,5296,5130,166,3.1
35068,CN5112100000000,51,121,"Montgomery County, VA",Jan-20,49186,47723,1463,3.0
35069,CN5112500000000,51,125,"Nelson County, VA",Jan-20,7541,7333,208,2.8
35070,CN5112700000000,51,127,"New Kent County, VA",Jan-20,12727,12408,319,2.5
35071,CN5113100000000,51,131,"Northampton County, VA",Jan-20,5398,5103,295,5.5
35072,CN5113300000000,51,133,"Northumberland County, VA",Jan-20,5686,5301,385,6.8
35073,CN5113500000000,51,135,"Nottoway County, VA",Jan-20,7396,7179,217,2.9
35074,CN5113700000000,51,137,"Orange County, VA",Jan-20,17648,17089,559,3.2
35075,CN5113900000000,51,139,"Page County, VA",Jan-20,12081,11376,705,5.8
35076,CN5114100000000,51,141,"Patrick County, VA",Jan-20,7127,6839,288,4.0
35077,CN5114300000000,51,143,"Pittsylvania County, VA",Jan-20,30278,29096,1182,3.9
35078,CN5114500000000,51,145,"Powhatan County, VA",Jan-20,14462,14036,426,2.9
35079,CN5114700000000,51,147,"Prince Edward County, VA",Jan-20,10379,9954,425,4.1
35080,CN5114900000000,51,149,"Prince George County, VA",Jan-20,15419,14860,559,3.6
35081,CN5115300000000,51,153,"Prince William County, VA",Jan-20,250393,243661,6732,2.7
35082,CN5115500000000,51,155,"Pulaski County, VA",Jan-20,15782,15208,574,3.6
35083,CN5115700000000,51,157,"Rappahannock County, VA",Jan-20,3760,3657,103,2.7
35084,CN5115900000000,51,159,"Richmond County, VA",Jan-20,4119,3973,146,3.5
35085,CN5116100000000,51,161,"Roanoke County, VA",Jan-20,49816,48398,1418,2.8
35086,CN5116300000000,51,163,"Rockbridge County, VA",Jan-20,10789,10447,342,3.2
35087,CN5116500000000,51,165,"Rockingham County, VA",Jan-20,43037,41947,1090,2.5
35088,CN5116700000000,51,167,"Russell County, VA",Jan-20,11425,10829,596,5.2
35089,CN5116900000000,51,169,"Scott County, VA",Jan-20,9243,8904,339,3.7
35090,CN5117100000000,51,171,"Shenandoah County, VA",Jan-20,22731,22110,621,2.7
35091,CN5117300000000,51,173,"Smyth County, VA",Jan-20,13925,13321,604,4.3
35092,CN5117500000000,51,175,"Southampton County, VA",Jan-20,9108,8831,277,3.0
35093,CN5117700000000,51,177,"Spotsylvania County, VA",Jan-20,68354,66262,2092,3.1
35094,CN5117900000000,51,179,"Stafford County, VA",Jan-20,73480,71348,2132,2.9
35095,CN5118100000000,51,181,"Surry County, VA",Jan-20,3659,3518,141,3.9
35096,CN5118300000000,51,183,"Sussex County, VA",Jan-20,3903,3702,201,5.1
35097,CN5118500000000,51,185,"Tazewell County, VA",Jan-20,15757,14912,845,5.4
35098,CN5118700000000,51,187,"Warren County, VA",Jan-20,20850,20194,656,3.1
35099,CN5119100000000,51,191,"Washington County, VA",Jan-20,27048,26040,1008,3.7
35100,CN5119300000000,51,193,"Westmoreland County, VA",Jan-20,9547,9135,412,4.3
35101,CN5119500000000,51,195,"Wise County, VA",Jan-20,13411,12707,704,5.2
35102,CN5119700000000,51,197,"Wythe County, VA",Jan-20,13659,13131,528,3.9
35103,CN5119900000000,51,199,"York County, VA",Jan-20,32980,32012,968,2.9
35104,CN5151000000000,51,510,"Alexandria city, VA",Jan-20,103294,100950,2344,2.3
35105,CN5152000000000,51,520,"Bristol city, VA",Jan-20,7273,6972,301,4.1
35106,CN5153000000000,51,530,"Buena Vista city, VA",Jan-20,3690,3587,103,2.8
35107,CN5154000000000,51,540,"Charlottesville city, VA",Jan-20,26844,26175,669,2.5
35108,CN5155000000000,51,550,"Chesapeake city, VA",Jan-20,123365,119606,3759,3.0
35109,CN5157000000000,51,570,"Colonial Heights city, VA",Jan-20,8983,8687,296,3.3
35110,CN5158000000000,51,580,"Covington city, VA",Jan-20,2436,2293,143,5.9
35111,CN5159000000000,51,590,"Danville city, VA",Jan-20,19303,18244,1059,5.5
35112,CN5159500000000,51,595,"Emporia city, VA",Jan-20,2281,2168,113,5.0
35113,CN5160000000000,51,600,"Fairfax city, VA",Jan-20,13704,13392,312,2.3
35114,CN5161000000000,51,610,"Falls Church city, VA",Jan-20,8751,8569,182,2.1
35115,CN5162000000000,51,620,"Franklin city, VA",Jan-20,3581,3426,155,4.3
35116,CN5163000000000,51,630,"Fredericksburg city, VA",Jan-20,14420,13926,494,3.4
35117,CN5164000000000,51,640,"Galax city, VA",Jan-20,2919,2819,100,3.4
35118,CN5165000000000,51,650,"Hampton city, VA",Jan-20,64823,62170,2653,4.1
35119,CN5166000000000,51,660,"Harrisonburg city, VA",Jan-20,25641,24841,800,3.1
35120,CN5167000000000,51,670,"Hopewell city, VA",Jan-20,9909,9449,460,4.6
35121,CN5167800000000,51,678,"Lexington city, VA",Jan-20,2107,2006,101,4.8
35122,CN5168000000000,51,680,"Lynchburg city, VA",Jan-20,36495,35081,1414,3.9
35123,CN5168300000000,51,683,"Manassas city, VA",Jan-20,22510,21879,631,2.8
35124,CN5168500000000,51,685,"Manassas Park city, VA",Jan-20,9566,9303,263,2.7
35125,CN5169000000000,51,690,"Martinsville city, VA",Jan-20,5542,5268,274,4.9
35126,CN5170000000000,51,700,"Newport News city, VA",Jan-20,89554,86056,3498,3.9
35127,CN5171000000000,51,710,"Norfolk city, VA",Jan-20,112273,108168,4105,3.7
35128,CN5172000000000,51,720,"Norton city, VA",Jan-20,1694,1613,81,4.8
35129,CN5173000000000,51,730,"Petersburg city, VA",Jan-20,13312,12535,777,5.8
35130,CN5173500000000,51,735,"Poquoson city, VA",Jan-20,6424,6253,171,2.7
35131,CN5174000000000,51,740,"Portsmouth city, VA",Jan-20,44482,42702,1780,4.0
35132,CN5175000000000,51,750,"Radford city, VA",Jan-20,8492,8166,326,3.8
35133,CN5176000000000,51,760,"Richmond city, VA",Jan-20,120799,116615,4184,3.5
35134,CN5177000000000,51,770,"Roanoke city, VA",Jan-20,49622,47947,1675,3.4
35135,CN5177500000000,51,775,"Salem city, VA",Jan-20,13088,12692,396,3.0
35136,CN5179000000000,51,790,"Staunton city, VA",Jan-20,12497,12134,363,2.9
35137,CN5180000000000,51,800,"Suffolk city, VA",Jan-20,44885,43440,1445,3.2
35138,CN5181000000000,51,810,"Virginia Beach city, VA",Jan-20,234357,227555,6802,2.9
35139,CN5182000000000,51,820,"Waynesboro city, VA",Jan-20,10904,10581,323,3.0
35140,CN5183000000000,51,830,"Williamsburg city, VA",Jan-20,6736,6454,282,4.2
35141,CN5184000000000,51,840,"Winchester city, VA",Jan-20,15069,14605,464,3.1
35142,CN5300100000000,53,1,"Adams County, WA",Jan-20,8521,7860,661,7.8
35143,CN5300300000000,53,3,"Asotin County, WA",Jan-20,10636,10187,449,4.2
35144,CN5300500000000,53,5,"Benton County, WA",Jan-20,104938,98912,6026,5.7
35145,CN5300700000000,53,7,"Chelan County, WA",Jan-20,43223,40638,2585,6.0
35146,CN5300900000000,53,9,"Clallam County, WA",Jan-20,29854,27637,2217,7.4
35147,CN5301100000000,53,11,"Clark County, WA",Jan-20,247962,236675,11287,4.6
35148,CN5301300000000,53,13,"Columbia County, WA",Jan-20,1757,1643,114,6.5
35149,CN5301500000000,53,15,"Cowlitz County, WA",Jan-20,48962,46069,2893,5.9
35150,CN5301700000000,53,17,"Douglas County, WA",Jan-20,20982,19514,1468,7.0
35151,CN5301900000000,53,19,"Ferry County, WA",Jan-20,2472,2173,299,12.1
35152,CN5302100000000,53,21,"Franklin County, WA",Jan-20,42102,38934,3168,7.5
35153,CN5302300000000,53,23,"Garfield County, WA",Jan-20,838,775,63,7.5
35154,CN5302500000000,53,25,"Grant County, WA",Jan-20,44885,40834,4051,9.0
35155,CN5302700000000,53,27,"Grays Harbor County, WA",Jan-20,29736,27483,2253,7.6
35156,CN5302900000000,53,29,"Island County, WA",Jan-20,37251,35364,1887,5.1
35157,CN5303100000000,53,31,"Jefferson County, WA",Jan-20,13500,12725,775,5.7
35158,CN5303300000000,53,33,"King County, WA",Jan-20,1302826,1267790,35036,2.7
35159,CN5303500000000,53,35,"Kitsap County, WA",Jan-20,132386,126528,5858,4.4
35160,CN5303700000000,53,37,"Kittitas County, WA",Jan-20,24354,22924,1430,5.9
35161,CN5303900000000,53,39,"Klickitat County, WA",Jan-20,9774,9125,649,6.6
35162,CN5304100000000,53,41,"Lewis County, WA",Jan-20,35516,33159,2357,6.6
35163,CN5304300000000,53,43,"Lincoln County, WA",Jan-20,4729,4447,282,6.0
35164,CN5304500000000,53,45,"Mason County, WA",Jan-20,26592,24905,1687,6.3
35165,CN5304700000000,53,47,"Okanogan County, WA",Jan-20,18778,17048,1730,9.2
35166,CN5304900000000,53,49,"Pacific County, WA",Jan-20,8587,8009,578,6.7
35167,CN5305100000000,53,51,"Pend Oreille County, WA",Jan-20,5178,4702,476,9.2
35168,CN5305300000000,53,53,"Pierce County, WA",Jan-20,454960,431793,23167,5.1
35169,CN5305500000000,53,55,"San Juan County, WA",Jan-20,8886,8480,406,4.6
35170,CN5305700000000,53,57,"Skagit County, WA",Jan-20,63887,59954,3933,6.2
35171,CN5305900000000,53,59,"Skamania County, WA",Jan-20,5668,5335,333,5.9
35172,CN5306100000000,53,61,"Snohomish County, WA",Jan-20,443958,430141,13817,3.1
35173,CN5306300000000,53,63,"Spokane County, WA",Jan-20,261965,247355,14610,5.6
35174,CN5306500000000,53,65,"Stevens County, WA",Jan-20,19266,17678,1588,8.2
35175,CN5306700000000,53,67,"Thurston County, WA",Jan-20,147321,140249,7072,4.8
35176,CN5306900000000,53,69,"Wahkiakum County, WA",Jan-20,1383,1287,96,6.9
35177,CN5307100000000,53,71,"Walla Walla County, WA",Jan-20,29704,28130,1574,5.3
35178,CN5307300000000,53,73,"Whatcom County, WA",Jan-20,118389,111841,6548,5.5
35179,CN5307500000000,53,75,"Whitman County, WA",Jan-20,24258,23303,955,3.9
35180,CN5307700000000,53,77,"Yakima County, WA",Jan-20,128105,117324,10781,8.4
35181,CN5400100000000,54,1,"Barbour County, WV",Jan-20,7392,6918,474,6.4
35182,CN5400300000000,54,3,"Berkeley County, WV",Jan-20,59096,57159,1937,3.3
35183,CN5400500000000,54,5,"Boone County, WV",Jan-20,7516,7015,501,6.7
35184,CN5400700000000,54,7,"Braxton County, WV",Jan-20,5321,4803,518,9.7
35185,CN5400900000000,54,9,"Brooke County, WV",Jan-20,9916,9349,567,5.7
35186,CN5401100000000,54,11,"Cabell County, WV",Jan-20,41726,40016,1710,4.1
35187,CN5401300000000,54,13,"Calhoun County, WV",Jan-20,2730,2201,529,19.4
35188,CN5401500000000,54,15,"Clay County, WV",Jan-20,3231,2860,371,11.5
35189,CN5401700000000,54,17,"Doddridge County, WV",Jan-20,3990,3786,204,5.1
35190,CN5401900000000,54,19,"Fayette County, WV",Jan-20,16422,15276,1146,7.0
35191,CN5402100000000,54,21,"Gilmer County, WV",Jan-20,2401,2186,215,9.0
35192,CN5402300000000,54,23,"Grant County, WV",Jan-20,5936,5600,336,5.7
35193,CN5402500000000,54,25,"Greenbrier County, WV",Jan-20,15835,14943,892,5.6
35194,CN5402700000000,54,27,"Hampshire County, WV",Jan-20,10891,10448,443,4.1
35195,CN5402900000000,54,29,"Hancock County, WV",Jan-20,12995,12262,733,5.6
35196,CN5403100000000,54,31,"Hardy County, WV",Jan-20,5850,5527,323,5.5
35197,CN5403300000000,54,33,"Harrison County, WV",Jan-20,34921,33163,1758,5.0
35198,CN5403500000000,54,35,"Jackson County, WV",Jan-20,13482,12669,813,6.0
35199,CN5403700000000,54,37,"Jefferson County, WV",Jan-20,30234,29333,901,3.0
35200,CN5403900000000,54,39,"Kanawha County, WV",Jan-20,82395,78398,3997,4.9
35201,CN5404100000000,54,41,"Lewis County, WV",Jan-20,6609,6107,502,7.6
35202,CN5404300000000,54,43,"Lincoln County, WV",Jan-20,7322,6771,551,7.5
35203,CN5404500000000,54,45,"Logan County, WV",Jan-20,11520,10654,866,7.5
35204,CN5404700000000,54,47,"McDowell County, WV",Jan-20,4651,4126,525,11.3
35205,CN5404900000000,54,49,"Marion County, WV",Jan-20,25793,24455,1338,5.2
35206,CN5405100000000,54,51,"Marshall County, WV",Jan-20,14128,13035,1093,7.7
35207,CN5405300000000,54,53,"Mason County, WV",Jan-20,10303,9619,684,6.6
35208,CN5405500000000,54,55,"Mercer County, WV",Jan-20,21010,19824,1186,5.6
35209,CN5405700000000,54,57,"Mineral County, WV",Jan-20,12630,11898,732,5.8
35210,CN5405900000000,54,59,"Mingo County, WV",Jan-20,7156,6478,678,9.5
35211,CN5406100000000,54,61,"Monongalia County, WV",Jan-20,54171,52236,1935,3.6
35212,CN5406300000000,54,63,"Monroe County, WV",Jan-20,5971,5665,306,5.1
35213,CN5406500000000,54,65,"Morgan County, WV",Jan-20,8173,7846,327,4.0
35214,CN5406700000000,54,67,"Nicholas County, WV",Jan-20,9740,8927,813,8.3
35215,CN5406900000000,54,69,"Ohio County, WV",Jan-20,20943,19908,1035,4.9
35216,CN5407100000000,54,71,"Pendleton County, WV",Jan-20,3734,3572,162,4.3
35217,CN5407300000000,54,73,"Pleasants County, WV",Jan-20,2990,2732,258,8.6
35218,CN5407500000000,54,75,"Pocahontas County, WV",Jan-20,4234,3999,235,5.6
35219,CN5407700000000,54,77,"Preston County, WV",Jan-20,15435,14642,793,5.1
35220,CN5407900000000,54,79,"Putnam County, WV",Jan-20,26983,25744,1239,4.6
35221,CN5408100000000,54,81,"Raleigh County, WV",Jan-20,30595,28994,1601,5.2
35222,CN5408300000000,54,83,"Randolph County, WV",Jan-20,12358,11505,853,6.9
35223,CN5408500000000,54,85,"Ritchie County, WV",Jan-20,4507,4186,321,7.1
35224,CN5408700000000,54,87,"Roane County, WV",Jan-20,5273,4674,599,11.4
35225,CN5408900000000,54,89,"Summers County, WV",Jan-20,4354,4066,288,6.6
35226,CN5409100000000,54,91,"Taylor County, WV",Jan-20,7936,7521,415,5.2
35227,CN5409300000000,54,93,"Tucker County, WV",Jan-20,3418,3203,215,6.3
35228,CN5409500000000,54,95,"Tyler County, WV",Jan-20,3152,2875,277,8.8
35229,CN5409700000000,54,97,"Upshur County, WV",Jan-20,9649,9017,632,6.5
35230,CN5409900000000,54,99,"Wayne County, WV",Jan-20,16009,15048,961,6.0
35231,CN5410100000000,54,101,"Webster County, WV",Jan-20,3356,3099,257,7.7
35232,CN5410300000000,54,103,"Wetzel County, WV",Jan-20,6745,6150,595,8.8
35233,CN5410500000000,54,105,"Wirt County, WV",Jan-20,2392,2140,252,10.5
35234,CN5410700000000,54,107,"Wood County, WV",Jan-20,37455,35327,2128,5.7
35235,CN5410900000000,54,109,"Wyoming County, WV",Jan-20,6778,6204,574,8.5
35236,CN5500100000000,55,1,"Adams County, WI",Jan-20,8018,7434,584,7.3
35237,CN5500300000000,55,3,"Ashland County, WI",Jan-20,7654,7218,436,5.7
35238,CN5500500000000,55,5,"Barron County, WI",Jan-20,24250,22840,1410,5.8
35239,CN5500700000000,55,7,"Bayfield County, WI",Jan-20,7480,6891,589,7.9
35240,CN5500900000000,55,9,"Brown County, WI",Jan-20,141269,135978,5291,3.7
35241,CN5501100000000,55,11,"Buffalo County, WI",Jan-20,6416,6012,404,6.3
35242,CN5501300000000,55,13,"Burnett County, WI",Jan-20,7007,6475,532,7.6
35243,CN5501500000000,55,15,"Calumet County, WI",Jan-20,27491,26562,929,3.4
35244,CN5501700000000,55,17,"Chippewa County, WI",Jan-20,33231,31278,1953,5.9
35245,CN5501900000000,55,19,"Clark County, WI",Jan-20,17713,16847,866,4.9
35246,CN5502100000000,55,21,"Columbia County, WI",Jan-20,31527,30220,1307,4.1
35247,CN5502300000000,55,23,"Crawford County, WI",Jan-20,7627,7102,525,6.9
35248,CN5502500000000,55,25,"Dane County, WI",Jan-20,319001,309890,9111,2.9
35249,CN5502700000000,55,27,"Dodge County, WI",Jan-20,47273,45334,1939,4.1
35250,CN5502900000000,55,29,"Door County, WI",Jan-20,14035,13195,840,6.0
35251,CN5503100000000,55,31,"Douglas County, WI",Jan-20,22972,21630,1342,5.8
35252,CN5503300000000,55,33,"Dunn County, WI",Jan-20,23680,22496,1184,5.0
35253,CN5503500000000,55,35,"Eau Claire County, WI",Jan-20,58156,55887,2269,3.9
35254,CN5503700000000,55,37,"Florence County, WI",Jan-20,2199,2069,130,5.9
35255,CN5503900000000,55,39,"Fond du Lac County, WI",Jan-20,56772,54650,2122,3.7
35256,CN5504100000000,55,41,"Forest County, WI",Jan-20,4017,3743,274,6.8
35257,CN5504300000000,55,43,"Grant County, WI",Jan-20,27154,25893,1261,4.6
35258,CN5504500000000,55,45,"Green County, WI",Jan-20,21042,20202,840,4.0
35259,CN5504700000000,55,47,"Green Lake County, WI",Jan-20,9161,8608,553,6.0
35260,CN5504900000000,55,49,"Iowa County, WI",Jan-20,13786,13192,594,4.3
35261,CN5505100000000,55,51,"Iron County, WI",Jan-20,2562,2375,187,7.3
35262,CN5505300000000,55,53,"Jackson County, WI",Jan-20,10182,9544,638,6.3
35263,CN5505500000000,55,55,"Jefferson County, WI",Jan-20,45695,43806,1889,4.1
35264,CN5505700000000,55,57,"Juneau County, WI",Jan-20,13360,12708,652,4.9
35265,CN5505900000000,55,59,"Kenosha County, WI",Jan-20,87602,83416,4186,4.8
35266,CN5506100000000,55,61,"Kewaunee County, WI",Jan-20,11028,10581,447,4.1
35267,CN5506300000000,55,63,"La Crosse County, WI",Jan-20,65414,62967,2447,3.7
35268,CN5506500000000,55,65,"Lafayette County, WI",Jan-20,10101,9726,375,3.7
35269,CN5506700000000,55,67,"Langlade County, WI",Jan-20,9288,8749,539,5.8
35270,CN5506900000000,55,69,"Lincoln County, WI",Jan-20,15167,14322,845,5.6
35271,CN5507100000000,55,71,"Manitowoc County, WI",Jan-20,40626,38766,1860,4.6
35272,CN5507300000000,55,73,"Marathon County, WI",Jan-20,74049,71390,2659,3.6
35273,CN5507500000000,55,75,"Marinette County, WI",Jan-20,19337,18160,1177,6.1
35274,CN5507700000000,55,77,"Marquette County, WI",Jan-20,7752,7302,450,5.8
35275,CN5507800000000,55,78,"Menominee County, WI",Jan-20,1572,1461,111,7.1
35276,CN5507900000000,55,79,"Milwaukee County, WI",Jan-20,465286,444357,20929,4.5
35277,CN5508100000000,55,81,"Monroe County, WI",Jan-20,23248,22297,951,4.1
35278,CN5508300000000,55,83,"Oconto County, WI",Jan-20,20828,19647,1181,5.7
35279,CN5508500000000,55,85,"Oneida County, WI",Jan-20,17136,16084,1052,6.1
35280,CN5508700000000,55,87,"Outagamie County, WI",Jan-20,102918,99158,3760,3.7
35281,CN5508900000000,55,89,"Ozaukee County, WI",Jan-20,48832,47294,1538,3.1
35282,CN5509100000000,55,91,"Pepin County, WI",Jan-20,4068,3828,240,5.9
35283,CN5509300000000,55,93,"Pierce County, WI",Jan-20,25465,24214,1251,4.9
35284,CN5509500000000,55,95,"Polk County, WI",Jan-20,24724,23117,1607,6.5
35285,CN5509700000000,55,97,"Portage County, WI",Jan-20,37861,36258,1603,4.2
35286,CN5509900000000,55,99,"Price County, WI",Jan-20,6445,6077,368,5.7
35287,CN5510100000000,55,101,"Racine County, WI",Jan-20,98051,93085,4966,5.1
35288,CN5510300000000,55,103,"Richland County, WI",Jan-20,9131,8722,409,4.5
35289,CN5510500000000,55,105,"Rock County, WI",Jan-20,85466,81042,4424,5.2
35290,CN5510700000000,55,107,"Rusk County, WI",Jan-20,6919,6440,479,6.9
35291,CN5510900000000,55,109,"St. Croix County, WI",Jan-20,50606,48179,2427,4.8
35292,CN5511100000000,55,111,"Sauk County, WI",Jan-20,35168,33712,1456,4.1
35293,CN5511300000000,55,113,"Sawyer County, WI",Jan-20,7720,7217,503,6.5
35294,CN5511500000000,55,115,"Shawano County, WI",Jan-20,20918,19915,1003,4.8
35295,CN5511700000000,55,117,"Sheboygan County, WI",Jan-20,61175,59074,2101,3.4
35296,CN5511900000000,55,119,"Taylor County, WI",Jan-20,11070,10416,654,5.9
35297,CN5512100000000,55,121,"Trempealeau County, WI",Jan-20,15897,15084,813,5.1
35298,CN5512300000000,55,123,"Vernon County, WI",Jan-20,15246,14481,765,5.0
35299,CN5512500000000,55,125,"Vilas County, WI",Jan-20,9798,9201,597,6.1
35300,CN5512700000000,55,127,"Walworth County, WI",Jan-20,56645,54152,2493,4.4
35301,CN5512900000000,55,129,"Washburn County, WI",Jan-20,7786,7298,488,6.3
35302,CN5513100000000,55,131,"Washington County, WI",Jan-20,77001,74309,2692,3.5
35303,CN5513300000000,55,133,"Waukesha County, WI",Jan-20,224165,216361,7804,3.5
35304,CN5513500000000,55,135,"Waupaca County, WI",Jan-20,25726,24614,1112,4.3
35305,CN5513700000000,55,137,"Waushara County, WI",Jan-20,11423,10745,678,5.9
35306,CN5513900000000,55,139,"Winnebago County, WI",Jan-20,91141,87953,3188,3.5
35307,CN5514100000000,55,141,"Wood County, WI",Jan-20,35111,33371,1740,5.0
35308,CN5600100000000,56,1,"Albany County, WY",Jan-20,20326,19665,661,3.3
35309,CN5600300000000,56,3,"Big Horn County, WY",Jan-20,5311,5024,287,5.4
35310,CN5600500000000,56,5,"Campbell County, WY",Jan-20,23757,22841,916,3.9
35311,CN5600700000000,56,7,"Carbon County, WY",Jan-20,7966,7628,338,4.2
35312,CN5600900000000,56,9,"Converse County, WY",Jan-20,9040,8767,273,3.0
35313,CN5601100000000,56,11,"Crook County, WY",Jan-20,3673,3558,115,3.1
35314,CN5601300000000,56,13,"Fremont County, WY",Jan-20,18848,17800,1048,5.6
35315,CN5601500000000,56,15,"Goshen County, WY",Jan-20,6639,6396,243,3.7
35316,CN5601700000000,56,17,"Hot Springs County, WY",Jan-20,2145,2053,92,4.3
35317,CN5601900000000,56,19,"Johnson County, WY",Jan-20,4090,3905,185,4.5
35318,CN5602100000000,56,21,"Laramie County, WY",Jan-20,48858,46912,1946,4.0
35319,CN5602300000000,56,23,"Lincoln County, WY",Jan-20,8872,8501,371,4.2
35320,CN5602500000000,56,25,"Natrona County, WY",Jan-20,39440,37589,1851,4.7
35321,CN5602700000000,56,27,"Niobrara County, WY",Jan-20,1223,1181,42,3.4
35322,CN5602900000000,56,29,"Park County, WY",Jan-20,14780,14008,772,5.2
35323,CN5603100000000,56,31,"Platte County, WY",Jan-20,4533,4325,208,4.6
35324,CN5603300000000,56,33,"Sheridan County, WY",Jan-20,15647,14976,671,4.3
35325,CN5603500000000,56,35,"Sublette County, WY",Jan-20,4234,3985,249,5.9
35326,CN5603700000000,56,37,"Sweetwater County, WY",Jan-20,21362,20198,1164,5.4
35327,CN5603900000000,56,39,"Teton County, WY",Jan-20,15473,15056,417,2.7
35328,CN5604100000000,56,41,"Uinta County, WY",Jan-20,8829,8416,413,4.7
35329,CN5604300000000,56,43,"Washakie County, WY",Jan-20,3943,3761,182,4.6
35330,CN5604500000000,56,45,"Weston County, WY",Jan-20,3832,3712,120,3.1
35331,CN7200100000000,72,1,"Adjuntas Municipio, PR",Jan-20,4143,3353,790,19.1
35332,CN7200300000000,72,3,"Aguada Municipio, PR",Jan-20,11249,9939,1310,11.6
35333,CN7200500000000,72,5,"Aguadilla Municipio, PR",Jan-20,13706,12164,1542,11.3
35334,CN7200700000000,72,7,"Aguas Buenas Municipio, PR",Jan-20,6180,5526,654,10.6
35335,CN7200900000000,72,9,"Aibonito Municipio, PR",Jan-20,6169,5402,767,12.4
35336,CN7201100000000,72,11,"Anasco Municipio, PR",Jan-20,8345,7499,846,10.1
35337,CN7201300000000,72,13,"Arecibo Municipio, PR",Jan-20,23014,20360,2654,11.5
35338,CN7201500000000,72,15,"Arroyo Municipio, PR",Jan-20,4438,3734,704,15.9
35339,CN7201700000000,72,17,"Barceloneta Municipio, PR",Jan-20,5590,4875,715,12.8
35340,CN7201900000000,72,19,"Barranquitas Municipio, PR",Jan-20,6965,6225,740,10.6
35341,CN7202100000000,72,21,"Bayamon Municipio, PR",Jan-20,60984,56784,4200,6.9
35342,CN7202300000000,72,23,"Cabo Rojo Municipio, PR",Jan-20,12910,11500,1410,10.9
35343,CN7202500000000,72,25,"Caguas Municipio, PR",Jan-20,44739,41335,3404,7.6
35344,CN7202700000000,72,27,"Camuy Municipio, PR",Jan-20,9105,8144,961,10.6
35345,CN7202900000000,72,29,"Canovanas Municipio, PR",Jan-20,14993,13909,1084,7.2
35346,CN7203100000000,72,31,"Carolina Municipio, PR",Jan-20,57337,53672,3665,6.4
35347,CN7203300000000,72,33,"Catano Municipio, PR",Jan-20,7322,6745,577,7.9
35348,CN7203500000000,72,35,"Cayey Municipio, PR",Jan-20,15184,13912,1272,8.4
35349,CN7203700000000,72,37,"Ceiba Municipio, PR",Jan-20,3456,3097,359,10.4
35350,CN7203900000000,72,39,"Ciales Municipio, PR",Jan-20,3551,3066,485,13.7
35351,CN7204100000000,72,41,"Cidra Municipio, PR",Jan-20,14473,13414,1059,7.3
35352,CN7204300000000,72,43,"Coamo Municipio, PR",Jan-20,9593,8235,1358,14.2
35353,CN7204500000000,72,45,"Comerio Municipio, PR",Jan-20,4665,4143,522,11.2
35354,CN7204700000000,72,47,"Corozal Municipio, PR",Jan-20,8388,7523,865,10.3
35355,CN7204900000000,72,49,"Culebra Municipio, PR",Jan-20,852,823,29,3.4
35356,CN7205100000000,72,51,"Dorado Municipio, PR",Jan-20,12354,11539,815,6.6
35357,CN7205300000000,72,53,"Fajardo Municipio, PR",Jan-20,10201,9108,1093,10.7
35358,CN7205400000000,72,54,"Florida Municipio, PR",Jan-20,3142,2751,391,12.4
35359,CN7205500000000,72,55,"Guanica Municipio, PR",Jan-20,4220,3328,892,21.1
35360,CN7205700000000,72,57,"Guayama Municipio, PR",Jan-20,10336,8982,1354,13.1
35361,CN7205900000000,72,59,"Guayanilla Municipio, PR",Jan-20,4687,3893,794,16.9
35362,CN7206100000000,72,61,"Guaynabo Municipio, PR",Jan-20,35087,33482,1605,4.6
35363,CN7206300000000,72,63,"Gurabo Municipio, PR",Jan-20,16924,15802,1122,6.6
35364,CN7206500000000,72,65,"Hatillo Municipio, PR",Jan-20,13241,11214,2027,15.3
35365,CN7206700000000,72,67,"Hormigueros Municipio, PR",Jan-20,5043,4529,514,10.2
35366,CN7206900000000,72,69,"Humacao Municipio, PR",Jan-20,16252,14384,1868,11.5
35367,CN7207100000000,72,71,"Isabela Municipio, PR",Jan-20,11093,9885,1208,10.9
35368,CN7207300000000,72,73,"Jayuya Municipio, PR",Jan-20,4103,3491,612,14.9
35369,CN7207500000000,72,75,"Juana Diaz Municipio, PR",Jan-20,14703,13159,1544,10.5
35370,CN7207700000000,72,77,"Juncos Municipio, PR",Jan-20,11539,10444,1095,9.5
35371,CN7207900000000,72,79,"Lajas Municipio, PR",Jan-20,5067,4240,827,16.3
35372,CN7208100000000,72,81,"Lares Municipio, PR",Jan-20,6921,5688,1233,17.8
35373,CN7208300000000,72,83,"Las Marias Municipio, PR",Jan-20,2581,2192,389,15.1
35374,CN7208500000000,72,85,"Las Piedras Municipio, PR",Jan-20,10636,9554,1082,10.2
35375,CN7208700000000,72,87,"Loiza Municipio, PR",Jan-20,7949,7218,731,9.2
35376,CN7208900000000,72,89,"Luquillo Municipio, PR",Jan-20,5765,5209,556,9.6
35377,CN7209100000000,72,91,"Manati Municipio, PR",Jan-20,10879,9901,978,9.0
35378,CN7209300000000,72,93,"Maricao Municipio, PR",Jan-20,1888,1579,309,16.4
35379,CN7209500000000,72,95,"Maunabo Municipio, PR",Jan-20,2832,2326,506,17.9
35380,CN7209700000000,72,97,"Mayaguez Municipio, PR",Jan-20,20526,18017,2509,12.2
35381,CN7209900000000,72,99,"Moca Municipio, PR",Jan-20,9937,8713,1224,12.3
35382,CN7210100000000,72,101,"Morovis Municipio, PR",Jan-20,7555,6728,827,10.9
35383,CN7210300000000,72,103,"Naguabo Municipio, PR",Jan-20,7701,6909,792,10.3
35384,CN7210500000000,72,105,"Naranjito Municipio, PR",Jan-20,6664,5989,675,10.1
35385,CN7210700000000,72,107,"Orocovis Municipio, PR",Jan-20,4795,4097,698,14.6
35386,CN7210900000000,72,109,"Patillas Municipio, PR",Jan-20,4088,3363,725,17.7
35387,CN7211100000000,72,111,"Penuelas Municipio, PR",Jan-20,5586,4708,878,15.7
35388,CN7211300000000,72,113,"Ponce Municipio, PR",Jan-20,42821,38279,4542,10.6
35389,CN7211500000000,72,115,"Quebradillas Municipio, PR",Jan-20,5854,5039,815,13.9
35390,CN7211700000000,72,117,"Rincon Municipio, PR",Jan-20,4654,3814,840,18.0
35391,CN7211900000000,72,119,"Rio Grande Municipio, PR",Jan-20,15825,14565,1260,8.0
35392,CN7212100000000,72,121,"Sabana Grande Municipio, PR",Jan-20,5976,5017,959,16.0
35393,CN7212300000000,72,123,"Salinas Municipio, PR",Jan-20,6658,5630,1028,15.4
35394,CN7212500000000,72,125,"San German Municipio, PR",Jan-20,9294,7988,1306,14.1
35395,CN7212700000000,72,127,"San Juan Municipio, PR",Jan-20,125278,117602,7676,6.1
35396,CN7212900000000,72,129,"San Lorenzo Municipio, PR",Jan-20,11011,9910,1101,10.0
35397,CN7213100000000,72,131,"San Sebastian Municipio, PR",Jan-20,9860,8274,1586,16.1
35398,CN7213300000000,72,133,"Santa Isabel Municipio, PR",Jan-20,9573,8614,959,10.0
35399,CN7213500000000,72,135,"Toa Alta Municipio, PR",Jan-20,25318,23699,1619,6.4
35400,CN7213700000000,72,137,"Toa Baja Municipio, PR",Jan-20,27244,25510,1734,6.4
35401,CN7213900000000,72,139,"Trujillo Alto Municipio, PR",Jan-20,25296,23875,1421,5.6
35402,CN7214100000000,72,141,"Utuado Municipio, PR",Jan-20,6441,5515,926,14.4
35403,CN7214300000000,72,143,"Vega Alta Municipio, PR",Jan-20,9216,8284,932,10.1
35404,CN7214500000000,72,145,"Vega Baja Municipio, PR",Jan-20,12452,11123,1329,10.7
35405,CN7214700000000,72,147,"Vieques Municipio, PR",Jan-20,2452,2274,178,7.3
35406,CN7214900000000,72,149,"Villalba Municipio, PR",Jan-20,7311,5859,1452,19.9
35407,CN7215100000000,72,151,"Yabucoa Municipio, PR",Jan-20,8383,7142,1241,14.8
35408,CN7215300000000,72,153,"Yauco Municipio, PR",Jan-20,9918,7925,1993,20.1
35409,CN0100100000000,01,1,"Autauga County, AL",Feb-20,25906,25196,710,2.7
35410,CN0100300000000,01,3,"Baldwin County, AL",Feb-20,95924,93418,2506,2.6
35411,CN0100500000000,01,5,"Barbour County, AL",Feb-20,8532,8234,298,3.5
35412,CN0100700000000,01,7,"Bibb County, AL",Feb-20,8628,8374,254,2.9
35413,CN0100900000000,01,9,"Blount County, AL",Feb-20,25179,24544,635,2.5
35414,CN0101100000000,01,11,"Bullock County, AL",Feb-20,4784,4629,155,3.2
35415,CN0101300000000,01,13,"Butler County, AL",Feb-20,9251,8871,380,4.1
35416,CN0101500000000,01,15,"Calhoun County, AL",Feb-20,45942,44376,1566,3.4
35417,CN0101700000000,01,17,"Chambers County, AL",Feb-20,15709,15264,445,2.8
35418,CN0101900000000,01,19,"Cherokee County, AL",Feb-20,11394,11072,322,2.8
35419,CN0102100000000,01,21,"Chilton County, AL",Feb-20,19691,19212,479,2.4
35420,CN0102300000000,01,23,"Choctaw County, AL",Feb-20,4532,4308,224,4.9
35421,CN0102500000000,01,25,"Clarke County, AL",Feb-20,7389,6975,414,5.6
35422,CN0102700000000,01,27,"Clay County, AL",Feb-20,6086,5924,162,2.7
35423,CN0102900000000,01,29,"Cleburne County, AL",Feb-20,5716,5549,167,2.9
35424,CN0103100000000,01,31,"Coffee County, AL",Feb-20,21190,20631,559,2.6
35425,CN0103300000000,01,33,"Colbert County, AL",Feb-20,23541,22664,877,3.7
35426,CN0103500000000,01,35,"Conecuh County, AL",Feb-20,4469,4299,170,3.8
35427,CN0103700000000,01,37,"Coosa County, AL",Feb-20,4469,4339,130,2.9
35428,CN0103900000000,01,39,"Covington County, AL",Feb-20,15489,14993,496,3.2
35429,CN0104100000000,01,41,"Crenshaw County, AL",Feb-20,6410,6226,184,2.9
35430,CN0104300000000,01,43,"Cullman County, AL",Feb-20,38597,37624,973,2.5
35431,CN0104500000000,01,45,"Dale County, AL",Feb-20,20567,20007,560,2.7
35432,CN0104700000000,01,47,"Dallas County, AL",Feb-20,14600,13852,748,5.1
35433,CN0104900000000,01,49,"DeKalb County, AL",Feb-20,30960,30135,825,2.7
35434,CN0105100000000,01,51,"Elmore County, AL",Feb-20,37151,36183,968,2.6
35435,CN0105300000000,01,53,"Escambia County, AL",Feb-20,14679,14175,504,3.4
35436,CN0105500000000,01,55,"Etowah County, AL",Feb-20,42803,41123,1680,3.9
35437,CN0105700000000,01,57,"Fayette County, AL",Feb-20,6539,6349,190,2.9
35438,CN0105900000000,01,59,"Franklin County, AL",Feb-20,14744,14226,518,3.5
35439,CN0106100000000,01,61,"Geneva County, AL",Feb-20,11021,10726,295,2.7
35440,CN0106300000000,01,63,"Greene County, AL",Feb-20,2870,2711,159,5.5
35441,CN0106500000000,01,65,"Hale County, AL",Feb-20,6225,5977,248,4.0
35442,CN0106700000000,01,67,"Henry County, AL",Feb-20,6896,6674,222,3.2
35443,CN0106900000000,01,69,"Houston County, AL",Feb-20,45901,44619,1282,2.8
35444,CN0107100000000,01,71,"Jackson County, AL",Feb-20,23191,22421,770,3.3
35445,CN0107300000000,01,73,"Jefferson County, AL",Feb-20,316161,307682,8479,2.7
35446,CN0107500000000,01,75,"Lamar County, AL",Feb-20,5844,5662,182,3.1
35447,CN0107700000000,01,77,"Lauderdale County, AL",Feb-20,42242,40967,1275,3.0
35448,CN0107900000000,01,79,"Lawrence County, AL",Feb-20,14254,13841,413,2.9
35449,CN0108100000000,01,81,"Lee County, AL",Feb-20,77018,75143,1875,2.4
35450,CN0108300000000,01,83,"Limestone County, AL",Feb-20,44106,43047,1059,2.4
35451,CN0108500000000,01,85,"Lowndes County, AL",Feb-20,3535,3357,178,5.0
35452,CN0108700000000,01,87,"Macon County, AL",Feb-20,7781,7479,302,3.9
35453,CN0108900000000,01,89,"Madison County, AL",Feb-20,186141,181831,4310,2.3
35454,CN0109100000000,01,91,"Marengo County, AL",Feb-20,7650,7375,275,3.6
35455,CN0109300000000,01,93,"Marion County, AL",Feb-20,12850,12339,511,4.0
35456,CN0109500000000,01,95,"Marshall County, AL",Feb-20,43832,42799,1033,2.4
35457,CN0109700000000,01,97,"Mobile County, AL",Feb-20,188250,181148,7102,3.8
35458,CN0109900000000,01,99,"Monroe County, AL",Feb-20,7455,7078,377,5.1
35459,CN0110100000000,01,101,"Montgomery County, AL",Feb-20,104530,101397,3133,3.0
35460,CN0110300000000,01,103,"Morgan County, AL",Feb-20,58025,56631,1394,2.4
35461,CN0110500000000,01,105,"Perry County, AL",Feb-20,3403,3239,164,4.8
35462,CN0110700000000,01,107,"Pickens County, AL",Feb-20,8012,7745,267,3.3
35463,CN0110900000000,01,109,"Pike County, AL",Feb-20,15439,14998,441,2.9
35464,CN0111100000000,01,111,"Randolph County, AL",Feb-20,9633,9362,271,2.8
35465,CN0111300000000,01,113,"Russell County, AL",Feb-20,23665,23022,643,2.7
35466,CN0111500000000,01,115,"St. Clair County, AL",Feb-20,40212,39202,1010,2.5
35467,CN0111700000000,01,117,"Shelby County, AL",Feb-20,115023,112687,2336,2.0
35468,CN0111900000000,01,119,"Sumter County, AL",Feb-20,4764,4574,190,4.0
35469,CN0112100000000,01,121,"Talladega County, AL",Feb-20,35358,34179,1179,3.3
35470,CN0112300000000,01,123,"Tallapoosa County, AL",Feb-20,18284,17764,520,2.8
35471,CN0112500000000,01,125,"Tuscaloosa County, AL",Feb-20,105653,103138,2515,2.4
35472,CN0112700000000,01,127,"Walker County, AL",Feb-20,25189,24366,823,3.3
35473,CN0112900000000,01,129,"Washington County, AL",Feb-20,6798,6477,321,4.7
35474,CN0113100000000,01,131,"Wilcox County, AL",Feb-20,2802,2564,238,8.5
35475,CN0113300000000,01,133,"Winston County, AL",Feb-20,10071,9746,325,3.2
35476,CN0201300000000,02,13,"Aleutians East Borough, AK",Feb-20,3104,3041,63,2.0
35477,CN0201600000000,02,16,"Aleutians West Census Area, AK",Feb-20,4625,4532,93,2.0
35478,CN0202000000000,02,20,"Anchorage Borough/municipality, AK",Feb-20,144632,138169,6463,4.5
35479,CN0205000000000,02,50,"Bethel Census Area, AK",Feb-20,6832,5973,859,12.6
35480,CN0206000000000,02,60,"Bristol Bay Borough, AK",Feb-20,236,200,36,15.3
35481,CN0206800000000,02,68,"Denali Borough, AK",Feb-20,561,459,102,18.2
35482,CN0207000000000,02,70,"Dillingham Census Area, AK",Feb-20,1805,1676,129,7.1
35483,CN0209000000000,02,90,"Fairbanks North Star Borough, AK",Feb-20,43236,41081,2155,5.0
35484,CN0210000000000,02,100,"Haines Borough, AK",Feb-20,896,753,143,16.0
35485,CN0210500000000,02,105,"Hoonah-Angoon Census Area, AK",Feb-20,960,793,167,17.4
35486,CN0211000000000,02,110,"Juneau Borough/city, AK",Feb-20,16178,15527,651,4.0
35487,CN0212200000000,02,122,"Kenai Peninsula Borough, AK",Feb-20,24616,22822,1794,7.3
35488,CN0213000000000,02,130,"Ketchikan Gateway Borough, AK",Feb-20,6143,5690,453,7.4
35489,CN0215000000000,02,150,"Kodiak Island Borough, AK",Feb-20,5943,5681,262,4.4
35490,CN0215800000000,02,158,"Kusilvak Census Area, AK",Feb-20,2681,2165,516,19.2
35491,CN0216400000000,02,164,"Lake and Peninsula Borough, AK",Feb-20,585,519,66,11.3
35492,CN0217000000000,02,170,"Matanuska-Susitna Borough, AK",Feb-20,46350,43247,3103,6.7
35493,CN0218000000000,02,180,"Nome Census Area, AK",Feb-20,4095,3671,424,10.4
35494,CN0218500000000,02,185,"North Slope Borough, AK",Feb-20,3723,3548,175,4.7
35495,CN0218800000000,02,188,"Northwest Arctic Borough, AK",Feb-20,2925,2525,400,13.7
35496,CN0219500000000,02,195,"Petersburg Borough, AK",Feb-20,1248,1127,121,9.7
35497,CN0219800000000,02,198,"Prince of Wales-Hyder Census Area, AK",Feb-20,2688,2419,269,10.0
35498,CN0222000000000,02,220,"Sitka Borough/city, AK",Feb-20,3951,3781,170,4.3
35499,CN0223000000000,02,230,"Skagway Municipality, AK",Feb-20,591,466,125,21.2
35500,CN0224000000000,02,240,"Southeast Fairbanks Census Area, AK",Feb-20,2692,2434,258,9.6
35501,CN0226100000000,02,261,"Valdez-Cordova Census Area, AK",Feb-20,4102,3645,457,11.1
35502,CN0227500000000,02,275,"Wrangell Borough/city, AK",Feb-20,941,867,74,7.9
35503,CN0228200000000,02,282,"Yakutat Borough/city, AK",Feb-20,217,189,28,12.9
35504,CN0229000000000,02,290,"Yukon-Koyukuk Census Area, AK",Feb-20,2394,2054,340,14.2
35505,CN0400100000000,04,1,"Apache County, AZ",Feb-20,20710,18588,2122,10.2
35506,CN0400300000000,04,3,"Cochise County, AZ",Feb-20,52169,49345,2824,5.4
35507,CN0400500000000,04,5,"Coconino County, AZ",Feb-20,77685,73191,4494,5.8
35508,CN0400700000000,04,7,"Gila County, AZ",Feb-20,21577,20418,1159,5.4
35509,CN0400900000000,04,9,"Graham County, AZ",Feb-20,15909,15152,757,4.8
35510,CN0401100000000,04,11,"Greenlee County, AZ",Feb-20,4628,4458,170,3.7
35511,CN0401200000000,04,12,"La Paz County, AZ",Feb-20,9774,9224,550,5.6
35512,CN0401300000000,04,13,"Maricopa County, AZ",Feb-20,2373098,2283286,89812,3.8
35513,CN0401500000000,04,15,"Mohave County, AZ",Feb-20,89571,84668,4903,5.5
35514,CN0401700000000,04,17,"Navajo County, AZ",Feb-20,40941,37833,3108,7.6
35515,CN0401900000000,04,19,"Pima County, AZ",Feb-20,507744,486239,21505,4.2
35516,CN0402100000000,04,21,"Pinal County, AZ",Feb-20,192715,183746,8969,4.7
35517,CN0402300000000,04,23,"Santa Cruz County, AZ",Feb-20,19873,18442,1431,7.2
35518,CN0402500000000,04,25,"Yavapai County, AZ",Feb-20,108048,103465,4583,4.2
35519,CN0402700000000,04,27,"Yuma County, AZ",Feb-20,98881,87010,11871,12.0
35520,CN0500100000000,05,1,"Arkansas County, AR",Feb-20,9345,9032,313,3.3
35521,CN0500300000000,05,3,"Ashley County, AR",Feb-20,7758,7209,549,7.1
35522,CN0500500000000,05,5,"Baxter County, AR",Feb-20,16097,15397,700,4.3
35523,CN0500700000000,05,7,"Benton County, AR",Feb-20,138984,135096,3888,2.8
35524,CN0500900000000,05,9,"Boone County, AR",Feb-20,16041,15466,575,3.6
35525,CN0501100000000,05,11,"Bradley County, AR",Feb-20,4534,4338,196,4.3
35526,CN0501300000000,05,13,"Calhoun County, AR",Feb-20,2469,2343,126,5.1
35527,CN0501500000000,05,15,"Carroll County, AR",Feb-20,12440,11938,502,4.0
35528,CN0501700000000,05,17,"Chicot County, AR",Feb-20,3283,2997,286,8.7
35529,CN0501900000000,05,19,"Clark County, AR",Feb-20,9726,9362,364,3.7
35530,CN0502100000000,05,21,"Clay County, AR",Feb-20,5657,5324,333,5.9
35531,CN0502300000000,05,23,"Cleburne County, AR",Feb-20,9120,8611,509,5.6
35532,CN0502500000000,05,25,"Cleveland County, AR",Feb-20,3240,3083,157,4.8
35533,CN0502700000000,05,27,"Columbia County, AR",Feb-20,9193,8764,429,4.7
35534,CN0502900000000,05,29,"Conway County, AR",Feb-20,8302,7907,395,4.8
35535,CN0503100000000,05,31,"Craighead County, AR",Feb-20,56444,54756,1688,3.0
35536,CN0503300000000,05,33,"Crawford County, AR",Feb-20,26862,25871,991,3.7
35537,CN0503500000000,05,35,"Crittenden County, AR",Feb-20,21419,20476,943,4.4
35538,CN0503700000000,05,37,"Cross County, AR",Feb-20,7405,7066,339,4.6
35539,CN0503900000000,05,39,"Dallas County, AR",Feb-20,2833,2690,143,5.0
35540,CN0504100000000,05,41,"Desha County, AR",Feb-20,5361,5083,278,5.2
35541,CN0504300000000,05,43,"Drew County, AR",Feb-20,7955,7478,477,6.0
35542,CN0504500000000,05,45,"Faulkner County, AR",Feb-20,61827,59751,2076,3.4
35543,CN0504700000000,05,47,"Franklin County, AR",Feb-20,7485,7196,289,3.9
35544,CN0504900000000,05,49,"Fulton County, AR",Feb-20,4980,4763,217,4.4
35545,CN0505100000000,05,51,"Garland County, AR",Feb-20,41317,39648,1669,4.0
35546,CN0505300000000,05,53,"Grant County, AR",Feb-20,8378,8049,329,3.9
35547,CN0505500000000,05,55,"Greene County, AR",Feb-20,20317,19487,830,4.1
35548,CN0505700000000,05,57,"Hempstead County, AR",Feb-20,9925,9496,429,4.3
35549,CN0505900000000,05,59,"Hot Spring County, AR",Feb-20,13988,13460,528,3.8
35550,CN0506100000000,05,61,"Howard County, AR",Feb-20,5795,5573,222,3.8
35551,CN0506300000000,05,63,"Independence County, AR",Feb-20,16639,15911,728,4.4
35552,CN0506500000000,05,65,"Izard County, AR",Feb-20,4891,4563,328,6.7
35553,CN0506700000000,05,67,"Jackson County, AR",Feb-20,5886,5462,424,7.2
35554,CN0506900000000,05,69,"Jefferson County, AR",Feb-20,27625,25990,1635,5.9
35555,CN0507100000000,05,71,"Johnson County, AR",Feb-20,10240,9776,464,4.5
35556,CN0507300000000,05,73,"Lafayette County, AR",Feb-20,2480,2352,128,5.2
35557,CN0507500000000,05,75,"Lawrence County, AR",Feb-20,6904,6582,322,4.7
35558,CN0507700000000,05,77,"Lee County, AR",Feb-20,2876,2698,178,6.2
35559,CN0507900000000,05,79,"Lincoln County, AR",Feb-20,3982,3771,211,5.3
35560,CN0508100000000,05,81,"Little River County, AR",Feb-20,5589,5304,285,5.1
35561,CN0508300000000,05,83,"Logan County, AR",Feb-20,8535,8126,409,4.8
35562,CN0508500000000,05,85,"Lonoke County, AR",Feb-20,34257,32994,1263,3.7
35563,CN0508700000000,05,87,"Madison County, AR",Feb-20,7570,7363,207,2.7
35564,CN0508900000000,05,89,"Marion County, AR",Feb-20,6654,6343,311,4.7
35565,CN0509100000000,05,91,"Miller County, AR",Feb-20,19881,19021,860,4.3
35566,CN0509300000000,05,93,"Mississippi County, AR",Feb-20,17244,16213,1031,6.0
35567,CN0509500000000,05,95,"Monroe County, AR",Feb-20,2811,2675,136,4.8
35568,CN0509700000000,05,97,"Montgomery County, AR",Feb-20,2942,2772,170,5.8
35569,CN0509900000000,05,99,"Nevada County, AR",Feb-20,3632,3479,153,4.2
35570,CN0510100000000,05,101,"Newton County, AR",Feb-20,3362,3217,145,4.3
35571,CN0510300000000,05,103,"Ouachita County, AR",Feb-20,9808,9266,542,5.5
35572,CN0510500000000,05,105,"Perry County, AR",Feb-20,4239,4056,183,4.3
35573,CN0510700000000,05,107,"Phillips County, AR",Feb-20,6384,5925,459,7.2
35574,CN0510900000000,05,109,"Pike County, AR",Feb-20,4262,4067,195,4.6
35575,CN0511100000000,05,111,"Poinsett County, AR",Feb-20,10518,10091,427,4.1
35576,CN0511300000000,05,113,"Polk County, AR",Feb-20,8252,7785,467,5.7
35577,CN0511500000000,05,115,"Pope County, AR",Feb-20,28800,27531,1269,4.4
35578,CN0511700000000,05,117,"Prairie County, AR",Feb-20,3589,3428,161,4.5
35579,CN0511900000000,05,119,"Pulaski County, AR",Feb-20,188399,181207,7192,3.8
35580,CN0512100000000,05,121,"Randolph County, AR",Feb-20,7469,7130,339,4.5
35581,CN0512300000000,05,123,"St. Francis County, AR",Feb-20,8135,7686,449,5.5
35582,CN0512500000000,05,125,"Saline County, AR",Feb-20,58468,56649,1819,3.1
35583,CN0512700000000,05,127,"Scott County, AR",Feb-20,4355,4190,165,3.8
35584,CN0512900000000,05,129,"Searcy County, AR",Feb-20,2828,2657,171,6.0
35585,CN0513100000000,05,131,"Sebastian County, AR",Feb-20,56513,54436,2077,3.7
35586,CN0513300000000,05,133,"Sevier County, AR",Feb-20,5548,5248,300,5.4
35587,CN0513500000000,05,135,"Sharp County, AR",Feb-20,5725,5387,338,5.9
35588,CN0513700000000,05,137,"Stone County, AR",Feb-20,4608,4347,261,5.7
35589,CN0513900000000,05,139,"Union County, AR",Feb-20,15839,14889,950,6.0
35590,CN0514100000000,05,141,"Van Buren County, AR",Feb-20,5679,5347,332,5.8
35591,CN0514300000000,05,143,"Washington County, AR",Feb-20,126433,123250,3183,2.5
35592,CN0514500000000,05,145,"White County, AR",Feb-20,33857,32067,1790,5.3
35593,CN0514700000000,05,147,"Woodruff County, AR",Feb-20,2754,2611,143,5.2
35594,CN0514900000000,05,149,"Yell County, AR",Feb-20,8453,8103,350,4.1
35595,CN0600100000000,06,1,"Alameda County, CA",Feb-20,840369,815376,24993,3.0
35596,CN0600300000000,06,3,"Alpine County, CA",Feb-20,645,613,32,5.0
35597,CN0600500000000,06,5,"Amador County, CA",Feb-20,14857,14202,655,4.4
35598,CN0600700000000,06,7,"Butte County, CA",Feb-20,98511,93153,5358,5.4
35599,CN0600900000000,06,9,"Calaveras County, CA",Feb-20,21609,20704,905,4.2
35600,CN0601100000000,06,11,"Colusa County, CA",Feb-20,11204,8986,2218,19.8
35601,CN0601300000000,06,13,"Contra Costa County, CA",Feb-20,558771,541273,17498,3.1
35602,CN0601500000000,06,15,"Del Norte County, CA",Feb-20,9615,9015,600,6.2
35603,CN0601700000000,06,17,"El Dorado County, CA",Feb-20,92266,88884,3382,3.7
35604,CN0601900000000,06,19,"Fresno County, CA",Feb-20,453973,415465,38508,8.5
35605,CN0602100000000,06,21,"Glenn County, CA",Feb-20,13257,12322,935,7.1
35606,CN0602300000000,06,23,"Humboldt County, CA",Feb-20,62100,59691,2409,3.9
35607,CN0602500000000,06,25,"Imperial County, CA",Feb-20,71651,59440,12211,17.0
35608,CN0602700000000,06,27,"Inyo County, CA",Feb-20,8677,8335,342,3.9
35609,CN0602900000000,06,29,"Kern County, CA",Feb-20,395841,359859,35982,9.1
35610,CN0603100000000,06,31,"Kings County, CA",Feb-20,58494,52756,5738,9.8
35611,CN0603300000000,06,33,"Lake County, CA",Feb-20,29115,27429,1686,5.8
35612,CN0603500000000,06,35,"Lassen County, CA",Feb-20,9786,9217,569,5.8
35613,CN0603700000000,06,37,"Los Angeles County, CA",Feb-20,5222823,4984604,238219,4.6
35614,CN0603900000000,06,39,"Madera County, CA",Feb-20,63995,58857,5138,8.0
35615,CN0604100000000,06,41,"Marin County, CA",Feb-20,139759,136481,3278,2.3
35616,CN0604300000000,06,43,"Mariposa County, CA",Feb-20,7204,6753,451,6.3
35617,CN0604500000000,06,45,"Mendocino County, CA",Feb-20,38405,36598,1807,4.7
35618,CN0604700000000,06,47,"Merced County, CA",Feb-20,115543,103529,12014,10.4
35619,CN0604900000000,06,49,"Modoc County, CA",Feb-20,3056,2756,300,9.8
35620,CN0605100000000,06,51,"Mono County, CA",Feb-20,8885,8550,335,3.8
35621,CN0605300000000,06,53,"Monterey County, CA",Feb-20,217071,195316,21755,10.0
35622,CN0605500000000,06,55,"Napa County, CA",Feb-20,73598,71239,2359,3.2
35623,CN0605700000000,06,57,"Nevada County, CA",Feb-20,48714,46939,1775,3.6
35624,CN0605900000000,06,59,"Orange County, CA",Feb-20,1623913,1578370,45543,2.8
35625,CN0606100000000,06,61,"Placer County, CA",Feb-20,188518,182518,6000,3.2
35626,CN0606300000000,06,63,"Plumas County, CA",Feb-20,7437,6622,815,11.0
35627,CN0606500000000,06,65,"Riverside County, CA",Feb-20,1104691,1058964,45727,4.1
35628,CN0606700000000,06,67,"Sacramento County, CA",Feb-20,714834,688034,26800,3.7
35629,CN0606900000000,06,69,"San Benito County, CA",Feb-20,31605,29653,1952,6.2
35630,CN0607100000000,06,71,"San Bernardino County, CA",Feb-20,969669,932642,37027,3.8
35631,CN0607300000000,06,73,"San Diego County, CA",Feb-20,1595340,1544265,51075,3.2
35632,CN0607500000000,06,75,"San Francisco County/city, CA",Feb-20,587233,573934,13299,2.3
35633,CN0607700000000,06,77,"San Joaquin County, CA",Feb-20,326471,304866,21605,6.6
35634,CN0607900000000,06,79,"San Luis Obispo County, CA",Feb-20,142474,138201,4273,3.0
35635,CN0608100000000,06,81,"San Mateo County, CA",Feb-20,462905,453177,9728,2.1
35636,CN0608300000000,06,83,"Santa Barbara County, CA",Feb-20,215493,205612,9881,4.6
35637,CN0608500000000,06,85,"Santa Clara County, CA",Feb-20,1055321,1028140,27181,2.6
35638,CN0608700000000,06,87,"Santa Cruz County, CA",Feb-20,141054,132050,9004,6.4
35639,CN0608900000000,06,89,"Shasta County, CA",Feb-20,73409,69411,3998,5.4
35640,CN0609100000000,06,91,"Sierra County, CA",Feb-20,1311,1220,91,6.9
35641,CN0609300000000,06,93,"Siskiyou County, CA",Feb-20,17010,15563,1447,8.5
35642,CN0609500000000,06,95,"Solano County, CA",Feb-20,208513,200341,8172,3.9
35643,CN0609700000000,06,97,"Sonoma County, CA",Feb-20,258841,251495,7346,2.8
35644,CN0609900000000,06,99,"Stanislaus County, CA",Feb-20,243980,227993,15987,6.6
35645,CN0610100000000,06,101,"Sutter County, CA",Feb-20,46617,42462,4155,8.9
35646,CN0610300000000,06,103,"Tehama County, CA",Feb-20,25754,24162,1592,6.2
35647,CN0610500000000,06,105,"Trinity County, CA",Feb-20,4450,4126,324,7.3
35648,CN0610700000000,06,107,"Tulare County, CA",Feb-20,205441,181823,23618,11.5
35649,CN0610900000000,06,109,"Tuolumne County, CA",Feb-20,21572,20504,1068,5.0
35650,CN0611100000000,06,111,"Ventura County, CA",Feb-20,424746,408975,15771,3.7
35651,CN0611300000000,06,113,"Yolo County, CA",Feb-20,109234,103947,5287,4.8
35652,CN0611500000000,06,115,"Yuba County, CA",Feb-20,30855,28712,2143,6.9
35653,CN0800100000000,08,1,"Adams County, CO",Feb-20,280046,270960,9086,3.2
35654,CN0800300000000,08,3,"Alamosa County, CO",Feb-20,8605,8244,361,4.2
35655,CN0800500000000,08,5,"Arapahoe County, CO",Feb-20,374347,363908,10439,2.8
35656,CN0800700000000,08,7,"Archuleta County, CO",Feb-20,6636,6388,248,3.7
35657,CN0800900000000,08,9,"Baca County, CO",Feb-20,2072,2027,45,2.2
35658,CN0801100000000,08,11,"Bent County, CO",Feb-20,1820,1769,51,2.8
35659,CN0801300000000,08,13,"Boulder County, CO",Feb-20,199780,194891,4889,2.4
35660,CN0801400000000,08,14,"Broomfield County/city, CO",Feb-20,41160,40085,1075,2.6
35661,CN0801500000000,08,15,"Chaffee County, CO",Feb-20,9564,9303,261,2.7
35662,CN0801700000000,08,17,"Cheyenne County, CO",Feb-20,1162,1143,19,1.6
35663,CN0801900000000,08,19,"Clear Creek County, CO",Feb-20,6206,6046,160,2.6
35664,CN0802100000000,08,21,"Conejos County, CO",Feb-20,4093,3905,188,4.6
35665,CN0802300000000,08,23,"Costilla County, CO",Feb-20,1873,1794,79,4.2
35666,CN0802500000000,08,25,"Crowley County, CO",Feb-20,1505,1436,69,4.6
35667,CN0802700000000,08,27,"Custer County, CO",Feb-20,2003,1937,66,3.3
35668,CN0802900000000,08,29,"Delta County, CO",Feb-20,14193,13601,592,4.2
35669,CN0803100000000,08,31,"Denver County/city, CO",Feb-20,428190,416025,12165,2.8
35670,CN0803300000000,08,33,"Dolores County, CO",Feb-20,1128,1087,41,3.6
35671,CN0803500000000,08,35,"Douglas County, CO",Feb-20,199198,194365,4833,2.4
35672,CN0803700000000,08,37,"Eagle County, CO",Feb-20,39182,38375,807,2.1
35673,CN0803900000000,08,39,"Elbert County, CO",Feb-20,15501,15131,370,2.4
35674,CN0804100000000,08,41,"El Paso County, CO",Feb-20,347369,335470,11899,3.4
35675,CN0804300000000,08,43,"Fremont County, CO",Feb-20,14723,13965,758,5.1
35676,CN0804500000000,08,45,"Garfield County, CO",Feb-20,33479,32365,1114,3.3
35677,CN0804700000000,08,47,"Gilpin County, CO",Feb-20,3874,3789,85,2.2
35678,CN0804900000000,08,49,"Grand County, CO",Feb-20,10365,10133,232,2.2
35679,CN0805100000000,08,51,"Gunnison County, CO",Feb-20,12014,11747,267,2.2
35680,CN0805300000000,08,53,"Hinsdale County, CO",Feb-20,362,350,12,3.3
35681,CN0805500000000,08,55,"Huerfano County, CO",Feb-20,2403,2212,191,7.9
35682,CN0805700000000,08,57,"Jackson County, CO",Feb-20,988,957,31,3.1
35683,CN0805900000000,08,59,"Jefferson County, CO",Feb-20,344089,335034,9055,2.6
35684,CN0806100000000,08,61,"Kiowa County, CO",Feb-20,927,914,13,1.4
35685,CN0806300000000,08,63,"Kit Carson County, CO",Feb-20,4208,4124,84,2.0
35686,CN0806500000000,08,65,"Lake County, CO",Feb-20,5359,5250,109,2.0
35687,CN0806700000000,08,67,"La Plata County, CO",Feb-20,31478,30517,961,3.1
35688,CN0806900000000,08,69,"Larimer County, CO",Feb-20,209210,203683,5527,2.6
35689,CN0807100000000,08,71,"Las Animas County, CO",Feb-20,6531,6258,273,4.2
35690,CN0807300000000,08,73,"Lincoln County, CO",Feb-20,2289,2219,70,3.1
35691,CN0807500000000,08,75,"Logan County, CO",Feb-20,10814,10538,276,2.6
35692,CN0807700000000,08,77,"Mesa County, CO",Feb-20,76746,73580,3166,4.1
35693,CN0807900000000,08,79,"Mineral County, CO",Feb-20,534,519,15,2.8
35694,CN0808100000000,08,81,"Moffat County, CO",Feb-20,7329,7014,315,4.3
35695,CN0808300000000,08,83,"Montezuma County, CO",Feb-20,12668,11955,713,5.6
35696,CN0808500000000,08,85,"Montrose County, CO",Feb-20,21634,20860,774,3.6
35697,CN0808700000000,08,87,"Morgan County, CO",Feb-20,16145,15692,453,2.8
35698,CN0808900000000,08,89,"Otero County, CO",Feb-20,8364,7990,374,4.5
35699,CN0809100000000,08,91,"Ouray County, CO",Feb-20,2332,2248,84,3.6
35700,CN0809300000000,08,93,"Park County, CO",Feb-20,11473,11178,295,2.6
35701,CN0809500000000,08,95,"Phillips County, CO",Feb-20,2472,2431,41,1.7
35702,CN0809700000000,08,97,"Pitkin County, CO",Feb-20,11478,11195,283,2.5
35703,CN0809900000000,08,99,"Prowers County, CO",Feb-20,6277,6111,166,2.6
35704,CN0810100000000,08,101,"Pueblo County, CO",Feb-20,76588,73284,3304,4.3
35705,CN0810300000000,08,103,"Rio Blanco County, CO",Feb-20,2976,2867,109,3.7
35706,CN0810500000000,08,105,"Rio Grande County, CO",Feb-20,5321,5039,282,5.3
35707,CN0810700000000,08,107,"Routt County, CO",Feb-20,17311,16946,365,2.1
35708,CN0810900000000,08,109,"Saguache County, CO",Feb-20,3538,3366,172,4.9
35709,CN0811100000000,08,111,"San Juan County, CO",Feb-20,536,518,18,3.4
35710,CN0811300000000,08,113,"San Miguel County, CO",Feb-20,6617,6503,114,1.7
35711,CN0811500000000,08,115,"Sedgwick County, CO",Feb-20,1216,1188,28,2.3
35712,CN0811700000000,08,117,"Summit County, CO",Feb-20,26002,25594,408,1.6
35713,CN0811900000000,08,119,"Teller County, CO",Feb-20,13018,12609,409,3.1
35714,CN0812100000000,08,121,"Washington County, CO",Feb-20,2792,2726,66,2.4
35715,CN0812300000000,08,123,"Weld County, CO",Feb-20,172414,167500,4914,2.9
35716,CN0812500000000,08,125,"Yuma County, CO",Feb-20,5600,5494,106,1.9
35717,CN0900100000000,09,1,"Fairfield County, CT",Feb-20,477917,456971,20946,4.4
35718,CN0900300000000,09,3,"Hartford County, CT",Feb-20,486620,465164,21456,4.4
35719,CN0900500000000,09,5,"Litchfield County, CT",Feb-20,104975,100261,4714,4.5
35720,CN0900700000000,09,7,"Middlesex County, CT",Feb-20,94654,90976,3678,3.9
35721,CN0900900000000,09,9,"New Haven County, CT",Feb-20,464192,443182,21010,4.5
35722,CN0901100000000,09,11,"New London County, CT",Feb-20,136918,130929,5989,4.4
35723,CN0901300000000,09,13,"Tolland County, CT",Feb-20,87802,84338,3464,3.9
35724,CN0901500000000,09,15,"Windham County, CT",Feb-20,64454,61360,3094,4.8
35725,CN1000100000000,10,1,"Kent County, DE",Feb-20,80309,76804,3505,4.4
35726,CN1000300000000,10,3,"New Castle County, DE",Feb-20,302963,291572,11391,3.8
35727,CN1000500000000,10,5,"Sussex County, DE",Feb-20,105116,100249,4867,4.6
35728,CN1100100000000,11,1,District of Columbia,Feb-20,419329,397669,21660,5.2
35729,CN1200100000000,12,1,"Alachua County, FL",Feb-20,142576,138750,3826,2.7
35730,CN1200300000000,12,3,"Baker County, FL",Feb-20,12043,11694,349,2.9
35731,CN1200500000000,12,5,"Bay County, FL",Feb-20,82157,79477,2680,3.3
35732,CN1200700000000,12,7,"Bradford County, FL",Feb-20,11302,10961,341,3.0
35733,CN1200900000000,12,9,"Brevard County, FL",Feb-20,286715,277830,8885,3.1
35734,CN1201100000000,12,11,"Broward County, FL",Feb-20,1048957,1018563,30394,2.9
35735,CN1201300000000,12,13,"Calhoun County, FL",Feb-20,4805,4641,164,3.4
35736,CN1201500000000,12,15,"Charlotte County, FL",Feb-20,73904,71305,2599,3.5
35737,CN1201700000000,12,17,"Citrus County, FL",Feb-20,47719,45440,2279,4.8
35738,CN1201900000000,12,19,"Clay County, FL",Feb-20,109475,106274,3201,2.9
35739,CN1202100000000,12,21,"Collier County, FL",Feb-20,185284,180007,5277,2.8
35740,CN1202300000000,12,23,"Columbia County, FL",Feb-20,30329,29393,936,3.1
35741,CN1202700000000,12,27,"DeSoto County, FL",Feb-20,15000,14498,502,3.3
35742,CN1202900000000,12,29,"Dixie County, FL",Feb-20,5939,5714,225,3.8
35743,CN1203100000000,12,31,"Duval County, FL",Feb-20,499858,484354,15504,3.1
35744,CN1203300000000,12,33,"Escambia County, FL",Feb-20,147161,142453,4708,3.2
35745,CN1203500000000,12,35,"Flagler County, FL",Feb-20,47644,45906,1738,3.6
35746,CN1203700000000,12,37,"Franklin County, FL",Feb-20,4521,4383,138,3.1
35747,CN1203900000000,12,39,"Gadsden County, FL",Feb-20,19075,18340,735,3.9
35748,CN1204100000000,12,41,"Gilchrist County, FL",Feb-20,7303,7070,233,3.2
35749,CN1204300000000,12,43,"Glades County, FL",Feb-20,5714,5509,205,3.6
35750,CN1204500000000,12,45,"Gulf County, FL",Feb-20,5606,5396,210,3.7
35751,CN1204700000000,12,47,"Hamilton County, FL",Feb-20,4207,4032,175,4.2
35752,CN1204900000000,12,49,"Hardee County, FL",Feb-20,8805,8431,374,4.2
35753,CN1205100000000,12,51,"Hendry County, FL",Feb-20,16166,15402,764,4.7
35754,CN1205300000000,12,53,"Hernando County, FL",Feb-20,73102,70119,2983,4.1
35755,CN1205500000000,12,55,"Highlands County, FL",Feb-20,36683,35056,1627,4.4
35756,CN1205700000000,12,57,"Hillsborough County, FL",Feb-20,763917,741842,22075,2.9
35757,CN1205900000000,12,59,"Holmes County, FL",Feb-20,7080,6832,248,3.5
35758,CN1206100000000,12,61,"Indian River County, FL",Feb-20,66698,64327,2371,3.6
35759,CN1206300000000,12,63,"Jackson County, FL",Feb-20,17222,16641,581,3.4
35760,CN1206500000000,12,65,"Jefferson County, FL",Feb-20,5670,5488,182,3.2
35761,CN1206700000000,12,67,"Lafayette County, FL",Feb-20,2899,2817,82,2.8
35762,CN1206900000000,12,69,"Lake County, FL",Feb-20,161182,156151,5031,3.1
35763,CN1207100000000,12,71,"Lee County, FL",Feb-20,356562,345949,10613,3.0
35764,CN1207300000000,12,73,"Leon County, FL",Feb-20,156781,152340,4441,2.8
35765,CN1207500000000,12,75,"Levy County, FL",Feb-20,16959,16367,592,3.5
35766,CN1207700000000,12,77,"Liberty County, FL",Feb-20,2665,2573,92,3.5
35767,CN1207900000000,12,79,"Madison County, FL",Feb-20,7480,7223,257,3.4
35768,CN1208100000000,12,81,"Manatee County, FL",Feb-20,184000,178565,5435,3.0
35769,CN1208300000000,12,83,"Marion County, FL",Feb-20,138944,133796,5148,3.7
35770,CN1208500000000,12,85,"Martin County, FL",Feb-20,75515,73258,2257,3.0
35771,CN1208600000000,12,86,"Miami-Dade County, FL",Feb-20,1404551,1384161,20390,1.5
35772,CN1208700000000,12,87,"Monroe County, FL",Feb-20,48159,47198,961,2.0
35773,CN1208900000000,12,89,"Nassau County, FL",Feb-20,41885,40696,1189,2.8
35774,CN1209100000000,12,91,"Okaloosa County, FL",Feb-20,96013,93429,2584,2.7
35775,CN1209300000000,12,93,"Okeechobee County, FL",Feb-20,18226,17691,535,2.9
35776,CN1209500000000,12,95,"Orange County, FL",Feb-20,772500,751168,21332,2.8
35777,CN1209700000000,12,97,"Osceola County, FL",Feb-20,186590,180754,5836,3.1
35778,CN1209900000000,12,99,"Palm Beach County, FL",Feb-20,742286,719637,22649,3.1
35779,CN1210100000000,12,101,"Pasco County, FL",Feb-20,241993,233875,8118,3.4
35780,CN1210300000000,12,103,"Pinellas County, FL",Feb-20,502725,488163,14562,2.9
35781,CN1210500000000,12,105,"Polk County, FL",Feb-20,309082,298382,10700,3.5
35782,CN1210700000000,12,107,"Putnam County, FL",Feb-20,26683,25532,1151,4.3
35783,CN1210900000000,12,109,"St. Johns County, FL",Feb-20,134707,131286,3421,2.5
35784,CN1211100000000,12,111,"St. Lucie County, FL",Feb-20,147604,142099,5505,3.7
35785,CN1211300000000,12,113,"Santa Rosa County, FL",Feb-20,83470,81100,2370,2.8
35786,CN1211500000000,12,115,"Sarasota County, FL",Feb-20,193051,187336,5715,3.0
35787,CN1211700000000,12,117,"Seminole County, FL",Feb-20,258810,251567,7243,2.8
35788,CN1211900000000,12,119,"Sumter County, FL",Feb-20,33349,31816,1533,4.6
35789,CN1212100000000,12,121,"Suwannee County, FL",Feb-20,17980,17373,607,3.4
35790,CN1212300000000,12,123,"Taylor County, FL",Feb-20,8161,7889,272,3.3
35791,CN1212500000000,12,125,"Union County, FL",Feb-20,4703,4570,133,2.8
35792,CN1212700000000,12,127,"Volusia County, FL",Feb-20,257750,249104,8646,3.4
35793,CN1212900000000,12,129,"Wakulla County, FL",Feb-20,15081,14658,423,2.8
35794,CN1213100000000,12,131,"Walton County, FL",Feb-20,31305,30429,876,2.8
35795,CN1213300000000,12,133,"Washington County, FL",Feb-20,9609,9274,335,3.5
35796,CN1300100000000,13,1,"Appling County, GA",Feb-20,9897,9534,363,3.7
35797,CN1300300000000,13,3,"Atkinson County, GA",Feb-20,5148,4994,154,3.0
35798,CN1300500000000,13,5,"Bacon County, GA",Feb-20,5057,4867,190,3.8
35799,CN1300700000000,13,7,"Baker County, GA",Feb-20,1229,1172,57,4.6
35800,CN1300900000000,13,9,"Baldwin County, GA",Feb-20,17810,17013,797,4.5
35801,CN1301100000000,13,11,"Banks County, GA",Feb-20,9899,9617,282,2.8
35802,CN1301300000000,13,13,"Barrow County, GA",Feb-20,41097,39891,1206,2.9
35803,CN1301500000000,13,15,"Bartow County, GA",Feb-20,51489,49717,1772,3.4
35804,CN1301700000000,13,17,"Ben Hill County, GA",Feb-20,5358,5060,298,5.6
35805,CN1301900000000,13,19,"Berrien County, GA",Feb-20,7710,7365,345,4.5
35806,CN1302100000000,13,21,"Bibb County, GA",Feb-20,68555,65858,2697,3.9
35807,CN1302300000000,13,23,"Bleckley County, GA",Feb-20,4579,4353,226,4.9
35808,CN1302500000000,13,25,"Brantley County, GA",Feb-20,7252,6967,285,3.9
35809,CN1302700000000,13,27,"Brooks County, GA",Feb-20,7131,6870,261,3.7
35810,CN1302900000000,13,29,"Bryan County, GA",Feb-20,18388,17812,576,3.1
35811,CN1303100000000,13,31,"Bulloch County, GA",Feb-20,36953,35551,1402,3.8
35812,CN1303300000000,13,33,"Burke County, GA",Feb-20,9320,8853,467,5.0
35813,CN1303500000000,13,35,"Butts County, GA",Feb-20,10941,10559,382,3.5
35814,CN1303700000000,13,37,"Calhoun County, GA",Feb-20,2383,2300,83,3.5
35815,CN1303900000000,13,39,"Camden County, GA",Feb-20,21032,20245,787,3.7
35816,CN1304300000000,13,43,"Candler County, GA",Feb-20,5716,5561,155,2.7
35817,CN1304500000000,13,45,"Carroll County, GA",Feb-20,56277,54174,2103,3.7
35818,CN1304700000000,13,47,"Catoosa County, GA",Feb-20,34225,33175,1050,3.1
35819,CN1304900000000,13,49,"Charlton County, GA",Feb-20,4894,4710,184,3.8
35820,CN1305100000000,13,51,"Chatham County, GA",Feb-20,140365,135554,4811,3.4
35821,CN1305300000000,13,53,"Chattahoochee County, GA",Feb-20,2023,1933,90,4.4
35822,CN1305500000000,13,55,"Chattooga County, GA",Feb-20,10376,9872,504,4.9
35823,CN1305700000000,13,57,"Cherokee County, GA",Feb-20,137887,134021,3866,2.8
35824,CN1305900000000,13,59,"Clarke County, GA",Feb-20,59920,57803,2117,3.5
35825,CN1306100000000,13,61,"Clay County, GA",Feb-20,910,845,65,7.1
35826,CN1306300000000,13,63,"Clayton County, GA",Feb-20,140224,134137,6087,4.3
35827,CN1306500000000,13,65,"Clinch County, GA",Feb-20,2642,2539,103,3.9
35828,CN1306700000000,13,67,"Cobb County, GA",Feb-20,431808,418630,13178,3.1
35829,CN1306900000000,13,69,"Coffee County, GA",Feb-20,19289,18488,801,4.2
35830,CN1307100000000,13,71,"Colquitt County, GA",Feb-20,21989,21297,692,3.1
35831,CN1307300000000,13,73,"Columbia County, GA",Feb-20,75894,73555,2339,3.1
35832,CN1307500000000,13,75,"Cook County, GA",Feb-20,8219,7932,287,3.5
35833,CN1307700000000,13,77,"Coweta County, GA",Feb-20,75833,73576,2257,3.0
35834,CN1307900000000,13,79,"Crawford County, GA",Feb-20,5691,5488,203,3.6
35835,CN1308100000000,13,81,"Crisp County, GA",Feb-20,9654,9264,390,4.0
35836,CN1308300000000,13,83,"Dade County, GA",Feb-20,8345,8059,286,3.4
35837,CN1308500000000,13,85,"Dawson County, GA",Feb-20,12502,12148,354,2.8
35838,CN1308700000000,13,87,"Decatur County, GA",Feb-20,11912,11466,446,3.7
35839,CN1308900000000,13,89,"DeKalb County, GA",Feb-20,405645,391458,14187,3.5
35840,CN1309100000000,13,91,"Dodge County, GA",Feb-20,7063,6680,383,5.4
35841,CN1309300000000,13,93,"Dooly County, GA",Feb-20,5193,4996,197,3.8
35842,CN1309500000000,13,95,"Dougherty County, GA",Feb-20,38914,37043,1871,4.8
35843,CN1309700000000,13,97,"Douglas County, GA",Feb-20,74398,71688,2710,3.6
35844,CN1309900000000,13,99,"Early County, GA",Feb-20,4550,4351,199,4.4
35845,CN1310100000000,13,101,"Echols County, GA",Feb-20,2000,1943,57,2.9
35846,CN1310300000000,13,103,"Effingham County, GA",Feb-20,31085,30150,935,3.0
35847,CN1310500000000,13,105,"Elbert County, GA",Feb-20,7751,7416,335,4.3
35848,CN1310700000000,13,107,"Emanuel County, GA",Feb-20,8449,8054,395,4.7
35849,CN1310900000000,13,109,"Evans County, GA",Feb-20,4983,4804,179,3.6
35850,CN1311100000000,13,111,"Fannin County, GA",Feb-20,11531,11110,421,3.7
35851,CN1311300000000,13,113,"Fayette County, GA",Feb-20,58898,57137,1761,3.0
35852,CN1311500000000,13,115,"Floyd County, GA",Feb-20,44830,43155,1675,3.7
35853,CN1311700000000,13,117,"Forsyth County, GA",Feb-20,124008,120589,3419,2.8
35854,CN1311900000000,13,119,"Franklin County, GA",Feb-20,10092,9707,385,3.8
35855,CN1312100000000,13,121,"Fulton County, GA",Feb-20,565766,545846,19920,3.5
35856,CN1312300000000,13,123,"Gilmer County, GA",Feb-20,11892,11446,446,3.8
35857,CN1312500000000,13,125,"Glascock County, GA",Feb-20,1306,1252,54,4.1
35858,CN1312700000000,13,127,"Glynn County, GA",Feb-20,39132,37820,1312,3.4
35859,CN1312900000000,13,129,"Gordon County, GA",Feb-20,28517,27501,1016,3.6
35860,CN1313100000000,13,131,"Grady County, GA",Feb-20,10616,10252,364,3.4
35861,CN1313300000000,13,133,"Greene County, GA",Feb-20,7005,6719,286,4.1
35862,CN1313500000000,13,135,"Gwinnett County, GA",Feb-20,497011,481670,15341,3.1
35863,CN1313700000000,13,137,"Habersham County, GA",Feb-20,19224,18555,669,3.5
35864,CN1313900000000,13,139,"Hall County, GA",Feb-20,103806,100951,2855,2.8
35865,CN1314100000000,13,141,"Hancock County, GA",Feb-20,2549,2408,141,5.5
35866,CN1314300000000,13,143,"Haralson County, GA",Feb-20,12775,12312,463,3.6
35867,CN1314500000000,13,145,"Harris County, GA",Feb-20,16787,16259,528,3.1
35868,CN1314700000000,13,147,"Hart County, GA",Feb-20,11193,10711,482,4.3
35869,CN1314900000000,13,149,"Heard County, GA",Feb-20,5364,5164,200,3.7
35870,CN1315100000000,13,151,"Henry County, GA",Feb-20,117492,113291,4201,3.6
35871,CN1315300000000,13,153,"Houston County, GA",Feb-20,71387,68993,2394,3.4
35872,CN1315500000000,13,155,"Irwin County, GA",Feb-20,3451,3288,163,4.7
35873,CN1315700000000,13,157,"Jackson County, GA",Feb-20,37023,36010,1013,2.7
35874,CN1315900000000,13,159,"Jasper County, GA",Feb-20,7058,6850,208,2.9
35875,CN1316100000000,13,161,"Jeff Davis County, GA",Feb-20,6135,5845,290,4.7
35876,CN1316300000000,13,163,"Jefferson County, GA",Feb-20,6759,6421,338,5.0
35877,CN1316500000000,13,165,"Jenkins County, GA",Feb-20,3132,2987,145,4.6
35878,CN1316700000000,13,167,"Johnson County, GA",Feb-20,4060,3893,167,4.1
35879,CN1316900000000,13,169,"Jones County, GA",Feb-20,13885,13420,465,3.3
35880,CN1317100000000,13,171,"Lamar County, GA",Feb-20,8414,8021,393,4.7
35881,CN1317300000000,13,173,"Lanier County, GA",Feb-20,3803,3649,154,4.0
35882,CN1317500000000,13,175,"Laurens County, GA",Feb-20,19144,18176,968,5.1
35883,CN1317700000000,13,177,"Lee County, GA",Feb-20,14952,14483,469,3.1
35884,CN1317900000000,13,179,"Liberty County, GA",Feb-20,26720,25688,1032,3.9
35885,CN1318100000000,13,181,"Lincoln County, GA",Feb-20,3639,3492,147,4.0
35886,CN1318300000000,13,183,"Long County, GA",Feb-20,8359,8066,293,3.5
35887,CN1318500000000,13,185,"Lowndes County, GA",Feb-20,51877,49959,1918,3.7
35888,CN1318700000000,13,187,"Lumpkin County, GA",Feb-20,16908,16387,521,3.1
35889,CN1318900000000,13,189,"McDuffie County, GA",Feb-20,8972,8502,470,5.2
35890,CN1319100000000,13,191,"McIntosh County, GA",Feb-20,6207,5986,221,3.6
35891,CN1319300000000,13,193,"Macon County, GA",Feb-20,4837,4615,222,4.6
35892,CN1319500000000,13,195,"Madison County, GA",Feb-20,13479,13045,434,3.2
35893,CN1319700000000,13,197,"Marion County, GA",Feb-20,3339,3191,148,4.4
35894,CN1319900000000,13,199,"Meriwether County, GA",Feb-20,9053,8661,392,4.3
35895,CN1320100000000,13,201,"Miller County, GA",Feb-20,2846,2750,96,3.4
35896,CN1320500000000,13,205,"Mitchell County, GA",Feb-20,8790,8378,412,4.7
35897,CN1320700000000,13,207,"Monroe County, GA",Feb-20,13177,12714,463,3.5
35898,CN1320900000000,13,209,"Montgomery County, GA",Feb-20,3857,3681,176,4.6
35899,CN1321100000000,13,211,"Morgan County, GA",Feb-20,9430,9130,300,3.2
35900,CN1321300000000,13,213,"Murray County, GA",Feb-20,15630,14805,825,5.3
35901,CN1321500000000,13,215,"Muscogee County, GA",Feb-20,77764,74316,3448,4.4
35902,CN1321700000000,13,217,"Newton County, GA",Feb-20,53066,51018,2048,3.9
35903,CN1321900000000,13,219,"Oconee County, GA",Feb-20,19754,19262,492,2.5
35904,CN1322100000000,13,221,"Oglethorpe County, GA",Feb-20,7081,6850,231,3.3
35905,CN1322300000000,13,223,"Paulding County, GA",Feb-20,87450,84770,2680,3.1
35906,CN1322500000000,13,225,"Peach County, GA",Feb-20,12033,11568,465,3.9
35907,CN1322700000000,13,227,"Pickens County, GA",Feb-20,15536,15045,491,3.2
35908,CN1322900000000,13,229,"Pierce County, GA",Feb-20,8833,8553,280,3.2
35909,CN1323100000000,13,231,"Pike County, GA",Feb-20,9052,8769,283,3.1
35910,CN1323300000000,13,233,"Polk County, GA",Feb-20,18619,17928,691,3.7
35911,CN1323500000000,13,235,"Pulaski County, GA",Feb-20,4144,3979,165,4.0
35912,CN1323700000000,13,237,"Putnam County, GA",Feb-20,8273,7922,351,4.2
35913,CN1323900000000,13,239,"Quitman County, GA",Feb-20,797,761,36,4.5
35914,CN1324100000000,13,241,"Rabun County, GA",Feb-20,6948,6694,254,3.7
35915,CN1324300000000,13,243,"Randolph County, GA",Feb-20,2616,2490,126,4.8
35916,CN1324500000000,13,245,"Richmond County, GA",Feb-20,85954,82116,3838,4.5
35917,CN1324700000000,13,247,"Rockdale County, GA",Feb-20,45477,43712,1765,3.9
35918,CN1324900000000,13,249,"Schley County, GA",Feb-20,2252,2169,83,3.7
35919,CN1325100000000,13,251,"Screven County, GA",Feb-20,5113,4888,225,4.4
35920,CN1325300000000,13,253,"Seminole County, GA",Feb-20,3124,2990,134,4.3
35921,CN1325500000000,13,255,"Spalding County, GA",Feb-20,29217,27976,1241,4.2
35922,CN1325700000000,13,257,"Stephens County, GA",Feb-20,10717,10296,421,3.9
35923,CN1325900000000,13,259,"Stewart County, GA",Feb-20,2457,2366,91,3.7
35924,CN1326100000000,13,261,"Sumter County, GA",Feb-20,13062,12428,634,4.9
35925,CN1326300000000,13,263,"Talbot County, GA",Feb-20,2827,2711,116,4.1
35926,CN1326500000000,13,265,"Taliaferro County, GA",Feb-20,581,539,42,7.2
35927,CN1326700000000,13,267,"Tattnall County, GA",Feb-20,9806,9414,392,4.0
35928,CN1326900000000,13,269,"Taylor County, GA",Feb-20,3257,3142,115,3.5
35929,CN1327100000000,13,271,"Telfair County, GA",Feb-20,4204,3805,399,9.5
35930,CN1327300000000,13,273,"Terrell County, GA",Feb-20,3547,3393,154,4.3
35931,CN1327500000000,13,275,"Thomas County, GA",Feb-20,16594,15906,688,4.1
35932,CN1327700000000,13,277,"Tift County, GA",Feb-20,20336,19635,701,3.4
35933,CN1327900000000,13,279,"Toombs County, GA",Feb-20,11839,11284,555,4.7
35934,CN1328100000000,13,281,"Towns County, GA",Feb-20,3867,3668,199,5.1
35935,CN1328300000000,13,283,"Treutlen County, GA",Feb-20,2679,2531,148,5.5
35936,CN1328500000000,13,285,"Troup County, GA",Feb-20,37828,36627,1201,3.2
35937,CN1328700000000,13,287,"Turner County, GA",Feb-20,3234,3076,158,4.9
35938,CN1328900000000,13,289,"Twiggs County, GA",Feb-20,2933,2762,171,5.8
35939,CN1329100000000,13,291,"Union County, GA",Feb-20,10406,10046,360,3.5
35940,CN1329300000000,13,293,"Upson County, GA",Feb-20,11572,11107,465,4.0
35941,CN1329500000000,13,295,"Walker County, GA",Feb-20,31976,30902,1074,3.4
35942,CN1329700000000,13,297,"Walton County, GA",Feb-20,46807,45332,1475,3.2
35943,CN1329900000000,13,299,"Ware County, GA",Feb-20,15843,15245,598,3.8
35944,CN1330100000000,13,301,"Warren County, GA",Feb-20,2903,2780,123,4.2
35945,CN1330300000000,13,303,"Washington County, GA",Feb-20,7073,6739,334,4.7
35946,CN1330500000000,13,305,"Wayne County, GA",Feb-20,11397,10948,449,3.9
35947,CN1330700000000,13,307,"Webster County, GA",Feb-20,1044,992,52,5.0
35948,CN1330900000000,13,309,"Wheeler County, GA",Feb-20,1665,1540,125,7.5
35949,CN1331100000000,13,311,"White County, GA",Feb-20,16471,16031,440,2.7
35950,CN1331300000000,13,313,"Whitfield County, GA",Feb-20,43521,41759,1762,4.0
35951,CN1331500000000,13,315,"Wilcox County, GA",Feb-20,2753,2637,116,4.2
35952,CN1331700000000,13,317,"Wilkes County, GA",Feb-20,3891,3678,213,5.5
35953,CN1331900000000,13,319,"Wilkinson County, GA",Feb-20,4052,3900,152,3.8
35954,CN1332100000000,13,321,"Worth County, GA",Feb-20,9092,8747,345,3.8
35955,CN1500100000000,15,1,"Hawaii County, HI",Feb-20,91794,88760,3034,3.3
35956,CN1500300000000,15,3,"Honolulu County/city, HI",Feb-20,453659,442261,11398,2.5
35957,CN1500700000000,15,7,"Kauai County, HI",Feb-20,36570,35549,1021,2.8
35958,CN1500900000000,15,9,"Maui County, HI",Feb-20,87084,84776,2308,2.7
35959,CN1600100000000,16,1,"Ada County, ID",Feb-20,260365,254134,6231,2.4
35960,CN1600300000000,16,3,"Adams County, ID",Feb-20,1658,1545,113,6.8
35961,CN1600500000000,16,5,"Bannock County, ID",Feb-20,43600,42277,1323,3.0
35962,CN1600700000000,16,7,"Bear Lake County, ID",Feb-20,2920,2814,106,3.6
35963,CN1600900000000,16,9,"Benewah County, ID",Feb-20,4140,3881,259,6.3
35964,CN1601100000000,16,11,"Bingham County, ID",Feb-20,23419,22723,696,3.0
35965,CN1601300000000,16,13,"Blaine County, ID",Feb-20,12643,12245,398,3.1
35966,CN1601500000000,16,15,"Boise County, ID",Feb-20,3656,3461,195,5.3
35967,CN1601700000000,16,17,"Bonner County, ID",Feb-20,20360,19362,998,4.9
35968,CN1601900000000,16,19,"Bonneville County, ID",Feb-20,58206,56704,1502,2.6
35969,CN1602100000000,16,21,"Boundary County, ID",Feb-20,5238,4961,277,5.3
35970,CN1602300000000,16,23,"Butte County, ID",Feb-20,1384,1350,34,2.5
35971,CN1602500000000,16,25,"Camas County, ID",Feb-20,681,661,20,2.9
35972,CN1602700000000,16,27,"Canyon County, ID",Feb-20,106260,102797,3463,3.3
35973,CN1602900000000,16,29,"Caribou County, ID",Feb-20,4094,3954,140,3.4
35974,CN1603100000000,16,31,"Cassia County, ID",Feb-20,12030,11744,286,2.4
35975,CN1603300000000,16,33,"Clark County, ID",Feb-20,358,342,16,4.5
35976,CN1603500000000,16,35,"Clearwater County, ID",Feb-20,2810,2623,187,6.7
35977,CN1603700000000,16,37,"Custer County, ID",Feb-20,1983,1894,89,4.5
35978,CN1603900000000,16,39,"Elmore County, ID",Feb-20,11466,11050,416,3.6
35979,CN1604100000000,16,41,"Franklin County, ID",Feb-20,6971,6815,156,2.2
35980,CN1604300000000,16,43,"Fremont County, ID",Feb-20,7787,7555,232,3.0
35981,CN1604500000000,16,45,"Gem County, ID",Feb-20,8441,8143,298,3.5
35982,CN1604700000000,16,47,"Gooding County, ID",Feb-20,8084,7830,254,3.1
35983,CN1604900000000,16,49,"Idaho County, ID",Feb-20,6416,6090,326,5.1
35984,CN1605100000000,16,51,"Jefferson County, ID",Feb-20,14108,13751,357,2.5
35985,CN1605300000000,16,53,"Jerome County, ID",Feb-20,12133,11758,375,3.1
35986,CN1605500000000,16,55,"Kootenai County, ID",Feb-20,80559,77242,3317,4.1
35987,CN1605700000000,16,57,"Latah County, ID",Feb-20,21143,20619,524,2.5
35988,CN1605900000000,16,59,"Lemhi County, ID",Feb-20,3460,3246,214,6.2
35989,CN1606100000000,16,61,"Lewis County, ID",Feb-20,1570,1472,98,6.2
35990,CN1606300000000,16,63,"Lincoln County, ID",Feb-20,2725,2568,157,5.8
35991,CN1606500000000,16,65,"Madison County, ID",Feb-20,21984,21582,402,1.8
35992,CN1606700000000,16,67,"Minidoka County, ID",Feb-20,11264,10939,325,2.9
35993,CN1606900000000,16,69,"Nez Perce County, ID",Feb-20,21338,20703,635,3.0
35994,CN1607100000000,16,71,"Oneida County, ID",Feb-20,2281,2223,58,2.5
35995,CN1607300000000,16,73,"Owyhee County, ID",Feb-20,5268,5066,202,3.8
35996,CN1607500000000,16,75,"Payette County, ID",Feb-20,11643,11190,453,3.9
35997,CN1607700000000,16,77,"Power County, ID",Feb-20,3815,3671,144,3.8
35998,CN1607900000000,16,79,"Shoshone County, ID",Feb-20,5084,4748,336,6.6
35999,CN1608100000000,16,81,"Teton County, ID",Feb-20,6289,6153,136,2.2
36000,CN1608300000000,16,83,"Twin Falls County, ID",Feb-20,41444,40191,1253,3.0
36001,CN1608500000000,16,85,"Valley County, ID",Feb-20,5626,5379,247,4.4
36002,CN1608700000000,16,87,"Washington County, ID",Feb-20,4613,4402,211,4.6
36003,CN1700100000000,17,1,"Adams County, IL",Feb-20,31415,30545,870,2.8
36004,CN1700300000000,17,3,"Alexander County, IL",Feb-20,2030,1927,103,5.1
36005,CN1700500000000,17,5,"Bond County, IL",Feb-20,7568,7327,241,3.2
36006,CN1700700000000,17,7,"Boone County, IL",Feb-20,25411,24024,1387,5.5
36007,CN1700900000000,17,9,"Brown County, IL",Feb-20,2929,2873,56,1.9
36008,CN1701100000000,17,11,"Bureau County, IL",Feb-20,16496,15773,723,4.4
36009,CN1701300000000,17,13,"Calhoun County, IL",Feb-20,2260,2173,87,3.8
36010,CN1701500000000,17,15,"Carroll County, IL",Feb-20,7020,6736,284,4.0
36011,CN1701700000000,17,17,"Cass County, IL",Feb-20,5917,5697,220,3.7
36012,CN1701900000000,17,19,"Champaign County, IL",Feb-20,110763,107875,2888,2.6
36013,CN1702100000000,17,21,"Christian County, IL",Feb-20,13879,13280,599,4.3
36014,CN1702300000000,17,23,"Clark County, IL",Feb-20,7370,7074,296,4.0
36015,CN1702500000000,17,25,"Clay County, IL",Feb-20,6206,5939,267,4.3
36016,CN1702700000000,17,27,"Clinton County, IL",Feb-20,20085,19532,553,2.8
36017,CN1702900000000,17,29,"Coles County, IL",Feb-20,23876,23204,672,2.8
36018,CN1703100000000,17,31,"Cook County, IL",Feb-20,2564954,2476865,88089,3.4
36019,CN1703300000000,17,33,"Crawford County, IL",Feb-20,8432,8138,294,3.5
36020,CN1703500000000,17,35,"Cumberland County, IL",Feb-20,6029,5847,182,3.0
36021,CN1703700000000,17,37,"DeKalb County, IL",Feb-20,54265,52363,1902,3.5
36022,CN1703900000000,17,39,"De Witt County, IL",Feb-20,7225,6980,245,3.4
36023,CN1704100000000,17,41,"Douglas County, IL",Feb-20,10041,9785,256,2.5
36024,CN1704300000000,17,43,"DuPage County, IL",Feb-20,502242,488992,13250,2.6
36025,CN1704500000000,17,45,"Edgar County, IL",Feb-20,8399,8119,280,3.3
36026,CN1704700000000,17,47,"Edwards County, IL",Feb-20,2639,2530,109,4.1
36027,CN1704900000000,17,49,"Effingham County, IL",Feb-20,19083,18548,535,2.8
36028,CN1705100000000,17,51,"Fayette County, IL",Feb-20,9550,9168,382,4.0
36029,CN1705300000000,17,53,"Ford County, IL",Feb-20,6359,6137,222,3.5
36030,CN1705500000000,17,55,"Franklin County, IL",Feb-20,16079,15378,701,4.4
36031,CN1705700000000,17,57,"Fulton County, IL",Feb-20,14759,13977,782,5.3
36032,CN1705900000000,17,59,"Gallatin County, IL",Feb-20,2291,2187,104,4.5
36033,CN1706100000000,17,61,"Greene County, IL",Feb-20,5796,5600,196,3.4
36034,CN1706300000000,17,63,"Grundy County, IL",Feb-20,25176,23999,1177,4.7
36035,CN1706500000000,17,65,"Hamilton County, IL",Feb-20,4305,4167,138,3.2
36036,CN1706700000000,17,67,"Hancock County, IL",Feb-20,7955,7614,341,4.3
36037,CN1706900000000,17,69,"Hardin County, IL",Feb-20,1286,1214,72,5.6
36038,CN1707100000000,17,71,"Henderson County, IL",Feb-20,3427,3264,163,4.8
36039,CN1707300000000,17,73,"Henry County, IL",Feb-20,24186,23139,1047,4.3
36040,CN1707500000000,17,75,"Iroquois County, IL",Feb-20,13680,13101,579,4.2
36041,CN1707700000000,17,77,"Jackson County, IL",Feb-20,27776,27005,771,2.8
36042,CN1707900000000,17,79,"Jasper County, IL",Feb-20,4614,4447,167,3.6
36043,CN1708100000000,17,81,"Jefferson County, IL",Feb-20,17171,16557,614,3.6
36044,CN1708300000000,17,83,"Jersey County, IL",Feb-20,10838,10434,404,3.7
36045,CN1708500000000,17,85,"Jo Daviess County, IL",Feb-20,10243,9795,448,4.4
36046,CN1708700000000,17,87,"Johnson County, IL",Feb-20,4220,4001,219,5.2
36047,CN1708900000000,17,89,"Kane County, IL",Feb-20,270431,259442,10989,4.1
36048,CN1709100000000,17,91,"Kankakee County, IL",Feb-20,55329,52822,2507,4.5
36049,CN1709300000000,17,93,"Kendall County, IL",Feb-20,67885,65626,2259,3.3
36050,CN1709500000000,17,95,"Knox County, IL",Feb-20,20838,19961,877,4.2
36051,CN1709700000000,17,97,"Lake County, IL",Feb-20,368187,354390,13797,3.7
36052,CN1709900000000,17,99,"LaSalle County, IL",Feb-20,53486,50914,2572,4.8
36053,CN1710100000000,17,101,"Lawrence County, IL",Feb-20,5772,5536,236,4.1
36054,CN1710300000000,17,103,"Lee County, IL",Feb-20,17296,16732,564,3.3
36055,CN1710500000000,17,105,"Livingston County, IL",Feb-20,15858,15292,566,3.6
36056,CN1710700000000,17,107,"Logan County, IL",Feb-20,12279,11862,417,3.4
36057,CN1710900000000,17,109,"McDonough County, IL",Feb-20,13084,12664,420,3.2
36058,CN1711100000000,17,111,"McHenry County, IL",Feb-20,164000,158432,5568,3.4
36059,CN1711300000000,17,113,"McLean County, IL",Feb-20,86658,84274,2384,2.8
36060,CN1711500000000,17,115,"Macon County, IL",Feb-20,47129,45087,2042,4.3
36061,CN1711700000000,17,117,"Macoupin County, IL",Feb-20,22534,21738,796,3.5
36062,CN1711900000000,17,119,"Madison County, IL",Feb-20,132902,128877,4025,3.0
36063,CN1712100000000,17,121,"Marion County, IL",Feb-20,17054,16447,607,3.6
36064,CN1712300000000,17,123,"Marshall County, IL",Feb-20,5107,4872,235,4.6
36065,CN1712500000000,17,125,"Mason County, IL",Feb-20,6075,5788,287,4.7
36066,CN1712700000000,17,127,"Massac County, IL",Feb-20,5579,5335,244,4.4
36067,CN1712900000000,17,129,"Menard County, IL",Feb-20,6344,6116,228,3.6
36068,CN1713100000000,17,131,"Mercer County, IL",Feb-20,7844,7414,430,5.5
36069,CN1713300000000,17,133,"Monroe County, IL",Feb-20,18605,18143,462,2.5
36070,CN1713500000000,17,135,"Montgomery County, IL",Feb-20,11358,10774,584,5.1
36071,CN1713700000000,17,137,"Morgan County, IL",Feb-20,15991,15440,551,3.4
36072,CN1713900000000,17,139,"Moultrie County, IL",Feb-20,7422,7235,187,2.5
36073,CN1714100000000,17,141,"Ogle County, IL",Feb-20,23940,22891,1049,4.4
36074,CN1714300000000,17,143,"Peoria County, IL",Feb-20,82684,78961,3723,4.5
36075,CN1714500000000,17,145,"Perry County, IL",Feb-20,8194,7883,311,3.8
36076,CN1714700000000,17,147,"Piatt County, IL",Feb-20,8616,8385,231,2.7
36077,CN1714900000000,17,149,"Pike County, IL",Feb-20,6594,6315,279,4.2
36078,CN1715100000000,17,151,"Pope County, IL",Feb-20,1653,1582,71,4.3
36079,CN1715300000000,17,153,"Pulaski County, IL",Feb-20,1911,1795,116,6.1
36080,CN1715500000000,17,155,"Putnam County, IL",Feb-20,3070,2910,160,5.2
36081,CN1715700000000,17,157,"Randolph County, IL",Feb-20,14039,13625,414,2.9
36082,CN1715900000000,17,159,"Richland County, IL",Feb-20,7061,6831,230,3.3
36083,CN1716100000000,17,161,"Rock Island County, IL",Feb-20,69781,66798,2983,4.3
36084,CN1716300000000,17,163,"St. Clair County, IL",Feb-20,125252,121052,4200,3.4
36085,CN1716500000000,17,165,"Saline County, IL",Feb-20,9494,9067,427,4.5
36086,CN1716700000000,17,167,"Sangamon County, IL",Feb-20,98883,95694,3189,3.2
36087,CN1716900000000,17,169,"Schuyler County, IL",Feb-20,3048,2933,115,3.8
36088,CN1717100000000,17,171,"Scott County, IL",Feb-20,2442,2328,114,4.7
36089,CN1717300000000,17,173,"Shelby County, IL",Feb-20,10253,9912,341,3.3
36090,CN1717500000000,17,175,"Stark County, IL",Feb-20,2380,2260,120,5.0
36091,CN1717700000000,17,177,"Stephenson County, IL",Feb-20,20950,20099,851,4.1
36092,CN1717900000000,17,179,"Tazewell County, IL",Feb-20,61930,59482,2448,4.0
36093,CN1718100000000,17,181,"Union County, IL",Feb-20,7400,7018,382,5.2
36094,CN1718300000000,17,183,"Vermilion County, IL",Feb-20,32271,30960,1311,4.1
36095,CN1718500000000,17,185,"Wabash County, IL",Feb-20,5862,5694,168,2.9
36096,CN1718700000000,17,187,"Warren County, IL",Feb-20,8127,7867,260,3.2
36097,CN1718900000000,17,189,"Washington County, IL",Feb-20,9769,9572,197,2.0
36098,CN1719100000000,17,191,"Wayne County, IL",Feb-20,6728,6472,256,3.8
36099,CN1719300000000,17,193,"White County, IL",Feb-20,6389,6189,200,3.1
36100,CN1719500000000,17,195,"Whiteside County, IL",Feb-20,27781,26765,1016,3.7
36101,CN1719700000000,17,197,"Will County, IL",Feb-20,353805,340211,13594,3.8
36102,CN1719900000000,17,199,"Williamson County, IL",Feb-20,31949,30849,1100,3.4
36103,CN1720100000000,17,201,"Winnebago County, IL",Feb-20,134619,128307,6312,4.7
36104,CN1720300000000,17,203,"Woodford County, IL",Feb-20,18104,17538,566,3.1
36105,CN1800100000000,18,1,"Adams County, IN",Feb-20,16925,16406,519,3.1
36106,CN1800300000000,18,3,"Allen County, IN",Feb-20,187748,181348,6400,3.4
36107,CN1800500000000,18,5,"Bartholomew County, IN",Feb-20,45236,44108,1128,2.5
36108,CN1800700000000,18,7,"Benton County, IN",Feb-20,4660,4526,134,2.9
36109,CN1800900000000,18,9,"Blackford County, IN",Feb-20,4816,4609,207,4.3
36110,CN1801100000000,18,11,"Boone County, IN",Feb-20,36326,35469,857,2.4
36111,CN1801300000000,18,13,"Brown County, IN",Feb-20,7746,7492,254,3.3
36112,CN1801500000000,18,15,"Carroll County, IN",Feb-20,10634,10293,341,3.2
36113,CN1801700000000,18,17,"Cass County, IN",Feb-20,17807,17123,684,3.8
36114,CN1801900000000,18,19,"Clark County, IN",Feb-20,62203,60231,1972,3.2
36115,CN1802100000000,18,21,"Clay County, IN",Feb-20,12096,11638,458,3.8
36116,CN1802300000000,18,23,"Clinton County, IN",Feb-20,17130,16675,455,2.7
36117,CN1802500000000,18,25,"Crawford County, IN",Feb-20,4889,4613,276,5.6
36118,CN1802700000000,18,27,"Daviess County, IN",Feb-20,16705,16244,461,2.8
36119,CN1802900000000,18,29,"Dearborn County, IN",Feb-20,25886,24881,1005,3.9
36120,CN1803100000000,18,31,"Decatur County, IN",Feb-20,14797,14331,466,3.1
36121,CN1803300000000,18,33,"DeKalb County, IN",Feb-20,22819,22154,665,2.9
36122,CN1803500000000,18,35,"Delaware County, IN",Feb-20,54905,52728,2177,4.0
36123,CN1803700000000,18,37,"Dubois County, IN",Feb-20,22932,22373,559,2.4
36124,CN1803900000000,18,39,"Elkhart County, IN",Feb-20,112571,109482,3089,2.7
36125,CN1804100000000,18,41,"Fayette County, IN",Feb-20,8498,8116,382,4.5
36126,CN1804300000000,18,43,"Floyd County, IN",Feb-20,42027,40719,1308,3.1
36127,CN1804500000000,18,45,"Fountain County, IN",Feb-20,7902,7625,277,3.5
36128,CN1804700000000,18,47,"Franklin County, IN",Feb-20,11186,10748,438,3.9
36129,CN1804900000000,18,49,"Fulton County, IN",Feb-20,9528,9160,368,3.9
36130,CN1805100000000,18,51,"Gibson County, IN",Feb-20,19782,19263,519,2.6
36131,CN1805300000000,18,53,"Grant County, IN",Feb-20,32177,31012,1165,3.6
36132,CN1805500000000,18,55,"Greene County, IN",Feb-20,13756,13135,621,4.5
36133,CN1805700000000,18,57,"Hamilton County, IN",Feb-20,184920,180514,4406,2.4
36134,CN1805900000000,18,59,"Hancock County, IN",Feb-20,40452,39318,1134,2.8
36135,CN1806100000000,18,61,"Harrison County, IN",Feb-20,20502,19812,690,3.4
36136,CN1806300000000,18,63,"Hendricks County, IN",Feb-20,90613,88293,2320,2.6
36137,CN1806500000000,18,65,"Henry County, IN",Feb-20,22074,21322,752,3.4
36138,CN1806700000000,18,67,"Howard County, IN",Feb-20,37021,35596,1425,3.8
36139,CN1806900000000,18,69,"Huntington County, IN",Feb-20,18231,17634,597,3.3
36140,CN1807100000000,18,71,"Jackson County, IN",Feb-20,22990,22418,572,2.5
36141,CN1807300000000,18,73,"Jasper County, IN",Feb-20,16326,15568,758,4.6
36142,CN1807500000000,18,75,"Jay County, IN",Feb-20,9306,9011,295,3.2
36143,CN1807700000000,18,77,"Jefferson County, IN",Feb-20,15036,14526,510,3.4
36144,CN1807900000000,18,79,"Jennings County, IN",Feb-20,13658,13175,483,3.5
36145,CN1808100000000,18,81,"Johnson County, IN",Feb-20,83466,81260,2206,2.6
36146,CN1808300000000,18,83,"Knox County, IN",Feb-20,18484,17895,589,3.2
36147,CN1808500000000,18,85,"Kosciusko County, IN",Feb-20,42028,40831,1197,2.8
36148,CN1808700000000,18,87,"LaGrange County, IN",Feb-20,19687,19204,483,2.5
36149,CN1808900000000,18,89,"Lake County, IN",Feb-20,232192,220245,11947,5.1
36150,CN1809100000000,18,91,"LaPorte County, IN",Feb-20,47772,45523,2249,4.7
36151,CN1809300000000,18,93,"Lawrence County, IN",Feb-20,21342,20550,792,3.7
36152,CN1809500000000,18,95,"Madison County, IN",Feb-20,59703,57278,2425,4.1
36153,CN1809700000000,18,97,"Marion County, IN",Feb-20,494260,478724,15536,3.1
36154,CN1809900000000,18,99,"Marshall County, IN",Feb-20,22783,22031,752,3.3
36155,CN1810100000000,18,101,"Martin County, IN",Feb-20,5363,5231,132,2.5
36156,CN1810300000000,18,103,"Miami County, IN",Feb-20,15122,14490,632,4.2
36157,CN1810500000000,18,105,"Monroe County, IN",Feb-20,72352,70036,2316,3.2
36158,CN1810700000000,18,107,"Montgomery County, IN",Feb-20,18657,18100,557,3.0
36159,CN1810900000000,18,109,"Morgan County, IN",Feb-20,36593,35387,1206,3.3
36160,CN1811100000000,18,111,"Newton County, IN",Feb-20,6950,6604,346,5.0
36161,CN1811300000000,18,113,"Noble County, IN",Feb-20,23270,22564,706,3.0
36162,CN1811500000000,18,115,"Ohio County, IN",Feb-20,3188,3081,107,3.4
36163,CN1811700000000,18,117,"Orange County, IN",Feb-20,8839,8506,333,3.8
36164,CN1811900000000,18,119,"Owen County, IN",Feb-20,9615,9227,388,4.0
36165,CN1812100000000,18,121,"Parke County, IN",Feb-20,6818,6556,262,3.8
36166,CN1812300000000,18,123,"Perry County, IN",Feb-20,9231,8913,318,3.4
36167,CN1812500000000,18,125,"Pike County, IN",Feb-20,6186,5953,233,3.8
36168,CN1812700000000,18,127,"Porter County, IN",Feb-20,87518,83920,3598,4.1
36169,CN1812900000000,18,129,"Posey County, IN",Feb-20,13592,13213,379,2.8
36170,CN1813100000000,18,131,"Pulaski County, IN",Feb-20,6396,6152,244,3.8
36171,CN1813300000000,18,133,"Putnam County, IN",Feb-20,16807,16233,574,3.4
36172,CN1813500000000,18,135,"Randolph County, IN",Feb-20,10987,10523,464,4.2
36173,CN1813700000000,18,137,"Ripley County, IN",Feb-20,14207,13680,527,3.7
36174,CN1813900000000,18,139,"Rush County, IN",Feb-20,8751,8510,241,2.8
36175,CN1814100000000,18,141,"St. Joseph County, IN",Feb-20,137099,132156,4943,3.6
36176,CN1814300000000,18,143,"Scott County, IN",Feb-20,10624,10280,344,3.2
36177,CN1814500000000,18,145,"Shelby County, IN",Feb-20,23264,22579,685,2.9
36178,CN1814700000000,18,147,"Spencer County, IN",Feb-20,10255,9839,416,4.1
36179,CN1814900000000,18,149,"Starke County, IN",Feb-20,9655,9186,469,4.9
36180,CN1815100000000,18,151,"Steuben County, IN",Feb-20,20945,20418,527,2.5
36181,CN1815300000000,18,153,"Sullivan County, IN",Feb-20,8410,8007,403,4.8
36182,CN1815500000000,18,155,"Switzerland County, IN",Feb-20,4919,4742,177,3.6
36183,CN1815700000000,18,157,"Tippecanoe County, IN",Feb-20,104764,101833,2931,2.8
36184,CN1815900000000,18,159,"Tipton County, IN",Feb-20,9079,8822,257,2.8
36185,CN1816100000000,18,161,"Union County, IN",Feb-20,3530,3414,116,3.3
36186,CN1816300000000,18,163,"Vanderburgh County, IN",Feb-20,95187,92264,2923,3.1
36187,CN1816500000000,18,165,"Vermillion County, IN",Feb-20,6994,6610,384,5.5
36188,CN1816700000000,18,167,"Vigo County, IN",Feb-20,48495,46441,2054,4.2
36189,CN1816900000000,18,169,"Wabash County, IN",Feb-20,15103,14613,490,3.2
36190,CN1817100000000,18,171,"Warren County, IN",Feb-20,4197,4072,125,3.0
36191,CN1817300000000,18,173,"Warrick County, IN",Feb-20,33238,32265,973,2.9
36192,CN1817500000000,18,175,"Washington County, IN",Feb-20,13678,13173,505,3.7
36193,CN1817700000000,18,177,"Wayne County, IN",Feb-20,30943,29844,1099,3.6
36194,CN1817900000000,18,179,"Wells County, IN",Feb-20,14440,14012,428,3.0
36195,CN1818100000000,18,181,"White County, IN",Feb-20,13434,13059,375,2.8
36196,CN1818300000000,18,183,"Whitley County, IN",Feb-20,17852,17331,521,2.9
36197,CN1900100000000,19,1,"Adair County, IA",Feb-20,4293,4164,129,3.0
36198,CN1900300000000,19,3,"Adams County, IA",Feb-20,2183,2143,40,1.8
36199,CN1900500000000,19,5,"Allamakee County, IA",Feb-20,7604,7216,388,5.1
36200,CN1900700000000,19,7,"Appanoose County, IA",Feb-20,6012,5797,215,3.6
36201,CN1900900000000,19,9,"Audubon County, IA",Feb-20,3132,3050,82,2.6
36202,CN1901100000000,19,11,"Benton County, IA",Feb-20,13697,13236,461,3.4
36203,CN1901300000000,19,13,"Black Hawk County, IA",Feb-20,69446,67010,2436,3.5
36204,CN1901500000000,19,15,"Boone County, IA",Feb-20,15114,14701,413,2.7
36205,CN1901700000000,19,17,"Bremer County, IA",Feb-20,14030,13658,372,2.7
36206,CN1901900000000,19,19,"Buchanan County, IA",Feb-20,11400,10997,403,3.5
36207,CN1902100000000,19,21,"Buena Vista County, IA",Feb-20,12186,11923,263,2.2
36208,CN1902300000000,19,23,"Butler County, IA",Feb-20,8086,7743,343,4.2
36209,CN1902500000000,19,25,"Calhoun County, IA",Feb-20,4294,4178,116,2.7
36210,CN1902700000000,19,27,"Carroll County, IA",Feb-20,11043,10823,220,2.0
36211,CN1902900000000,19,29,"Cass County, IA",Feb-20,6953,6721,232,3.3
36212,CN1903100000000,19,31,"Cedar County, IA",Feb-20,11000,10653,347,3.2
36213,CN1903300000000,19,33,"Cerro Gordo County, IA",Feb-20,23732,23036,696,2.9
36214,CN1903500000000,19,35,"Cherokee County, IA",Feb-20,6326,6124,202,3.2
36215,CN1903700000000,19,37,"Chickasaw County, IA",Feb-20,6682,6422,260,3.9
36216,CN1903900000000,19,39,"Clarke County, IA",Feb-20,4991,4805,186,3.7
36217,CN1904100000000,19,41,"Clay County, IA",Feb-20,8583,8304,279,3.3
36218,CN1904300000000,19,43,"Clayton County, IA",Feb-20,10213,9571,642,6.3
36219,CN1904500000000,19,45,"Clinton County, IA",Feb-20,22882,21935,947,4.1
36220,CN1904700000000,19,47,"Crawford County, IA",Feb-20,8358,7956,402,4.8
36221,CN1904900000000,19,49,"Dallas County, IA",Feb-20,50032,49047,985,2.0
36222,CN1905100000000,19,51,"Davis County, IA",Feb-20,4318,4198,120,2.8
36223,CN1905300000000,19,53,"Decatur County, IA",Feb-20,4552,4452,100,2.2
36224,CN1905500000000,19,55,"Delaware County, IA",Feb-20,10823,10493,330,3.0
36225,CN1905700000000,19,57,"Des Moines County, IA",Feb-20,19130,18169,961,5.0
36226,CN1905900000000,19,59,"Dickinson County, IA",Feb-20,9752,9351,401,4.1
36227,CN1906100000000,19,61,"Dubuque County, IA",Feb-20,57069,55128,1941,3.4
36228,CN1906300000000,19,63,"Emmet County, IA",Feb-20,5310,5151,159,3.0
36229,CN1906500000000,19,65,"Fayette County, IA",Feb-20,11047,10547,500,4.5
36230,CN1906700000000,19,67,"Floyd County, IA",Feb-20,8786,8389,397,4.5
36231,CN1906900000000,19,69,"Franklin County, IA",Feb-20,5772,5591,181,3.1
36232,CN1907100000000,19,71,"Fremont County, IA",Feb-20,3726,3645,81,2.2
36233,CN1907300000000,19,73,"Greene County, IA",Feb-20,5542,5416,126,2.3
36234,CN1907500000000,19,75,"Grundy County, IA",Feb-20,6655,6444,211,3.2
36235,CN1907700000000,19,77,"Guthrie County, IA",Feb-20,5802,5574,228,3.9
36236,CN1907900000000,19,79,"Hamilton County, IA",Feb-20,6998,6778,220,3.1
36237,CN1908100000000,19,81,"Hancock County, IA",Feb-20,6022,5861,161,2.7
36238,CN1908300000000,19,83,"Hardin County, IA",Feb-20,8145,7848,297,3.6
36239,CN1908500000000,19,85,"Harrison County, IA",Feb-20,7589,7381,208,2.7
36240,CN1908700000000,19,87,"Henry County, IA",Feb-20,9930,9603,327,3.3
36241,CN1908900000000,19,89,"Howard County, IA",Feb-20,5339,5134,205,3.8
36242,CN1909100000000,19,91,"Humboldt County, IA",Feb-20,5161,4993,168,3.3
36243,CN1909300000000,19,93,"Ida County, IA",Feb-20,4283,4157,126,2.9
36244,CN1909500000000,19,95,"Iowa County, IA",Feb-20,10699,10389,310,2.9
36245,CN1909700000000,19,97,"Jackson County, IA",Feb-20,11167,10668,499,4.5
36246,CN1909900000000,19,99,"Jasper County, IA",Feb-20,20053,19373,680,3.4
36247,CN1910100000000,19,101,"Jefferson County, IA",Feb-20,10446,10196,250,2.4
36248,CN1910300000000,19,103,"Johnson County, IA",Feb-20,86546,84882,1664,1.9
36249,CN1910500000000,19,105,"Jones County, IA",Feb-20,11005,10495,510,4.6
36250,CN1910700000000,19,107,"Keokuk County, IA",Feb-20,5368,5134,234,4.4
36251,CN1910900000000,19,109,"Kossuth County, IA",Feb-20,8558,8332,226,2.6
36252,CN1911100000000,19,111,"Lee County, IA",Feb-20,16262,15582,680,4.2
36253,CN1911300000000,19,113,"Linn County, IA",Feb-20,122902,118899,4003,3.3
36254,CN1911500000000,19,115,"Louisa County, IA",Feb-20,6205,5942,263,4.2
36255,CN1911700000000,19,117,"Lucas County, IA",Feb-20,4708,4605,103,2.2
36256,CN1911900000000,19,119,"Lyon County, IA",Feb-20,7180,7017,163,2.3
36257,CN1912100000000,19,121,"Madison County, IA",Feb-20,8777,8381,396,4.5
36258,CN1912300000000,19,123,"Mahaska County, IA",Feb-20,12037,11696,341,2.8
36259,CN1912500000000,19,125,"Marion County, IA",Feb-20,18583,18134,449,2.4
36260,CN1912700000000,19,127,"Marshall County, IA",Feb-20,18299,17048,1251,6.8
36261,CN1912900000000,19,129,"Mills County, IA",Feb-20,7568,7392,176,2.3
36262,CN1913100000000,19,131,"Mitchell County, IA",Feb-20,7197,7056,141,2.0
36263,CN1913300000000,19,133,"Monona County, IA",Feb-20,4530,4374,156,3.4
36264,CN1913500000000,19,135,"Monroe County, IA",Feb-20,4143,4009,134,3.2
36265,CN1913700000000,19,137,"Montgomery County, IA",Feb-20,5105,4960,145,2.8
36266,CN1913900000000,19,139,"Muscatine County, IA",Feb-20,22144,21446,698,3.2
36267,CN1914100000000,19,141,"O'Brien County, IA",Feb-20,8440,8236,204,2.4
36268,CN1914300000000,19,143,"Osceola County, IA",Feb-20,3591,3506,85,2.4
36269,CN1914500000000,19,145,"Page County, IA",Feb-20,6468,6298,170,2.6
36270,CN1914700000000,19,147,"Palo Alto County, IA",Feb-20,4838,4702,136,2.8
36271,CN1914900000000,19,149,"Plymouth County, IA",Feb-20,15110,14767,343,2.3
36272,CN1915100000000,19,151,"Pocahontas County, IA",Feb-20,4591,4492,99,2.2
36273,CN1915300000000,19,153,"Polk County, IA",Feb-20,271912,263581,8331,3.1
36274,CN1915500000000,19,155,"Pottawattamie County, IA",Feb-20,49581,48260,1321,2.7
36275,CN1915700000000,19,157,"Poweshiek County, IA",Feb-20,10801,10437,364,3.4
36276,CN1915900000000,19,159,"Ringgold County, IA",Feb-20,2514,2444,70,2.8
36277,CN1916100000000,19,161,"Sac County, IA",Feb-20,5352,5188,164,3.1
36278,CN1916300000000,19,163,"Scott County, IA",Feb-20,88952,85691,3261,3.7
36279,CN1916500000000,19,165,"Shelby County, IA",Feb-20,6795,6624,171,2.5
36280,CN1916700000000,19,167,"Sioux County, IA",Feb-20,21850,21309,541,2.5
36281,CN1916900000000,19,169,"Story County, IA",Feb-20,59598,58602,996,1.7
36282,CN1917100000000,19,171,"Tama County, IA",Feb-20,9607,9189,418,4.4
36283,CN1917300000000,19,173,"Taylor County, IA",Feb-20,3265,3206,59,1.8
36284,CN1917500000000,19,175,"Union County, IA",Feb-20,6457,6208,249,3.9
36285,CN1917700000000,19,177,"Van Buren County, IA",Feb-20,3702,3570,132,3.6
36286,CN1917900000000,19,179,"Wapello County, IA",Feb-20,17947,17290,657,3.7
36287,CN1918100000000,19,181,"Warren County, IA",Feb-20,28708,27843,865,3.0
36288,CN1918300000000,19,183,"Washington County, IA",Feb-20,12292,11886,406,3.3
36289,CN1918500000000,19,185,"Wayne County, IA",Feb-20,2890,2816,74,2.6
36290,CN1918700000000,19,187,"Webster County, IA",Feb-20,19663,18995,668,3.4
36291,CN1918900000000,19,189,"Winnebago County, IA",Feb-20,5266,5114,152,2.9
36292,CN1919100000000,19,191,"Winneshiek County, IA",Feb-20,12616,12106,510,4.0
36293,CN1919300000000,19,193,"Woodbury County, IA",Feb-20,56524,54725,1799,3.2
36294,CN1919500000000,19,195,"Worth County, IA",Feb-20,4339,4186,153,3.5
36295,CN1919700000000,19,197,"Wright County, IA",Feb-20,7167,6959,208,2.9
36296,CN2000100000000,20,1,"Allen County, KS",Feb-20,6421,6193,228,3.6
36297,CN2000300000000,20,3,"Anderson County, KS",Feb-20,4202,4059,143,3.4
36298,CN2000500000000,20,5,"Atchison County, KS",Feb-20,7029,6641,388,5.5
36299,CN2000700000000,20,7,"Barber County, KS",Feb-20,2297,2236,61,2.7
36300,CN2000900000000,20,9,"Barton County, KS",Feb-20,13293,12794,499,3.8
36301,CN2001100000000,20,11,"Bourbon County, KS",Feb-20,6594,6277,317,4.8
36302,CN2001300000000,20,13,"Brown County, KS",Feb-20,5363,5203,160,3.0
36303,CN2001500000000,20,15,"Butler County, KS",Feb-20,33025,31904,1121,3.4
36304,CN2001700000000,20,17,"Chase County, KS",Feb-20,1552,1509,43,2.8
36305,CN2001900000000,20,19,"Chautauqua County, KS",Feb-20,1424,1376,48,3.4
36306,CN2002100000000,20,21,"Cherokee County, KS",Feb-20,10162,9840,322,3.2
36307,CN2002300000000,20,23,"Cheyenne County, KS",Feb-20,1317,1285,32,2.4
36308,CN2002500000000,20,25,"Clark County, KS",Feb-20,1080,1055,25,2.3
36309,CN2002700000000,20,27,"Clay County, KS",Feb-20,3769,3653,116,3.1
36310,CN2002900000000,20,29,"Cloud County, KS",Feb-20,3749,3642,107,2.9
36311,CN2003100000000,20,31,"Coffey County, KS",Feb-20,4182,3991,191,4.6
36312,CN2003300000000,20,33,"Comanche County, KS",Feb-20,839,816,23,2.7
36313,CN2003500000000,20,35,"Cowley County, KS",Feb-20,16329,15752,577,3.5
36314,CN2003700000000,20,37,"Crawford County, KS",Feb-20,18625,17875,750,4.0
36315,CN2003900000000,20,39,"Decatur County, KS",Feb-20,1178,1141,37,3.1
36316,CN2004100000000,20,41,"Dickinson County, KS",Feb-20,8764,8409,355,4.1
36317,CN2004300000000,20,43,"Doniphan County, KS",Feb-20,4129,3970,159,3.9
36318,CN2004500000000,20,45,"Douglas County, KS",Feb-20,67075,65076,1999,3.0
36319,CN2004700000000,20,47,"Edwards County, KS",Feb-20,1382,1352,30,2.2
36320,CN2004900000000,20,49,"Elk County, KS",Feb-20,1149,1113,36,3.1
36321,CN2005100000000,20,51,"Ellis County, KS",Feb-20,17044,16682,362,2.1
36322,CN2005300000000,20,53,"Ellsworth County, KS",Feb-20,2690,2621,69,2.6
36323,CN2005500000000,20,55,"Finney County, KS",Feb-20,20876,20441,435,2.1
36324,CN2005700000000,20,57,"Ford County, KS",Feb-20,16968,16556,412,2.4
36325,CN2005900000000,20,59,"Franklin County, KS",Feb-20,14299,13784,515,3.6
36326,CN2006100000000,20,61,"Geary County, KS",Feb-20,11403,10888,515,4.5
36327,CN2006300000000,20,63,"Gove County, KS",Feb-20,1474,1447,27,1.8
36328,CN2006500000000,20,65,"Graham County, KS",Feb-20,1085,1056,29,2.7
36329,CN2006700000000,20,67,"Grant County, KS",Feb-20,3138,3058,80,2.5
36330,CN2006900000000,20,69,"Gray County, KS",Feb-20,3173,3102,71,2.2
36331,CN2007100000000,20,71,"Greeley County, KS",Feb-20,778,764,14,1.8
36332,CN2007300000000,20,73,"Greenwood County, KS",Feb-20,3312,3187,125,3.8
36333,CN2007500000000,20,75,"Hamilton County, KS",Feb-20,1621,1592,29,1.8
36334,CN2007700000000,20,77,"Harper County, KS",Feb-20,2988,2913,75,2.5
36335,CN2007900000000,20,79,"Harvey County, KS",Feb-20,17272,16732,540,3.1
36336,CN2008100000000,20,81,"Haskell County, KS",Feb-20,2170,2124,46,2.1
36337,CN2008300000000,20,83,"Hodgeman County, KS",Feb-20,978,949,29,3.0
36338,CN2008500000000,20,85,"Jackson County, KS",Feb-20,7208,6969,239,3.3
36339,CN2008700000000,20,87,"Jefferson County, KS",Feb-20,10168,9801,367,3.6
36340,CN2008900000000,20,89,"Jewell County, KS",Feb-20,1244,1212,32,2.6
36341,CN2009100000000,20,91,"Johnson County, KS",Feb-20,342010,332840,9170,2.7
36342,CN2009300000000,20,93,"Kearny County, KS",Feb-20,2021,1985,36,1.8
36343,CN2009500000000,20,95,"Kingman County, KS",Feb-20,3462,3353,109,3.1
36344,CN2009700000000,20,97,"Kiowa County, KS",Feb-20,1267,1238,29,2.3
36345,CN2009900000000,20,99,"Labette County, KS",Feb-20,9943,9530,413,4.2
36346,CN2010100000000,20,101,"Lane County, KS",Feb-20,746,725,21,2.8
36347,CN2010300000000,20,103,"Leavenworth County, KS",Feb-20,36966,35575,1391,3.8
36348,CN2010500000000,20,105,"Lincoln County, KS",Feb-20,1698,1659,39,2.3
36349,CN2010700000000,20,107,"Linn County, KS",Feb-20,4525,4208,317,7.0
36350,CN2010900000000,20,109,"Logan County, KS",Feb-20,1616,1580,36,2.2
36351,CN2011100000000,20,111,"Lyon County, KS",Feb-20,16829,16243,586,3.5
36352,CN2011300000000,20,113,"McPherson County, KS",Feb-20,17212,16804,408,2.4
36353,CN2011500000000,20,115,"Marion County, KS",Feb-20,5920,5765,155,2.6
36354,CN2011700000000,20,117,"Marshall County, KS",Feb-20,5448,5291,157,2.9
36355,CN2011900000000,20,119,"Meade County, KS",Feb-20,2067,2021,46,2.2
36356,CN2012100000000,20,121,"Miami County, KS",Feb-20,17737,17065,672,3.8
36357,CN2012300000000,20,123,"Mitchell County, KS",Feb-20,3259,3184,75,2.3
36358,CN2012500000000,20,125,"Montgomery County, KS",Feb-20,14510,13842,668,4.6
36359,CN2012700000000,20,127,"Morris County, KS",Feb-20,3034,2936,98,3.2
36360,CN2012900000000,20,129,"Morton County, KS",Feb-20,1109,1080,29,2.6
36361,CN2013100000000,20,131,"Nemaha County, KS",Feb-20,5246,5109,137,2.6
36362,CN2013300000000,20,133,"Neosho County, KS",Feb-20,6200,5927,273,4.4
36363,CN2013500000000,20,135,"Ness County, KS",Feb-20,1312,1278,34,2.6
36364,CN2013700000000,20,137,"Norton County, KS",Feb-20,2655,2600,55,2.1
36365,CN2013900000000,20,139,"Osage County, KS",Feb-20,8015,7700,315,3.9
36366,CN2014100000000,20,141,"Osborne County, KS",Feb-20,2078,2021,57,2.7
36367,CN2014300000000,20,143,"Ottawa County, KS",Feb-20,2978,2898,80,2.7
36368,CN2014500000000,20,145,"Pawnee County, KS",Feb-20,2835,2742,93,3.3
36369,CN2014700000000,20,147,"Phillips County, KS",Feb-20,2611,2549,62,2.4
36370,CN2014900000000,20,149,"Pottawatomie County, KS",Feb-20,12704,12321,383,3.0
36371,CN2015100000000,20,151,"Pratt County, KS",Feb-20,4881,4765,116,2.4
36372,CN2015300000000,20,153,"Rawlins County, KS",Feb-20,1463,1434,29,2.0
36373,CN2015500000000,20,155,"Reno County, KS",Feb-20,29655,28686,969,3.3
36374,CN2015700000000,20,157,"Republic County, KS",Feb-20,2183,2128,55,2.5
36375,CN2015900000000,20,159,"Rice County, KS",Feb-20,5195,5065,130,2.5
36376,CN2016100000000,20,161,"Riley County, KS",Feb-20,35799,34851,948,2.6
36377,CN2016300000000,20,163,"Rooks County, KS",Feb-20,2461,2384,77,3.1
36378,CN2016500000000,20,165,"Rush County, KS",Feb-20,1614,1571,43,2.7
36379,CN2016700000000,20,167,"Russell County, KS",Feb-20,3221,3123,98,3.0
36380,CN2016900000000,20,169,"Saline County, KS",Feb-20,30271,29257,1014,3.3
36381,CN2017100000000,20,171,"Scott County, KS",Feb-20,2809,2756,53,1.9
36382,CN2017300000000,20,173,"Sedgwick County, KS",Feb-20,256380,246239,10141,4.0
36383,CN2017500000000,20,175,"Seward County, KS",Feb-20,9259,8976,283,3.1
36384,CN2017700000000,20,177,"Shawnee County, KS",Feb-20,90878,87620,3258,3.6
36385,CN2017900000000,20,179,"Sheridan County, KS",Feb-20,1390,1358,32,2.3
36386,CN2018100000000,20,181,"Sherman County, KS",Feb-20,2760,2680,80,2.9
36387,CN2018300000000,20,183,"Smith County, KS",Feb-20,1961,1906,55,2.8
36388,CN2018500000000,20,185,"Stafford County, KS",Feb-20,2035,1974,61,3.0
36389,CN2018700000000,20,187,"Stanton County, KS",Feb-20,967,940,27,2.8
36390,CN2018900000000,20,189,"Stevens County, KS",Feb-20,2478,2401,77,3.1
36391,CN2019100000000,20,191,"Sumner County, KS",Feb-20,11068,10671,397,3.6
36392,CN2019300000000,20,193,"Thomas County, KS",Feb-20,4267,4180,87,2.0
36393,CN2019500000000,20,195,"Trego County, KS",Feb-20,1419,1374,45,3.2
36394,CN2019700000000,20,197,"Wabaunsee County, KS",Feb-20,3665,3522,143,3.9
36395,CN2019900000000,20,199,"Wallace County, KS",Feb-20,782,762,20,2.6
36396,CN2020100000000,20,201,"Washington County, KS",Feb-20,2893,2813,80,2.8
36397,CN2020300000000,20,203,"Wichita County, KS",Feb-20,1183,1162,21,1.8
36398,CN2020500000000,20,205,"Wilson County, KS",Feb-20,3991,3811,180,4.5
36399,CN2020700000000,20,207,"Woodson County, KS",Feb-20,1575,1516,59,3.7
36400,CN2020900000000,20,209,"Wyandotte County, KS",Feb-20,78140,74664,3476,4.4
36401,CN2100100000000,21,1,"Adair County, KY",Feb-20,7203,6786,417,5.8
36402,CN2100300000000,21,3,"Allen County, KY",Feb-20,8998,8645,353,3.9
36403,CN2100500000000,21,5,"Anderson County, KY",Feb-20,12280,11798,482,3.9
36404,CN2100700000000,21,7,"Ballard County, KY",Feb-20,3509,3305,204,5.8
36405,CN2100900000000,21,9,"Barren County, KY",Feb-20,18826,17935,891,4.7
36406,CN2101100000000,21,11,"Bath County, KY",Feb-20,4651,4272,379,8.1
36407,CN2101300000000,21,13,"Bell County, KY",Feb-20,8526,7919,607,7.1
36408,CN2101500000000,21,15,"Boone County, KY",Feb-20,71109,68686,2423,3.4
36409,CN2101700000000,21,17,"Bourbon County, KY",Feb-20,9508,9123,385,4.0
36410,CN2101900000000,21,19,"Boyd County, KY",Feb-20,18023,16922,1101,6.1
36411,CN2102100000000,21,21,"Boyle County, KY",Feb-20,12428,11877,551,4.4
36412,CN2102300000000,21,23,"Bracken County, KY",Feb-20,3873,3640,233,6.0
36413,CN2102500000000,21,25,"Breathitt County, KY",Feb-20,3492,3128,364,10.4
36414,CN2102700000000,21,27,"Breckinridge County, KY",Feb-20,7931,7440,491,6.2
36415,CN2102900000000,21,29,"Bullitt County, KY",Feb-20,43178,41471,1707,4.0
36416,CN2103100000000,21,31,"Butler County, KY",Feb-20,5230,4951,279,5.3
36417,CN2103300000000,21,33,"Caldwell County, KY",Feb-20,5504,5217,287,5.2
36418,CN2103500000000,21,35,"Calloway County, KY",Feb-20,19133,18133,1000,5.2
36419,CN2103700000000,21,37,"Campbell County, KY",Feb-20,50967,49199,1768,3.5
36420,CN2103900000000,21,39,"Carlisle County, KY",Feb-20,2298,2200,98,4.3
36421,CN2104100000000,21,41,"Carroll County, KY",Feb-20,5221,4998,223,4.3
36422,CN2104300000000,21,43,"Carter County, KY",Feb-20,9928,9053,875,8.8
36423,CN2104500000000,21,45,"Casey County, KY",Feb-20,6686,6403,283,4.2
36424,CN2104700000000,21,47,"Christian County, KY",Feb-20,25598,24206,1392,5.4
36425,CN2104900000000,21,49,"Clark County, KY",Feb-20,17167,16436,731,4.3
36426,CN2105100000000,21,51,"Clay County, KY",Feb-20,5187,4824,363,7.0
36427,CN2105300000000,21,53,"Clinton County, KY",Feb-20,4016,3783,233,5.8
36428,CN2105500000000,21,55,"Crittenden County, KY",Feb-20,3840,3657,183,4.8
36429,CN2105700000000,21,57,"Cumberland County, KY",Feb-20,3198,3023,175,5.5
36430,CN2105900000000,21,59,"Daviess County, KY",Feb-20,47758,45857,1901,4.0
36431,CN2106100000000,21,61,"Edmonson County, KY",Feb-20,4886,4632,254,5.2
36432,CN2106300000000,21,63,"Elliott County, KY",Feb-20,2113,1883,230,10.9
36433,CN2106500000000,21,65,"Estill County, KY",Feb-20,5474,5161,313,5.7
36434,CN2106700000000,21,67,"Fayette County, KY",Feb-20,173810,168375,5435,3.1
36435,CN2106900000000,21,69,"Fleming County, KY",Feb-20,6129,5736,393,6.4
36436,CN2107100000000,21,71,"Floyd County, KY",Feb-20,11064,10232,832,7.5
36437,CN2107300000000,21,73,"Franklin County, KY",Feb-20,25661,24735,926,3.6
36438,CN2107500000000,21,75,"Fulton County, KY",Feb-20,2023,1928,95,4.7
36439,CN2107700000000,21,77,"Gallatin County, KY",Feb-20,4072,3910,162,4.0
36440,CN2107900000000,21,79,"Garrard County, KY",Feb-20,7650,7290,360,4.7
36441,CN2108100000000,21,81,"Grant County, KY",Feb-20,11799,11260,539,4.6
36442,CN2108300000000,21,83,"Graves County, KY",Feb-20,15733,14994,739,4.7
36443,CN2108500000000,21,85,"Grayson County, KY",Feb-20,11131,10530,601,5.4
36444,CN2108700000000,21,87,"Green County, KY",Feb-20,5073,4859,214,4.2
36445,CN2108900000000,21,89,"Greenup County, KY",Feb-20,13628,12571,1057,7.8
36446,CN2109100000000,21,91,"Hancock County, KY",Feb-20,3980,3847,133,3.3
36447,CN2109300000000,21,93,"Hardin County, KY",Feb-20,49322,47268,2054,4.2
36448,CN2109500000000,21,95,"Harlan County, KY",Feb-20,6762,5961,801,11.8
36449,CN2109700000000,21,97,"Harrison County, KY",Feb-20,8831,8463,368,4.2
36450,CN2109900000000,21,99,"Hart County, KY",Feb-20,8036,7525,511,6.4
36451,CN2110100000000,21,101,"Henderson County, KY",Feb-20,22098,21255,843,3.8
36452,CN2110300000000,21,103,"Henry County, KY",Feb-20,8247,7950,297,3.6
36453,CN2110500000000,21,105,"Hickman County, KY",Feb-20,1709,1622,87,5.1
36454,CN2110700000000,21,107,"Hopkins County, KY",Feb-20,18412,17539,873,4.7
36455,CN2110900000000,21,109,"Jackson County, KY",Feb-20,4096,3821,275,6.7
36456,CN2111100000000,21,111,"Jefferson County, KY",Feb-20,403530,388684,14846,3.7
36457,CN2111300000000,21,113,"Jessamine County, KY",Feb-20,26446,25532,914,3.5
36458,CN2111500000000,21,115,"Johnson County, KY",Feb-20,6734,6246,488,7.2
36459,CN2111700000000,21,117,"Kenton County, KY",Feb-20,88041,84904,3137,3.6
36460,CN2111900000000,21,119,"Knott County, KY",Feb-20,4464,4132,332,7.4
36461,CN2112100000000,21,121,"Knox County, KY",Feb-20,9879,9338,541,5.5
36462,CN2112300000000,21,123,"Larue County, KY",Feb-20,6040,5754,286,4.7
36463,CN2112500000000,21,125,"Laurel County, KY",Feb-20,24641,23461,1180,4.8
36464,CN2112700000000,21,127,"Lawrence County, KY",Feb-20,5275,4846,429,8.1
36465,CN2112900000000,21,129,"Lee County, KY",Feb-20,2120,1987,133,6.3
36466,CN2113100000000,21,131,"Leslie County, KY",Feb-20,2760,2455,305,11.1
36467,CN2113300000000,21,133,"Letcher County, KY",Feb-20,6486,5900,586,9.0
36468,CN2113500000000,21,135,"Lewis County, KY",Feb-20,4726,4219,507,10.7
36469,CN2113700000000,21,137,"Lincoln County, KY",Feb-20,9234,8768,466,5.0
36470,CN2113900000000,21,139,"Livingston County, KY",Feb-20,3672,3438,234,6.4
36471,CN2114100000000,21,141,"Logan County, KY",Feb-20,12636,12122,514,4.1
36472,CN2114300000000,21,143,"Lyon County, KY",Feb-20,3031,2890,141,4.7
36473,CN2114500000000,21,145,"McCracken County, KY",Feb-20,29289,27799,1490,5.1
36474,CN2114700000000,21,147,"McCreary County, KY",Feb-20,4665,4358,307,6.6
36475,CN2114900000000,21,149,"McLean County, KY",Feb-20,4201,4018,183,4.4
36476,CN2115100000000,21,151,"Madison County, KY",Feb-20,47570,45804,1766,3.7
36477,CN2115300000000,21,153,"Magoffin County, KY",Feb-20,3443,2887,556,16.1
36478,CN2115500000000,21,155,"Marion County, KY",Feb-20,9670,9342,328,3.4
36479,CN2115700000000,21,157,"Marshall County, KY",Feb-20,15180,14392,788,5.2
36480,CN2115900000000,21,159,"Martin County, KY",Feb-20,2833,2566,267,9.4
36481,CN2116100000000,21,161,"Mason County, KY",Feb-20,7008,6587,421,6.0
36482,CN2116300000000,21,163,"Meade County, KY",Feb-20,12344,11739,605,4.9
36483,CN2116500000000,21,165,"Menifee County, KY",Feb-20,2355,2137,218,9.3
36484,CN2116700000000,21,167,"Mercer County, KY",Feb-20,9991,9508,483,4.8
36485,CN2116900000000,21,169,"Metcalfe County, KY",Feb-20,4086,3876,210,5.1
36486,CN2117100000000,21,171,"Monroe County, KY",Feb-20,4712,4487,225,4.8
36487,CN2117300000000,21,173,"Montgomery County, KY",Feb-20,11640,10966,674,5.8
36488,CN2117500000000,21,175,"Morgan County, KY",Feb-20,4638,4328,310,6.7
36489,CN2117700000000,21,177,"Muhlenberg County, KY",Feb-20,10491,9740,751,7.2
36490,CN2117900000000,21,179,"Nelson County, KY",Feb-20,23322,22310,1012,4.3
36491,CN2118100000000,21,181,"Nicholas County, KY",Feb-20,3320,3150,170,5.1
36492,CN2118300000000,21,183,"Ohio County, KY",Feb-20,9901,9302,599,6.0
36493,CN2118500000000,21,185,"Oldham County, KY",Feb-20,33524,32545,979,2.9
36494,CN2118700000000,21,187,"Owen County, KY",Feb-20,5071,4851,220,4.3
36495,CN2118900000000,21,189,"Owsley County, KY",Feb-20,1145,1062,83,7.2
36496,CN2119100000000,21,191,"Pendleton County, KY",Feb-20,7057,6741,316,4.5
36497,CN2119300000000,21,193,"Perry County, KY",Feb-20,8379,7721,658,7.9
36498,CN2119500000000,21,195,"Pike County, KY",Feb-20,19940,18541,1399,7.0
36499,CN2119700000000,21,197,"Powell County, KY",Feb-20,5025,4688,337,6.7
36500,CN2119900000000,21,199,"Pulaski County, KY",Feb-20,26787,25493,1294,4.8
36501,CN2120100000000,21,201,"Robertson County, KY",Feb-20,822,775,47,5.7
36502,CN2120300000000,21,203,"Rockcastle County, KY",Feb-20,6749,6402,347,5.1
36503,CN2120500000000,21,205,"Rowan County, KY",Feb-20,10623,10019,604,5.7
36504,CN2120700000000,21,207,"Russell County, KY",Feb-20,6221,5861,360,5.8
36505,CN2120900000000,21,209,"Scott County, KY",Feb-20,28922,27952,970,3.4
36506,CN2121100000000,21,211,"Shelby County, KY",Feb-20,25553,24771,782,3.1
36507,CN2121300000000,21,213,"Simpson County, KY",Feb-20,8855,8466,389,4.4
36508,CN2121500000000,21,215,"Spencer County, KY",Feb-20,10303,9956,347,3.4
36509,CN2121700000000,21,217,"Taylor County, KY",Feb-20,12655,12138,517,4.1
36510,CN2121900000000,21,219,"Todd County, KY",Feb-20,5497,5267,230,4.2
36511,CN2122100000000,21,221,"Trigg County, KY",Feb-20,6141,5813,328,5.3
36512,CN2122300000000,21,223,"Trimble County, KY",Feb-20,3894,3729,165,4.2
36513,CN2122500000000,21,225,"Union County, KY",Feb-20,6118,5839,279,4.6
36514,CN2122700000000,21,227,"Warren County, KY",Feb-20,65748,63301,2447,3.7
36515,CN2122900000000,21,229,"Washington County, KY",Feb-20,6250,6020,230,3.7
36516,CN2123100000000,21,231,"Wayne County, KY",Feb-20,7371,6954,417,5.7
36517,CN2123300000000,21,233,"Webster County, KY",Feb-20,5538,5276,262,4.7
36518,CN2123500000000,21,235,"Whitley County, KY",Feb-20,13665,12986,679,5.0
36519,CN2123700000000,21,237,"Wolfe County, KY",Feb-20,2024,1857,167,8.3
36520,CN2123900000000,21,239,"Woodford County, KY",Feb-20,14554,14079,475,3.3
36521,CN2200100000000,22,1,"Acadia Parish, LA",Feb-20,23574,22483,1091,4.6
36522,CN2200300000000,22,3,"Allen Parish, LA",Feb-20,8924,8425,499,5.6
36523,CN2200500000000,22,5,"Ascension Parish, LA",Feb-20,64725,62402,2323,3.6
36524,CN2200700000000,22,7,"Assumption Parish, LA",Feb-20,8869,8366,503,5.7
36525,CN2200900000000,22,9,"Avoyelles Parish, LA",Feb-20,14913,14132,781,5.2
36526,CN2201100000000,22,11,"Beauregard Parish, LA",Feb-20,14582,13874,708,4.9
36527,CN2201300000000,22,13,"Bienville Parish, LA",Feb-20,5514,5197,317,5.7
36528,CN2201500000000,22,15,"Bossier Parish, LA",Feb-20,57407,55279,2128,3.7
36529,CN2201700000000,22,17,"Caddo Parish, LA",Feb-20,103033,98110,4923,4.8
36530,CN2201900000000,22,19,"Calcasieu Parish, LA",Feb-20,103480,99332,4148,4.0
36531,CN2202100000000,22,21,"Caldwell Parish, LA",Feb-20,3761,3510,251,6.7
36532,CN2202300000000,22,23,"Cameron Parish, LA",Feb-20,3841,3697,144,3.7
36533,CN2202500000000,22,25,"Catahoula Parish, LA",Feb-20,3357,3171,186,5.5
36534,CN2202700000000,22,27,"Claiborne Parish, LA",Feb-20,5854,5508,346,5.9
36535,CN2202900000000,22,29,"Concordia Parish, LA",Feb-20,7090,6648,442,6.2
36536,CN2203100000000,22,31,"De Soto Parish, LA",Feb-20,10842,10230,612,5.6
36537,CN2203300000000,22,33,"East Baton Rouge Parish, LA",Feb-20,232932,224223,8709,3.7
36538,CN2203500000000,22,35,"East Carroll Parish, LA",Feb-20,1866,1655,211,11.3
36539,CN2203700000000,22,37,"East Feliciana Parish, LA",Feb-20,8030,7726,304,3.8
36540,CN2203900000000,22,39,"Evangeline Parish, LA",Feb-20,11639,11038,601,5.2
36541,CN2204100000000,22,41,"Franklin Parish, LA",Feb-20,7300,6803,497,6.8
36542,CN2204300000000,22,43,"Grant Parish, LA",Feb-20,8150,7706,444,5.4
36543,CN2204500000000,22,45,"Iberia Parish, LA",Feb-20,27889,26431,1458,5.2
36544,CN2204700000000,22,47,"Iberville Parish, LA",Feb-20,14225,13446,779,5.5
36545,CN2204900000000,22,49,"Jackson Parish, LA",Feb-20,6823,6515,308,4.5
36546,CN2205100000000,22,51,"Jefferson Parish, LA",Feb-20,215129,207311,7818,3.6
36547,CN2205300000000,22,53,"Jefferson Davis Parish, LA",Feb-20,13044,12489,555,4.3
36548,CN2205500000000,22,55,"Lafayette Parish, LA",Feb-20,112611,108221,4390,3.9
36549,CN2205700000000,22,57,"Lafourche Parish, LA",Feb-20,41727,40139,1588,3.8
36550,CN2205900000000,22,59,"LaSalle Parish, LA",Feb-20,6754,6503,251,3.7
36551,CN2206100000000,22,61,"Lincoln Parish, LA",Feb-20,22095,21170,925,4.2
36552,CN2206300000000,22,63,"Livingston Parish, LA",Feb-20,69409,67015,2394,3.4
36553,CN2206500000000,22,65,"Madison Parish, LA",Feb-20,3445,3196,249,7.2
36554,CN2206700000000,22,67,"Morehouse Parish, LA",Feb-20,10082,9201,881,8.7
36555,CN2206900000000,22,69,"Natchitoches Parish, LA",Feb-20,16482,15705,777,4.7
36556,CN2207100000000,22,71,"Orleans Parish, LA",Feb-20,179631,172117,7514,4.2
36557,CN2207300000000,22,73,"Ouachita Parish, LA",Feb-20,70222,66784,3438,4.9
36558,CN2207500000000,22,75,"Plaquemines Parish, LA",Feb-20,10093,9731,362,3.6
36559,CN2207700000000,22,77,"Pointe Coupee Parish, LA",Feb-20,9924,9478,446,4.5
36560,CN2207900000000,22,79,"Rapides Parish, LA",Feb-20,54814,52398,2416,4.4
36561,CN2208100000000,22,81,"Red River Parish, LA",Feb-20,3735,3542,193,5.2
36562,CN2208300000000,22,83,"Richland Parish, LA",Feb-20,8133,7605,528,6.5
36563,CN2208500000000,22,85,"Sabine Parish, LA",Feb-20,9075,8676,399,4.4
36564,CN2208700000000,22,87,"St. Bernard Parish, LA",Feb-20,19971,19082,889,4.5
36565,CN2208900000000,22,89,"St. Charles Parish, LA",Feb-20,25300,24351,949,3.8
36566,CN2209100000000,22,91,"St. Helena Parish, LA",Feb-20,4307,4078,229,5.3
36567,CN2209300000000,22,93,"St. James Parish, LA",Feb-20,9311,8796,515,5.5
36568,CN2209500000000,22,95,"St. John the Baptist Parish, LA",Feb-20,19800,18793,1007,5.1
36569,CN2209700000000,22,97,"St. Landry Parish, LA",Feb-20,31700,29870,1830,5.8
36570,CN2209900000000,22,99,"St. Martin Parish, LA",Feb-20,22025,21002,1023,4.6
36571,CN2210100000000,22,101,"St. Mary Parish, LA",Feb-20,19607,18587,1020,5.2
36572,CN2210300000000,22,103,"St. Tammany Parish, LA",Feb-20,119820,115612,4208,3.5
36573,CN2210500000000,22,105,"Tangipahoa Parish, LA",Feb-20,54463,51887,2576,4.7
36574,CN2210700000000,22,107,"Tensas Parish, LA",Feb-20,1361,1241,120,8.8
36575,CN2210900000000,22,109,"Terrebonne Parish, LA",Feb-20,46027,44184,1843,4.0
36576,CN2211100000000,22,111,"Union Parish, LA",Feb-20,9123,8619,504,5.5
36577,CN2211300000000,22,113,"Vermilion Parish, LA",Feb-20,23807,22729,1078,4.5
36578,CN2211500000000,22,115,"Vernon Parish, LA",Feb-20,16129,15142,987,6.1
36579,CN2211700000000,22,117,"Washington Parish, LA",Feb-20,16680,15841,839,5.0
36580,CN2211900000000,22,119,"Webster Parish, LA",Feb-20,14470,13647,823,5.7
36581,CN2212100000000,22,121,"West Baton Rouge Parish, LA",Feb-20,13786,13262,524,3.8
36582,CN2212300000000,22,123,"West Carroll Parish, LA",Feb-20,3591,3167,424,11.8
36583,CN2212500000000,22,125,"West Feliciana Parish, LA",Feb-20,5443,5243,200,3.7
36584,CN2212700000000,22,127,"Winn Parish, LA",Feb-20,4831,4543,288,6.0
36585,CN2300100000000,23,1,"Androscoggin County, ME",Feb-20,55457,53347,2110,3.8
36586,CN2300300000000,23,3,"Aroostook County, ME",Feb-20,30516,28642,1874,6.1
36587,CN2300500000000,23,5,"Cumberland County, ME",Feb-20,162457,157603,4854,3.0
36588,CN2300700000000,23,7,"Franklin County, ME",Feb-20,14438,13752,686,4.8
36589,CN2300900000000,23,9,"Hancock County, ME",Feb-20,27407,25553,1854,6.8
36590,CN2301100000000,23,11,"Kennebec County, ME",Feb-20,61905,59425,2480,4.0
36591,CN2301300000000,23,13,"Knox County, ME",Feb-20,19683,18731,952,4.8
36592,CN2301500000000,23,15,"Lincoln County, ME",Feb-20,16224,15450,774,4.8
36593,CN2301700000000,23,17,"Oxford County, ME",Feb-20,26892,25605,1287,4.8
36594,CN2301900000000,23,19,"Penobscot County, ME",Feb-20,77471,73945,3526,4.6
36595,CN2302100000000,23,21,"Piscataquis County, ME",Feb-20,7271,6864,407,5.6
36596,CN2302300000000,23,23,"Sagadahoc County, ME",Feb-20,19528,18934,594,3.0
36597,CN2302500000000,23,25,"Somerset County, ME",Feb-20,22462,20979,1483,6.6
36598,CN2302700000000,23,27,"Waldo County, ME",Feb-20,20213,19211,1002,5.0
36599,CN2302900000000,23,29,"Washington County, ME",Feb-20,13745,12685,1060,7.7
36600,CN2303100000000,23,31,"York County, ME",Feb-20,112216,107693,4523,4.0
36601,CN2400100000000,24,1,"Allegany County, MD",Feb-20,32447,30695,1752,5.4
36602,CN2400300000000,24,3,"Anne Arundel County, MD",Feb-20,319049,309354,9695,3.0
36603,CN2400500000000,24,5,"Baltimore County, MD",Feb-20,458971,442375,16596,3.6
36604,CN2400900000000,24,9,"Calvert County, MD",Feb-20,51007,49479,1528,3.0
36605,CN2401100000000,24,11,"Caroline County, MD",Feb-20,18209,17519,690,3.8
36606,CN2401300000000,24,13,"Carroll County, MD",Feb-20,97370,94403,2967,3.0
36607,CN2401500000000,24,15,"Cecil County, MD",Feb-20,54090,51871,2219,4.1
36608,CN2401700000000,24,17,"Charles County, MD",Feb-20,89059,85922,3137,3.5
36609,CN2401900000000,24,19,"Dorchester County, MD",Feb-20,15283,14534,749,4.9
36610,CN2402100000000,24,21,"Frederick County, MD",Feb-20,136219,131846,4373,3.2
36611,CN2402300000000,24,23,"Garrett County, MD",Feb-20,15623,14775,848,5.4
36612,CN2402500000000,24,25,"Harford County, MD",Feb-20,142821,137987,4834,3.4
36613,CN2402700000000,24,27,"Howard County, MD",Feb-20,189709,184643,5066,2.7
36614,CN2402900000000,24,29,"Kent County, MD",Feb-20,10306,9797,509,4.9
36615,CN2403100000000,24,31,"Montgomery County, MD",Feb-20,566018,549538,16480,2.9
36616,CN2403300000000,24,33,"Prince George's County, MD",Feb-20,519266,500616,18650,3.6
36617,CN2403500000000,24,35,"Queen Anne's County, MD",Feb-20,28526,27587,939,3.3
36618,CN2403700000000,24,37,"St. Mary's County, MD",Feb-20,58016,56132,1884,3.2
36619,CN2403900000000,24,39,"Somerset County, MD",Feb-20,9257,8700,557,6.0
36620,CN2404100000000,24,41,"Talbot County, MD",Feb-20,18919,18182,737,3.9
36621,CN2404300000000,24,43,"Washington County, MD",Feb-20,75128,72004,3124,4.2
36622,CN2404500000000,24,45,"Wicomico County, MD",Feb-20,51050,48497,2553,5.0
36623,CN2404700000000,24,47,"Worcester County, MD",Feb-20,26012,23582,2430,9.3
36624,CN2451000000000,24,510,"Baltimore city, MD",Feb-20,290560,276865,13695,4.7
36625,CN2500100000000,25,1,"Barnstable County, MA",Feb-20,108982,102318,6664,6.1
36626,CN2500300000000,25,3,"Berkshire County, MA",Feb-20,64344,61568,2776,4.3
36627,CN2500500000000,25,5,"Bristol County, MA",Feb-20,305873,291868,14005,4.6
36628,CN2500700000000,25,7,"Dukes County, MA",Feb-20,8486,7867,619,7.3
36629,CN2500900000000,25,9,"Essex County, MA",Feb-20,429373,415131,14242,3.3
36630,CN2501100000000,25,11,"Franklin County, MA",Feb-20,41467,40165,1302,3.1
36631,CN2501300000000,25,13,"Hampden County, MA",Feb-20,232061,221863,10198,4.4
36632,CN2501500000000,25,15,"Hampshire County, MA",Feb-20,91662,88906,2756,3.0
36633,CN2501700000000,25,17,"Middlesex County, MA",Feb-20,929407,906588,22819,2.5
36634,CN2501900000000,25,19,"Nantucket County/town, MA",Feb-20,6286,5562,724,11.5
36635,CN2502100000000,25,21,"Norfolk County, MA",Feb-20,396348,385528,10820,2.7
36636,CN2502300000000,25,23,"Plymouth County, MA",Feb-20,286627,276322,10305,3.6
36637,CN2502500000000,25,25,"Suffolk County, MA",Feb-20,461523,449203,12320,2.7
36638,CN2502700000000,25,27,"Worcester County, MA",Feb-20,452457,436372,16085,3.6
36639,CN2600100000000,26,1,"Alcona County, MI",Feb-20,3839,3560,279,7.3
36640,CN2600300000000,26,3,"Alger County, MI",Feb-20,3102,2876,226,7.3
36641,CN2600500000000,26,5,"Allegan County, MI",Feb-20,62631,60800,1831,2.9
36642,CN2600700000000,26,7,"Alpena County, MI",Feb-20,13446,12831,615,4.6
36643,CN2600900000000,26,9,"Antrim County, MI",Feb-20,10201,9632,569,5.6
36644,CN2601100000000,26,11,"Arenac County, MI",Feb-20,5999,5566,433,7.2
36645,CN2601300000000,26,13,"Baraga County, MI",Feb-20,3310,3110,200,6.0
36646,CN2601500000000,26,15,"Barry County, MI",Feb-20,32186,31185,1001,3.1
36647,CN2601700000000,26,17,"Bay County, MI",Feb-20,49951,47648,2303,4.6
36648,CN2601900000000,26,19,"Benzie County, MI",Feb-20,8813,8297,516,5.9
36649,CN2602100000000,26,21,"Berrien County, MI",Feb-20,74034,71250,2784,3.8
36650,CN2602300000000,26,23,"Branch County, MI",Feb-20,19411,18770,641,3.3
36651,CN2602500000000,26,25,"Calhoun County, MI",Feb-20,63089,60826,2263,3.6
36652,CN2602700000000,26,27,"Cass County, MI",Feb-20,24824,23856,968,3.9
36653,CN2602900000000,26,29,"Charlevoix County, MI",Feb-20,12375,11737,638,5.2
36654,CN2603100000000,26,31,"Cheboygan County, MI",Feb-20,10063,8627,1436,14.3
36655,CN2603300000000,26,33,"Chippewa County, MI",Feb-20,16261,15206,1055,6.5
36656,CN2603500000000,26,35,"Clare County, MI",Feb-20,11738,10975,763,6.5
36657,CN2603700000000,26,37,"Clinton County, MI",Feb-20,42040,40988,1052,2.5
36658,CN2603900000000,26,39,"Crawford County, MI",Feb-20,5677,5337,340,6.0
36659,CN2604100000000,26,41,"Delta County, MI",Feb-20,17151,16229,922,5.4
36660,CN2604300000000,26,43,"Dickinson County, MI",Feb-20,12320,11802,518,4.2
36661,CN2604500000000,26,45,"Eaton County, MI",Feb-20,58688,57006,1682,2.9
36662,CN2604700000000,26,47,"Emmet County, MI",Feb-20,17269,16186,1083,6.3
36663,CN2604900000000,26,49,"Genesee County, MI",Feb-20,185753,178195,7558,4.1
36664,CN2605100000000,26,51,"Gladwin County, MI",Feb-20,9876,9301,575,5.8
36665,CN2605300000000,26,53,"Gogebic County, MI",Feb-20,6128,5798,330,5.4
36666,CN2605500000000,26,55,"Grand Traverse County, MI",Feb-20,49127,47397,1730,3.5
36667,CN2605700000000,26,57,"Gratiot County, MI",Feb-20,18363,17646,717,3.9
36668,CN2605900000000,26,59,"Hillsdale County, MI",Feb-20,20451,19707,744,3.6
36669,CN2606100000000,26,61,"Houghton County, MI",Feb-20,16946,16213,733,4.3
36670,CN2606300000000,26,63,"Huron County, MI",Feb-20,15252,14569,683,4.5
36671,CN2606500000000,26,65,"Ingham County, MI",Feb-20,154734,150478,4256,2.8
36672,CN2606700000000,26,67,"Ionia County, MI",Feb-20,30593,29704,889,2.9
36673,CN2606900000000,26,69,"Iosco County, MI",Feb-20,10176,9472,704,6.9
36674,CN2607100000000,26,71,"Iron County, MI",Feb-20,5205,4893,312,6.0
36675,CN2607300000000,26,73,"Isabella County, MI",Feb-20,35124,33859,1265,3.6
36676,CN2607500000000,26,75,"Jackson County, MI",Feb-20,75042,72487,2555,3.4
36677,CN2607700000000,26,77,"Kalamazoo County, MI",Feb-20,135993,132295,3698,2.7
36678,CN2607900000000,26,79,"Kalkaska County, MI",Feb-20,7885,7375,510,6.5
36679,CN2608100000000,26,81,"Kent County, MI",Feb-20,365532,356838,8694,2.4
36680,CN2608300000000,26,83,"Keweenaw County, MI",Feb-20,911,862,49,5.4
36681,CN2608500000000,26,85,"Lake County, MI",Feb-20,3862,3629,233,6.0
36682,CN2608700000000,26,87,"Lapeer County, MI",Feb-20,41485,39125,2360,5.7
36683,CN2608900000000,26,89,"Leelanau County, MI",Feb-20,10353,9950,403,3.9
36684,CN2609100000000,26,91,"Lenawee County, MI",Feb-20,47006,45393,1613,3.4
36685,CN2609300000000,26,93,"Livingston County, MI",Feb-20,103681,100570,3111,3.0
36686,CN2609500000000,26,95,"Luce County, MI",Feb-20,2301,2166,135,5.9
36687,CN2609700000000,26,97,"Mackinac County, MI",Feb-20,4324,3552,772,17.9
36688,CN2609900000000,26,99,"Macomb County, MI",Feb-20,448162,431762,16400,3.7
36689,CN2610100000000,26,101,"Manistee County, MI",Feb-20,10238,9642,596,5.8
36690,CN2610300000000,26,103,"Marquette County, MI",Feb-20,33346,31783,1563,4.7
36691,CN2610500000000,26,105,"Mason County, MI",Feb-20,13145,12457,688,5.2
36692,CN2610700000000,26,107,"Mecosta County, MI",Feb-20,18528,17664,864,4.7
36693,CN2610900000000,26,109,"Menominee County, MI",Feb-20,11051,10630,421,3.8
36694,CN2611100000000,26,111,"Midland County, MI",Feb-20,40307,38830,1477,3.7
36695,CN2611300000000,26,113,"Missaukee County, MI",Feb-20,6944,6584,360,5.2
36696,CN2611500000000,26,115,"Monroe County, MI",Feb-20,75999,73431,2568,3.4
36697,CN2611700000000,26,117,"Montcalm County, MI",Feb-20,28711,27653,1058,3.7
36698,CN2611900000000,26,119,"Montmorency County, MI",Feb-20,2965,2686,279,9.4
36699,CN2612100000000,26,121,"Muskegon County, MI",Feb-20,77865,74944,2921,3.8
36700,CN2612300000000,26,123,"Newaygo County, MI",Feb-20,23547,22581,966,4.1
36701,CN2612500000000,26,125,"Oakland County, MI",Feb-20,675949,656451,19498,2.9
36702,CN2612700000000,26,127,"Oceana County, MI",Feb-20,11598,10826,772,6.7
36703,CN2612900000000,26,129,"Ogemaw County, MI",Feb-20,7811,7202,609,7.8
36704,CN2613100000000,26,131,"Ontonagon County, MI",Feb-20,2111,1977,134,6.3
36705,CN2613300000000,26,133,"Osceola County, MI",Feb-20,11503,11062,441,3.8
36706,CN2613500000000,26,135,"Oscoda County, MI",Feb-20,2945,2755,190,6.5
36707,CN2613700000000,26,137,"Otsego County, MI",Feb-20,11590,11019,571,4.9
36708,CN2613900000000,26,139,"Ottawa County, MI",Feb-20,163304,159581,3723,2.3
36709,CN2614100000000,26,141,"Presque Isle County, MI",Feb-20,4842,4342,500,10.3
36710,CN2614300000000,26,143,"Roscommon County, MI",Feb-20,7493,6871,622,8.3
36711,CN2614500000000,26,145,"Saginaw County, MI",Feb-20,87086,83265,3821,4.4
36712,CN2614700000000,26,147,"St. Clair County, MI",Feb-20,75924,72389,3535,4.7
36713,CN2614900000000,26,149,"St. Joseph County, MI",Feb-20,27692,26802,890,3.2
36714,CN2615100000000,26,151,"Sanilac County, MI",Feb-20,19442,18511,931,4.8
36715,CN2615300000000,26,153,"Schoolcraft County, MI",Feb-20,3275,3023,252,7.7
36716,CN2615500000000,26,155,"Shiawassee County, MI",Feb-20,34031,32762,1269,3.7
36717,CN2615700000000,26,157,"Tuscola County, MI",Feb-20,24168,22938,1230,5.1
36718,CN2615900000000,26,159,"Van Buren County, MI",Feb-20,35615,34009,1606,4.5
36719,CN2616100000000,26,161,"Washtenaw County, MI",Feb-20,203704,199256,4448,2.2
36720,CN2616300000000,26,163,"Wayne County, MI",Feb-20,802802,767844,34958,4.4
36721,CN2616500000000,26,165,"Wexford County, MI",Feb-20,14982,14300,682,4.6
36722,CN2700100000000,27,1,"Aitkin County, MN",Feb-20,7243,6667,576,8.0
36723,CN2700300000000,27,3,"Anoka County, MN",Feb-20,199884,193322,6562,3.3
36724,CN2700500000000,27,5,"Becker County, MN",Feb-20,18624,17582,1042,5.6
36725,CN2700700000000,27,7,"Beltrami County, MN",Feb-20,24609,23375,1234,5.0
36726,CN2700900000000,27,9,"Benton County, MN",Feb-20,22396,21255,1141,5.1
36727,CN2701100000000,27,11,"Big Stone County, MN",Feb-20,2383,2236,147,6.2
36728,CN2701300000000,27,13,"Blue Earth County, MN",Feb-20,41744,40520,1224,2.9
36729,CN2701500000000,27,15,"Brown County, MN",Feb-20,14156,13482,674,4.8
36730,CN2701700000000,27,17,"Carlton County, MN",Feb-20,18100,17116,984,5.4
36731,CN2701900000000,27,19,"Carver County, MN",Feb-20,58954,57298,1656,2.8
36732,CN2702100000000,27,21,"Cass County, MN",Feb-20,13975,12895,1080,7.7
36733,CN2702300000000,27,23,"Chippewa County, MN",Feb-20,6907,6565,342,5.0
36734,CN2702500000000,27,25,"Chisago County, MN",Feb-20,30555,29052,1503,4.9
36735,CN2702700000000,27,27,"Clay County, MN",Feb-20,36597,35372,1225,3.3
36736,CN2702900000000,27,29,"Clearwater County, MN",Feb-20,4605,4060,545,11.8
36737,CN2703100000000,27,31,"Cook County, MN",Feb-20,2908,2746,162,5.6
36738,CN2703300000000,27,33,"Cottonwood County, MN",Feb-20,5886,5661,225,3.8
36739,CN2703500000000,27,35,"Crow Wing County, MN",Feb-20,31795,30007,1788,5.6
36740,CN2703700000000,27,37,"Dakota County, MN",Feb-20,243949,236827,7122,2.9
36741,CN2703900000000,27,39,"Dodge County, MN",Feb-20,11886,11388,498,4.2
36742,CN2704100000000,27,41,"Douglas County, MN",Feb-20,20944,20140,804,3.8
36743,CN2704300000000,27,43,"Faribault County, MN",Feb-20,6804,6439,365,5.4
36744,CN2704500000000,27,45,"Fillmore County, MN",Feb-20,11508,10967,541,4.7
36745,CN2704700000000,27,47,"Freeborn County, MN",Feb-20,16102,15502,600,3.7
36746,CN2704900000000,27,49,"Goodhue County, MN",Feb-20,27124,26102,1022,3.8
36747,CN2705100000000,27,51,"Grant County, MN",Feb-20,3213,3024,189,5.9
36748,CN2705300000000,27,53,"Hennepin County, MN",Feb-20,711762,693607,18155,2.6
36749,CN2705500000000,27,55,"Houston County, MN",Feb-20,10484,10049,435,4.1
36750,CN2705700000000,27,57,"Hubbard County, MN",Feb-20,9778,9084,694,7.1
36751,CN2705900000000,27,59,"Isanti County, MN",Feb-20,21750,20591,1159,5.3
36752,CN2706100000000,27,61,"Itasca County, MN",Feb-20,22203,20657,1546,7.0
36753,CN2706300000000,27,63,"Jackson County, MN",Feb-20,5644,5429,215,3.8
36754,CN2706500000000,27,65,"Kanabec County, MN",Feb-20,9218,8372,846,9.2
36755,CN2706700000000,27,67,"Kandiyohi County, MN",Feb-20,23966,22887,1079,4.5
36756,CN2706900000000,27,69,"Kittson County, MN",Feb-20,2303,2198,105,4.6
36757,CN2707100000000,27,71,"Koochiching County, MN",Feb-20,5738,5386,352,6.1
36758,CN2707300000000,27,73,"Lac qui Parle County, MN",Feb-20,3526,3323,203,5.8
36759,CN2707500000000,27,75,"Lake County, MN",Feb-20,5378,5153,225,4.2
36760,CN2707700000000,27,77,"Lake of the Woods County, MN",Feb-20,2587,2489,98,3.8
36761,CN2707900000000,27,79,"Le Sueur County, MN",Feb-20,16498,15438,1060,6.4
36762,CN2708100000000,27,81,"Lincoln County, MN",Feb-20,3163,2976,187,5.9
36763,CN2708300000000,27,83,"Lyon County, MN",Feb-20,14171,13633,538,3.8
36764,CN2708500000000,27,85,"McLeod County, MN",Feb-20,19163,18264,899,4.7
36765,CN2708700000000,27,87,"Mahnomen County, MN",Feb-20,2291,2132,159,6.9
36766,CN2708900000000,27,89,"Marshall County, MN",Feb-20,5320,4852,468,8.8
36767,CN2709100000000,27,91,"Martin County, MN",Feb-20,9729,9349,380,3.9
36768,CN2709300000000,27,93,"Meeker County, MN",Feb-20,13352,12662,690,5.2
36769,CN2709500000000,27,95,"Mille Lacs County, MN",Feb-20,13341,12299,1042,7.8
36770,CN2709700000000,27,97,"Morrison County, MN",Feb-20,17514,16176,1338,7.6
36771,CN2709900000000,27,99,"Mower County, MN",Feb-20,20258,19567,691,3.4
36772,CN2710100000000,27,101,"Murray County, MN",Feb-20,4625,4330,295,6.4
36773,CN2710300000000,27,103,"Nicollet County, MN",Feb-20,21463,20899,564,2.6
36774,CN2710500000000,27,105,"Nobles County, MN",Feb-20,11078,10701,377,3.4
36775,CN2710700000000,27,107,"Norman County, MN",Feb-20,3124,2938,186,6.0
36776,CN2710900000000,27,109,"Olmsted County, MN",Feb-20,89019,86664,2355,2.6
36777,CN2711100000000,27,111,"Otter Tail County, MN",Feb-20,31113,29368,1745,5.6
36778,CN2711300000000,27,113,"Pennington County, MN",Feb-20,8757,8156,601,6.9
36779,CN2711500000000,27,115,"Pine County, MN",Feb-20,15241,14048,1193,7.8
36780,CN2711700000000,27,117,"Pipestone County, MN",Feb-20,4755,4517,238,5.0
36781,CN2711900000000,27,119,"Polk County, MN",Feb-20,16530,15777,753,4.6
36782,CN2712100000000,27,121,"Pope County, MN",Feb-20,6464,6222,242,3.7
36783,CN2712300000000,27,123,"Ramsey County, MN",Feb-20,291966,283591,8375,2.9
36784,CN2712500000000,27,125,"Red Lake County, MN",Feb-20,2221,2039,182,8.2
36785,CN2712700000000,27,127,"Redwood County, MN",Feb-20,7427,7108,319,4.3
36786,CN2712900000000,27,129,"Renville County, MN",Feb-20,8226,7723,503,6.1
36787,CN2713100000000,27,131,"Rice County, MN",Feb-20,37401,36062,1339,3.6
36788,CN2713300000000,27,133,"Rock County, MN",Feb-20,5494,5354,140,2.5
36789,CN2713500000000,27,135,"Roseau County, MN",Feb-20,7899,7502,397,5.0
36790,CN2713700000000,27,137,"St. Louis County, MN",Feb-20,102899,98398,4501,4.4
36791,CN2713900000000,27,139,"Scott County, MN",Feb-20,84398,81965,2433,2.9
36792,CN2714100000000,27,141,"Sherburne County, MN",Feb-20,53315,50993,2322,4.4
36793,CN2714300000000,27,143,"Sibley County, MN",Feb-20,8486,8071,415,4.9
36794,CN2714500000000,27,145,"Stearns County, MN",Feb-20,91396,87935,3461,3.8
36795,CN2714700000000,27,147,"Steele County, MN",Feb-20,21443,20706,737,3.4
36796,CN2714900000000,27,149,"Stevens County, MN",Feb-20,5194,5026,168,3.2
36797,CN2715100000000,27,151,"Swift County, MN",Feb-20,4777,4517,260,5.4
36798,CN2715300000000,27,153,"Todd County, MN",Feb-20,13517,12788,729,5.4
36799,CN2715500000000,27,155,"Traverse County, MN",Feb-20,1693,1603,90,5.3
36800,CN2715700000000,27,157,"Wabasha County, MN",Feb-20,12258,11729,529,4.3
36801,CN2715900000000,27,159,"Wadena County, MN",Feb-20,6057,5550,507,8.4
36802,CN2716100000000,27,161,"Waseca County, MN",Feb-20,8883,8432,451,5.1
36803,CN2716300000000,27,163,"Washington County, MN",Feb-20,144732,140470,4262,2.9
36804,CN2716500000000,27,165,"Watonwan County, MN",Feb-20,6251,5966,285,4.6
36805,CN2716700000000,27,167,"Wilkin County, MN",Feb-20,3351,3230,121,3.6
36806,CN2716900000000,27,169,"Winona County, MN",Feb-20,28703,27827,876,3.1
36807,CN2717100000000,27,171,"Wright County, MN",Feb-20,76776,73725,3051,4.0
36808,CN2717300000000,27,173,"Yellow Medicine County, MN",Feb-20,5264,5035,229,4.4
36809,CN2800100000000,28,1,"Adams County, MS",Feb-20,11150,10420,730,6.5
36810,CN2800300000000,28,3,"Alcorn County, MS",Feb-20,16148,15422,726,4.5
36811,CN2800500000000,28,5,"Amite County, MS",Feb-20,4357,4056,301,6.9
36812,CN2800700000000,28,7,"Attala County, MS",Feb-20,6958,6513,445,6.4
36813,CN2800900000000,28,9,"Benton County, MS",Feb-20,3024,2845,179,5.9
36814,CN2801100000000,28,11,"Bolivar County, MS",Feb-20,11978,11133,845,7.1
36815,CN2801300000000,28,13,"Calhoun County, MS",Feb-20,5535,5228,307,5.5
36816,CN2801500000000,28,15,"Carroll County, MS",Feb-20,3444,3232,212,6.2
36817,CN2801700000000,28,17,"Chickasaw County, MS",Feb-20,6753,6413,340,5.0
36818,CN2801900000000,28,19,"Choctaw County, MS",Feb-20,3646,3449,197,5.4
36819,CN2802100000000,28,21,"Claiborne County, MS",Feb-20,2951,2669,282,9.6
36820,CN2802300000000,28,23,"Clarke County, MS",Feb-20,5925,5559,366,6.2
36821,CN2802500000000,28,25,"Clay County, MS",Feb-20,7606,7066,540,7.1
36822,CN2802700000000,28,27,"Coahoma County, MS",Feb-20,8211,7549,662,8.1
36823,CN2802900000000,28,29,"Copiah County, MS",Feb-20,11031,10366,665,6.0
36824,CN2803100000000,28,31,"Covington County, MS",Feb-20,8030,7634,396,4.9
36825,CN2803300000000,28,33,"DeSoto County, MS",Feb-20,90466,86751,3715,4.1
36826,CN2803500000000,28,35,"Forrest County, MS",Feb-20,33277,31731,1546,4.6
36827,CN2803700000000,28,37,"Franklin County, MS",Feb-20,2736,2560,176,6.4
36828,CN2803900000000,28,39,"George County, MS",Feb-20,8717,8091,626,7.2
36829,CN2804100000000,28,41,"Greene County, MS",Feb-20,4324,3978,346,8.0
36830,CN2804300000000,28,43,"Grenada County, MS",Feb-20,9285,8840,445,4.8
36831,CN2804500000000,28,45,"Hancock County, MS",Feb-20,18743,17755,988,5.3
36832,CN2804700000000,28,47,"Harrison County, MS",Feb-20,86198,81992,4206,4.9
36833,CN2804900000000,28,49,"Hinds County, MS",Feb-20,105551,100470,5081,4.8
36834,CN2805100000000,28,51,"Holmes County, MS",Feb-20,5599,5081,518,9.3
36835,CN2805300000000,28,53,"Humphreys County, MS",Feb-20,2228,1970,258,11.6
36836,CN2805500000000,28,55,"Issaquena County, MS",Feb-20,365,335,30,8.2
36837,CN2805700000000,28,57,"Itawamba County, MS",Feb-20,10475,9985,490,4.7
36838,CN2805900000000,28,59,"Jackson County, MS",Feb-20,58261,54990,3271,5.6
36839,CN2806100000000,28,61,"Jasper County, MS",Feb-20,6139,5662,477,7.8
36840,CN2806300000000,28,63,"Jefferson County, MS",Feb-20,1948,1677,271,13.9
36841,CN2806500000000,28,65,"Jefferson Davis County, MS",Feb-20,4122,3844,278,6.7
36842,CN2806700000000,28,67,"Jones County, MS",Feb-20,25806,24448,1358,5.3
36843,CN2806900000000,28,69,"Kemper County, MS",Feb-20,3516,3260,256,7.3
36844,CN2807100000000,28,71,"Lafayette County, MS",Feb-20,28439,27355,1084,3.8
36845,CN2807300000000,28,73,"Lamar County, MS",Feb-20,30837,29586,1251,4.1
36846,CN2807500000000,28,75,"Lauderdale County, MS",Feb-20,30362,28875,1487,4.9
36847,CN2807700000000,28,77,"Lawrence County, MS",Feb-20,4506,4234,272,6.0
36848,CN2807900000000,28,79,"Leake County, MS",Feb-20,7820,7392,428,5.5
36849,CN2808100000000,28,81,"Lee County, MS",Feb-20,40947,39264,1683,4.1
36850,CN2808300000000,28,83,"Leflore County, MS",Feb-20,9912,9194,718,7.2
36851,CN2808500000000,28,85,"Lincoln County, MS",Feb-20,14394,13637,757,5.3
36852,CN2808700000000,28,87,"Lowndes County, MS",Feb-20,25077,23811,1266,5.0
36853,CN2808900000000,28,89,"Madison County, MS",Feb-20,52612,50498,2114,4.0
36854,CN2809100000000,28,91,"Marion County, MS",Feb-20,9942,9404,538,5.4
36855,CN2809300000000,28,93,"Marshall County, MS",Feb-20,14335,13582,753,5.3
36856,CN2809500000000,28,95,"Monroe County, MS",Feb-20,15466,14684,782,5.1
36857,CN2809700000000,28,97,"Montgomery County, MS",Feb-20,3894,3658,236,6.1
36858,CN2809900000000,28,99,"Neshoba County, MS",Feb-20,9993,9410,583,5.8
36859,CN2810100000000,28,101,"Newton County, MS",Feb-20,8812,8350,462,5.2
36860,CN2810300000000,28,103,"Noxubee County, MS",Feb-20,3732,3470,262,7.0
36861,CN2810500000000,28,105,"Oktibbeha County, MS",Feb-20,22040,20970,1070,4.9
36862,CN2810700000000,28,107,"Panola County, MS",Feb-20,12301,11536,765,6.2
36863,CN2810900000000,28,109,"Pearl River County, MS",Feb-20,23773,22628,1145,4.8
36864,CN2811100000000,28,111,"Perry County, MS",Feb-20,4311,4020,291,6.8
36865,CN2811300000000,28,113,"Pike County, MS",Feb-20,14280,13436,844,5.9
36866,CN2811500000000,28,115,"Pontotoc County, MS",Feb-20,14695,14096,599,4.1
36867,CN2811700000000,28,117,"Prentiss County, MS",Feb-20,11194,10654,540,4.8
36868,CN2811900000000,28,119,"Quitman County, MS",Feb-20,2313,2133,180,7.8
36869,CN2812100000000,28,121,"Rankin County, MS",Feb-20,75331,72456,2875,3.8
36870,CN2812300000000,28,123,"Scott County, MS",Feb-20,12496,11949,547,4.4
36871,CN2812500000000,28,125,"Sharkey County, MS",Feb-20,1588,1445,143,9.0
36872,CN2812700000000,28,127,"Simpson County, MS",Feb-20,10662,10095,567,5.3
36873,CN2812900000000,28,129,"Smith County, MS",Feb-20,6806,6443,363,5.3
36874,CN2813100000000,28,131,"Stone County, MS",Feb-20,6846,6450,396,5.8
36875,CN2813300000000,28,133,"Sunflower County, MS",Feb-20,7587,6886,701,9.2
36876,CN2813500000000,28,135,"Tallahatchie County, MS",Feb-20,5205,4871,334,6.4
36877,CN2813700000000,28,137,"Tate County, MS",Feb-20,12236,11601,635,5.2
36878,CN2813900000000,28,139,"Tippah County, MS",Feb-20,9354,8922,432,4.6
36879,CN2814100000000,28,141,"Tishomingo County, MS",Feb-20,8546,8081,465,5.4
36880,CN2814300000000,28,143,"Tunica County, MS",Feb-20,4401,4133,268,6.1
36881,CN2814500000000,28,145,"Union County, MS",Feb-20,14286,13709,577,4.0
36882,CN2814700000000,28,147,"Walthall County, MS",Feb-20,4748,4434,314,6.6
36883,CN2814900000000,28,149,"Warren County, MS",Feb-20,19905,18851,1054,5.3
36884,CN2815100000000,28,151,"Washington County, MS",Feb-20,16704,15469,1235,7.4
36885,CN2815300000000,28,153,"Wayne County, MS",Feb-20,7383,6931,452,6.1
36886,CN2815500000000,28,155,"Webster County, MS",Feb-20,3937,3715,222,5.6
36887,CN2815700000000,28,157,"Wilkinson County, MS",Feb-20,2779,2514,265,9.5
36888,CN2815900000000,28,159,"Winston County, MS",Feb-20,7357,6927,430,5.8
36889,CN2816100000000,28,161,"Yalobusha County, MS",Feb-20,4943,4691,252,5.1
36890,CN2816300000000,28,163,"Yazoo County, MS",Feb-20,9272,8722,550,5.9
36891,CN2900100000000,29,1,"Adair County, MO",Feb-20,10246,9866,380,3.7
36892,CN2900300000000,29,3,"Andrew County, MO",Feb-20,9778,9452,326,3.3
36893,CN2900500000000,29,5,"Atchison County, MO",Feb-20,2716,2628,88,3.2
36894,CN2900700000000,29,7,"Audrain County, MO",Feb-20,10737,10308,429,4.0
36895,CN2900900000000,29,9,"Barry County, MO",Feb-20,15829,15150,679,4.3
36896,CN2901100000000,29,11,"Barton County, MO",Feb-20,5273,5100,173,3.3
36897,CN2901300000000,29,13,"Bates County, MO",Feb-20,8009,7655,354,4.4
36898,CN2901500000000,29,15,"Benton County, MO",Feb-20,7290,6827,463,6.4
36899,CN2901700000000,29,17,"Bollinger County, MO",Feb-20,5580,5342,238,4.3
36900,CN2901900000000,29,19,"Boone County, MO",Feb-20,99179,96662,2517,2.5
36901,CN2902100000000,29,21,"Buchanan County, MO",Feb-20,44526,42935,1591,3.6
36902,CN2902300000000,29,23,"Butler County, MO",Feb-20,18123,17296,827,4.6
36903,CN2902500000000,29,25,"Caldwell County, MO",Feb-20,4442,4271,171,3.8
36904,CN2902700000000,29,27,"Callaway County, MO",Feb-20,21433,20691,742,3.5
36905,CN2902900000000,29,29,"Camden County, MO",Feb-20,17790,16561,1229,6.9
36906,CN2903100000000,29,31,"Cape Girardeau County, MO",Feb-20,41330,39999,1331,3.2
36907,CN2903300000000,29,33,"Carroll County, MO",Feb-20,4897,4724,173,3.5
36908,CN2903500000000,29,35,"Carter County, MO",Feb-20,2554,2388,166,6.5
36909,CN2903700000000,29,37,"Cass County, MO",Feb-20,55265,53354,1911,3.5
36910,CN2903900000000,29,39,"Cedar County, MO",Feb-20,5823,5599,224,3.8
36911,CN2904100000000,29,41,"Chariton County, MO",Feb-20,3805,3658,147,3.9
36912,CN2904300000000,29,43,"Christian County, MO",Feb-20,45477,44015,1462,3.2
36913,CN2904500000000,29,45,"Clark County, MO",Feb-20,3256,3104,152,4.7
36914,CN2904700000000,29,47,"Clay County, MO",Feb-20,136876,132799,4077,3.0
36915,CN2904900000000,29,49,"Clinton County, MO",Feb-20,10815,10454,361,3.3
36916,CN2905100000000,29,51,"Cole County, MO",Feb-20,39002,37870,1132,2.9
36917,CN2905300000000,29,53,"Cooper County, MO",Feb-20,7541,7238,303,4.0
36918,CN2905500000000,29,55,"Crawford County, MO",Feb-20,11056,10539,517,4.7
36919,CN2905700000000,29,57,"Dade County, MO",Feb-20,3611,3477,134,3.7
36920,CN2905900000000,29,59,"Dallas County, MO",Feb-20,7155,6830,325,4.5
36921,CN2906100000000,29,61,"Daviess County, MO",Feb-20,4169,4014,155,3.7
36922,CN2906300000000,29,63,"DeKalb County, MO",Feb-20,4877,4680,197,4.0
36923,CN2906500000000,29,65,"Dent County, MO",Feb-20,6298,6045,253,4.0
36924,CN2906700000000,29,67,"Douglas County, MO",Feb-20,5122,4872,250,4.9
36925,CN2906900000000,29,69,"Dunklin County, MO",Feb-20,11764,10971,793,6.7
36926,CN2907100000000,29,71,"Franklin County, MO",Feb-20,53448,51376,2072,3.9
36927,CN2907300000000,29,73,"Gasconade County, MO",Feb-20,7705,7429,276,3.6
36928,CN2907500000000,29,75,"Gentry County, MO",Feb-20,3535,3435,100,2.8
36929,CN2907700000000,29,77,"Greene County, MO",Feb-20,152787,148135,4652,3.0
36930,CN2907900000000,29,79,"Grundy County, MO",Feb-20,4453,4300,153,3.4
36931,CN2908100000000,29,81,"Harrison County, MO",Feb-20,3889,3693,196,5.0
36932,CN2908300000000,29,83,"Henry County, MO",Feb-20,9790,9363,427,4.4
36933,CN2908500000000,29,85,"Hickory County, MO",Feb-20,3829,3633,196,5.1
36934,CN2908700000000,29,87,"Holt County, MO",Feb-20,2589,2509,80,3.1
36935,CN2908900000000,29,89,"Howard County, MO",Feb-20,4911,4743,168,3.4
36936,CN2909100000000,29,91,"Howell County, MO",Feb-20,16677,16006,671,4.0
36937,CN2909300000000,29,93,"Iron County, MO",Feb-20,3568,3362,206,5.8
36938,CN2909500000000,29,95,"Jackson County, MO",Feb-20,364637,350283,14354,3.9
36939,CN2909700000000,29,97,"Jasper County, MO",Feb-20,57797,55993,1804,3.1
36940,CN2909900000000,29,99,"Jefferson County, MO",Feb-20,118591,114107,4484,3.8
36941,CN2910100000000,29,101,"Johnson County, MO",Feb-20,23560,22539,1021,4.3
36942,CN2910300000000,29,103,"Knox County, MO",Feb-20,1808,1720,88,4.9
36943,CN2910500000000,29,105,"Laclede County, MO",Feb-20,17273,16243,1030,6.0
36944,CN2910700000000,29,107,"Lafayette County, MO",Feb-20,17049,16401,648,3.8
36945,CN2910900000000,29,109,"Lawrence County, MO",Feb-20,18219,17460,759,4.2
36946,CN2911100000000,29,111,"Lewis County, MO",Feb-20,5011,4828,183,3.7
36947,CN2911300000000,29,113,"Lincoln County, MO",Feb-20,28539,27439,1100,3.9
36948,CN2911500000000,29,115,"Linn County, MO",Feb-20,5157,4880,277,5.4
36949,CN2911700000000,29,117,"Livingston County, MO",Feb-20,7443,7211,232,3.1
36950,CN2911900000000,29,119,"McDonald County, MO",Feb-20,10925,10566,359,3.3
36951,CN2912100000000,29,121,"Macon County, MO",Feb-20,7645,7333,312,4.1
36952,CN2912300000000,29,123,"Madison County, MO",Feb-20,5535,5285,250,4.5
36953,CN2912500000000,29,125,"Maries County, MO",Feb-20,3934,3787,147,3.7
36954,CN2912700000000,29,127,"Marion County, MO",Feb-20,14415,13921,494,3.4
36955,CN2912900000000,29,129,"Mercer County, MO",Feb-20,1942,1862,80,4.1
36956,CN2913100000000,29,131,"Miller County, MO",Feb-20,12300,11615,685,5.6
36957,CN2913300000000,29,133,"Mississippi County, MO",Feb-20,5855,5597,258,4.4
36958,CN2913500000000,29,135,"Moniteau County, MO",Feb-20,7375,7112,263,3.6
36959,CN2913700000000,29,137,"Monroe County, MO",Feb-20,3894,3703,191,4.9
36960,CN2913900000000,29,139,"Montgomery County, MO",Feb-20,5803,5584,219,3.8
36961,CN2914100000000,29,141,"Morgan County, MO",Feb-20,8170,7689,481,5.9
36962,CN2914300000000,29,143,"New Madrid County, MO",Feb-20,8457,8046,411,4.9
36963,CN2914500000000,29,145,"Newton County, MO",Feb-20,27666,26734,932,3.4
36964,CN2914700000000,29,147,"Nodaway County, MO",Feb-20,11100,10738,362,3.3
36965,CN2914900000000,29,149,"Oregon County, MO",Feb-20,4098,3904,194,4.7
36966,CN2915100000000,29,151,"Osage County, MO",Feb-20,7125,6946,179,2.5
36967,CN2915300000000,29,153,"Ozark County, MO",Feb-20,3363,3162,201,6.0
36968,CN2915500000000,29,155,"Pemiscot County, MO",Feb-20,6451,6072,379,5.9
36969,CN2915700000000,29,157,"Perry County, MO",Feb-20,10011,9704,307,3.1
36970,CN2915900000000,29,159,"Pettis County, MO",Feb-20,21799,20469,1330,6.1
36971,CN2916100000000,29,161,"Phelps County, MO",Feb-20,19945,19181,764,3.8
36972,CN2916300000000,29,163,"Pike County, MO",Feb-20,7481,7181,300,4.0
36973,CN2916500000000,29,165,"Platte County, MO",Feb-20,58888,57286,1602,2.7
36974,CN2916700000000,29,167,"Polk County, MO",Feb-20,14727,14231,496,3.4
36975,CN2916900000000,29,169,"Pulaski County, MO",Feb-20,14809,14210,599,4.0
36976,CN2917100000000,29,171,"Putnam County, MO",Feb-20,2306,2215,91,3.9
36977,CN2917300000000,29,173,"Ralls County, MO",Feb-20,5639,5429,210,3.7
36978,CN2917500000000,29,175,"Randolph County, MO",Feb-20,10623,10173,450,4.2
36979,CN2917700000000,29,177,"Ray County, MO",Feb-20,11073,10657,416,3.8
36980,CN2917900000000,29,179,"Reynolds County, MO",Feb-20,3010,2881,129,4.3
36981,CN2918100000000,29,181,"Ripley County, MO",Feb-20,5017,4769,248,4.9
36982,CN2918300000000,29,183,"St. Charles County, MO",Feb-20,226899,220432,6467,2.9
36983,CN2918500000000,29,185,"St. Clair County, MO",Feb-20,3776,3593,183,4.8
36984,CN2918600000000,29,186,"Ste. Genevieve County, MO",Feb-20,9219,8852,367,4.0
36985,CN2918700000000,29,187,"St. Francois County, MO",Feb-20,26766,25428,1338,5.0
36986,CN2918900000000,29,189,"St. Louis County, MO",Feb-20,532080,514851,17229,3.2
36987,CN2919500000000,29,195,"Saline County, MO",Feb-20,10729,10287,442,4.1
36988,CN2919700000000,29,197,"Schuyler County, MO",Feb-20,1969,1871,98,5.0
36989,CN2919900000000,29,199,"Scotland County, MO",Feb-20,2420,2347,73,3.0
36990,CN2920100000000,29,201,"Scott County, MO",Feb-20,20131,19317,814,4.0
36991,CN2920300000000,29,203,"Shannon County, MO",Feb-20,3208,3006,202,6.3
36992,CN2920500000000,29,205,"Shelby County, MO",Feb-20,3179,3035,144,4.5
36993,CN2920700000000,29,207,"Stoddard County, MO",Feb-20,13227,12540,687,5.2
36994,CN2920900000000,29,209,"Stone County, MO",Feb-20,12976,11561,1415,10.9
36995,CN2921100000000,29,211,"Sullivan County, MO",Feb-20,2751,2624,127,4.6
36996,CN2921300000000,29,213,"Taney County, MO",Feb-20,25552,22379,3173,12.4
36997,CN2921500000000,29,215,"Texas County, MO",Feb-20,9128,8691,437,4.8
36998,CN2921700000000,29,217,"Vernon County, MO",Feb-20,9588,9237,351,3.7
36999,CN2921900000000,29,219,"Warren County, MO",Feb-20,18071,17410,661,3.7
37000,CN2922100000000,29,221,"Washington County, MO",Feb-20,10332,9704,628,6.1
37001,CN2922300000000,29,223,"Wayne County, MO",Feb-20,5207,4944,263,5.1
37002,CN2922500000000,29,225,"Webster County, MO",Feb-20,17520,16840,680,3.9
37003,CN2922700000000,29,227,"Worth County, MO",Feb-20,1182,1153,29,2.5
37004,CN2922900000000,29,229,"Wright County, MO",Feb-20,7656,7250,406,5.3
37005,CN2951000000000,29,510,"St. Louis city, MO",Feb-20,152631,146529,6102,4.0
37006,CN3000100000000,30,1,"Beaverhead County, MT",Feb-20,5024,4853,171,3.4
37007,CN3000300000000,30,3,"Big Horn County, MT",Feb-20,4657,4310,347,7.5
37008,CN3000500000000,30,5,"Blaine County, MT",Feb-20,2530,2424,106,4.2
37009,CN3000700000000,30,7,"Broadwater County, MT",Feb-20,2595,2464,131,5.0
37010,CN3000900000000,30,9,"Carbon County, MT",Feb-20,5516,5265,251,4.6
37011,CN3001100000000,30,11,"Carter County, MT",Feb-20,628,613,15,2.4
37012,CN3001300000000,30,13,"Cascade County, MT",Feb-20,38088,36657,1431,3.8
37013,CN3001500000000,30,15,"Chouteau County, MT",Feb-20,2449,2367,82,3.3
37014,CN3001700000000,30,17,"Custer County, MT",Feb-20,6129,5874,255,4.2
37015,CN3001900000000,30,19,"Daniels County, MT",Feb-20,896,869,27,3.0
37016,CN3002100000000,30,21,"Dawson County, MT",Feb-20,4568,4432,136,3.0
37017,CN3002300000000,30,23,"Deer Lodge County, MT",Feb-20,4999,4806,193,3.9
37018,CN3002500000000,30,25,"Fallon County, MT",Feb-20,1688,1654,34,2.0
37019,CN3002700000000,30,27,"Fergus County, MT",Feb-20,6075,5796,279,4.6
37020,CN3002900000000,30,29,"Flathead County, MT",Feb-20,47768,44807,2961,6.2
37021,CN3003100000000,30,31,"Gallatin County, MT",Feb-20,69563,67824,1739,2.5
37022,CN3003300000000,30,33,"Garfield County, MT",Feb-20,730,708,22,3.0
37023,CN3003500000000,30,35,"Glacier County, MT",Feb-20,5419,4972,447,8.2
37024,CN3003700000000,30,37,"Golden Valley County, MT",Feb-20,369,351,18,4.9
37025,CN3003900000000,30,39,"Granite County, MT",Feb-20,1729,1609,120,6.9
37026,CN3004100000000,30,41,"Hill County, MT",Feb-20,7626,7354,272,3.6
37027,CN3004300000000,30,43,"Jefferson County, MT",Feb-20,5708,5479,229,4.0
37028,CN3004500000000,30,45,"Judith Basin County, MT",Feb-20,985,943,42,4.3
37029,CN3004700000000,30,47,"Lake County, MT",Feb-20,13257,12528,729,5.5
37030,CN3004900000000,30,49,"Lewis and Clark County, MT",Feb-20,35827,34548,1279,3.6
37031,CN3005100000000,30,51,"Liberty County, MT",Feb-20,953,925,28,2.9
37032,CN3005300000000,30,53,"Lincoln County, MT",Feb-20,8042,7261,781,9.7
37033,CN3005500000000,30,55,"McCone County, MT",Feb-20,951,931,20,2.1
37034,CN3005700000000,30,57,"Madison County, MT",Feb-20,5554,5351,203,3.7
37035,CN3005900000000,30,59,"Meagher County, MT",Feb-20,1008,970,38,3.8
37036,CN3006100000000,30,61,"Mineral County, MT",Feb-20,1774,1590,184,10.4
37037,CN3006300000000,30,63,"Missoula County, MT",Feb-20,64456,61886,2570,4.0
37038,CN3006500000000,30,65,"Musselshell County, MT",Feb-20,2293,2164,129,5.6
37039,CN3006700000000,30,67,"Park County, MT",Feb-20,8694,8304,390,4.5
37040,CN3006900000000,30,69,"Petroleum County, MT",Feb-20,283,269,14,4.9
37041,CN3007100000000,30,71,"Phillips County, MT",Feb-20,1876,1790,86,4.6
37042,CN3007300000000,30,73,"Pondera County, MT",Feb-20,2641,2551,90,3.4
37043,CN3007500000000,30,75,"Powder River County, MT",Feb-20,956,927,29,3.0
37044,CN3007700000000,30,77,"Powell County, MT",Feb-20,2921,2797,124,4.2
37045,CN3007900000000,30,79,"Prairie County, MT",Feb-20,484,460,24,5.0
37046,CN3008100000000,30,81,"Ravalli County, MT",Feb-20,20338,19320,1018,5.0
37047,CN3008300000000,30,83,"Richland County, MT",Feb-20,5904,5723,181,3.1
37048,CN3008500000000,30,85,"Roosevelt County, MT",Feb-20,4492,4270,222,4.9
37049,CN3008700000000,30,87,"Rosebud County, MT",Feb-20,3768,3580,188,5.0
37050,CN3008900000000,30,89,"Sanders County, MT",Feb-20,4817,4434,383,8.0
37051,CN3009100000000,30,91,"Sheridan County, MT",Feb-20,1727,1680,47,2.7
37052,CN3009300000000,30,93,"Silver Bow County, MT",Feb-20,17165,16386,779,4.5
37053,CN3009500000000,30,95,"Stillwater County, MT",Feb-20,5335,5151,184,3.4
37054,CN3009700000000,30,97,"Sweet Grass County, MT",Feb-20,1803,1750,53,2.9
37055,CN3009900000000,30,99,"Teton County, MT",Feb-20,2744,2629,115,4.2
37056,CN3010100000000,30,101,"Toole County, MT",Feb-20,2093,2023,70,3.3
37057,CN3010300000000,30,103,"Treasure County, MT",Feb-20,335,327,8,2.4
37058,CN3010500000000,30,105,"Valley County, MT",Feb-20,4025,3870,155,3.9
37059,CN3010700000000,30,107,"Wheatland County, MT",Feb-20,785,747,38,4.8
37060,CN3010900000000,30,109,"Wibaux County, MT",Feb-20,452,438,14,3.1
37061,CN3011100000000,30,111,"Yellowstone County, MT",Feb-20,81734,78737,2997,3.7
37062,CN3100100000000,31,1,"Adams County, NE",Feb-20,16816,16284,532,3.2
37063,CN3100300000000,31,3,"Antelope County, NE",Feb-20,3599,3495,104,2.9
37064,CN3100500000000,31,5,"Arthur County, NE",Feb-20,231,218,13,5.6
37065,CN3100700000000,31,7,"Banner County, NE",Feb-20,389,377,12,3.1
37066,CN3100900000000,31,9,"Blaine County, NE",Feb-20,265,253,12,4.5
37067,CN3101100000000,31,11,"Boone County, NE",Feb-20,2977,2893,84,2.8
37068,CN3101300000000,31,13,"Box Butte County, NE",Feb-20,5359,5192,167,3.1
37069,CN3101500000000,31,15,"Boyd County, NE",Feb-20,1103,1070,33,3.0
37070,CN3101700000000,31,17,"Brown County, NE",Feb-20,1403,1361,42,3.0
37071,CN3101900000000,31,19,"Buffalo County, NE",Feb-20,27792,27084,708,2.5
37072,CN3102100000000,31,21,"Burt County, NE",Feb-20,3493,3347,146,4.2
37073,CN3102300000000,31,23,"Butler County, NE",Feb-20,4511,4382,129,2.9
37074,CN3102500000000,31,25,"Cass County, NE",Feb-20,13685,13232,453,3.3
37075,CN3102700000000,31,27,"Cedar County, NE",Feb-20,4507,4388,119,2.6
37076,CN3102900000000,31,29,"Chase County, NE",Feb-20,2304,2260,44,1.9
37077,CN3103100000000,31,31,"Cherry County, NE",Feb-20,3356,3277,79,2.4
37078,CN3103300000000,31,33,"Cheyenne County, NE",Feb-20,4276,4134,142,3.3
37079,CN3103500000000,31,35,"Clay County, NE",Feb-20,3309,3207,102,3.1
37080,CN3103700000000,31,37,"Colfax County, NE",Feb-20,5571,5437,134,2.4
37081,CN3103900000000,31,39,"Cuming County, NE",Feb-20,4694,4575,119,2.5
37082,CN3104100000000,31,41,"Custer County, NE",Feb-20,6438,6302,136,2.1
37083,CN3104300000000,31,43,"Dakota County, NE",Feb-20,10861,10368,493,4.5
37084,CN3104500000000,31,45,"Dawes County, NE",Feb-20,4906,4789,117,2.4
37085,CN3104700000000,31,47,"Dawson County, NE",Feb-20,13176,12769,407,3.1
37086,CN3104900000000,31,49,"Deuel County, NE",Feb-20,957,934,23,2.4
37087,CN3105100000000,31,51,"Dixon County, NE",Feb-20,3070,2966,104,3.4
37088,CN3105300000000,31,53,"Dodge County, NE",Feb-20,19534,18958,576,2.9
37089,CN3105500000000,31,55,"Douglas County, NE",Feb-20,301739,291893,9846,3.3
37090,CN3105700000000,31,57,"Dundy County, NE",Feb-20,1195,1168,27,2.3
37091,CN3105900000000,31,59,"Fillmore County, NE",Feb-20,3116,3047,69,2.2
37092,CN3106100000000,31,61,"Franklin County, NE",Feb-20,1460,1418,42,2.9
37093,CN3106300000000,31,63,"Frontier County, NE",Feb-20,1646,1586,60,3.6
37094,CN3106500000000,31,65,"Furnas County, NE",Feb-20,2536,2475,61,2.4
37095,CN3106700000000,31,67,"Gage County, NE",Feb-20,11049,10667,382,3.5
37096,CN3106900000000,31,69,"Garden County, NE",Feb-20,1087,1049,38,3.5
37097,CN3107100000000,31,71,"Garfield County, NE",Feb-20,1155,1128,27,2.3
37098,CN3107300000000,31,73,"Gosper County, NE",Feb-20,1098,1075,23,2.1
37099,CN3107500000000,31,75,"Grant County, NE",Feb-20,438,428,10,2.3
37100,CN3107700000000,31,77,"Greeley County, NE",Feb-20,1226,1191,35,2.9
37101,CN3107900000000,31,79,"Hall County, NE",Feb-20,31907,30713,1194,3.7
37102,CN3108100000000,31,81,"Hamilton County, NE",Feb-20,4775,4637,138,2.9
37103,CN3108300000000,31,83,"Harlan County, NE",Feb-20,1773,1719,54,3.0
37104,CN3108500000000,31,85,"Hayes County, NE",Feb-20,633,614,19,3.0
37105,CN3108700000000,31,87,"Hitchcock County, NE",Feb-20,1267,1223,44,3.5
37106,CN3108900000000,31,89,"Holt County, NE",Feb-20,5817,5667,150,2.6
37107,CN3109100000000,31,91,"Hooker County, NE",Feb-20,375,362,13,3.5
37108,CN3109300000000,31,93,"Howard County, NE",Feb-20,3354,3254,100,3.0
37109,CN3109500000000,31,95,"Jefferson County, NE",Feb-20,4190,4081,109,2.6
37110,CN3109700000000,31,97,"Johnson County, NE",Feb-20,2086,2005,81,3.9
37111,CN3109900000000,31,99,"Kearney County, NE",Feb-20,3831,3745,86,2.2
37112,CN3110100000000,31,101,"Keith County, NE",Feb-20,4463,4327,136,3.0
37113,CN3110300000000,31,103,"Keya Paha County, NE",Feb-20,615,602,13,2.1
37114,CN3110500000000,31,105,"Kimball County, NE",Feb-20,2022,1968,54,2.7
37115,CN3110700000000,31,107,"Knox County, NE",Feb-20,4657,4494,163,3.5
37116,CN3110900000000,31,109,"Lancaster County, NE",Feb-20,180252,175492,4760,2.6
37117,CN3111100000000,31,111,"Lincoln County, NE",Feb-20,18180,17569,611,3.4
37118,CN3111300000000,31,113,"Logan County, NE",Feb-20,479,467,12,2.5
37119,CN3111500000000,31,115,"Loup County, NE",Feb-20,415,398,17,4.1
37120,CN3111700000000,31,117,"McPherson County, NE",Feb-20,447,430,17,3.8
37121,CN3111900000000,31,119,"Madison County, NE",Feb-20,19803,19212,591,3.0
37122,CN3112100000000,31,121,"Merrick County, NE",Feb-20,4013,3896,117,2.9
37123,CN3112300000000,31,123,"Morrill County, NE",Feb-20,2649,2549,100,3.8
37124,CN3112500000000,31,125,"Nance County, NE",Feb-20,1992,1936,56,2.8
37125,CN3112700000000,31,127,"Nemaha County, NE",Feb-20,3620,3516,104,2.9
37126,CN3112900000000,31,129,"Nuckolls County, NE",Feb-20,2460,2379,81,3.3
37127,CN3113100000000,31,131,"Otoe County, NE",Feb-20,8475,8237,238,2.8
37128,CN3113300000000,31,133,"Pawnee County, NE",Feb-20,1488,1452,36,2.4
37129,CN3113500000000,31,135,"Perkins County, NE",Feb-20,1834,1798,36,2.0
37130,CN3113700000000,31,137,"Phelps County, NE",Feb-20,5003,4888,115,2.3
37131,CN3113900000000,31,139,"Pierce County, NE",Feb-20,4076,3968,108,2.6
37132,CN3114100000000,31,141,"Platte County, NE",Feb-20,17735,17240,495,2.8
37133,CN3114300000000,31,143,"Polk County, NE",Feb-20,2976,2876,100,3.4
37134,CN3114500000000,31,145,"Red Willow County, NE",Feb-20,5879,5714,165,2.8
37135,CN3114700000000,31,147,"Richardson County, NE",Feb-20,4214,4087,127,3.0
37136,CN3114900000000,31,149,"Rock County, NE",Feb-20,892,871,21,2.4
37137,CN3115100000000,31,151,"Saline County, NE",Feb-20,7463,7196,267,3.6
37138,CN3115300000000,31,153,"Sarpy County, NE",Feb-20,97272,94467,2805,2.9
37139,CN3115500000000,31,155,"Saunders County, NE",Feb-20,11278,10967,311,2.8
37140,CN3115700000000,31,157,"Scotts Bluff County, NE",Feb-20,18034,17391,643,3.6
37141,CN3115900000000,31,159,"Seward County, NE",Feb-20,9110,8857,253,2.8
37142,CN3116100000000,31,161,"Sheridan County, NE",Feb-20,2689,2622,67,2.5
37143,CN3116300000000,31,163,"Sherman County, NE",Feb-20,1698,1642,56,3.3
37144,CN3116500000000,31,165,"Sioux County, NE",Feb-20,745,728,17,2.3
37145,CN3116700000000,31,167,"Stanton County, NE",Feb-20,3531,3431,100,2.8
37146,CN3116900000000,31,169,"Thayer County, NE",Feb-20,2767,2700,67,2.4
37147,CN3117100000000,31,171,"Thomas County, NE",Feb-20,435,414,21,4.8
37148,CN3117300000000,31,173,"Thurston County, NE",Feb-20,3099,2986,113,3.6
37149,CN3117500000000,31,175,"Valley County, NE",Feb-20,2126,2065,61,2.9
37150,CN3117700000000,31,177,"Washington County, NE",Feb-20,11381,11049,332,2.9
37151,CN3117900000000,31,179,"Wayne County, NE",Feb-20,5922,5778,144,2.4
37152,CN3118100000000,31,181,"Webster County, NE",Feb-20,1698,1638,60,3.5
37153,CN3118300000000,31,183,"Wheeler County, NE",Feb-20,566,554,12,2.1
37154,CN3118500000000,31,185,"York County, NE",Feb-20,7208,7029,179,2.5
37155,CN3200100000000,32,1,"Churchill County, NV",Feb-20,11350,10938,412,3.6
37156,CN3200300000000,32,3,"Clark County, NV",Feb-20,1154132,1109378,44754,3.9
37157,CN3200500000000,32,5,"Douglas County, NV",Feb-20,23535,22595,940,4.0
37158,CN3200700000000,32,7,"Elko County, NV",Feb-20,27063,26176,887,3.3
37159,CN3200900000000,32,9,"Esmeralda County, NV",Feb-20,461,443,18,3.9
37160,CN3201100000000,32,11,"Eureka County, NV",Feb-20,1103,1077,26,2.4
37161,CN3201300000000,32,13,"Humboldt County, NV",Feb-20,8317,8043,274,3.3
37162,CN3201500000000,32,15,"Lander County, NV",Feb-20,3264,3143,121,3.7
37163,CN3201700000000,32,17,"Lincoln County, NV",Feb-20,2158,2075,83,3.8
37164,CN3201900000000,32,19,"Lyon County, NV",Feb-20,23639,22464,1175,5.0
37165,CN3202100000000,32,21,"Mineral County, NV",Feb-20,2024,1945,79,3.9
37166,CN3202300000000,32,23,"Nye County, NV",Feb-20,17934,17053,881,4.9
37167,CN3202700000000,32,27,"Pershing County, NV",Feb-20,2594,2481,113,4.4
37168,CN3202900000000,32,29,"Storey County, NV",Feb-20,2087,2008,79,3.8
37169,CN3203100000000,32,31,"Washoe County, NV",Feb-20,261747,253310,8437,3.2
37170,CN3203300000000,32,33,"White Pine County, NV",Feb-20,4697,4540,157,3.3
37171,CN3251000000000,32,510,"Carson City, NV",Feb-20,26889,25783,1106,4.1
37172,CN3300100000000,33,1,"Belknap County, NH",Feb-20,31038,30059,979,3.2
37173,CN3300300000000,33,3,"Carroll County, NH",Feb-20,23727,22973,754,3.2
37174,CN3300500000000,33,5,"Cheshire County, NH",Feb-20,41511,40207,1304,3.1
37175,CN3300700000000,33,7,"Coos County, NH",Feb-20,14734,14116,618,4.2
37176,CN3300900000000,33,9,"Grafton County, NH",Feb-20,51056,49761,1295,2.5
37177,CN3301100000000,33,11,"Hillsborough County, NH",Feb-20,246147,238375,7772,3.2
37178,CN3301300000000,33,13,"Merrimack County, NH",Feb-20,84872,82642,2230,2.6
37179,CN3301500000000,33,15,"Rockingham County, NH",Feb-20,188911,182610,6301,3.3
37180,CN3301700000000,33,17,"Strafford County, NH",Feb-20,75363,73281,2082,2.8
37181,CN3301900000000,33,19,"Sullivan County, NH",Feb-20,23065,22438,627,2.7
37182,CN3400100000000,34,1,"Atlantic County, NJ",Feb-20,121288,113570,7718,6.4
37183,CN3400300000000,34,3,"Bergen County, NJ",Feb-20,493995,477262,16733,3.4
37184,CN3400500000000,34,5,"Burlington County, NJ",Feb-20,235262,226480,8782,3.7
37185,CN3400700000000,34,7,"Camden County, NJ",Feb-20,258589,246814,11775,4.6
37186,CN3400900000000,34,9,"Cape May County, NJ",Feb-20,41867,36790,5077,12.1
37187,CN3401100000000,34,11,"Cumberland County, NJ",Feb-20,66290,61756,4534,6.8
37188,CN3401300000000,34,13,"Essex County, NJ",Feb-20,375825,357005,18820,5.0
37189,CN3401500000000,34,15,"Gloucester County, NJ",Feb-20,153172,146539,6633,4.3
37190,CN3401700000000,34,17,"Hudson County, NJ",Feb-20,369783,356337,13446,3.6
37191,CN3401900000000,34,19,"Hunterdon County, NJ",Feb-20,65595,63361,2234,3.4
37192,CN3402100000000,34,21,"Mercer County, NJ",Feb-20,207301,199797,7504,3.6
37193,CN3402300000000,34,23,"Middlesex County, NJ",Feb-20,447281,431391,15890,3.6
37194,CN3402500000000,34,25,"Monmouth County, NJ",Feb-20,335263,322679,12584,3.8
37195,CN3402700000000,34,27,"Morris County, NJ",Feb-20,261338,252699,8639,3.3
37196,CN3402900000000,34,29,"Ocean County, NJ",Feb-20,281663,268725,12938,4.6
37197,CN3403100000000,34,31,"Passaic County, NJ",Feb-20,248840,236273,12567,5.1
37198,CN3403300000000,34,33,"Salem County, NJ",Feb-20,29831,28107,1724,5.8
37199,CN3403500000000,34,35,"Somerset County, NJ",Feb-20,174401,168315,6086,3.5
37200,CN3403700000000,34,37,"Sussex County, NJ",Feb-20,75572,72232,3340,4.4
37201,CN3403900000000,34,39,"Union County, NJ",Feb-20,281827,269659,12168,4.3
37202,CN3404100000000,34,41,"Warren County, NJ",Feb-20,57182,54793,2389,4.2
37203,CN3500100000000,35,1,"Bernalillo County, NM",Feb-20,336093,321028,15065,4.5
37204,CN3500300000000,35,3,"Catron County, NM",Feb-20,1134,1038,96,8.5
37205,CN3500500000000,35,5,"Chaves County, NM",Feb-20,27326,25990,1336,4.9
37206,CN3500600000000,35,6,"Cibola County, NM",Feb-20,9003,8420,583,6.5
37207,CN3500700000000,35,7,"Colfax County, NM",Feb-20,5296,5046,250,4.7
37208,CN3500900000000,35,9,"Curry County, NM",Feb-20,21584,20708,876,4.1
37209,CN3501100000000,35,11,"De Baca County, NM",Feb-20,702,672,30,4.3
37210,CN3501300000000,35,13,"Dona Ana County, NM",Feb-20,98887,92693,6194,6.3
37211,CN3501500000000,35,15,"Eddy County, NM",Feb-20,36399,35261,1138,3.1
37212,CN3501700000000,35,17,"Grant County, NM",Feb-20,12193,11594,599,4.9
37213,CN3501900000000,35,19,"Guadalupe County, NM",Feb-20,1463,1391,72,4.9
37214,CN3502100000000,35,21,"Harding County, NM",Feb-20,287,274,13,4.5
37215,CN3502300000000,35,23,"Hidalgo County, NM",Feb-20,2001,1907,94,4.7
37216,CN3502500000000,35,25,"Lea County, NM",Feb-20,32637,31288,1349,4.1
37217,CN3502700000000,35,27,"Lincoln County, NM",Feb-20,8681,8239,442,5.1
37218,CN3502800000000,35,28,"Los Alamos County, NM",Feb-20,9468,9164,304,3.2
37219,CN3502900000000,35,29,"Luna County, NM",Feb-20,9915,8199,1716,17.3
37220,CN3503100000000,35,31,"McKinley County, NM",Feb-20,24368,22653,1715,7.0
37221,CN3503300000000,35,33,"Mora County, NM",Feb-20,2071,1924,147,7.1
37222,CN3503500000000,35,35,"Otero County, NM",Feb-20,24977,23707,1270,5.1
37223,CN3503700000000,35,37,"Quay County, NM",Feb-20,3161,2995,166,5.3
37224,CN3503900000000,35,39,"Rio Arriba County, NM",Feb-20,16676,15722,954,5.7
37225,CN3504100000000,35,41,"Roosevelt County, NM",Feb-20,7959,7612,347,4.4
37226,CN3504300000000,35,43,"Sandoval County, NM",Feb-20,66572,63357,3215,4.8
37227,CN3504500000000,35,45,"San Juan County, NM",Feb-20,51597,48337,3260,6.3
37228,CN3504700000000,35,47,"San Miguel County, NM",Feb-20,11076,10431,645,5.8
37229,CN3504900000000,35,49,"Santa Fe County, NM",Feb-20,77000,73938,3062,4.0
37230,CN3505100000000,35,51,"Sierra County, NM",Feb-20,3791,3471,320,8.4
37231,CN3505300000000,35,53,"Socorro County, NM",Feb-20,6301,5957,344,5.5
37232,CN3505500000000,35,55,"Taos County, NM",Feb-20,15607,14646,961,6.2
37233,CN3505700000000,35,57,"Torrance County, NM",Feb-20,5443,5060,383,7.0
37234,CN3505900000000,35,59,"Union County, NM",Feb-20,1669,1599,70,4.2
37235,CN3506100000000,35,61,"Valencia County, NM",Feb-20,30801,29133,1668,5.4
37236,CN3600100000000,36,1,"Albany County, NY",Feb-20,159966,154090,5876,3.7
37237,CN3600300000000,36,3,"Allegany County, NY",Feb-20,20223,18969,1254,6.2
37238,CN3600500000000,36,5,"Bronx County, NY",Feb-20,597969,570240,27729,4.6
37239,CN3600700000000,36,7,"Broome County, NY",Feb-20,84313,79751,4562,5.4
37240,CN3600900000000,36,9,"Cattaraugus County, NY",Feb-20,34975,32857,2118,6.1
37241,CN3601100000000,36,11,"Cayuga County, NY",Feb-20,35707,33881,1826,5.1
37242,CN3601300000000,36,13,"Chautauqua County, NY",Feb-20,54615,51546,3069,5.6
37243,CN3601500000000,36,15,"Chemung County, NY",Feb-20,35369,33695,1674,4.7
37244,CN3601700000000,36,17,"Chenango County, NY",Feb-20,22142,20921,1221,5.5
37245,CN3601900000000,36,19,"Clinton County, NY",Feb-20,36529,34693,1836,5.0
37246,CN3602100000000,36,21,"Columbia County, NY",Feb-20,31022,29859,1163,3.7
37247,CN3602300000000,36,23,"Cortland County, NY",Feb-20,23590,22215,1375,5.8
37248,CN3602500000000,36,25,"Delaware County, NY",Feb-20,19213,18170,1043,5.4
37249,CN3602700000000,36,27,"Dutchess County, NY",Feb-20,145225,139631,5594,3.9
37250,CN3602900000000,36,29,"Erie County, NY",Feb-20,443692,422871,20821,4.7
37251,CN3603100000000,36,31,"Essex County, NY",Feb-20,17501,16480,1021,5.8
37252,CN3603300000000,36,33,"Franklin County, NY",Feb-20,19887,18766,1121,5.6
37253,CN3603500000000,36,35,"Fulton County, NY",Feb-20,22944,21622,1322,5.8
37254,CN3603700000000,36,37,"Genesee County, NY",Feb-20,29666,28220,1446,4.9
37255,CN3603900000000,36,39,"Greene County, NY",Feb-20,21004,19962,1042,5.0
37256,CN3604100000000,36,41,"Hamilton County, NY",Feb-20,2133,1948,185,8.7
37257,CN3604300000000,36,43,"Herkimer County, NY",Feb-20,28110,26476,1634,5.8
37258,CN3604500000000,36,45,"Jefferson County, NY",Feb-20,43773,40682,3091,7.1
37259,CN3604700000000,36,47,"Kings County, NY",Feb-20,1201328,1159584,41744,3.5
37260,CN3604900000000,36,49,"Lewis County, NY",Feb-20,11869,10988,881,7.4
37261,CN3605100000000,36,51,"Livingston County, NY",Feb-20,31062,29520,1542,5.0
37262,CN3605300000000,36,53,"Madison County, NY",Feb-20,33055,31344,1711,5.2
37263,CN3605500000000,36,55,"Monroe County, NY",Feb-20,364822,349017,15805,4.3
37264,CN3605700000000,36,57,"Montgomery County, NY",Feb-20,22482,21117,1365,6.1
37265,CN3605900000000,36,59,"Nassau County, NY",Feb-20,712029,687125,24904,3.5
37266,CN3606100000000,36,61,"New York County, NY",Feb-20,915144,887541,27603,3.0
37267,CN3606300000000,36,63,"Niagara County, NY",Feb-20,99656,93887,5769,5.8
37268,CN3606500000000,36,65,"Oneida County, NY",Feb-20,101255,96649,4606,4.5
37269,CN3606700000000,36,67,"Onondaga County, NY",Feb-20,222463,213015,9448,4.2
37270,CN3606900000000,36,69,"Ontario County, NY",Feb-20,56038,53540,2498,4.5
37271,CN3607100000000,36,71,"Orange County, NY",Feb-20,184812,177326,7486,4.1
37272,CN3607300000000,36,73,"Orleans County, NY",Feb-20,17705,16738,967,5.5
37273,CN3607500000000,36,75,"Oswego County, NY",Feb-20,53728,50310,3418,6.4
37274,CN3607700000000,36,77,"Otsego County, NY",Feb-20,28222,26774,1448,5.1
37275,CN3607900000000,36,79,"Putnam County, NY",Feb-20,51713,49669,2044,4.0
37276,CN3608100000000,36,81,"Queens County, NY",Feb-20,1143541,1109421,34120,3.0
37277,CN3608300000000,36,83,"Rensselaer County, NY",Feb-20,82606,79250,3356,4.1
37278,CN3608500000000,36,85,"Richmond County, NY",Feb-20,222822,215436,7386,3.3
37279,CN3608700000000,36,87,"Rockland County, NY",Feb-20,155260,149590,5670,3.7
37280,CN3608900000000,36,89,"St. Lawrence County, NY",Feb-20,44009,41358,2651,6.0
37281,CN3609100000000,36,91,"Saratoga County, NY",Feb-20,121073,116700,4373,3.6
37282,CN3609300000000,36,93,"Schenectady County, NY",Feb-20,77324,74262,3062,4.0
37283,CN3609500000000,36,95,"Schoharie County, NY",Feb-20,14989,14105,884,5.9
37284,CN3609700000000,36,97,"Schuyler County, NY",Feb-20,8027,7515,512,6.4
37285,CN3609900000000,36,99,"Seneca County, NY",Feb-20,16208,15437,771,4.8
37286,CN3610100000000,36,101,"Steuben County, NY",Feb-20,42795,40462,2333,5.5
37287,CN3610300000000,36,103,"Suffolk County, NY",Feb-20,783945,752486,31459,4.0
37288,CN3610500000000,36,105,"Sullivan County, NY",Feb-20,37039,35341,1698,4.6
37289,CN3610700000000,36,107,"Tioga County, NY",Feb-20,22934,21779,1155,5.0
37290,CN3610900000000,36,109,"Tompkins County, NY",Feb-20,50354,48573,1781,3.5
37291,CN3611100000000,36,111,"Ulster County, NY",Feb-20,88527,84917,3610,4.1
37292,CN3611300000000,36,113,"Warren County, NY",Feb-20,31261,29593,1668,5.3
37293,CN3611500000000,36,115,"Washington County, NY",Feb-20,27667,26335,1332,4.8
37294,CN3611700000000,36,117,"Wayne County, NY",Feb-20,44343,42176,2167,4.9
37295,CN3611900000000,36,119,"Westchester County, NY",Feb-20,484949,466144,18805,3.9
37296,CN3612100000000,36,121,"Wyoming County, NY",Feb-20,18038,16962,1076,6.0
37297,CN3612300000000,36,123,"Yates County, NY",Feb-20,11955,11370,585,4.9
37298,CN3700100000000,37,1,"Alamance County, NC",Feb-20,83276,80318,2958,3.6
37299,CN3700300000000,37,3,"Alexander County, NC",Feb-20,18275,17728,547,3.0
37300,CN3700500000000,37,5,"Alleghany County, NC",Feb-20,4428,4199,229,5.2
37301,CN3700700000000,37,7,"Anson County, NC",Feb-20,11099,10606,493,4.4
37302,CN3700900000000,37,9,"Ashe County, NC",Feb-20,13044,12540,504,3.9
37303,CN3701100000000,37,11,"Avery County, NC",Feb-20,7351,7061,290,3.9
37304,CN3701300000000,37,13,"Beaufort County, NC",Feb-20,19600,18733,867,4.4
37305,CN3701500000000,37,15,"Bertie County, NC",Feb-20,7900,7484,416,5.3
37306,CN3701700000000,37,17,"Bladen County, NC",Feb-20,14865,14147,718,4.8
37307,CN3701900000000,37,19,"Brunswick County, NC",Feb-20,53883,51078,2805,5.2
37308,CN3702100000000,37,21,"Buncombe County, NC",Feb-20,142495,138349,4146,2.9
37309,CN3702300000000,37,23,"Burke County, NC",Feb-20,41626,40167,1459,3.5
37310,CN3702500000000,37,25,"Cabarrus County, NC",Feb-20,111342,107570,3772,3.4
37311,CN3702700000000,37,27,"Caldwell County, NC",Feb-20,37044,35700,1344,3.6
37312,CN3702900000000,37,29,"Camden County, NC",Feb-20,4660,4491,169,3.6
37313,CN3703100000000,37,31,"Carteret County, NC",Feb-20,31816,30490,1326,4.2
37314,CN3703300000000,37,33,"Caswell County, NC",Feb-20,10019,9587,432,4.3
37315,CN3703500000000,37,35,"Catawba County, NC",Feb-20,80010,77273,2737,3.4
37316,CN3703700000000,37,37,"Chatham County, NC",Feb-20,36696,35535,1161,3.2
37317,CN3703900000000,37,39,"Cherokee County, NC",Feb-20,11192,10699,493,4.4
37318,CN3704100000000,37,41,"Chowan County, NC",Feb-20,5599,5356,243,4.3
37319,CN3704300000000,37,43,"Clay County, NC",Feb-20,4149,3973,176,4.2
37320,CN3704500000000,37,45,"Cleveland County, NC",Feb-20,49665,47721,1944,3.9
37321,CN3704700000000,37,47,"Columbus County, NC",Feb-20,23266,22118,1148,4.9
37322,CN3704900000000,37,49,"Craven County, NC",Feb-20,42227,40643,1584,3.8
37323,CN3705100000000,37,51,"Cumberland County, NC",Feb-20,128711,122411,6300,4.9
37324,CN3705300000000,37,53,"Currituck County, NC",Feb-20,14149,13598,551,3.9
37325,CN3705500000000,37,55,"Dare County, NC",Feb-20,17924,16526,1398,7.8
37326,CN3705700000000,37,57,"Davidson County, NC",Feb-20,82222,79240,2982,3.6
37327,CN3705900000000,37,59,"Davie County, NC",Feb-20,20984,20295,689,3.3
37328,CN3706100000000,37,61,"Duplin County, NC",Feb-20,26191,25201,990,3.8
37329,CN3706300000000,37,63,"Durham County, NC",Feb-20,175112,169663,5449,3.1
37330,CN3706500000000,37,65,"Edgecombe County, NC",Feb-20,21477,20340,1137,5.3
37331,CN3706700000000,37,67,"Forsyth County, NC",Feb-20,190349,183667,6682,3.5
37332,CN3706900000000,37,69,"Franklin County, NC",Feb-20,32101,30895,1206,3.8
37333,CN3707100000000,37,71,"Gaston County, NC",Feb-20,113505,109177,4328,3.8
37334,CN3707300000000,37,73,"Gates County, NC",Feb-20,5357,5146,211,3.9
37335,CN3707500000000,37,75,"Graham County, NC",Feb-20,3091,2893,198,6.4
37336,CN3707700000000,37,77,"Granville County, NC",Feb-20,30494,29522,972,3.2
37337,CN3707900000000,37,79,"Greene County, NC",Feb-20,9708,9366,342,3.5
37338,CN3708100000000,37,81,"Guilford County, NC",Feb-20,265470,255220,10250,3.9
37339,CN3708300000000,37,83,"Halifax County, NC",Feb-20,20703,19483,1220,5.9
37340,CN3708500000000,37,85,"Harnett County, NC",Feb-20,54311,52033,2278,4.2
37341,CN3708700000000,37,87,"Haywood County, NC",Feb-20,30431,29378,1053,3.5
37342,CN3708900000000,37,89,"Henderson County, NC",Feb-20,55896,54149,1747,3.1
37343,CN3709100000000,37,91,"Hertford County, NC",Feb-20,9254,8784,470,5.1
37344,CN3709300000000,37,93,"Hoke County, NC",Feb-20,20345,19362,983,4.8
37345,CN3709500000000,37,95,"Hyde County, NC",Feb-20,1814,1573,241,13.3
37346,CN3709700000000,37,97,"Iredell County, NC",Feb-20,91505,88282,3223,3.5
37347,CN3709900000000,37,99,"Jackson County, NC",Feb-20,19682,18865,817,4.2
37348,CN3710100000000,37,101,"Johnston County, NC",Feb-20,101739,98304,3435,3.4
37349,CN3710300000000,37,103,"Jones County, NC",Feb-20,4481,4321,160,3.6
37350,CN3710500000000,37,105,"Lee County, NC",Feb-20,26110,25043,1067,4.1
37351,CN3710700000000,37,107,"Lenoir County, NC",Feb-20,28183,27164,1019,3.6
37352,CN3710900000000,37,109,"Lincoln County, NC",Feb-20,44506,42978,1528,3.4
37353,CN3711100000000,37,111,"McDowell County, NC",Feb-20,20799,20013,786,3.8
37354,CN3711300000000,37,113,"Macon County, NC",Feb-20,15374,14732,642,4.2
37355,CN3711500000000,37,115,"Madison County, NC",Feb-20,10330,9957,373,3.6
37356,CN3711700000000,37,117,"Martin County, NC",Feb-20,9102,8685,417,4.6
37357,CN3711900000000,37,119,"Mecklenburg County, NC",Feb-20,634601,612810,21791,3.4
37358,CN3712100000000,37,121,"Mitchell County, NC",Feb-20,6007,5708,299,5.0
37359,CN3712300000000,37,123,"Montgomery County, NC",Feb-20,11674,11235,439,3.8
37360,CN3712500000000,37,125,"Moore County, NC",Feb-20,43031,41489,1542,3.6
37361,CN3712700000000,37,127,"Nash County, NC",Feb-20,43782,41824,1958,4.5
37362,CN3712900000000,37,129,"New Hanover County, NC",Feb-20,126122,121823,4299,3.4
37363,CN3713100000000,37,131,"Northampton County, NC",Feb-20,7899,7467,432,5.5
37364,CN3713300000000,37,133,"Onslow County, NC",Feb-20,66639,63817,2822,4.2
37365,CN3713500000000,37,135,"Orange County, NC",Feb-20,80757,78387,2370,2.9
37366,CN3713700000000,37,137,"Pamlico County, NC",Feb-20,5412,5223,189,3.5
37367,CN3713900000000,37,139,"Pasquotank County, NC",Feb-20,16778,16015,763,4.5
37368,CN3714100000000,37,141,"Pender County, NC",Feb-20,29435,28334,1101,3.7
37369,CN3714300000000,37,143,"Perquimans County, NC",Feb-20,5013,4777,236,4.7
37370,CN3714500000000,37,145,"Person County, NC",Feb-20,18898,18153,745,3.9
37371,CN3714700000000,37,147,"Pitt County, NC",Feb-20,90938,87423,3515,3.9
37372,CN3714900000000,37,149,"Polk County, NC",Feb-20,9044,8725,319,3.5
37373,CN3715100000000,37,151,"Randolph County, NC",Feb-20,67120,64725,2395,3.6
37374,CN3715300000000,37,153,"Richmond County, NC",Feb-20,16870,15981,889,5.3
37375,CN3715500000000,37,155,"Robeson County, NC",Feb-20,51090,48495,2595,5.1
37376,CN3715700000000,37,157,"Rockingham County, NC",Feb-20,40690,38962,1728,4.2
37377,CN3715900000000,37,159,"Rowan County, NC",Feb-20,67794,65100,2694,4.0
37378,CN3716100000000,37,161,"Rutherford County, NC",Feb-20,25678,24427,1251,4.9
37379,CN3716300000000,37,163,"Sampson County, NC",Feb-20,30190,29060,1130,3.7
37380,CN3716500000000,37,165,"Scotland County, NC",Feb-20,11793,11014,779,6.6
37381,CN3716700000000,37,167,"Stanly County, NC",Feb-20,30741,29613,1128,3.7
37382,CN3716900000000,37,169,"Stokes County, NC",Feb-20,22092,21313,779,3.5
37383,CN3717100000000,37,171,"Surry County, NC",Feb-20,34217,32972,1245,3.6
37384,CN3717300000000,37,173,"Swain County, NC",Feb-20,6729,6407,322,4.8
37385,CN3717500000000,37,175,"Transylvania County, NC",Feb-20,14661,14155,506,3.5
37386,CN3717700000000,37,177,"Tyrrell County, NC",Feb-20,1335,1238,97,7.3
37387,CN3717900000000,37,179,"Union County, NC",Feb-20,126622,122496,4126,3.3
37388,CN3718100000000,37,181,"Vance County, NC",Feb-20,17492,16536,956,5.5
37389,CN3718300000000,37,183,"Wake County, NC",Feb-20,610600,591633,18967,3.1
37390,CN3718500000000,37,185,"Warren County, NC",Feb-20,6738,6371,367,5.4
37391,CN3718700000000,37,187,"Washington County, NC",Feb-20,4448,4153,295,6.6
37392,CN3718900000000,37,189,"Watauga County, NC",Feb-20,29831,28892,939,3.1
37393,CN3719100000000,37,191,"Wayne County, NC",Feb-20,52632,50575,2057,3.9
37394,CN3719300000000,37,193,"Wilkes County, NC",Feb-20,29313,28140,1173,4.0
37395,CN3719500000000,37,195,"Wilson County, NC",Feb-20,35138,33272,1866,5.3
37396,CN3719700000000,37,197,"Yadkin County, NC",Feb-20,18061,17446,615,3.4
37397,CN3719900000000,37,199,"Yancey County, NC",Feb-20,8523,8181,342,4.0
37398,CN3800100000000,38,1,"Adams County, ND",Feb-20,1059,1027,32,3.0
37399,CN3800300000000,38,3,"Barnes County, ND",Feb-20,5148,5013,135,2.6
37400,CN3800500000000,38,5,"Benson County, ND",Feb-20,2293,2187,106,4.6
37401,CN3800700000000,38,7,"Billings County, ND",Feb-20,351,341,10,2.8
37402,CN3800900000000,38,9,"Bottineau County, ND",Feb-20,2841,2721,120,4.2
37403,CN3801100000000,38,11,"Bowman County, ND",Feb-20,1694,1661,33,1.9
37404,CN3801300000000,38,13,"Burke County, ND",Feb-20,1037,1007,30,2.9
37405,CN3801500000000,38,15,"Burleigh County, ND",Feb-20,49182,47770,1412,2.9
37406,CN3801700000000,38,17,"Cass County, ND",Feb-20,103043,100696,2347,2.3
37407,CN3801900000000,38,19,"Cavalier County, ND",Feb-20,1837,1774,63,3.4
37408,CN3802100000000,38,21,"Dickey County, ND",Feb-20,2234,2190,44,2.0
37409,CN3802300000000,38,23,"Divide County, ND",Feb-20,1345,1326,19,1.4
37410,CN3802500000000,38,25,"Dunn County, ND",Feb-20,3137,3083,54,1.7
37411,CN3802700000000,38,27,"Eddy County, ND",Feb-20,1180,1125,55,4.7
37412,CN3802900000000,38,29,"Emmons County, ND",Feb-20,1414,1332,82,5.8
37413,CN3803100000000,38,31,"Foster County, ND",Feb-20,1442,1399,43,3.0
37414,CN3803300000000,38,33,"Golden Valley County, ND",Feb-20,811,794,17,2.1
37415,CN3803500000000,38,35,"Grand Forks County, ND",Feb-20,37090,36228,862,2.3
37416,CN3803700000000,38,37,"Grant County, ND",Feb-20,1174,1143,31,2.6
37417,CN3803900000000,38,39,"Griggs County, ND",Feb-20,988,966,22,2.2
37418,CN3804100000000,38,41,"Hettinger County, ND",Feb-20,1306,1271,35,2.7
37419,CN3804300000000,38,43,"Kidder County, ND",Feb-20,1233,1167,66,5.4
37420,CN3804500000000,38,45,"LaMoure County, ND",Feb-20,1980,1931,49,2.5
37421,CN3804700000000,38,47,"Logan County, ND",Feb-20,866,835,31,3.6
37422,CN3804900000000,38,49,"McHenry County, ND",Feb-20,3007,2853,154,5.1
37423,CN3805100000000,38,51,"McIntosh County, ND",Feb-20,1090,1054,36,3.3
37424,CN3805300000000,38,53,"McKenzie County, ND",Feb-20,10268,10063,205,2.0
37425,CN3805500000000,38,55,"McLean County, ND",Feb-20,4521,4321,200,4.4
37426,CN3805700000000,38,57,"Mercer County, ND",Feb-20,3348,3159,189,5.6
37427,CN3805900000000,38,59,"Morton County, ND",Feb-20,16258,15638,620,3.8
37428,CN3806100000000,38,61,"Mountrail County, ND",Feb-20,7345,7223,122,1.7
37429,CN3806300000000,38,63,"Nelson County, ND",Feb-20,1350,1298,52,3.9
37430,CN3806500000000,38,65,"Oliver County, ND",Feb-20,867,817,50,5.8
37431,CN3806700000000,38,67,"Pembina County, ND",Feb-20,3207,3072,135,4.2
37432,CN3806900000000,38,69,"Pierce County, ND",Feb-20,1663,1599,64,3.8
37433,CN3807100000000,38,71,"Ramsey County, ND",Feb-20,5403,5220,183,3.4
37434,CN3807300000000,38,73,"Ransom County, ND",Feb-20,2772,2710,62,2.2
37435,CN3807500000000,38,75,"Renville County, ND",Feb-20,1199,1158,41,3.4
37436,CN3807700000000,38,77,"Richland County, ND",Feb-20,8393,8185,208,2.5
37437,CN3807900000000,38,79,"Rolette County, ND",Feb-20,4557,4162,395,8.7
37438,CN3808100000000,38,81,"Sargent County, ND",Feb-20,2607,2565,42,1.6
37439,CN3808300000000,38,83,"Sheridan County, ND",Feb-20,659,606,53,8.0
37440,CN3808500000000,38,85,"Sioux County, ND",Feb-20,1203,1167,36,3.0
37441,CN3808700000000,38,87,"Slope County, ND",Feb-20,387,378,9,2.3
37442,CN3808900000000,38,89,"Stark County, ND",Feb-20,18147,17695,452,2.5
37443,CN3809100000000,38,91,"Steele County, ND",Feb-20,938,921,17,1.8
37444,CN3809300000000,38,93,"Stutsman County, ND",Feb-20,10055,9788,267,2.7
37445,CN3809500000000,38,95,"Towner County, ND",Feb-20,1028,999,29,2.8
37446,CN3809700000000,38,97,"Traill County, ND",Feb-20,4311,4195,116,2.7
37447,CN3809900000000,38,99,"Walsh County, ND",Feb-20,4928,4757,171,3.5
37448,CN3810100000000,38,101,"Ward County, ND",Feb-20,30940,29979,961,3.1
37449,CN3810300000000,38,103,"Wells County, ND",Feb-20,1830,1743,87,4.8
37450,CN3810500000000,38,105,"Williams County, ND",Feb-20,23774,23280,494,2.1
37451,CN3900100000000,39,1,"Adams County, OH",Feb-20,10945,10006,939,8.6
37452,CN3900300000000,39,3,"Allen County, OH",Feb-20,48093,45747,2346,4.9
37453,CN3900500000000,39,5,"Ashland County, OH",Feb-20,27418,26111,1307,4.8
37454,CN3900700000000,39,7,"Ashtabula County, OH",Feb-20,44752,42055,2697,6.0
37455,CN3900900000000,39,9,"Athens County, OH",Feb-20,29730,28130,1600,5.4
37456,CN3901100000000,39,11,"Auglaize County, OH",Feb-20,25205,24299,906,3.6
37457,CN3901300000000,39,13,"Belmont County, OH",Feb-20,30043,27682,2361,7.9
37458,CN3901500000000,39,15,"Brown County, OH",Feb-20,19924,18680,1244,6.2
37459,CN3901700000000,39,17,"Butler County, OH",Feb-20,196234,188255,7979,4.1
37460,CN3901900000000,39,19,"Carroll County, OH",Feb-20,13162,12319,843,6.4
37461,CN3902100000000,39,21,"Champaign County, OH",Feb-20,20389,19537,852,4.2
37462,CN3902300000000,39,23,"Clark County, OH",Feb-20,63841,60657,3184,5.0
37463,CN3902500000000,39,25,"Clermont County, OH",Feb-20,107616,103083,4533,4.2
37464,CN3902700000000,39,27,"Clinton County, OH",Feb-20,18166,17207,959,5.3
37465,CN3902900000000,39,29,"Columbiana County, OH",Feb-20,47705,44910,2795,5.9
37466,CN3903100000000,39,31,"Coshocton County, OH",Feb-20,14292,13309,983,6.9
37467,CN3903300000000,39,33,"Crawford County, OH",Feb-20,18383,17400,983,5.3
37468,CN3903500000000,39,35,"Cuyahoga County, OH",Feb-20,610234,578981,31253,5.1
37469,CN3903700000000,39,37,"Darke County, OH",Feb-20,26122,24955,1167,4.5
37470,CN3903900000000,39,39,"Defiance County, OH",Feb-20,18107,17265,842,4.7
37471,CN3904100000000,39,41,"Delaware County, OH",Feb-20,111969,108307,3662,3.3
37472,CN3904300000000,39,43,"Erie County, OH",Feb-20,35696,33540,2156,6.0
37473,CN3904500000000,39,45,"Fairfield County, OH",Feb-20,79520,76244,3276,4.1
37474,CN3904700000000,39,47,"Fayette County, OH",Feb-20,14082,13476,606,4.3
37475,CN3904900000000,39,49,"Franklin County, OH",Feb-20,707952,682088,25864,3.7
37476,CN3905100000000,39,51,"Fulton County, OH",Feb-20,22801,21611,1190,5.2
37477,CN3905300000000,39,53,"Gallia County, OH",Feb-20,12535,11662,873,7.0
37478,CN3905500000000,39,55,"Geauga County, OH",Feb-20,49048,46796,2252,4.6
37479,CN3905700000000,39,57,"Greene County, OH",Feb-20,83707,80423,3284,3.9
37480,CN3905900000000,39,59,"Guernsey County, OH",Feb-20,18759,17336,1423,7.6
37481,CN3906100000000,39,61,"Hamilton County, OH",Feb-20,417841,401136,16705,4.0
37482,CN3906300000000,39,63,"Hancock County, OH",Feb-20,42297,40850,1447,3.4
37483,CN3906500000000,39,65,"Hardin County, OH",Feb-20,13964,13298,666,4.8
37484,CN3906700000000,39,67,"Harrison County, OH",Feb-20,6711,6231,480,7.2
37485,CN3906900000000,39,69,"Henry County, OH",Feb-20,13321,12512,809,6.1
37486,CN3907100000000,39,71,"Highland County, OH",Feb-20,17348,16277,1071,6.2
37487,CN3907300000000,39,73,"Hocking County, OH",Feb-20,13403,12642,761,5.7
37488,CN3907500000000,39,75,"Holmes County, OH",Feb-20,20904,20211,693,3.3
37489,CN3907700000000,39,77,"Huron County, OH",Feb-20,28209,25985,2224,7.9
37490,CN3907900000000,39,79,"Jackson County, OH",Feb-20,12919,11876,1043,8.1
37491,CN3908100000000,39,81,"Jefferson County, OH",Feb-20,27714,25756,1958,7.1
37492,CN3908300000000,39,83,"Knox County, OH",Feb-20,32123,30724,1399,4.4
37493,CN3908500000000,39,85,"Lake County, OH",Feb-20,126348,120078,6270,5.0
37494,CN3908700000000,39,87,"Lawrence County, OH",Feb-20,24087,22670,1417,5.9
37495,CN3908900000000,39,89,"Licking County, OH",Feb-20,92159,88399,3760,4.1
37496,CN3909100000000,39,91,"Logan County, OH",Feb-20,23192,22221,971,4.2
37497,CN3909300000000,39,93,"Lorain County, OH",Feb-20,153900,145307,8593,5.6
37498,CN3909500000000,39,95,"Lucas County, OH",Feb-20,210802,200235,10567,5.0
37499,CN3909700000000,39,97,"Madison County, OH",Feb-20,21269,20470,799,3.8
37500,CN3909900000000,39,99,"Mahoning County, OH",Feb-20,102618,96152,6466,6.3
37501,CN3910100000000,39,101,"Marion County, OH",Feb-20,28434,27206,1228,4.3
37502,CN3910300000000,39,103,"Medina County, OH",Feb-20,97322,93045,4277,4.4
37503,CN3910500000000,39,105,"Meigs County, OH",Feb-20,9255,8437,818,8.8
37504,CN3910700000000,39,107,"Mercer County, OH",Feb-20,23442,22711,731,3.1
37505,CN3910900000000,39,109,"Miami County, OH",Feb-20,54647,52354,2293,4.2
37506,CN3911100000000,39,111,"Monroe County, OH",Feb-20,5468,4860,608,11.1
37507,CN3911300000000,39,113,"Montgomery County, OH",Feb-20,253881,242538,11343,4.5
37508,CN3911500000000,39,115,"Morgan County, OH",Feb-20,6880,6256,624,9.1
37509,CN3911700000000,39,117,"Morrow County, OH",Feb-20,17206,16354,852,5.0
37510,CN3911900000000,39,119,"Muskingum County, OH",Feb-20,40086,37561,2525,6.3
37511,CN3912100000000,39,121,"Noble County, OH",Feb-20,4724,4301,423,9.0
37512,CN3912300000000,39,123,"Ottawa County, OH",Feb-20,20373,18691,1682,8.3
37513,CN3912500000000,39,125,"Paulding County, OH",Feb-20,8745,8273,472,5.4
37514,CN3912700000000,39,127,"Perry County, OH",Feb-20,16406,15326,1080,6.6
37515,CN3912900000000,39,129,"Pickaway County, OH",Feb-20,27073,25811,1262,4.7
37516,CN3913100000000,39,131,"Pike County, OH",Feb-20,10948,10093,855,7.8
37517,CN3913300000000,39,133,"Portage County, OH",Feb-20,87704,83354,4350,5.0
37518,CN3913500000000,39,135,"Preble County, OH",Feb-20,21283,20324,959,4.5
37519,CN3913700000000,39,137,"Putnam County, OH",Feb-20,18957,18242,715,3.8
37520,CN3913900000000,39,139,"Richland County, OH",Feb-20,52506,49774,2732,5.2
37521,CN3914100000000,39,141,"Ross County, OH",Feb-20,35942,34017,1925,5.4
37522,CN3914300000000,39,143,"Sandusky County, OH",Feb-20,30603,29040,1563,5.1
37523,CN3914500000000,39,145,"Scioto County, OH",Feb-20,29379,27104,2275,7.7
37524,CN3914700000000,39,147,"Seneca County, OH",Feb-20,27514,26216,1298,4.7
37525,CN3914900000000,39,149,"Shelby County, OH",Feb-20,24009,23026,983,4.1
37526,CN3915100000000,39,151,"Stark County, OH",Feb-20,186855,176954,9901,5.3
37527,CN3915300000000,39,153,"Summit County, OH",Feb-20,272981,259777,13204,4.8
37528,CN3915500000000,39,155,"Trumbull County, OH",Feb-20,86398,80543,5855,6.8
37529,CN3915700000000,39,157,"Tuscarawas County, OH",Feb-20,45014,42547,2467,5.5
37530,CN3915900000000,39,159,"Union County, OH",Feb-20,29528,28506,1022,3.5
37531,CN3916100000000,39,161,"Van Wert County, OH",Feb-20,15350,14680,670,4.4
37532,CN3916300000000,39,163,"Vinton County, OH",Feb-20,5726,5246,480,8.4
37533,CN3916500000000,39,165,"Warren County, OH",Feb-20,119764,115292,4472,3.7
37534,CN3916700000000,39,167,"Washington County, OH",Feb-20,27664,25787,1877,6.8
37535,CN3916900000000,39,169,"Wayne County, OH",Feb-20,63490,61194,2296,3.6
37536,CN3917100000000,39,171,"Williams County, OH",Feb-20,19006,18283,723,3.8
37537,CN3917300000000,39,173,"Wood County, OH",Feb-20,71381,68561,2820,4.0
37538,CN3917500000000,39,175,"Wyandot County, OH",Feb-20,13226,12745,481,3.6
37539,CN4000100000000,40,1,"Adair County, OK",Feb-20,7994,7693,301,3.8
37540,CN4000300000000,40,3,"Alfalfa County, OK",Feb-20,2824,2764,60,2.1
37541,CN4000500000000,40,5,"Atoka County, OK",Feb-20,4962,4737,225,4.5
37542,CN4000700000000,40,7,"Beaver County, OK",Feb-20,2885,2836,49,1.7
37543,CN4000900000000,40,9,"Beckham County, OK",Feb-20,9710,9305,405,4.2
37544,CN4001100000000,40,11,"Blaine County, OK",Feb-20,4695,4583,112,2.4
37545,CN4001300000000,40,13,"Bryan County, OK",Feb-20,21564,20978,586,2.7
37546,CN4001500000000,40,15,"Caddo County, OK",Feb-20,11708,11284,424,3.6
37547,CN4001700000000,40,17,"Canadian County, OK",Feb-20,74419,72392,2027,2.7
37548,CN4001900000000,40,19,"Carter County, OK",Feb-20,21270,20563,707,3.3
37549,CN4002100000000,40,21,"Cherokee County, OK",Feb-20,18759,18093,666,3.6
37550,CN4002300000000,40,23,"Choctaw County, OK",Feb-20,5434,5173,261,4.8
37551,CN4002500000000,40,25,"Cimarron County, OK",Feb-20,1329,1309,20,1.5
37552,CN4002700000000,40,27,"Cleveland County, OK",Feb-20,142814,139343,3471,2.4
37553,CN4002900000000,40,29,"Coal County, OK",Feb-20,2520,2419,101,4.0
37554,CN4003100000000,40,31,"Comanche County, OK",Feb-20,48066,46635,1431,3.0
37555,CN4003300000000,40,33,"Cotton County, OK",Feb-20,2710,2642,68,2.5
37556,CN4003500000000,40,35,"Craig County, OK",Feb-20,5804,5598,206,3.5
37557,CN4003700000000,40,37,"Creek County, OK",Feb-20,31375,30316,1059,3.4
37558,CN4003900000000,40,39,"Custer County, OK",Feb-20,15864,15433,431,2.7
37559,CN4004100000000,40,41,"Delaware County, OK",Feb-20,17970,17353,617,3.4
37560,CN4004300000000,40,43,"Dewey County, OK",Feb-20,2904,2837,67,2.3
37561,CN4004500000000,40,45,"Ellis County, OK",Feb-20,2120,2071,49,2.3
37562,CN4004700000000,40,47,"Garfield County, OK",Feb-20,26518,25729,789,3.0
37563,CN4004900000000,40,49,"Garvin County, OK",Feb-20,12503,12073,430,3.4
37564,CN4005100000000,40,51,"Grady County, OK",Feb-20,26592,25750,842,3.2
37565,CN4005300000000,40,53,"Grant County, OK",Feb-20,2595,2540,55,2.1
37566,CN4005500000000,40,55,"Greer County, OK",Feb-20,1789,1725,64,3.6
37567,CN4005700000000,40,57,"Harmon County, OK",Feb-20,1152,1122,30,2.6
37568,CN4005900000000,40,59,"Harper County, OK",Feb-20,1737,1695,42,2.4
37569,CN4006100000000,40,61,"Haskell County, OK",Feb-20,4230,3997,233,5.5
37570,CN4006300000000,40,63,"Hughes County, OK",Feb-20,5339,5077,262,4.9
37571,CN4006500000000,40,65,"Jackson County, OK",Feb-20,10691,10415,276,2.6
37572,CN4006700000000,40,67,"Jefferson County, OK",Feb-20,2529,2445,84,3.3
37573,CN4006900000000,40,69,"Johnston County, OK",Feb-20,3294,3128,166,5.0
37574,CN4007100000000,40,71,"Kay County, OK",Feb-20,17971,17291,680,3.8
37575,CN4007300000000,40,73,"Kingfisher County, OK",Feb-20,9158,8974,184,2.0
37576,CN4007500000000,40,75,"Kiowa County, OK",Feb-20,3439,3338,101,2.9
37577,CN4007700000000,40,77,"Latimer County, OK",Feb-20,3119,2894,225,7.2
37578,CN4007900000000,40,79,"Le Flore County, OK",Feb-20,18940,18133,807,4.3
37579,CN4008100000000,40,81,"Lincoln County, OK",Feb-20,15786,15281,505,3.2
37580,CN4008300000000,40,83,"Logan County, OK",Feb-20,22119,21525,594,2.7
37581,CN4008500000000,40,85,"Love County, OK",Feb-20,6167,6032,135,2.2
37582,CN4008700000000,40,87,"McClain County, OK",Feb-20,19662,19162,500,2.5
37583,CN4008900000000,40,89,"McCurtain County, OK",Feb-20,14699,13961,738,5.0
37584,CN4009100000000,40,91,"McIntosh County, OK",Feb-20,7153,6700,453,6.3
37585,CN4009300000000,40,93,"Major County, OK",Feb-20,3829,3751,78,2.0
37586,CN4009500000000,40,95,"Marshall County, OK",Feb-20,6905,6678,227,3.3
37587,CN4009700000000,40,97,"Mayes County, OK",Feb-20,19340,18796,544,2.8
37588,CN4009900000000,40,99,"Murray County, OK",Feb-20,6302,6117,185,2.9
37589,CN4010100000000,40,101,"Muskogee County, OK",Feb-20,29710,28672,1038,3.5
37590,CN4010300000000,40,103,"Noble County, OK",Feb-20,5642,5508,134,2.4
37591,CN4010500000000,40,105,"Nowata County, OK",Feb-20,4587,4452,135,2.9
37592,CN4010700000000,40,107,"Okfuskee County, OK",Feb-20,4606,4384,222,4.8
37593,CN4010900000000,40,109,"Oklahoma County, OK",Feb-20,384558,374178,10380,2.7
37594,CN4011100000000,40,111,"Okmulgee County, OK",Feb-20,15556,14865,691,4.4
37595,CN4011300000000,40,113,"Osage County, OK",Feb-20,20525,19813,712,3.5
37596,CN4011500000000,40,115,"Ottawa County, OK",Feb-20,13979,13569,410,2.9
37597,CN4011700000000,40,117,"Pawnee County, OK",Feb-20,7296,7040,256,3.5
37598,CN4011900000000,40,119,"Payne County, OK",Feb-20,37706,36716,990,2.6
37599,CN4012100000000,40,121,"Pittsburg County, OK",Feb-20,16936,16223,713,4.2
37600,CN4012300000000,40,123,"Pontotoc County, OK",Feb-20,19453,18926,527,2.7
37601,CN4012500000000,40,125,"Pottawatomie County, OK",Feb-20,32398,31344,1054,3.3
37602,CN4012700000000,40,127,"Pushmataha County, OK",Feb-20,4261,4039,222,5.2
37603,CN4012900000000,40,129,"Roger Mills County, OK",Feb-20,1826,1768,58,3.2
37604,CN4013100000000,40,131,"Rogers County, OK",Feb-20,44804,43518,1286,2.9
37605,CN4013300000000,40,133,"Seminole County, OK",Feb-20,9481,9056,425,4.5
37606,CN4013500000000,40,135,"Sequoyah County, OK",Feb-20,16154,15500,654,4.0
37607,CN4013700000000,40,137,"Stephens County, OK",Feb-20,18400,17623,777,4.2
37608,CN4013900000000,40,139,"Texas County, OK",Feb-20,11634,11437,197,1.7
37609,CN4014100000000,40,141,"Tillman County, OK",Feb-20,2943,2851,92,3.1
37610,CN4014300000000,40,143,"Tulsa County, OK",Feb-20,321153,311865,9288,2.9
37611,CN4014500000000,40,145,"Wagoner County, OK",Feb-20,37741,36618,1123,3.0
37612,CN4014700000000,40,147,"Washington County, OK",Feb-20,22021,21339,682,3.1
37613,CN4014900000000,40,149,"Washita County, OK",Feb-20,5127,4931,196,3.8
37614,CN4015100000000,40,151,"Woods County, OK",Feb-20,4602,4526,76,1.7
37615,CN4015300000000,40,153,"Woodward County, OK",Feb-20,8736,8463,273,3.1
37616,CN4100100000000,41,1,"Baker County, OR",Feb-20,7007,6635,372,5.3
37617,CN4100300000000,41,3,"Benton County, OR",Feb-20,49214,47852,1362,2.8
37618,CN4100500000000,41,5,"Clackamas County, OR",Feb-20,219763,212442,7321,3.3
37619,CN4100700000000,41,7,"Clatsop County, OR",Feb-20,18847,18103,744,3.9
37620,CN4100900000000,41,9,"Columbia County, OR",Feb-20,24589,23468,1121,4.6
37621,CN4101100000000,41,11,"Coos County, OR",Feb-20,26084,24866,1218,4.7
37622,CN4101300000000,41,13,"Crook County, OR",Feb-20,9502,8961,541,5.7
37623,CN4101500000000,41,15,"Curry County, OR",Feb-20,8698,8224,474,5.4
37624,CN4101700000000,41,17,"Deschutes County, OR",Feb-20,95628,91731,3897,4.1
37625,CN4101900000000,41,19,"Douglas County, OR",Feb-20,46142,43890,2252,4.9
37626,CN4102100000000,41,21,"Gilliam County, OR",Feb-20,905,853,52,5.7
37627,CN4102300000000,41,23,"Grant County, OR",Feb-20,3064,2776,288,9.4
37628,CN4102500000000,41,25,"Harney County, OR",Feb-20,3435,3217,218,6.3
37629,CN4102700000000,41,27,"Hood River County, OR",Feb-20,13366,12958,408,3.1
37630,CN4102900000000,41,29,"Jackson County, OR",Feb-20,102301,97723,4578,4.5
37631,CN4103100000000,41,31,"Jefferson County, OR",Feb-20,9971,9398,573,5.7
37632,CN4103300000000,41,33,"Josephine County, OR",Feb-20,35664,33851,1813,5.1
37633,CN4103500000000,41,35,"Klamath County, OR",Feb-20,28512,26367,2145,7.5
37634,CN4103700000000,41,37,"Lake County, OR",Feb-20,3519,3336,183,5.2
37635,CN4103900000000,41,39,"Lane County, OR",Feb-20,182398,175338,7060,3.9
37636,CN4104100000000,41,41,"Lincoln County, OR",Feb-20,20298,19359,939,4.6
37637,CN4104300000000,41,43,"Linn County, OR",Feb-20,58878,56384,2494,4.2
37638,CN4104500000000,41,45,"Malheur County, OR",Feb-20,12180,11633,547,4.5
37639,CN4104700000000,41,47,"Marion County, OR",Feb-20,161623,155199,6424,4.0
37640,CN4104900000000,41,49,"Morrow County, OR",Feb-20,5588,5327,261,4.7
37641,CN4105100000000,41,51,"Multnomah County, OR",Feb-20,456615,441912,14703,3.2
37642,CN4105300000000,41,53,"Polk County, OR",Feb-20,39908,38317,1591,4.0
37643,CN4105500000000,41,55,"Sherman County, OR",Feb-20,930,884,46,4.9
37644,CN4105700000000,41,57,"Tillamook County, OR",Feb-20,11650,11173,477,4.1
37645,CN4105900000000,41,59,"Umatilla County, OR",Feb-20,35698,33865,1833,5.1
37646,CN4106100000000,41,61,"Union County, OR",Feb-20,11845,11193,652,5.5
37647,CN4106300000000,41,63,"Wallowa County, OR",Feb-20,3259,3017,242,7.4
37648,CN4106500000000,41,65,"Wasco County, OR",Feb-20,12233,11650,583,4.8
37649,CN4106700000000,41,67,"Washington County, OR",Feb-20,325690,316144,9546,2.9
37650,CN4106900000000,41,69,"Wheeler County, OR",Feb-20,741,714,27,3.6
37651,CN4107100000000,41,71,"Yamhill County, OR",Feb-20,54781,52923,1858,3.4
37652,CN4200100000000,42,1,"Adams County, PA",Feb-20,55499,53395,2104,3.8
37653,CN4200300000000,42,3,"Allegheny County, PA",Feb-20,653882,623089,30793,4.7
37654,CN4200500000000,42,5,"Armstrong County, PA",Feb-20,33017,30645,2372,7.2
37655,CN4200700000000,42,7,"Beaver County, PA",Feb-20,85281,80359,4922,5.8
37656,CN4200900000000,42,9,"Bedford County, PA",Feb-20,23717,22105,1612,6.8
37657,CN4201100000000,42,11,"Berks County, PA",Feb-20,219323,208419,10904,5.0
37658,CN4201300000000,42,13,"Blair County, PA",Feb-20,59633,56430,3203,5.4
37659,CN4201500000000,42,15,"Bradford County, PA",Feb-20,29102,27498,1604,5.5
37660,CN4201700000000,42,17,"Bucks County, PA",Feb-20,347096,331592,15504,4.5
37661,CN4201900000000,42,19,"Butler County, PA",Feb-20,101030,96048,4982,4.9
37662,CN4202100000000,42,21,"Cambria County, PA",Feb-20,58746,54989,3757,6.4
37663,CN4202300000000,42,23,"Cameron County, PA",Feb-20,2052,1889,163,7.9
37664,CN4202500000000,42,25,"Carbon County, PA",Feb-20,32563,30549,2014,6.2
37665,CN4202700000000,42,27,"Centre County, PA",Feb-20,82197,79056,3141,3.8
37666,CN4202900000000,42,29,"Chester County, PA",Feb-20,286517,276490,10027,3.5
37667,CN4203100000000,42,31,"Clarion County, PA",Feb-20,17419,16298,1121,6.4
37668,CN4203300000000,42,33,"Clearfield County, PA",Feb-20,36741,34175,2566,7.0
37669,CN4203500000000,42,35,"Clinton County, PA",Feb-20,18588,17317,1271,6.8
37670,CN4203700000000,42,37,"Columbia County, PA",Feb-20,34305,32389,1916,5.6
37671,CN4203900000000,42,39,"Crawford County, PA",Feb-20,38645,36312,2333,6.0
37672,CN4204100000000,42,41,"Cumberland County, PA",Feb-20,133303,128237,5066,3.8
37673,CN4204300000000,42,43,"Dauphin County, PA",Feb-20,145686,139157,6529,4.5
37674,CN4204500000000,42,45,"Delaware County, PA",Feb-20,304527,291171,13356,4.4
37675,CN4204700000000,42,47,"Elk County, PA",Feb-20,15476,14440,1036,6.7
37676,CN4204900000000,42,49,"Erie County, PA",Feb-20,129859,122373,7486,5.8
37677,CN4205100000000,42,51,"Fayette County, PA",Feb-20,58429,53843,4586,7.8
37678,CN4205300000000,42,53,"Forest County, PA",Feb-20,1821,1648,173,9.5
37679,CN4205500000000,42,55,"Franklin County, PA",Feb-20,79274,75564,3710,4.7
37680,CN4205700000000,42,57,"Fulton County, PA",Feb-20,8190,7550,640,7.8
37681,CN4205900000000,42,59,"Greene County, PA",Feb-20,16928,15809,1119,6.6
37682,CN4206100000000,42,61,"Huntingdon County, PA",Feb-20,20293,18581,1712,8.4
37683,CN4206300000000,42,63,"Indiana County, PA",Feb-20,39975,37502,2473,6.2
37684,CN4206500000000,42,65,"Jefferson County, PA",Feb-20,20731,19441,1290,6.2
37685,CN4206700000000,42,67,"Juniata County, PA",Feb-20,12717,11997,720,5.7
37686,CN4206900000000,42,69,"Lackawanna County, PA",Feb-20,106009,100068,5941,5.6
37687,CN4207100000000,42,71,"Lancaster County, PA",Feb-20,287319,276102,11217,3.9
37688,CN4207300000000,42,73,"Lawrence County, PA",Feb-20,41106,38003,3103,7.5
37689,CN4207500000000,42,75,"Lebanon County, PA",Feb-20,73307,69979,3328,4.5
37690,CN4207700000000,42,77,"Lehigh County, PA",Feb-20,194446,184902,9544,4.9
37691,CN4207900000000,42,79,"Luzerne County, PA",Feb-20,159323,148734,10589,6.6
37692,CN4208100000000,42,81,"Lycoming County, PA",Feb-20,57434,53937,3497,6.1
37693,CN4208300000000,42,83,"McKean County, PA",Feb-20,17524,16245,1279,7.3
37694,CN4208500000000,42,85,"Mercer County, PA",Feb-20,49013,46096,2917,6.0
37695,CN4208700000000,42,87,"Mifflin County, PA",Feb-20,21419,20167,1252,5.8
37696,CN4208900000000,42,89,"Monroe County, PA",Feb-20,84724,79473,5251,6.2
37697,CN4209100000000,42,91,"Montgomery County, PA",Feb-20,457680,439835,17845,3.9
37698,CN4209300000000,42,93,"Montour County, PA",Feb-20,9282,8916,366,3.9
37699,CN4209500000000,42,95,"Northampton County, PA",Feb-20,163043,154841,8202,5.0
37700,CN4209700000000,42,97,"Northumberland County, PA",Feb-20,43012,40115,2897,6.7
37701,CN4209900000000,42,99,"Perry County, PA",Feb-20,24813,23647,1166,4.7
37702,CN4210100000000,42,101,"Philadelphia County/city, PA",Feb-20,742078,698435,43643,5.9
37703,CN4210300000000,42,103,"Pike County, PA",Feb-20,25542,23830,1712,6.7
37704,CN4210500000000,42,105,"Potter County, PA",Feb-20,7303,6646,657,9.0
37705,CN4210700000000,42,107,"Schuylkill County, PA",Feb-20,66875,62800,4075,6.1
37706,CN4210900000000,42,109,"Snyder County, PA",Feb-20,20517,19353,1164,5.7
37707,CN4211100000000,42,111,"Somerset County, PA",Feb-20,34436,32044,2392,6.9
37708,CN4211300000000,42,113,"Sullivan County, PA",Feb-20,2631,2450,181,6.9
37709,CN4211500000000,42,115,"Susquehanna County, PA",Feb-20,20694,19455,1239,6.0
37710,CN4211700000000,42,117,"Tioga County, PA",Feb-20,19425,18043,1382,7.1
37711,CN4211900000000,42,119,"Union County, PA",Feb-20,20000,19134,866,4.3
37712,CN4212100000000,42,121,"Venango County, PA",Feb-20,22419,20925,1494,6.7
37713,CN4212300000000,42,123,"Warren County, PA",Feb-20,19034,17882,1152,6.1
37714,CN4212500000000,42,125,"Washington County, PA",Feb-20,108534,102444,6090,5.6
37715,CN4212700000000,42,127,"Wayne County, PA",Feb-20,22255,20712,1543,6.9
37716,CN4212900000000,42,129,"Westmoreland County, PA",Feb-20,183534,173263,10271,5.6
37717,CN4213100000000,42,131,"Wyoming County, PA",Feb-20,13781,12928,853,6.2
37718,CN4213300000000,42,133,"York County, PA",Feb-20,237650,227147,10503,4.4
37719,CN4400100000000,44,1,"Bristol County, RI",Feb-20,26120,25268,852,3.3
37720,CN4400300000000,44,3,"Kent County, RI",Feb-20,91302,87961,3341,3.7
37721,CN4400500000000,44,5,"Newport County, RI",Feb-20,44698,42976,1722,3.9
37722,CN4400700000000,44,7,"Providence County, RI",Feb-20,327136,313444,13692,4.2
37723,CN4400900000000,44,9,"Washington County, RI",Feb-20,69175,66582,2593,3.7
37724,CN4500100000000,45,1,"Abbeville County, SC",Feb-20,10135,9761,374,3.7
37725,CN4500300000000,45,3,"Aiken County, SC",Feb-20,75719,73387,2332,3.1
37726,CN4500500000000,45,5,"Allendale County, SC",Feb-20,2705,2530,175,6.5
37727,CN4500700000000,45,7,"Anderson County, SC",Feb-20,92313,89639,2674,2.9
37728,CN4500900000000,45,9,"Bamberg County, SC",Feb-20,5011,4723,288,5.7
37729,CN4501100000000,45,11,"Barnwell County, SC",Feb-20,8274,7890,384,4.6
37730,CN4501300000000,45,13,"Beaufort County, SC",Feb-20,78918,76709,2209,2.8
37731,CN4501500000000,45,15,"Berkeley County, SC",Feb-20,105429,102563,2866,2.7
37732,CN4501700000000,45,17,"Calhoun County, SC",Feb-20,6687,6453,234,3.5
37733,CN4501900000000,45,19,"Charleston County, SC",Feb-20,214939,209712,5227,2.4
37734,CN4502100000000,45,21,"Cherokee County, SC",Feb-20,25323,24463,860,3.4
37735,CN4502300000000,45,23,"Chester County, SC",Feb-20,13625,13031,594,4.4
37736,CN4502500000000,45,25,"Chesterfield County, SC",Feb-20,22305,21607,698,3.1
37737,CN4502700000000,45,27,"Clarendon County, SC",Feb-20,12797,12263,534,4.2
37738,CN4502900000000,45,29,"Colleton County, SC",Feb-20,16920,16346,574,3.4
37739,CN4503100000000,45,31,"Darlington County, SC",Feb-20,30392,29351,1041,3.4
37740,CN4503300000000,45,33,"Dillon County, SC",Feb-20,13309,12732,577,4.3
37741,CN4503500000000,45,35,"Dorchester County, SC",Feb-20,79178,77110,2068,2.6
37742,CN4503700000000,45,37,"Edgefield County, SC",Feb-20,10872,10545,327,3.0
37743,CN4503900000000,45,39,"Fairfield County, SC",Feb-20,9750,9301,449,4.6
37744,CN4504100000000,45,41,"Florence County, SC",Feb-20,67084,65024,2060,3.1
37745,CN4504300000000,45,43,"Georgetown County, SC",Feb-20,25769,24686,1083,4.2
37746,CN4504500000000,45,45,"Greenville County, SC",Feb-20,257896,251124,6772,2.6
37747,CN4504700000000,45,47,"Greenwood County, SC",Feb-20,31571,30468,1103,3.5
37748,CN4504900000000,45,49,"Hampton County, SC",Feb-20,8467,8217,250,3.0
37749,CN4505100000000,45,51,"Horry County, SC",Feb-20,147606,141363,6243,4.2
37750,CN4505300000000,45,53,"Jasper County, SC",Feb-20,12977,12630,347,2.7
37751,CN4505500000000,45,55,"Kershaw County, SC",Feb-20,29769,28765,1004,3.4
37752,CN4505700000000,45,57,"Lancaster County, SC",Feb-20,41982,40464,1518,3.6
37753,CN4505900000000,45,59,"Laurens County, SC",Feb-20,30618,29624,994,3.2
37754,CN4506100000000,45,61,"Lee County, SC",Feb-20,6718,6363,355,5.3
37755,CN4506300000000,45,63,"Lexington County, SC",Feb-20,152218,148460,3758,2.5
37756,CN4506500000000,45,65,"McCormick County, SC",Feb-20,3446,3303,143,4.1
37757,CN4506700000000,45,67,"Marion County, SC",Feb-20,12950,12363,587,4.5
37758,CN4506900000000,45,69,"Marlboro County, SC",Feb-20,9223,8788,435,4.7
37759,CN4507100000000,45,71,"Newberry County, SC",Feb-20,19364,18814,550,2.8
37760,CN4507300000000,45,73,"Oconee County, SC",Feb-20,35400,34356,1044,2.9
37761,CN4507500000000,45,75,"Orangeburg County, SC",Feb-20,35556,33862,1694,4.8
37762,CN4507700000000,45,77,"Pickens County, SC",Feb-20,58179,56460,1719,3.0
37763,CN4507900000000,45,79,"Richland County, SC",Feb-20,201174,195433,5741,2.9
37764,CN4508100000000,45,81,"Saluda County, SC",Feb-20,9059,8805,254,2.8
37765,CN4508300000000,45,83,"Spartanburg County, SC",Feb-20,154756,150474,4282,2.8
37766,CN4508500000000,45,85,"Sumter County, SC",Feb-20,44352,42722,1630,3.7
37767,CN4508700000000,45,87,"Union County, SC",Feb-20,11811,11354,457,3.9
37768,CN4508900000000,45,89,"Williamsburg County, SC",Feb-20,12128,11530,598,4.9
37769,CN4509100000000,45,91,"York County, SC",Feb-20,142455,138377,4078,2.9
37770,CN4600300000000,46,3,"Aurora County, SD",Feb-20,1470,1428,42,2.9
37771,CN4600500000000,46,5,"Beadle County, SD",Feb-20,9505,9191,314,3.3
37772,CN4600700000000,46,7,"Bennett County, SD",Feb-20,1072,1012,60,5.6
37773,CN4600900000000,46,9,"Bon Homme County, SD",Feb-20,2824,2722,102,3.6
37774,CN4601100000000,46,11,"Brookings County, SD",Feb-20,19473,18870,603,3.1
37775,CN4601300000000,46,13,"Brown County, SD",Feb-20,20731,20040,691,3.3
37776,CN4601500000000,46,15,"Brule County, SD",Feb-20,2357,2278,79,3.4
37777,CN4601700000000,46,17,"Buffalo County, SD",Feb-20,665,621,44,6.6
37778,CN4601900000000,46,19,"Butte County, SD",Feb-20,4969,4780,189,3.8
37779,CN4602100000000,46,21,"Campbell County, SD",Feb-20,768,736,32,4.2
37780,CN4602300000000,46,23,"Charles Mix County, SD",Feb-20,3634,3507,127,3.5
37781,CN4602500000000,46,25,"Clark County, SD",Feb-20,1887,1797,90,4.8
37782,CN4602700000000,46,27,"Clay County, SD",Feb-20,7825,7614,211,2.7
37783,CN4602900000000,46,29,"Codington County, SD",Feb-20,15519,14996,523,3.4
37784,CN4603100000000,46,31,"Corson County, SD",Feb-20,1346,1274,72,5.3
37785,CN4603300000000,46,33,"Custer County, SD",Feb-20,3996,3785,211,5.3
37786,CN4603500000000,46,35,"Davison County, SD",Feb-20,10982,10617,365,3.3
37787,CN4603700000000,46,37,"Day County, SD",Feb-20,2748,2574,174,6.3
37788,CN4603900000000,46,39,"Deuel County, SD",Feb-20,2119,1957,162,7.6
37789,CN4604100000000,46,41,"Dewey County, SD",Feb-20,2169,2030,139,6.4
37790,CN4604300000000,46,43,"Douglas County, SD",Feb-20,1566,1506,60,3.8
37791,CN4604500000000,46,45,"Edmunds County, SD",Feb-20,2013,1951,62,3.1
37792,CN4604700000000,46,47,"Fall River County, SD",Feb-20,2882,2745,137,4.8
37793,CN4604900000000,46,49,"Faulk County, SD",Feb-20,1021,982,39,3.8
37794,CN4605100000000,46,51,"Grant County, SD",Feb-20,4423,4185,238,5.4
37795,CN4605300000000,46,53,"Gregory County, SD",Feb-20,1978,1904,74,3.7
37796,CN4605500000000,46,55,"Haakon County, SD",Feb-20,1029,996,33,3.2
37797,CN4605700000000,46,57,"Hamlin County, SD",Feb-20,3282,3167,115,3.5
37798,CN4605900000000,46,59,"Hand County, SD",Feb-20,1741,1693,48,2.8
37799,CN4606100000000,46,61,"Hanson County, SD",Feb-20,1736,1628,108,6.2
37800,CN4606300000000,46,63,"Harding County, SD",Feb-20,706,688,18,2.5
37801,CN4606500000000,46,65,"Hughes County, SD",Feb-20,9926,9611,315,3.2
37802,CN4606700000000,46,67,"Hutchinson County, SD",Feb-20,3598,3446,152,4.2
37803,CN4606900000000,46,69,"Hyde County, SD",Feb-20,683,658,25,3.7
37804,CN4607100000000,46,71,"Jackson County, SD",Feb-20,1116,1047,69,6.2
37805,CN4607300000000,46,73,"Jerauld County, SD",Feb-20,1089,1063,26,2.4
37806,CN4607500000000,46,75,"Jones County, SD",Feb-20,502,483,19,3.8
37807,CN4607700000000,46,77,"Kingsbury County, SD",Feb-20,2615,2516,99,3.8
37808,CN4607900000000,46,79,"Lake County, SD",Feb-20,6738,6507,231,3.4
37809,CN4608100000000,46,81,"Lawrence County, SD",Feb-20,13399,12997,402,3.0
37810,CN4608300000000,46,83,"Lincoln County, SD",Feb-20,34894,33933,961,2.8
37811,CN4608500000000,46,85,"Lyman County, SD",Feb-20,1602,1519,83,5.2
37812,CN4608700000000,46,87,"McCook County, SD",Feb-20,3090,2984,106,3.4
37813,CN4608900000000,46,89,"McPherson County, SD",Feb-20,989,938,51,5.2
37814,CN4609100000000,46,91,"Marshall County, SD",Feb-20,2327,2198,129,5.5
37815,CN4609300000000,46,93,"Meade County, SD",Feb-20,14086,13568,518,3.7
37816,CN4609500000000,46,95,"Mellette County, SD",Feb-20,727,683,44,6.1
37817,CN4609700000000,46,97,"Miner County, SD",Feb-20,1159,1124,35,3.0
37818,CN4609900000000,46,99,"Minnehaha County, SD",Feb-20,114408,110654,3754,3.3
37819,CN4610100000000,46,101,"Moody County, SD",Feb-20,3979,3822,157,3.9
37820,CN4610200000000,46,102,"Oglala Lakota County, SD",Feb-20,3543,3250,293,8.3
37821,CN4610300000000,46,103,"Pennington County, SD",Feb-20,56748,54656,2092,3.7
37822,CN4610500000000,46,105,"Perkins County, SD",Feb-20,1397,1351,46,3.3
37823,CN4610700000000,46,107,"Potter County, SD",Feb-20,983,950,33,3.4
37824,CN4610900000000,46,109,"Roberts County, SD",Feb-20,4874,4566,308,6.3
37825,CN4611100000000,46,111,"Sanborn County, SD",Feb-20,1142,1100,42,3.7
37826,CN4611500000000,46,115,"Spink County, SD",Feb-20,3145,2995,150,4.8
37827,CN4611700000000,46,117,"Stanley County, SD",Feb-20,1834,1756,78,4.3
37828,CN4611900000000,46,119,"Sully County, SD",Feb-20,775,754,21,2.7
37829,CN4612100000000,46,121,"Todd County, SD",Feb-20,3138,2939,199,6.3
37830,CN4612300000000,46,123,"Tripp County, SD",Feb-20,2967,2877,90,3.0
37831,CN4612500000000,46,125,"Turner County, SD",Feb-20,4726,4544,182,3.9
37832,CN4612700000000,46,127,"Union County, SD",Feb-20,8587,8268,319,3.7
37833,CN4612900000000,46,129,"Walworth County, SD",Feb-20,2105,1953,152,7.2
37834,CN4613500000000,46,135,"Yankton County, SD",Feb-20,11964,11590,374,3.1
37835,CN4613700000000,46,137,"Ziebach County, SD",Feb-20,902,869,33,3.7
37836,CN4700100000000,47,1,"Anderson County, TN",Feb-20,34885,33554,1331,3.8
37837,CN4700300000000,47,3,"Bedford County, TN",Feb-20,21271,20406,865,4.1
37838,CN4700500000000,47,5,"Benton County, TN",Feb-20,6989,6597,392,5.6
37839,CN4700700000000,47,7,"Bledsoe County, TN",Feb-20,4441,4178,263,5.9
37840,CN4700900000000,47,9,"Blount County, TN",Feb-20,64320,61894,2426,3.8
37841,CN4701100000000,47,11,"Bradley County, TN",Feb-20,53279,51327,1952,3.7
37842,CN4701300000000,47,13,"Campbell County, TN",Feb-20,15036,14248,788,5.2
37843,CN4701500000000,47,15,"Cannon County, TN",Feb-20,6752,6540,212,3.1
37844,CN4701700000000,47,17,"Carroll County, TN",Feb-20,12148,11510,638,5.3
37845,CN4701900000000,47,19,"Carter County, TN",Feb-20,24202,23143,1059,4.4
37846,CN4702100000000,47,21,"Cheatham County, TN",Feb-20,22364,21717,647,2.9
37847,CN4702300000000,47,23,"Chester County, TN",Feb-20,8636,8323,313,3.6
37848,CN4702500000000,47,25,"Claiborne County, TN",Feb-20,13215,12587,628,4.8
37849,CN4702700000000,47,27,"Clay County, TN",Feb-20,2780,2576,204,7.3
37850,CN4702900000000,47,29,"Cocke County, TN",Feb-20,15028,14068,960,6.4
37851,CN4703100000000,47,31,"Coffee County, TN",Feb-20,25893,24857,1036,4.0
37852,CN4703300000000,47,33,"Crockett County, TN",Feb-20,7204,6877,327,4.5
37853,CN4703500000000,47,35,"Cumberland County, TN",Feb-20,23910,22419,1491,6.2
37854,CN4703700000000,47,37,"Davidson County, TN",Feb-20,412414,401318,11096,2.7
37855,CN4703900000000,47,39,"Decatur County, TN",Feb-20,4587,4314,273,6.0
37856,CN4704100000000,47,41,"DeKalb County, TN",Feb-20,7815,7435,380,4.9
37857,CN4704300000000,47,43,"Dickson County, TN",Feb-20,27648,26763,885,3.2
37858,CN4704500000000,47,45,"Dyer County, TN",Feb-20,16658,15793,865,5.2
37859,CN4704700000000,47,47,"Fayette County, TN",Feb-20,19358,18643,715,3.7
37860,CN4704900000000,47,49,"Fentress County, TN",Feb-20,7634,7276,358,4.7
37861,CN4705100000000,47,51,"Franklin County, TN",Feb-20,20717,19872,845,4.1
37862,CN4705300000000,47,53,"Gibson County, TN",Feb-20,22383,21340,1043,4.7
37863,CN4705500000000,47,55,"Giles County, TN",Feb-20,15251,14510,741,4.9
37864,CN4705700000000,47,57,"Grainger County, TN",Feb-20,9706,9229,477,4.9
37865,CN4705900000000,47,59,"Greene County, TN",Feb-20,29566,28018,1548,5.2
37866,CN4706100000000,47,61,"Grundy County, TN",Feb-20,5107,4867,240,4.7
37867,CN4706300000000,47,63,"Hamblen County, TN",Feb-20,28703,27450,1253,4.4
37868,CN4706500000000,47,65,"Hamilton County, TN",Feb-20,186212,179561,6651,3.6
37869,CN4706700000000,47,67,"Hancock County, TN",Feb-20,2165,2020,145,6.7
37870,CN4706900000000,47,69,"Hardeman County, TN",Feb-20,9621,9088,533,5.5
37871,CN4707100000000,47,71,"Hardin County, TN",Feb-20,10585,10017,568,5.4
37872,CN4707300000000,47,73,"Hawkins County, TN",Feb-20,23845,22701,1144,4.8
37873,CN4707500000000,47,75,"Haywood County, TN",Feb-20,7843,7449,394,5.0
37874,CN4707700000000,47,77,"Henderson County, TN",Feb-20,12422,11788,634,5.1
37875,CN4707900000000,47,79,"Henry County, TN",Feb-20,14314,13540,774,5.4
37876,CN4708100000000,47,81,"Hickman County, TN",Feb-20,11723,11325,398,3.4
37877,CN4708300000000,47,83,"Houston County, TN",Feb-20,3371,3161,210,6.2
37878,CN4708500000000,47,85,"Humphreys County, TN",Feb-20,9019,8589,430,4.8
37879,CN4708700000000,47,87,"Jackson County, TN",Feb-20,4763,4496,267,5.6
37880,CN4708900000000,47,89,"Jefferson County, TN",Feb-20,25214,24018,1196,4.7
37881,CN4709100000000,47,91,"Johnson County, TN",Feb-20,7775,7434,341,4.4
37882,CN4709300000000,47,93,"Knox County, TN",Feb-20,245805,238103,7702,3.1
37883,CN4709500000000,47,95,"Lake County, TN",Feb-20,1787,1672,115,6.4
37884,CN4709700000000,47,97,"Lauderdale County, TN",Feb-20,9868,9306,562,5.7
37885,CN4709900000000,47,99,"Lawrence County, TN",Feb-20,19619,18783,836,4.3
37886,CN4710100000000,47,101,"Lewis County, TN",Feb-20,5228,5016,212,4.1
37887,CN4710300000000,47,103,"Lincoln County, TN",Feb-20,16463,15277,1186,7.2
37888,CN4710500000000,47,105,"Loudon County, TN",Feb-20,23839,22948,891,3.7
37889,CN4710700000000,47,107,"McMinn County, TN",Feb-20,24213,23211,1002,4.1
37890,CN4710900000000,47,109,"McNairy County, TN",Feb-20,8678,8149,529,6.1
37891,CN4711100000000,47,111,"Macon County, TN",Feb-20,11690,11296,394,3.4
37892,CN4711300000000,47,113,"Madison County, TN",Feb-20,49224,47345,1879,3.8
37893,CN4711500000000,47,115,"Marion County, TN",Feb-20,12674,12068,606,4.8
37894,CN4711700000000,47,117,"Marshall County, TN",Feb-20,15813,15199,614,3.9
37895,CN4711900000000,47,119,"Maury County, TN",Feb-20,50506,48884,1622,3.2
37896,CN4712100000000,47,121,"Meigs County, TN",Feb-20,5242,4975,267,5.1
37897,CN4712300000000,47,123,"Monroe County, TN",Feb-20,20304,19464,840,4.1
37898,CN4712500000000,47,125,"Montgomery County, TN",Feb-20,87299,83735,3564,4.1
37899,CN4712700000000,47,127,"Moore County, TN",Feb-20,3704,3583,121,3.3
37900,CN4712900000000,47,129,"Morgan County, TN",Feb-20,8029,7637,392,4.9
37901,CN4713100000000,47,131,"Obion County, TN",Feb-20,12685,12036,649,5.1
37902,CN4713300000000,47,133,"Overton County, TN",Feb-20,10281,9800,481,4.7
37903,CN4713500000000,47,135,"Perry County, TN",Feb-20,3125,2943,182,5.8
37904,CN4713700000000,47,137,"Pickett County, TN",Feb-20,2376,2251,125,5.3
37905,CN4713900000000,47,139,"Polk County, TN",Feb-20,7729,7381,348,4.5
37906,CN4714100000000,47,141,"Putnam County, TN",Feb-20,35450,34088,1362,3.8
37907,CN4714300000000,47,143,"Rhea County, TN",Feb-20,13663,12869,794,5.8
37908,CN4714500000000,47,145,"Roane County, TN",Feb-20,23720,22613,1107,4.7
37909,CN4714700000000,47,147,"Robertson County, TN",Feb-20,39037,37833,1204,3.1
37910,CN4714900000000,47,149,"Rutherford County, TN",Feb-20,188095,182903,5192,2.8
37911,CN4715100000000,47,151,"Scott County, TN",Feb-20,8300,7880,420,5.1
37912,CN4715300000000,47,153,"Sequatchie County, TN",Feb-20,6294,5999,295,4.7
37913,CN4715500000000,47,155,"Sevier County, TN",Feb-20,52964,49717,3247,6.1
37914,CN4715700000000,47,157,"Shelby County, TN",Feb-20,447084,427614,19470,4.4
37915,CN4715900000000,47,159,"Smith County, TN",Feb-20,9713,9388,325,3.3
37916,CN4716100000000,47,161,"Stewart County, TN",Feb-20,5627,5332,295,5.2
37917,CN4716300000000,47,163,"Sullivan County, TN",Feb-20,70302,67381,2921,4.2
37918,CN4716500000000,47,165,"Sumner County, TN",Feb-20,104604,101533,3071,2.9
37919,CN4716700000000,47,167,"Tipton County, TN",Feb-20,28421,27181,1240,4.4
37920,CN4716900000000,47,169,"Trousdale County, TN",Feb-20,5564,5382,182,3.3
37921,CN4717100000000,47,171,"Unicoi County, TN",Feb-20,7315,6854,461,6.3
37922,CN4717300000000,47,173,"Union County, TN",Feb-20,7685,7358,327,4.3
37923,CN4717500000000,47,175,"Van Buren County, TN",Feb-20,2061,1952,109,5.3
37924,CN4717700000000,47,177,"Warren County, TN",Feb-20,16621,15863,758,4.6
37925,CN4717900000000,47,179,"Washington County, TN",Feb-20,60988,58610,2378,3.9
37926,CN4718100000000,47,181,"Wayne County, TN",Feb-20,6294,5942,352,5.6
37927,CN4718300000000,47,183,"Weakley County, TN",Feb-20,16328,15688,640,3.9
37928,CN4718500000000,47,185,"White County, TN",Feb-20,12342,11833,509,4.1
37929,CN4718700000000,47,187,"Williamson County, TN",Feb-20,131059,127709,3350,2.6
37930,CN4718900000000,47,189,"Wilson County, TN",Feb-20,78450,76155,2295,2.9
37931,CN4800100000000,48,1,"Anderson County, TX",Feb-20,24194,23486,708,2.9
37932,CN4800300000000,48,3,"Andrews County, TX",Feb-20,9998,9754,244,2.4
37933,CN4800500000000,48,5,"Angelina County, TX",Feb-20,36084,34560,1524,4.2
37934,CN4800700000000,48,7,"Aransas County, TX",Feb-20,9479,9065,414,4.4
37935,CN4800900000000,48,9,"Archer County, TX",Feb-20,4164,4040,124,3.0
37936,CN4801100000000,48,11,"Armstrong County, TX",Feb-20,945,916,29,3.1
37937,CN4801300000000,48,13,"Atascosa County, TX",Feb-20,22068,21253,815,3.7
37938,CN4801500000000,48,15,"Austin County, TX",Feb-20,14363,13854,509,3.5
37939,CN4801700000000,48,17,"Bailey County, TX",Feb-20,2460,2368,92,3.7
37940,CN4801900000000,48,19,"Bandera County, TX",Feb-20,10227,9895,332,3.2
37941,CN4802100000000,48,21,"Bastrop County, TX",Feb-20,43806,42528,1278,2.9
37942,CN4802300000000,48,23,"Baylor County, TX",Feb-20,1784,1737,47,2.6
37943,CN4802500000000,48,25,"Bee County, TX",Feb-20,9936,9456,480,4.8
37944,CN4802700000000,48,27,"Bell County, TX",Feb-20,146316,140828,5488,3.8
37945,CN4802900000000,48,29,"Bexar County, TX",Feb-20,964600,934452,30148,3.1
37946,CN4803100000000,48,31,"Blanco County, TX",Feb-20,6651,6494,157,2.4
37947,CN4803300000000,48,33,"Borden County, TX",Feb-20,429,419,10,2.3
37948,CN4803500000000,48,35,"Bosque County, TX",Feb-20,8406,8103,303,3.6
37949,CN4803700000000,48,37,"Bowie County, TX",Feb-20,40269,38556,1713,4.3
37950,CN4803900000000,48,39,"Brazoria County, TX",Feb-20,183079,175160,7919,4.3
37951,CN4804100000000,48,41,"Brazos County, TX",Feb-20,123365,120124,3241,2.6
37952,CN4804300000000,48,43,"Brewster County, TX",Feb-20,4250,4126,124,2.9
37953,CN4804500000000,48,45,"Briscoe County, TX",Feb-20,570,548,22,3.9
37954,CN4804700000000,48,47,"Brooks County, TX",Feb-20,2686,2540,146,5.4
37955,CN4804900000000,48,49,"Brown County, TX",Feb-20,15646,15035,611,3.9
37956,CN4805100000000,48,51,"Burleson County, TX",Feb-20,8698,8393,305,3.5
37957,CN4805300000000,48,53,"Burnet County, TX",Feb-20,23887,23225,662,2.8
37958,CN4805500000000,48,55,"Caldwell County, TX",Feb-20,20078,19433,645,3.2
37959,CN4805700000000,48,57,"Calhoun County, TX",Feb-20,12390,11979,411,3.3
37960,CN4805900000000,48,59,"Callahan County, TX",Feb-20,6218,6025,193,3.1
37961,CN4806100000000,48,61,"Cameron County, TX",Feb-20,169117,159293,9824,5.8
37962,CN4806300000000,48,63,"Camp County, TX",Feb-20,5029,4807,222,4.4
37963,CN4806500000000,48,65,"Carson County, TX",Feb-20,3061,2972,89,2.9
37964,CN4806700000000,48,67,"Cass County, TX",Feb-20,12461,11909,552,4.4
37965,CN4806900000000,48,69,"Castro County, TX",Feb-20,3431,3335,96,2.8
37966,CN4807100000000,48,71,"Chambers County, TX",Feb-20,19867,18947,920,4.6
37967,CN4807300000000,48,73,"Cherokee County, TX",Feb-20,21016,20153,863,4.1
37968,CN4807500000000,48,75,"Childress County, TX",Feb-20,2915,2829,86,3.0
37969,CN4807700000000,48,77,"Clay County, TX",Feb-20,4946,4800,146,3.0
37970,CN4807900000000,48,79,"Cochran County, TX",Feb-20,1128,1085,43,3.8
37971,CN4808100000000,48,81,"Coke County, TX",Feb-20,1465,1423,42,2.9
37972,CN4808300000000,48,83,"Coleman County, TX",Feb-20,2877,2745,132,4.6
37973,CN4808500000000,48,85,"Collin County, TX",Feb-20,574807,557582,17225,3.0
37974,CN4808700000000,48,87,"Collingsworth County, TX",Feb-20,1138,1098,40,3.5
37975,CN4808900000000,48,89,"Colorado County, TX",Feb-20,9905,9570,335,3.4
37976,CN4809100000000,48,91,"Comal County, TX",Feb-20,74522,72296,2226,3.0
37977,CN4809300000000,48,93,"Comanche County, TX",Feb-20,5640,5436,204,3.6
37978,CN4809500000000,48,95,"Concho County, TX",Feb-20,1351,1314,37,2.7
37979,CN4809700000000,48,97,"Cooke County, TX",Feb-20,20000,19373,627,3.1
37980,CN4809900000000,48,99,"Coryell County, TX",Feb-20,24525,23583,942,3.8
37981,CN4810100000000,48,101,"Cottle County, TX",Feb-20,547,521,26,4.8
37982,CN4810300000000,48,103,"Crane County, TX",Feb-20,1559,1483,76,4.9
37983,CN4810500000000,48,105,"Crockett County, TX",Feb-20,1646,1577,69,4.2
37984,CN4810700000000,48,107,"Crosby County, TX",Feb-20,2501,2411,90,3.6
37985,CN4810900000000,48,109,"Culberson County, TX",Feb-20,1048,1013,35,3.3
37986,CN4811100000000,48,111,"Dallam County, TX",Feb-20,3882,3799,83,2.1
37987,CN4811300000000,48,113,"Dallas County, TX",Feb-20,1390999,1344725,46274,3.3
37988,CN4811500000000,48,115,"Dawson County, TX",Feb-20,4744,4539,205,4.3
37989,CN4811700000000,48,117,"Deaf Smith County, TX",Feb-20,8522,8283,239,2.8
37990,CN4811900000000,48,119,"Delta County, TX",Feb-20,2466,2376,90,3.6
37991,CN4812100000000,48,121,"Denton County, TX",Feb-20,504556,489893,14663,2.9
37992,CN4812300000000,48,123,"DeWitt County, TX",Feb-20,9948,9686,262,2.6
37993,CN4812500000000,48,125,"Dickens County, TX",Feb-20,669,641,28,4.2
37994,CN4812700000000,48,127,"Dimmit County, TX",Feb-20,7498,7288,210,2.8
37995,CN4812900000000,48,129,"Donley County, TX",Feb-20,1393,1347,46,3.3
37996,CN4813100000000,48,131,"Duval County, TX",Feb-20,4934,4677,257,5.2
37997,CN4813300000000,48,133,"Eastland County, TX",Feb-20,8168,7879,289,3.5
37998,CN4813500000000,48,135,"Ector County, TX",Feb-20,88372,85445,2927,3.3
37999,CN4813700000000,48,137,"Edwards County, TX",Feb-20,1145,1121,24,2.1
38000,CN4813900000000,48,139,"Ellis County, TX",Feb-20,94526,91667,2859,3.0
38001,CN4814100000000,48,141,"El Paso County, TX",Feb-20,369182,354995,14187,3.8
38002,CN4814300000000,48,143,"Erath County, TX",Feb-20,21219,20511,708,3.3
38003,CN4814500000000,48,145,"Falls County, TX",Feb-20,6644,6414,230,3.5
38004,CN4814700000000,48,147,"Fannin County, TX",Feb-20,17645,17170,475,2.7
38005,CN4814900000000,48,149,"Fayette County, TX",Feb-20,12110,11788,322,2.7
38006,CN4815100000000,48,151,"Fisher County, TX",Feb-20,1619,1575,44,2.7
38007,CN4815300000000,48,153,"Floyd County, TX",Feb-20,2578,2443,135,5.2
38008,CN4815500000000,48,155,"Foard County, TX",Feb-20,589,572,17,2.9
38009,CN4815700000000,48,157,"Fort Bend County, TX",Feb-20,399539,385635,13904,3.5
38010,CN4815900000000,48,159,"Franklin County, TX",Feb-20,4674,4514,160,3.4
38011,CN4816100000000,48,161,"Freestone County, TX",Feb-20,6436,6107,329,5.1
38012,CN4816300000000,48,163,"Frio County, TX",Feb-20,10484,10191,293,2.8
38013,CN4816500000000,48,165,"Gaines County, TX",Feb-20,10000,9739,261,2.6
38014,CN4816700000000,48,167,"Galveston County, TX",Feb-20,168474,161720,6754,4.0
38015,CN4816900000000,48,169,"Garza County, TX",Feb-20,2189,2121,68,3.1
38016,CN4817100000000,48,171,"Gillespie County, TX",Feb-20,13604,13256,348,2.6
38017,CN4817300000000,48,173,"Glasscock County, TX",Feb-20,790,773,17,2.2
38018,CN4817500000000,48,175,"Goliad County, TX",Feb-20,3271,3146,125,3.8
38019,CN4817700000000,48,177,"Gonzales County, TX",Feb-20,9710,9425,285,2.9
38020,CN4817900000000,48,179,"Gray County, TX",Feb-20,8089,7766,323,4.0
38021,CN4818100000000,48,181,"Grayson County, TX",Feb-20,64461,62386,2075,3.2
38022,CN4818300000000,48,183,"Gregg County, TX",Feb-20,57990,55641,2349,4.1
38023,CN4818500000000,48,185,"Grimes County, TX",Feb-20,11359,10888,471,4.1
38024,CN4818700000000,48,187,"Guadalupe County, TX",Feb-20,82701,80336,2365,2.9
38025,CN4818900000000,48,189,"Hale County, TX",Feb-20,12005,11466,539,4.5
38026,CN4819100000000,48,191,"Hall County, TX",Feb-20,1054,1005,49,4.6
38027,CN4819300000000,48,193,"Hamilton County, TX",Feb-20,3677,3556,121,3.3
38028,CN4819500000000,48,195,"Hansford County, TX",Feb-20,2733,2672,61,2.2
38029,CN4819700000000,48,197,"Hardeman County, TX",Feb-20,1735,1685,50,2.9
38030,CN4819900000000,48,199,"Hardin County, TX",Feb-20,25485,24351,1134,4.4
38031,CN4820100000000,48,201,"Harris County, TX",Feb-20,2361581,2269910,91671,3.9
38032,CN4820300000000,48,203,"Harrison County, TX",Feb-20,29523,28272,1251,4.2
38033,CN4820500000000,48,205,"Hartley County, TX",Feb-20,2794,2745,49,1.8
38034,CN4820700000000,48,207,"Haskell County, TX",Feb-20,2286,2211,75,3.3
38035,CN4820900000000,48,209,"Hays County, TX",Feb-20,122502,119193,3309,2.7
38036,CN4821100000000,48,211,"Hemphill County, TX",Feb-20,1881,1819,62,3.3
38037,CN4821300000000,48,213,"Henderson County, TX",Feb-20,36922,35595,1327,3.6
38038,CN4821500000000,48,215,"Hidalgo County, TX",Feb-20,362658,338312,24346,6.7
38039,CN4821700000000,48,217,"Hill County, TX",Feb-20,16560,15994,566,3.4
38040,CN4821900000000,48,219,"Hockley County, TX",Feb-20,11292,10944,348,3.1
38041,CN4822100000000,48,221,"Hood County, TX",Feb-20,28104,27107,997,3.5
38042,CN4822300000000,48,223,"Hopkins County, TX",Feb-20,17646,17081,565,3.2
38043,CN4822500000000,48,225,"Houston County, TX",Feb-20,10356,10016,340,3.3
38044,CN4822700000000,48,227,"Howard County, TX",Feb-20,14190,13736,454,3.2
38045,CN4822900000000,48,229,"Hudspeth County, TX",Feb-20,1851,1773,78,4.2
38046,CN4823100000000,48,231,"Hunt County, TX",Feb-20,44296,42726,1570,3.5
38047,CN4823300000000,48,233,"Hutchinson County, TX",Feb-20,8757,8343,414,4.7
38048,CN4823500000000,48,235,"Irion County, TX",Feb-20,768,749,19,2.5
38049,CN4823700000000,48,237,"Jack County, TX",Feb-20,3417,3271,146,4.3
38050,CN4823900000000,48,239,"Jackson County, TX",Feb-20,7699,7455,244,3.2
38051,CN4824100000000,48,241,"Jasper County, TX",Feb-20,12853,11995,858,6.7
38052,CN4824300000000,48,243,"Jeff Davis County, TX",Feb-20,1002,970,32,3.2
38053,CN4824500000000,48,245,"Jefferson County, TX",Feb-20,107841,101556,6285,5.8
38054,CN4824700000000,48,247,"Jim Hogg County, TX",Feb-20,1867,1780,87,4.7
38055,CN4824900000000,48,249,"Jim Wells County, TX",Feb-20,16871,15987,884,5.2
38056,CN4825100000000,48,251,"Johnson County, TX",Feb-20,83714,80978,2736,3.3
38057,CN4825300000000,48,253,"Jones County, TX",Feb-20,5806,5576,230,4.0
38058,CN4825500000000,48,255,"Karnes County, TX",Feb-20,7435,7245,190,2.6
38059,CN4825700000000,48,257,"Kaufman County, TX",Feb-20,65958,63769,2189,3.3
38060,CN4825900000000,48,259,"Kendall County, TX",Feb-20,22490,21868,622,2.8
38061,CN4826100000000,48,261,"Kenedy County, TX",Feb-20,204,197,7,3.4
38062,CN4826300000000,48,263,"Kent County, TX",Feb-20,486,471,15,3.1
38063,CN4826500000000,48,265,"Kerr County, TX",Feb-20,22498,21775,723,3.2
38064,CN4826700000000,48,267,"Kimble County, TX",Feb-20,1818,1757,61,3.4
38065,CN4826900000000,48,269,"King County, TX",Feb-20,238,232,6,2.5
38066,CN4827100000000,48,271,"Kinney County, TX",Feb-20,1403,1339,64,4.6
38067,CN4827300000000,48,273,"Kleberg County, TX",Feb-20,13679,13060,619,4.5
38068,CN4827500000000,48,275,"Knox County, TX",Feb-20,1428,1377,51,3.6
38069,CN4827700000000,48,277,"Lamar County, TX",Feb-20,24476,23678,798,3.3
38070,CN4827900000000,48,279,"Lamb County, TX",Feb-20,5381,5178,203,3.8
38071,CN4828100000000,48,281,"Lampasas County, TX",Feb-20,9375,9063,312,3.3
38072,CN4828300000000,48,283,"La Salle County, TX",Feb-20,4429,4293,136,3.1
38073,CN4828500000000,48,285,"Lavaca County, TX",Feb-20,8422,8178,244,2.9
38074,CN4828700000000,48,287,"Lee County, TX",Feb-20,10079,9801,278,2.8
38075,CN4828900000000,48,289,"Leon County, TX",Feb-20,6352,6055,297,4.7
38076,CN4829100000000,48,291,"Liberty County, TX",Feb-20,33852,32002,1850,5.5
38077,CN4829300000000,48,293,"Limestone County, TX",Feb-20,8726,8372,354,4.1
38078,CN4829500000000,48,295,"Lipscomb County, TX",Feb-20,1644,1600,44,2.7
38079,CN4829700000000,48,297,"Live Oak County, TX",Feb-20,5705,5519,186,3.3
38080,CN4829900000000,48,299,"Llano County, TX",Feb-20,8742,8442,300,3.4
38081,CN4830100000000,48,301,"Loving County, TX",Feb-20,685,681,4,0.6
38082,CN4830300000000,48,303,"Lubbock County, TX",Feb-20,159088,154721,4367,2.7
38083,CN4830500000000,48,305,"Lynn County, TX",Feb-20,2805,2705,100,3.6
38084,CN4830700000000,48,307,"McCulloch County, TX",Feb-20,3323,3168,155,4.7
38085,CN4830900000000,48,309,"McLennan County, TX",Feb-20,120809,116871,3938,3.3
38086,CN4831100000000,48,311,"McMullen County, TX",Feb-20,904,890,14,1.5
38087,CN4831300000000,48,313,"Madison County, TX",Feb-20,4499,4317,182,4.0
38088,CN4831500000000,48,315,"Marion County, TX",Feb-20,4215,4015,200,4.7
38089,CN4831700000000,48,317,"Martin County, TX",Feb-20,2906,2821,85,2.9
38090,CN4831900000000,48,319,"Mason County, TX",Feb-20,1782,1722,60,3.4
38091,CN4832100000000,48,321,"Matagorda County, TX",Feb-20,16751,15781,970,5.8
38092,CN4832300000000,48,323,"Maverick County, TX",Feb-20,24547,22190,2357,9.6
38093,CN4832500000000,48,325,"Medina County, TX",Feb-20,22187,21465,722,3.3
38094,CN4832700000000,48,327,"Menard County, TX",Feb-20,865,836,29,3.4
38095,CN4832900000000,48,329,"Midland County, TX",Feb-20,108114,105606,2508,2.3
38096,CN4833100000000,48,331,"Milam County, TX",Feb-20,9704,9264,440,4.5
38097,CN4833300000000,48,333,"Mills County, TX",Feb-20,1908,1850,58,3.0
38098,CN4833500000000,48,335,"Mitchell County, TX",Feb-20,2346,2270,76,3.2
38099,CN4833700000000,48,337,"Montague County, TX",Feb-20,9458,9153,305,3.2
38100,CN4833900000000,48,339,"Montgomery County, TX",Feb-20,289593,279483,10110,3.5
38101,CN4834100000000,48,341,"Moore County, TX",Feb-20,10814,10546,268,2.5
38102,CN4834300000000,48,343,"Morris County, TX",Feb-20,4862,4594,268,5.5
38103,CN4834500000000,48,345,"Motley County, TX",Feb-20,470,453,17,3.6
38104,CN4834700000000,48,347,"Nacogdoches County, TX",Feb-20,28241,27171,1070,3.8
38105,CN4834900000000,48,349,"Navarro County, TX",Feb-20,24462,23624,838,3.4
38106,CN4835100000000,48,351,"Newton County, TX",Feb-20,5225,4895,330,6.3
38107,CN4835300000000,48,353,"Nolan County, TX",Feb-20,7316,7094,222,3.0
38108,CN4835500000000,48,355,"Nueces County, TX",Feb-20,168231,161198,7033,4.2
38109,CN4835700000000,48,357,"Ochiltree County, TX",Feb-20,4335,4188,147,3.4
38110,CN4835900000000,48,359,"Oldham County, TX",Feb-20,929,900,29,3.1
38111,CN4836100000000,48,361,"Orange County, TX",Feb-20,36634,34803,1831,5.0
38112,CN4836300000000,48,363,"Palo Pinto County, TX",Feb-20,13583,13157,426,3.1
38113,CN4836500000000,48,365,"Panola County, TX",Feb-20,10225,9761,464,4.5
38114,CN4836700000000,48,367,"Parker County, TX",Feb-20,68650,66555,2095,3.1
38115,CN4836900000000,48,369,"Parmer County, TX",Feb-20,4889,4772,117,2.4
38116,CN4837100000000,48,371,"Pecos County, TX",Feb-20,6390,6153,237,3.7
38117,CN4837300000000,48,373,"Polk County, TX",Feb-20,18336,17409,927,5.1
38118,CN4837500000000,48,375,"Potter County, TX",Feb-20,55992,54492,1500,2.7
38119,CN4837700000000,48,377,"Presidio County, TX",Feb-20,3195,2928,267,8.4
38120,CN4837900000000,48,379,"Rains County, TX",Feb-20,6225,6043,182,2.9
38121,CN4838100000000,48,381,"Randall County, TX",Feb-20,73157,71364,1793,2.5
38122,CN4838300000000,48,383,"Reagan County, TX",Feb-20,1936,1882,54,2.8
38123,CN4838500000000,48,385,"Real County, TX",Feb-20,1023,974,49,4.8
38124,CN4838700000000,48,387,"Red River County, TX",Feb-20,5159,4916,243,4.7
38125,CN4838900000000,48,389,"Reeves County, TX",Feb-20,12555,12309,246,2.0
38126,CN4839100000000,48,391,"Refugio County, TX",Feb-20,3156,3038,118,3.7
38127,CN4839300000000,48,393,"Roberts County, TX",Feb-20,417,405,12,2.9
38128,CN4839500000000,48,395,"Robertson County, TX",Feb-20,7930,7641,289,3.6
38129,CN4839700000000,48,397,"Rockwall County, TX",Feb-20,53118,51523,1595,3.0
38130,CN4839900000000,48,399,"Runnels County, TX",Feb-20,4634,4487,147,3.2
38131,CN4840100000000,48,401,"Rusk County, TX",Feb-20,22975,22051,924,4.0
38132,CN4840300000000,48,403,"Sabine County, TX",Feb-20,3696,3438,258,7.0
38133,CN4840500000000,48,405,"San Augustine County, TX",Feb-20,3555,3376,179,5.0
38134,CN4840700000000,48,407,"San Jacinto County, TX",Feb-20,11931,11374,557,4.7
38135,CN4840900000000,48,409,"San Patricio County, TX",Feb-20,30035,28379,1656,5.5
38136,CN4841100000000,48,411,"San Saba County, TX",Feb-20,2597,2505,92,3.5
38137,CN4841300000000,48,413,"Schleicher County, TX",Feb-20,1317,1277,40,3.0
38138,CN4841500000000,48,415,"Scurry County, TX",Feb-20,6770,6512,258,3.8
38139,CN4841700000000,48,417,"Shackelford County, TX",Feb-20,1903,1856,47,2.5
38140,CN4841900000000,48,419,"Shelby County, TX",Feb-20,11188,10712,476,4.3
38141,CN4842100000000,48,421,"Sherman County, TX",Feb-20,1387,1354,33,2.4
38142,CN4842300000000,48,423,"Smith County, TX",Feb-20,107438,103725,3713,3.5
38143,CN4842500000000,48,425,"Somervell County, TX",Feb-20,4450,4286,164,3.7
38144,CN4842700000000,48,427,"Starr County, TX",Feb-20,26387,22978,3409,12.9
38145,CN4842900000000,48,429,"Stephens County, TX",Feb-20,4083,3948,135,3.3
38146,CN4843100000000,48,431,"Sterling County, TX",Feb-20,573,554,19,3.3
38147,CN4843300000000,48,433,"Stonewall County, TX",Feb-20,576,557,19,3.3
38148,CN4843500000000,48,435,"Sutton County, TX",Feb-20,1351,1298,53,3.9
38149,CN4843700000000,48,437,"Swisher County, TX",Feb-20,2613,2513,100,3.8
38150,CN4843900000000,48,439,"Tarrant County, TX",Feb-20,1101454,1066126,35328,3.2
38151,CN4844100000000,48,441,"Taylor County, TX",Feb-20,68062,66092,1970,2.9
38152,CN4844300000000,48,443,"Terrell County, TX",Feb-20,370,356,14,3.8
38153,CN4844500000000,48,445,"Terry County, TX",Feb-20,4899,4728,171,3.5
38154,CN4844700000000,48,447,"Throckmorton County, TX",Feb-20,642,618,24,3.7
38155,CN4844900000000,48,449,"Titus County, TX",Feb-20,13192,12644,548,4.2
38156,CN4845100000000,48,451,"Tom Green County, TX",Feb-20,54948,53309,1639,3.0
38157,CN4845300000000,48,453,"Travis County, TX",Feb-20,757671,738329,19342,2.6
38158,CN4845500000000,48,455,"Trinity County, TX",Feb-20,5342,5070,272,5.1
38159,CN4845700000000,48,457,"Tyler County, TX",Feb-20,7205,6777,428,5.9
38160,CN4845900000000,48,459,"Upshur County, TX",Feb-20,17852,17096,756,4.2
38161,CN4846100000000,48,461,"Upton County, TX",Feb-20,1715,1659,56,3.3
38162,CN4846300000000,48,463,"Uvalde County, TX",Feb-20,11432,11017,415,3.6
38163,CN4846500000000,48,465,"Val Verde County, TX",Feb-20,23292,22362,930,4.0
38164,CN4846700000000,48,467,"Van Zandt County, TX",Feb-20,26325,25413,912,3.5
38165,CN4846900000000,48,469,"Victoria County, TX",Feb-20,42777,41147,1630,3.8
38166,CN4847100000000,48,471,"Walker County, TX",Feb-20,24465,23535,930,3.8
38167,CN4847300000000,48,473,"Waller County, TX",Feb-20,23898,22999,899,3.8
38168,CN4847500000000,48,475,"Ward County, TX",Feb-20,8002,7795,207,2.6
38169,CN4847700000000,48,477,"Washington County, TX",Feb-20,15488,14986,502,3.2
38170,CN4847900000000,48,479,"Webb County, TX",Feb-20,120300,115563,4737,3.9
38171,CN4848100000000,48,481,"Wharton County, TX",Feb-20,21858,21065,793,3.6
38172,CN4848300000000,48,483,"Wheeler County, TX",Feb-20,2293,2219,74,3.2
38173,CN4848500000000,48,485,"Wichita County, TX",Feb-20,56590,54799,1791,3.2
38174,CN4848700000000,48,487,"Wilbarger County, TX",Feb-20,4998,4797,201,4.0
38175,CN4848900000000,48,489,"Willacy County, TX",Feb-20,6835,6273,562,8.2
38176,CN4849100000000,48,491,"Williamson County, TX",Feb-20,320860,312002,8858,2.8
38177,CN4849300000000,48,493,"Wilson County, TX",Feb-20,25315,24554,761,3.0
38178,CN4849500000000,48,495,"Winkler County, TX",Feb-20,4044,3911,133,3.3
38179,CN4849700000000,48,497,"Wise County, TX",Feb-20,32532,31416,1116,3.4
38180,CN4849900000000,48,499,"Wood County, TX",Feb-20,17945,17209,736,4.1
38181,CN4850100000000,48,501,"Yoakum County, TX",Feb-20,3784,3651,133,3.5
38182,CN4850300000000,48,503,"Young County, TX",Feb-20,7947,7708,239,3.0
38183,CN4850500000000,48,505,"Zapata County, TX",Feb-20,4906,4601,305,6.2
38184,CN4850700000000,48,507,"Zavala County, TX",Feb-20,3429,3119,310,9.0
38185,CN4900100000000,49,1,"Beaver County, UT",Feb-20,2828,2743,85,3.0
38186,CN4900300000000,49,3,"Box Elder County, UT",Feb-20,26178,25424,754,2.9
38187,CN4900500000000,49,5,"Cache County, UT",Feb-20,65067,63587,1480,2.3
38188,CN4900700000000,49,7,"Carbon County, UT",Feb-20,8556,8191,365,4.3
38189,CN4900900000000,49,9,"Daggett County, UT",Feb-20,327,312,15,4.6
38190,CN4901100000000,49,11,"Davis County, UT",Feb-20,175982,171476,4506,2.6
38191,CN4901300000000,49,13,"Duchesne County, UT",Feb-20,7727,7350,377,4.9
38192,CN4901500000000,49,15,"Emery County, UT",Feb-20,4260,4031,229,5.4
38193,CN4901700000000,49,17,"Garfield County, UT",Feb-20,2376,2084,292,12.3
38194,CN4901900000000,49,19,"Grand County, UT",Feb-20,5756,5297,459,8.0
38195,CN4902100000000,49,21,"Iron County, UT",Feb-20,25264,24479,785,3.1
38196,CN4902300000000,49,23,"Juab County, UT",Feb-20,5880,5714,166,2.8
38197,CN4902500000000,49,25,"Kane County, UT",Feb-20,3596,3461,135,3.8
38198,CN4902700000000,49,27,"Millard County, UT",Feb-20,5964,5784,180,3.0
38199,CN4902900000000,49,29,"Morgan County, UT",Feb-20,5627,5480,147,2.6
38200,CN4903100000000,49,31,"Piute County, UT",Feb-20,479,450,29,6.1
38201,CN4903300000000,49,33,"Rich County, UT",Feb-20,959,911,48,5.0
38202,CN4903500000000,49,35,"Salt Lake County, UT",Feb-20,645226,627701,17525,2.7
38203,CN4903700000000,49,37,"San Juan County, UT",Feb-20,5594,5182,412,7.4
38204,CN4903900000000,49,39,"Sanpete County, UT",Feb-20,12457,12005,452,3.6
38205,CN4904100000000,49,41,"Sevier County, UT",Feb-20,9699,9328,371,3.8
38206,CN4904300000000,49,43,"Summit County, UT",Feb-20,27281,26684,597,2.2
38207,CN4904500000000,49,45,"Tooele County, UT",Feb-20,34536,33522,1014,2.9
38208,CN4904700000000,49,47,"Uintah County, UT",Feb-20,13494,12728,766,5.7
38209,CN4904900000000,49,49,"Utah County, UT",Feb-20,315559,307596,7963,2.5
38210,CN4905100000000,49,51,"Wasatch County, UT",Feb-20,16670,16206,464,2.8
38211,CN4905300000000,49,53,"Washington County, UT",Feb-20,77990,75345,2645,3.4
38212,CN4905500000000,49,55,"Wayne County, UT",Feb-20,1355,1211,144,10.6
38213,CN4905700000000,49,57,"Weber County, UT",Feb-20,129288,125196,4092,3.2
38214,CN5000100000000,50,1,"Addison County, VT",Feb-20,20084,19542,542,2.7
38215,CN5000300000000,50,3,"Bennington County, VT",Feb-20,17785,17222,563,3.2
38216,CN5000500000000,50,5,"Caledonia County, VT",Feb-20,14159,13644,515,3.6
38217,CN5000700000000,50,7,"Chittenden County, VT",Feb-20,94628,92935,1693,1.8
38218,CN5000900000000,50,9,"Essex County, VT",Feb-20,2632,2517,115,4.4
38219,CN5001100000000,50,11,"Franklin County, VT",Feb-20,26769,26053,716,2.7
38220,CN5001300000000,50,13,"Grand Isle County, VT",Feb-20,3996,3853,143,3.6
38221,CN5001500000000,50,15,"Lamoille County, VT",Feb-20,13887,13370,517,3.7
38222,CN5001700000000,50,17,"Orange County, VT",Feb-20,15723,15211,512,3.3
38223,CN5001900000000,50,19,"Orleans County, VT",Feb-20,13370,12602,768,5.7
38224,CN5002100000000,50,21,"Rutland County, VT",Feb-20,30029,29180,849,2.8
38225,CN5002300000000,50,23,"Washington County, VT",Feb-20,34324,33458,866,2.5
38226,CN5002500000000,50,25,"Windham County, VT",Feb-20,21880,21360,520,2.4
38227,CN5002700000000,50,27,"Windsor County, VT",Feb-20,28869,28279,590,2.0
38228,CN5100100000000,51,1,"Accomack County, VA",Feb-20,16485,15771,714,4.3
38229,CN5100300000000,51,3,"Albemarle County, VA",Feb-20,59054,57745,1309,2.2
38230,CN5100500000000,51,5,"Alleghany County, VA",Feb-20,6973,6678,295,4.2
38231,CN5100700000000,51,7,"Amelia County, VA",Feb-20,6439,6234,205,3.2
38232,CN5100900000000,51,9,"Amherst County, VA",Feb-20,15189,14689,500,3.3
38233,CN5101100000000,51,11,"Appomattox County, VA",Feb-20,7253,6974,279,3.8
38234,CN5101300000000,51,13,"Arlington County, VA",Feb-20,158455,155616,2839,1.8
38235,CN5101500000000,51,15,"Augusta County, VA",Feb-20,38381,37502,879,2.3
38236,CN5101700000000,51,17,"Bath County, VA",Feb-20,2530,2459,71,2.8
38237,CN5101900000000,51,19,"Bedford County, VA",Feb-20,38830,37702,1128,2.9
38238,CN5102100000000,51,21,"Bland County, VA",Feb-20,2912,2818,94,3.2
38239,CN5102300000000,51,23,"Botetourt County, VA",Feb-20,17659,17203,456,2.6
38240,CN5102500000000,51,25,"Brunswick County, VA",Feb-20,6044,5760,284,4.7
38241,CN5102700000000,51,27,"Buchanan County, VA",Feb-20,6733,6264,469,7.0
38242,CN5102900000000,51,29,"Buckingham County, VA",Feb-20,6671,6363,308,4.6
38243,CN5103100000000,51,31,"Campbell County, VA",Feb-20,26275,25419,856,3.3
38244,CN5103300000000,51,33,"Caroline County, VA",Feb-20,15701,15185,516,3.3
38245,CN5103500000000,51,35,"Carroll County, VA",Feb-20,13561,12924,637,4.7
38246,CN5103600000000,51,36,"Charles City County, VA",Feb-20,3757,3633,124,3.3
38247,CN5103700000000,51,37,"Charlotte County, VA",Feb-20,5319,5121,198,3.7
38248,CN5104100000000,51,41,"Chesterfield County, VA",Feb-20,192727,187710,5017,2.6
38249,CN5104300000000,51,43,"Clarke County, VA",Feb-20,7766,7590,176,2.3
38250,CN5104500000000,51,45,"Craig County, VA",Feb-20,2324,2258,66,2.8
38251,CN5104700000000,51,47,"Culpeper County, VA",Feb-20,25262,24566,696,2.8
38252,CN5104900000000,51,49,"Cumberland County, VA",Feb-20,4722,4572,150,3.2
38253,CN5105100000000,51,51,"Dickenson County, VA",Feb-20,4856,4556,300,6.2
38254,CN5105300000000,51,53,"Dinwiddie County, VA",Feb-20,14024,13574,450,3.2
38255,CN5105700000000,51,57,"Essex County, VA",Feb-20,5564,5337,227,4.1
38256,CN5105900000000,51,59,"Fairfax County, VA",Feb-20,651529,637718,13811,2.1
38257,CN5106100000000,51,61,"Fauquier County, VA",Feb-20,38135,37244,891,2.3
38258,CN5106300000000,51,63,"Floyd County, VA",Feb-20,8417,8167,250,3.0
38259,CN5106500000000,51,65,"Fluvanna County, VA",Feb-20,14396,14072,324,2.3
38260,CN5106700000000,51,67,"Franklin County, VA",Feb-20,26795,25953,842,3.1
38261,CN5106900000000,51,69,"Frederick County, VA",Feb-20,49266,48136,1130,2.3
38262,CN5107100000000,51,71,"Giles County, VA",Feb-20,8144,7844,300,3.7
38263,CN5107300000000,51,73,"Gloucester County, VA",Feb-20,19794,19268,526,2.7
38264,CN5107500000000,51,75,"Goochland County, VA",Feb-20,11494,11204,290,2.5
38265,CN5107700000000,51,77,"Grayson County, VA",Feb-20,8294,7999,295,3.6
38266,CN5107900000000,51,79,"Greene County, VA",Feb-20,10845,10603,242,2.2
38267,CN5108100000000,51,81,"Greensville County, VA",Feb-20,4313,4168,145,3.4
38268,CN5108300000000,51,83,"Halifax County, VA",Feb-20,15689,15015,674,4.3
38269,CN5108500000000,51,85,"Hanover County, VA",Feb-20,60864,59473,1391,2.3
38270,CN5108700000000,51,87,"Henrico County, VA",Feb-20,187065,182188,4877,2.6
38271,CN5108900000000,51,89,"Henry County, VA",Feb-20,24091,23287,804,3.3
38272,CN5109100000000,51,91,"Highland County, VA",Feb-20,1207,1170,37,3.1
38273,CN5109300000000,51,93,"Isle of Wight County, VA",Feb-20,19627,19082,545,2.8
38274,CN5109500000000,51,95,"James City County, VA",Feb-20,37012,36008,1004,2.7
38275,CN5109700000000,51,97,"King and Queen County, VA",Feb-20,3934,3832,102,2.6
38276,CN5109900000000,51,99,"King George County, VA",Feb-20,13853,13485,368,2.7
38277,CN5110100000000,51,101,"King William County, VA",Feb-20,9407,9149,258,2.7
38278,CN5110300000000,51,103,"Lancaster County, VA",Feb-20,5498,5147,351,6.4
38279,CN5110500000000,51,105,"Lee County, VA",Feb-20,8377,7987,390,4.7
38280,CN5110700000000,51,107,"Loudoun County, VA",Feb-20,228327,223417,4910,2.2
38281,CN5110900000000,51,109,"Louisa County, VA",Feb-20,20412,19833,579,2.8
38282,CN5111100000000,51,111,"Lunenburg County, VA",Feb-20,5347,5184,163,3.0
38283,CN5111300000000,51,113,"Madison County, VA",Feb-20,7568,7408,160,2.1
38284,CN5111500000000,51,115,"Mathews County, VA",Feb-20,4184,4063,121,2.9
38285,CN5111700000000,51,117,"Mecklenburg County, VA",Feb-20,12372,11861,511,4.1
38286,CN5111900000000,51,119,"Middlesex County, VA",Feb-20,5333,5175,158,3.0
38287,CN5112100000000,51,121,"Montgomery County, VA",Feb-20,51507,50146,1361,2.6
38288,CN5112500000000,51,125,"Nelson County, VA",Feb-20,7662,7464,198,2.6
38289,CN5112700000000,51,127,"New Kent County, VA",Feb-20,12816,12526,290,2.3
38290,CN5113100000000,51,131,"Northampton County, VA",Feb-20,5366,5081,285,5.3
38291,CN5113300000000,51,133,"Northumberland County, VA",Feb-20,5719,5353,366,6.4
38292,CN5113500000000,51,135,"Nottoway County, VA",Feb-20,7412,7206,206,2.8
38293,CN5113700000000,51,137,"Orange County, VA",Feb-20,17724,17219,505,2.8
38294,CN5113900000000,51,139,"Page County, VA",Feb-20,12107,11459,648,5.4
38295,CN5114100000000,51,141,"Patrick County, VA",Feb-20,7153,6885,268,3.7
38296,CN5114300000000,51,143,"Pittsylvania County, VA",Feb-20,30283,29129,1154,3.8
38297,CN5114500000000,51,145,"Powhatan County, VA",Feb-20,14556,14174,382,2.6
38298,CN5114700000000,51,147,"Prince Edward County, VA",Feb-20,10507,10125,382,3.6
38299,CN5114900000000,51,149,"Prince George County, VA",Feb-20,15511,15006,505,3.3
38300,CN5115300000000,51,153,"Prince William County, VA",Feb-20,252178,246012,6166,2.4
38301,CN5115500000000,51,155,"Pulaski County, VA",Feb-20,16787,15973,814,4.8
38302,CN5115700000000,51,157,"Rappahannock County, VA",Feb-20,3771,3681,90,2.4
38303,CN5115900000000,51,159,"Richmond County, VA",Feb-20,4129,4002,127,3.1
38304,CN5116100000000,51,161,"Roanoke County, VA",Feb-20,50126,48811,1315,2.6
38305,CN5116300000000,51,163,"Rockbridge County, VA",Feb-20,10810,10517,293,2.7
38306,CN5116500000000,51,165,"Rockingham County, VA",Feb-20,43353,42389,964,2.2
38307,CN5116700000000,51,167,"Russell County, VA",Feb-20,11448,10876,572,5.0
38308,CN5116900000000,51,169,"Scott County, VA",Feb-20,9264,8940,324,3.5
38309,CN5117100000000,51,171,"Shenandoah County, VA",Feb-20,22799,22232,567,2.5
38310,CN5117300000000,51,173,"Smyth County, VA",Feb-20,13895,13328,567,4.1
38311,CN5117500000000,51,175,"Southampton County, VA",Feb-20,9081,8836,245,2.7
38312,CN5117700000000,51,177,"Spotsylvania County, VA",Feb-20,68784,66883,1901,2.8
38313,CN5117900000000,51,179,"Stafford County, VA",Feb-20,73950,72033,1917,2.6
38314,CN5118100000000,51,181,"Surry County, VA",Feb-20,3682,3551,131,3.6
38315,CN5118300000000,51,183,"Sussex County, VA",Feb-20,3889,3712,177,4.6
38316,CN5118500000000,51,185,"Tazewell County, VA",Feb-20,15787,14987,800,5.1
38317,CN5118700000000,51,187,"Warren County, VA",Feb-20,20973,20380,593,2.8
38318,CN5119100000000,51,191,"Washington County, VA",Feb-20,27104,26153,951,3.5
38319,CN5119300000000,51,193,"Westmoreland County, VA",Feb-20,9601,9217,384,4.0
38320,CN5119500000000,51,195,"Wise County, VA",Feb-20,13599,12940,659,4.8
38321,CN5119700000000,51,197,"Wythe County, VA",Feb-20,13822,13195,627,4.5
38322,CN5119900000000,51,199,"York County, VA",Feb-20,33100,32254,846,2.6
38323,CN5151000000000,51,510,"Alexandria city, VA",Feb-20,104087,101927,2160,2.1
38324,CN5152000000000,51,520,"Bristol city, VA",Feb-20,7290,7009,281,3.9
38325,CN5153000000000,51,530,"Buena Vista city, VA",Feb-20,3709,3627,82,2.2
38326,CN5154000000000,51,540,"Charlottesville city, VA",Feb-20,27327,26742,585,2.1
38327,CN5155000000000,51,550,"Chesapeake city, VA",Feb-20,123894,120499,3395,2.7
38328,CN5157000000000,51,570,"Colonial Heights city, VA",Feb-20,9031,8776,255,2.8
38329,CN5158000000000,51,580,"Covington city, VA",Feb-20,2442,2299,143,5.9
38330,CN5159000000000,51,590,"Danville city, VA",Feb-20,19297,18238,1059,5.5
38331,CN5159500000000,51,595,"Emporia city, VA",Feb-20,2287,2184,103,4.5
38332,CN5160000000000,51,600,"Fairfax city, VA",Feb-20,13805,13523,282,2.0
38333,CN5161000000000,51,610,"Falls Church city, VA",Feb-20,8810,8652,158,1.8
38334,CN5162000000000,51,620,"Franklin city, VA",Feb-20,3585,3446,139,3.9
38335,CN5163000000000,51,630,"Fredericksburg city, VA",Feb-20,14500,14063,437,3.0
38336,CN5164000000000,51,640,"Galax city, VA",Feb-20,2952,2852,100,3.4
38337,CN5165000000000,51,650,"Hampton city, VA",Feb-20,65091,62639,2452,3.8
38338,CN5166000000000,51,660,"Harrisonburg city, VA",Feb-20,25854,25158,696,2.7
38339,CN5167000000000,51,670,"Hopewell city, VA",Feb-20,9953,9544,409,4.1
38340,CN5167800000000,51,678,"Lexington city, VA",Feb-20,2122,2040,82,3.9
38341,CN5168000000000,51,680,"Lynchburg city, VA",Feb-20,36633,35350,1283,3.5
38342,CN5168300000000,51,683,"Manassas city, VA",Feb-20,22666,22094,572,2.5
38343,CN5168500000000,51,685,"Manassas Park city, VA",Feb-20,9627,9393,234,2.4
38344,CN5169000000000,51,690,"Martinsville city, VA",Feb-20,5563,5305,258,4.6
38345,CN5170000000000,51,700,"Newport News city, VA",Feb-20,89933,86715,3218,3.6
38346,CN5171000000000,51,710,"Norfolk city, VA",Feb-20,112762,108996,3766,3.3
38347,CN5172000000000,51,720,"Norton city, VA",Feb-20,1713,1636,77,4.5
38348,CN5173000000000,51,730,"Petersburg city, VA",Feb-20,13453,12661,792,5.9
38349,CN5173500000000,51,735,"Poquoson city, VA",Feb-20,6439,6292,147,2.3
38350,CN5174000000000,51,740,"Portsmouth city, VA",Feb-20,44737,43030,1707,3.8
38351,CN5175000000000,51,750,"Radford city, VA",Feb-20,8885,8592,293,3.3
38352,CN5176000000000,51,760,"Richmond city, VA",Feb-20,121662,117795,3867,3.2
38353,CN5177000000000,51,770,"Roanoke city, VA",Feb-20,49913,48361,1552,3.1
38354,CN5177500000000,51,775,"Salem city, VA",Feb-20,13167,12803,364,2.8
38355,CN5179000000000,51,790,"Staunton city, VA",Feb-20,12563,12233,330,2.6
38356,CN5180000000000,51,800,"Suffolk city, VA",Feb-20,45084,43760,1324,2.9
38357,CN5181000000000,51,810,"Virginia Beach city, VA",Feb-20,235430,229285,6145,2.6
38358,CN5182000000000,51,820,"Waynesboro city, VA",Feb-20,10984,10671,313,2.8
38359,CN5183000000000,51,830,"Williamsburg city, VA",Feb-20,6760,6504,256,3.8
38360,CN5184000000000,51,840,"Winchester city, VA",Feb-20,15132,14726,406,2.7
38361,CN5300100000000,53,1,"Adams County, WA",Feb-20,8492,7877,615,7.2
38362,CN5300300000000,53,3,"Asotin County, WA",Feb-20,10651,10212,439,4.1
38363,CN5300500000000,53,5,"Benton County, WA",Feb-20,105195,99430,5765,5.5
38364,CN5300700000000,53,7,"Chelan County, WA",Feb-20,43045,40507,2538,5.9
38365,CN5300900000000,53,9,"Clallam County, WA",Feb-20,29302,27410,1892,6.5
38366,CN5301100000000,53,11,"Clark County, WA",Feb-20,248872,237565,11307,4.5
38367,CN5301300000000,53,13,"Columbia County, WA",Feb-20,1780,1673,107,6.0
38368,CN5301500000000,53,15,"Cowlitz County, WA",Feb-20,49047,46176,2871,5.9
38369,CN5301700000000,53,17,"Douglas County, WA",Feb-20,20992,19575,1417,6.8
38370,CN5301900000000,53,19,"Ferry County, WA",Feb-20,2502,2170,332,13.3
38371,CN5302100000000,53,21,"Franklin County, WA",Feb-20,42448,39385,3063,7.2
38372,CN5302300000000,53,23,"Garfield County, WA",Feb-20,814,757,57,7.0
38373,CN5302500000000,53,25,"Grant County, WA",Feb-20,44955,41109,3846,8.6
38374,CN5302700000000,53,27,"Grays Harbor County, WA",Feb-20,29442,27366,2076,7.1
38375,CN5302900000000,53,29,"Island County, WA",Feb-20,37080,35273,1807,4.9
38376,CN5303100000000,53,31,"Jefferson County, WA",Feb-20,13319,12582,737,5.5
38377,CN5303300000000,53,33,"King County, WA",Feb-20,1310239,1278267,31972,2.4
38378,CN5303500000000,53,35,"Kitsap County, WA",Feb-20,133434,127812,5622,4.2
38379,CN5303700000000,53,37,"Kittitas County, WA",Feb-20,24185,22819,1366,5.6
38380,CN5303900000000,53,39,"Klickitat County, WA",Feb-20,9839,9193,646,6.6
38381,CN5304100000000,53,41,"Lewis County, WA",Feb-20,35364,33121,2243,6.3
38382,CN5304300000000,53,43,"Lincoln County, WA",Feb-20,4753,4465,288,6.1
38383,CN5304500000000,53,45,"Mason County, WA",Feb-20,26576,24931,1645,6.2
38384,CN5304700000000,53,47,"Okanogan County, WA",Feb-20,18929,17265,1664,8.8
38385,CN5304900000000,53,49,"Pacific County, WA",Feb-20,8554,7988,566,6.6
38386,CN5305100000000,53,51,"Pend Oreille County, WA",Feb-20,5183,4711,472,9.1
38387,CN5305300000000,53,53,"Pierce County, WA",Feb-20,456345,433701,22644,5.0
38388,CN5305500000000,53,55,"San Juan County, WA",Feb-20,8485,8124,361,4.3
38389,CN5305700000000,53,57,"Skagit County, WA",Feb-20,63484,59855,3629,5.7
38390,CN5305900000000,53,59,"Skamania County, WA",Feb-20,5667,5355,312,5.5
38391,CN5306100000000,53,61,"Snohomish County, WA",Feb-20,446145,433844,12301,2.8
38392,CN5306300000000,53,63,"Spokane County, WA",Feb-20,262904,248229,14675,5.6
38393,CN5306500000000,53,65,"Stevens County, WA",Feb-20,19367,17706,1661,8.6
38394,CN5306700000000,53,67,"Thurston County, WA",Feb-20,148241,141303,6938,4.7
38395,CN5306900000000,53,69,"Wahkiakum County, WA",Feb-20,1361,1268,93,6.8
38396,CN5307100000000,53,71,"Walla Walla County, WA",Feb-20,30292,28821,1471,4.9
38397,CN5307300000000,53,73,"Whatcom County, WA",Feb-20,118175,112296,5879,5.0
38398,CN5307500000000,53,75,"Whitman County, WA",Feb-20,24585,23645,940,3.8
38399,CN5307700000000,53,77,"Yakima County, WA",Feb-20,130037,119652,10385,8.0
38400,CN5400100000000,54,1,"Barbour County, WV",Feb-20,7483,6968,515,6.9
38401,CN5400300000000,54,3,"Berkeley County, WV",Feb-20,58805,56898,1907,3.2
38402,CN5400500000000,54,5,"Boone County, WV",Feb-20,7544,7044,500,6.6
38403,CN5400700000000,54,7,"Braxton County, WV",Feb-20,5396,4835,561,10.4
38404,CN5400900000000,54,9,"Brooke County, WV",Feb-20,10005,9446,559,5.6
38405,CN5401100000000,54,11,"Cabell County, WV",Feb-20,42131,40407,1724,4.1
38406,CN5401300000000,54,13,"Calhoun County, WV",Feb-20,2756,2215,541,19.6
38407,CN5401500000000,54,15,"Clay County, WV",Feb-20,3291,2881,410,12.5
38408,CN5401700000000,54,17,"Doddridge County, WV",Feb-20,4054,3840,214,5.3
38409,CN5401900000000,54,19,"Fayette County, WV",Feb-20,16450,15251,1199,7.3
38410,CN5402100000000,54,21,"Gilmer County, WV",Feb-20,2482,2266,216,8.7
38411,CN5402300000000,54,23,"Grant County, WV",Feb-20,6012,5662,350,5.8
38412,CN5402500000000,54,25,"Greenbrier County, WV",Feb-20,15980,15094,886,5.5
38413,CN5402700000000,54,27,"Hampshire County, WV",Feb-20,11053,10627,426,3.9
38414,CN5402900000000,54,29,"Hancock County, WV",Feb-20,13079,12364,715,5.5
38415,CN5403100000000,54,31,"Hardy County, WV",Feb-20,5927,5606,321,5.4
38416,CN5403300000000,54,33,"Harrison County, WV",Feb-20,35038,33227,1811,5.2
38417,CN5403500000000,54,35,"Jackson County, WV",Feb-20,13470,12643,827,6.1
38418,CN5403700000000,54,37,"Jefferson County, WV",Feb-20,30488,29627,861,2.8
38419,CN5403900000000,54,39,"Kanawha County, WV",Feb-20,82690,78718,3972,4.8
38420,CN5404100000000,54,41,"Lewis County, WV",Feb-20,6677,6143,534,8.0
38421,CN5404300000000,54,43,"Lincoln County, WV",Feb-20,7418,6838,580,7.8
38422,CN5404500000000,54,45,"Logan County, WV",Feb-20,11539,10674,865,7.5
38423,CN5404700000000,54,47,"McDowell County, WV",Feb-20,4678,4158,520,11.1
38424,CN5404900000000,54,49,"Marion County, WV",Feb-20,26206,24859,1347,5.1
38425,CN5405100000000,54,51,"Marshall County, WV",Feb-20,14204,13078,1126,7.9
38426,CN5405300000000,54,53,"Mason County, WV",Feb-20,10425,9729,696,6.7
38427,CN5405500000000,54,55,"Mercer County, WV",Feb-20,21315,20111,1204,5.6
38428,CN5405700000000,54,57,"Mineral County, WV",Feb-20,12857,12132,725,5.6
38429,CN5405900000000,54,59,"Mingo County, WV",Feb-20,7195,6493,702,9.8
38430,CN5406100000000,54,61,"Monongalia County, WV",Feb-20,56224,54308,1916,3.4
38431,CN5406300000000,54,63,"Monroe County, WV",Feb-20,6175,5831,344,5.6
38432,CN5406500000000,54,65,"Morgan County, WV",Feb-20,8208,7888,320,3.9
38433,CN5406700000000,54,67,"Nicholas County, WV",Feb-20,9746,8900,846,8.7
38434,CN5406900000000,54,69,"Ohio County, WV",Feb-20,20970,19971,999,4.8
38435,CN5407100000000,54,71,"Pendleton County, WV",Feb-20,3794,3637,157,4.1
38436,CN5407300000000,54,73,"Pleasants County, WV",Feb-20,2993,2733,260,8.7
38437,CN5407500000000,54,75,"Pocahontas County, WV",Feb-20,4280,4045,235,5.5
38438,CN5407700000000,54,77,"Preston County, WV",Feb-20,16129,15292,837,5.2
38439,CN5407900000000,54,79,"Putnam County, WV",Feb-20,27255,25994,1261,4.6
38440,CN5408100000000,54,81,"Raleigh County, WV",Feb-20,30533,28908,1625,5.3
38441,CN5408300000000,54,83,"Randolph County, WV",Feb-20,12475,11621,854,6.8
38442,CN5408500000000,54,85,"Ritchie County, WV",Feb-20,4493,4158,335,7.5
38443,CN5408700000000,54,87,"Roane County, WV",Feb-20,5370,4739,631,11.8
38444,CN5408900000000,54,89,"Summers County, WV",Feb-20,4383,4091,292,6.7
38445,CN5409100000000,54,91,"Taylor County, WV",Feb-20,8035,7595,440,5.5
38446,CN5409300000000,54,93,"Tucker County, WV",Feb-20,3434,3210,224,6.5
38447,CN5409500000000,54,95,"Tyler County, WV",Feb-20,3191,2900,291,9.1
38448,CN5409700000000,54,97,"Upshur County, WV",Feb-20,9796,9114,682,7.0
38449,CN5409900000000,54,99,"Wayne County, WV",Feb-20,16175,15188,987,6.1
38450,CN5410100000000,54,101,"Webster County, WV",Feb-20,3468,3153,315,9.1
38451,CN5410300000000,54,103,"Wetzel County, WV",Feb-20,6793,6178,615,9.1
38452,CN5410500000000,54,105,"Wirt County, WV",Feb-20,2407,2152,255,10.6
38453,CN5410700000000,54,107,"Wood County, WV",Feb-20,37568,35393,2175,5.8
38454,CN5410900000000,54,109,"Wyoming County, WV",Feb-20,6808,6237,571,8.4
38455,CN5500100000000,55,1,"Adams County, WI",Feb-20,8031,7401,630,7.8
38456,CN5500300000000,55,3,"Ashland County, WI",Feb-20,7614,7159,455,6.0
38457,CN5500500000000,55,5,"Barron County, WI",Feb-20,23992,22581,1411,5.9
38458,CN5500700000000,55,7,"Bayfield County, WI",Feb-20,7371,6785,586,8.0
38459,CN5500900000000,55,9,"Brown County, WI",Feb-20,141950,137028,4922,3.5
38460,CN5501100000000,55,11,"Buffalo County, WI",Feb-20,6290,5902,388,6.2
38461,CN5501300000000,55,13,"Burnett County, WI",Feb-20,6959,6391,568,8.2
38462,CN5501500000000,55,15,"Calumet County, WI",Feb-20,27281,26394,887,3.3
38463,CN5501700000000,55,17,"Chippewa County, WI",Feb-20,33595,31693,1902,5.7
38464,CN5501900000000,55,19,"Clark County, WI",Feb-20,17336,16521,815,4.7
38465,CN5502100000000,55,21,"Columbia County, WI",Feb-20,31858,30522,1336,4.2
38466,CN5502300000000,55,23,"Crawford County, WI",Feb-20,7453,6906,547,7.3
38467,CN5502500000000,55,25,"Dane County, WI",Feb-20,322376,314298,8078,2.5
38468,CN5502700000000,55,27,"Dodge County, WI",Feb-20,46971,45192,1779,3.8
38469,CN5502900000000,55,29,"Door County, WI",Feb-20,13773,12960,813,5.9
38470,CN5503100000000,55,31,"Douglas County, WI",Feb-20,23291,21884,1407,6.0
38471,CN5503300000000,55,33,"Dunn County, WI",Feb-20,24550,23387,1163,4.7
38472,CN5503500000000,55,35,"Eau Claire County, WI",Feb-20,58971,56979,1992,3.4
38473,CN5503700000000,55,37,"Florence County, WI",Feb-20,2173,2048,125,5.8
38474,CN5503900000000,55,39,"Fond du Lac County, WI",Feb-20,57255,55297,1958,3.4
38475,CN5504100000000,55,41,"Forest County, WI",Feb-20,3958,3710,248,6.3
38476,CN5504300000000,55,43,"Grant County, WI",Feb-20,27896,26658,1238,4.4
38477,CN5504500000000,55,45,"Green County, WI",Feb-20,21090,20261,829,3.9
38478,CN5504700000000,55,47,"Green Lake County, WI",Feb-20,9038,8503,535,5.9
38479,CN5504900000000,55,49,"Iowa County, WI",Feb-20,13732,13140,592,4.3
38480,CN5505100000000,55,51,"Iron County, WI",Feb-20,2527,2338,189,7.5
38481,CN5505300000000,55,53,"Jackson County, WI",Feb-20,10040,9402,638,6.4
38482,CN5505500000000,55,55,"Jefferson County, WI",Feb-20,45751,43894,1857,4.1
38483,CN5505700000000,55,57,"Juneau County, WI",Feb-20,13317,12641,676,5.1
38484,CN5505900000000,55,59,"Kenosha County, WI",Feb-20,88212,84052,4160,4.7
38485,CN5506100000000,55,61,"Kewaunee County, WI",Feb-20,10900,10491,409,3.8
38486,CN5506300000000,55,63,"La Crosse County, WI",Feb-20,66656,64483,2173,3.3
38487,CN5506500000000,55,65,"Lafayette County, WI",Feb-20,9979,9615,364,3.6
38488,CN5506700000000,55,67,"Langlade County, WI",Feb-20,9209,8694,515,5.6
38489,CN5506900000000,55,69,"Lincoln County, WI",Feb-20,15088,14277,811,5.4
38490,CN5507100000000,55,71,"Manitowoc County, WI",Feb-20,40567,38782,1785,4.4
38491,CN5507300000000,55,73,"Marathon County, WI",Feb-20,73830,71417,2413,3.3
38492,CN5507500000000,55,75,"Marinette County, WI",Feb-20,19187,18074,1113,5.8
38493,CN5507700000000,55,77,"Marquette County, WI",Feb-20,7793,7292,501,6.4
38494,CN5507800000000,55,78,"Menominee County, WI",Feb-20,1554,1453,101,6.5
38495,CN5507900000000,55,79,"Milwaukee County, WI",Feb-20,468820,448726,20094,4.3
38496,CN5508100000000,55,81,"Monroe County, WI",Feb-20,23071,22184,887,3.8
38497,CN5508300000000,55,83,"Oconto County, WI",Feb-20,20723,19602,1121,5.4
38498,CN5508500000000,55,85,"Oneida County, WI",Feb-20,17146,16037,1109,6.5
38499,CN5508700000000,55,87,"Outagamie County, WI",Feb-20,102506,99091,3415,3.3
38500,CN5508900000000,55,89,"Ozaukee County, WI",Feb-20,48862,47465,1397,2.9
38501,CN5509100000000,55,91,"Pepin County, WI",Feb-20,4009,3782,227,5.7
38502,CN5509300000000,55,93,"Pierce County, WI",Feb-20,25402,24134,1268,5.0
38503,CN5509500000000,55,95,"Polk County, WI",Feb-20,24604,22936,1668,6.8
38504,CN5509700000000,55,97,"Portage County, WI",Feb-20,38493,36974,1519,3.9
38505,CN5509900000000,55,99,"Price County, WI",Feb-20,6347,5953,394,6.2
38506,CN5510100000000,55,101,"Racine County, WI",Feb-20,98104,93236,4868,5.0
38507,CN5510300000000,55,103,"Richland County, WI",Feb-20,9006,8626,380,4.2
38508,CN5510500000000,55,105,"Rock County, WI",Feb-20,85480,81528,3952,4.6
38509,CN5510700000000,55,107,"Rusk County, WI",Feb-20,6793,6320,473,7.0
38510,CN5510900000000,55,109,"St. Croix County, WI",Feb-20,50592,48161,2431,4.8
38511,CN5511100000000,55,111,"Sauk County, WI",Feb-20,34779,33411,1368,3.9
38512,CN5511300000000,55,113,"Sawyer County, WI",Feb-20,7696,7130,566,7.4
38513,CN5511500000000,55,115,"Shawano County, WI",Feb-20,20618,19684,934,4.5
38514,CN5511700000000,55,117,"Sheboygan County, WI",Feb-20,61246,59298,1948,3.2
38515,CN5511900000000,55,119,"Taylor County, WI",Feb-20,10906,10218,688,6.3
38516,CN5512100000000,55,121,"Trempealeau County, WI",Feb-20,15736,14941,795,5.1
38517,CN5512300000000,55,123,"Vernon County, WI",Feb-20,15031,14309,722,4.8
38518,CN5512500000000,55,125,"Vilas County, WI",Feb-20,9584,8990,594,6.2
38519,CN5512700000000,55,127,"Walworth County, WI",Feb-20,57230,54855,2375,4.1
38520,CN5512900000000,55,129,"Washburn County, WI",Feb-20,7653,7206,447,5.8
38521,CN5513100000000,55,131,"Washington County, WI",Feb-20,77412,74870,2542,3.3
38522,CN5513300000000,55,133,"Waukesha County, WI",Feb-20,225357,218223,7134,3.2
38523,CN5513500000000,55,135,"Waupaca County, WI",Feb-20,25477,24475,1002,3.9
38524,CN5513700000000,55,137,"Waushara County, WI",Feb-20,11213,10583,630,5.6
38525,CN5513900000000,55,139,"Winnebago County, WI",Feb-20,91287,88391,2896,3.2
38526,CN5514100000000,55,141,"Wood County, WI",Feb-20,34880,33250,1630,4.7
38527,CN5600100000000,56,1,"Albany County, WY",Feb-20,20673,20031,642,3.1
38528,CN5600300000000,56,3,"Big Horn County, WY",Feb-20,5303,5011,292,5.5
38529,CN5600500000000,56,5,"Campbell County, WY",Feb-20,23789,22875,914,3.8
38530,CN5600700000000,56,7,"Carbon County, WY",Feb-20,7959,7606,353,4.4
38531,CN5600900000000,56,9,"Converse County, WY",Feb-20,9061,8776,285,3.1
38532,CN5601100000000,56,11,"Crook County, WY",Feb-20,3673,3553,120,3.3
38533,CN5601300000000,56,13,"Fremont County, WY",Feb-20,18958,17928,1030,5.4
38534,CN5601500000000,56,15,"Goshen County, WY",Feb-20,6637,6400,237,3.6
38535,CN5601700000000,56,17,"Hot Springs County, WY",Feb-20,2161,2064,97,4.5
38536,CN5601900000000,56,19,"Johnson County, WY",Feb-20,4080,3908,172,4.2
38537,CN5602100000000,56,21,"Laramie County, WY",Feb-20,49166,47167,1999,4.1
38538,CN5602300000000,56,23,"Lincoln County, WY",Feb-20,8856,8485,371,4.2
38539,CN5602500000000,56,25,"Natrona County, WY",Feb-20,39532,37684,1848,4.7
38540,CN5602700000000,56,27,"Niobrara County, WY",Feb-20,1229,1185,44,3.6
38541,CN5602900000000,56,29,"Park County, WY",Feb-20,14802,14069,733,5.0
38542,CN5603100000000,56,31,"Platte County, WY",Feb-20,4558,4343,215,4.7
38543,CN5603300000000,56,33,"Sheridan County, WY",Feb-20,15734,15055,679,4.3
38544,CN5603500000000,56,35,"Sublette County, WY",Feb-20,4205,3950,255,6.1
38545,CN5603700000000,56,37,"Sweetwater County, WY",Feb-20,21483,20317,1166,5.4
38546,CN5603900000000,56,39,"Teton County, WY",Feb-20,15358,14955,403,2.6
38547,CN5604100000000,56,41,"Uinta County, WY",Feb-20,8789,8386,403,4.6
38548,CN5604300000000,56,43,"Washakie County, WY",Feb-20,3917,3720,197,5.0
38549,CN5604500000000,56,45,"Weston County, WY",Feb-20,3829,3706,123,3.2
38550,CN7200100000000,72,1,"Adjuntas Municipio, PR",Feb-20 p,4145,3378,767,18.5
38551,CN7200300000000,72,3,"Aguada Municipio, PR",Feb-20 p,11322,10219,1103,9.7
38552,CN7200500000000,72,5,"Aguadilla Municipio, PR",Feb-20 p,13724,12498,1226,8.9
38553,CN7200700000000,72,7,"Aguas Buenas Municipio, PR",Feb-20 p,6229,5677,552,8.9
38554,CN7200900000000,72,9,"Aibonito Municipio, PR",Feb-20 p,6102,5516,586,9.6
38555,CN7201100000000,72,11,"Anasco Municipio, PR",Feb-20 p,8398,7707,691,8.2
38556,CN7201300000000,72,13,"Arecibo Municipio, PR",Feb-20 p,22898,20843,2055,9.0
38557,CN7201500000000,72,15,"Arroyo Municipio, PR",Feb-20 p,4456,3834,622,14.0
38558,CN7201700000000,72,17,"Barceloneta Municipio, PR",Feb-20 p,5621,5014,607,10.8
38559,CN7201900000000,72,19,"Barranquitas Municipio, PR",Feb-20 p,6889,6351,538,7.8
38560,CN7202100000000,72,21,"Bayamon Municipio, PR",Feb-20 p,61841,58386,3455,5.6
38561,CN7202300000000,72,23,"Cabo Rojo Municipio, PR",Feb-20 p,12884,11815,1069,8.3
38562,CN7202500000000,72,25,"Caguas Municipio, PR",Feb-20 p,45245,42506,2739,6.1
38563,CN7202700000000,72,27,"Camuy Municipio, PR",Feb-20 p,9070,8329,741,8.2
38564,CN7202900000000,72,29,"Canovanas Municipio, PR",Feb-20 p,15239,14303,936,6.1
38565,CN7203100000000,72,31,"Carolina Municipio, PR",Feb-20 p,58206,55203,3003,5.2
38566,CN7203300000000,72,33,"Catano Municipio, PR",Feb-20 p,7399,6937,462,6.2
38567,CN7203500000000,72,35,"Cayey Municipio, PR",Feb-20 p,15282,14301,981,6.4
38568,CN7203700000000,72,37,"Ceiba Municipio, PR",Feb-20 p,3464,3185,279,8.1
38569,CN7203900000000,72,39,"Ciales Municipio, PR",Feb-20 p,3487,3132,355,10.2
38570,CN7204100000000,72,41,"Cidra Municipio, PR",Feb-20 p,14641,13791,850,5.8
38571,CN7204300000000,72,43,"Coamo Municipio, PR",Feb-20 p,9441,8346,1095,11.6
38572,CN7204500000000,72,45,"Comerio Municipio, PR",Feb-20 p,4674,4243,431,9.2
38573,CN7204700000000,72,47,"Corozal Municipio, PR",Feb-20 p,8383,7702,681,8.1
38574,CN7204900000000,72,49,"Culebra Municipio, PR",Feb-20 p,849,823,26,3.1
38575,CN7205100000000,72,51,"Dorado Municipio, PR",Feb-20 p,12498,11843,655,5.2
38576,CN7205300000000,72,53,"Fajardo Municipio, PR",Feb-20 p,10216,9363,853,8.3
38577,CN7205400000000,72,54,"Florida Municipio, PR",Feb-20 p,3155,2829,326,10.3
38578,CN7205500000000,72,55,"Guanica Municipio, PR",Feb-20 p,3985,3354,631,15.8
38579,CN7205700000000,72,57,"Guayama Municipio, PR",Feb-20 p,10306,9220,1086,10.5
38580,CN7205900000000,72,59,"Guayanilla Municipio, PR",Feb-20 p,4659,3971,688,14.8
38581,CN7206100000000,72,61,"Guaynabo Municipio, PR",Feb-20 p,35740,34411,1329,3.7
38582,CN7206300000000,72,63,"Gurabo Municipio, PR",Feb-20 p,17184,16255,929,5.4
38583,CN7206500000000,72,65,"Hatillo Municipio, PR",Feb-20 p,13384,11450,1934,14.5
38584,CN7206700000000,72,67,"Hormigueros Municipio, PR",Feb-20 p,5050,4659,391,7.7
38585,CN7206900000000,72,69,"Humacao Municipio, PR",Feb-20 p,16294,14760,1534,9.4
38586,CN7207100000000,72,71,"Isabela Municipio, PR",Feb-20 p,11139,10148,991,8.9
38587,CN7207300000000,72,73,"Jayuya Municipio, PR",Feb-20 p,4049,3537,512,12.6
38588,CN7207500000000,72,75,"Juana Diaz Municipio, PR",Feb-20 p,14659,13392,1267,8.6
38589,CN7207700000000,72,77,"Juncos Municipio, PR",Feb-20 p,11597,10730,867,7.5
38590,CN7207900000000,72,79,"Lajas Municipio, PR",Feb-20 p,4936,4338,598,12.1
38591,CN7208100000000,72,81,"Lares Municipio, PR",Feb-20 p,6828,5694,1134,16.6
38592,CN7208300000000,72,83,"Las Marias Municipio, PR",Feb-20 p,2535,2240,295,11.6
38593,CN7208500000000,72,85,"Las Piedras Municipio, PR",Feb-20 p,10661,9811,850,8.0
38594,CN7208700000000,72,87,"Loiza Municipio, PR",Feb-20 p,8027,7422,605,7.5
38595,CN7208900000000,72,89,"Luquillo Municipio, PR",Feb-20 p,5822,5355,467,8.0
38596,CN7209100000000,72,91,"Manati Municipio, PR",Feb-20 p,10895,10104,791,7.3
38597,CN7209300000000,72,93,"Maricao Municipio, PR",Feb-20 p,1874,1572,302,16.1
38598,CN7209500000000,72,95,"Maunabo Municipio, PR",Feb-20 p,2901,2391,510,17.6
38599,CN7209700000000,72,97,"Mayaguez Municipio, PR",Feb-20 p,20475,18556,1919,9.4
38600,CN7209900000000,72,99,"Moca Municipio, PR",Feb-20 p,9937,8934,1003,10.1
38601,CN7210100000000,72,101,"Morovis Municipio, PR",Feb-20 p,7530,6911,619,8.2
38602,CN7210300000000,72,103,"Naguabo Municipio, PR",Feb-20 p,7696,7082,614,8.0
38603,CN7210500000000,72,105,"Naranjito Municipio, PR",Feb-20 p,6685,6152,533,8.0
38604,CN7210700000000,72,107,"Orocovis Municipio, PR",Feb-20 p,4721,4192,529,11.2
38605,CN7210900000000,72,109,"Patillas Municipio, PR",Feb-20 p,4126,3445,681,16.5
38606,CN7211100000000,72,111,"Penuelas Municipio, PR",Feb-20 p,5528,4830,698,12.6
38607,CN7211300000000,72,113,"Ponce Municipio, PR",Feb-20 p,42914,39282,3632,8.5
38608,CN7211500000000,72,115,"Quebradillas Municipio, PR",Feb-20 p,5808,5165,643,11.1
38609,CN7211700000000,72,117,"Rincon Municipio, PR",Feb-20 p,4769,3924,845,17.7
38610,CN7211900000000,72,119,"Rio Grande Municipio, PR",Feb-20 p,15993,14969,1024,6.4
38611,CN7212100000000,72,121,"Sabana Grande Municipio, PR",Feb-20 p,5855,5074,781,13.3
38612,CN7212300000000,72,123,"Salinas Municipio, PR",Feb-20 p,6569,5693,876,13.3
38613,CN7212500000000,72,125,"San German Municipio, PR",Feb-20 p,9184,8212,972,10.6
38614,CN7212700000000,72,127,"San Juan Municipio, PR",Feb-20 p,127066,120870,6196,4.9
38615,CN7212900000000,72,129,"San Lorenzo Municipio, PR",Feb-20 p,11147,10180,967,8.7
38616,CN7213100000000,72,131,"San Sebastian Municipio, PR",Feb-20 p,9828,8392,1436,14.6
38617,CN7213300000000,72,133,"Santa Isabel Municipio, PR",Feb-20 p,8841,8096,745,8.4
38618,CN7213500000000,72,135,"Toa Alta Municipio, PR",Feb-20 p,25678,24371,1307,5.1
38619,CN7213700000000,72,137,"Toa Baja Municipio, PR",Feb-20 p,27667,26236,1431,5.2
38620,CN7213900000000,72,139,"Trujillo Alto Municipio, PR",Feb-20 p,25662,24550,1112,4.3
38621,CN7214100000000,72,141,"Utuado Municipio, PR",Feb-20 p,6423,5630,793,12.3
38622,CN7214300000000,72,143,"Vega Alta Municipio, PR",Feb-20 p,9236,8519,717,7.8
38623,CN7214500000000,72,145,"Vega Baja Municipio, PR",Feb-20 p,12505,11436,1069,8.5
38624,CN7214700000000,72,147,"Vieques Municipio, PR",Feb-20 p,2486,2338,148,6.0
38625,CN7214900000000,72,149,"Villalba Municipio, PR",Feb-20 p,7334,6000,1334,18.2
38626,CN7215100000000,72,151,"Yabucoa Municipio, PR",Feb-20 p,8396,7329,1067,12.7
38627,CN7215300000000,72,153,"Yauco Municipio, PR",Feb-20 p,9718,8063,1655,17.0
38628,CN0100100000000,01,1,"Autauga County, AL",Mar-20,25835,25114,721,2.8
38629,CN0100300000000,01,3,"Baldwin County, AL",Mar-20,96391,93782,2609,2.7
38630,CN0100500000000,01,5,"Barbour County, AL",Mar-20,8537,8221,316,3.7
38631,CN0100700000000,01,7,"Bibb County, AL",Mar-20,8617,8348,269,3.1
38632,CN0100900000000,01,9,"Blount County, AL",Mar-20,25103,24421,682,2.7
38633,CN0101100000000,01,11,"Bullock County, AL",Mar-20,4610,4453,157,3.4
38634,CN0101300000000,01,13,"Butler County, AL",Mar-20,9030,8663,367,4.1
38635,CN0101500000000,01,15,"Calhoun County, AL",Mar-20,45630,44010,1620,3.6
38636,CN0101700000000,01,17,"Chambers County, AL",Mar-20,15759,15284,475,3.0
38637,CN0101900000000,01,19,"Cherokee County, AL",Mar-20,11597,11263,334,2.9
38638,CN0102100000000,01,21,"Chilton County, AL",Mar-20,19603,19083,520,2.7
38639,CN0102300000000,01,23,"Choctaw County, AL",Mar-20,4520,4295,225,5.0
38640,CN0102500000000,01,25,"Clarke County, AL",Mar-20,7537,7090,447,5.9
38641,CN0102700000000,01,27,"Clay County, AL",Mar-20,6094,5915,179,2.9
38642,CN0102900000000,01,29,"Cleburne County, AL",Mar-20,5669,5479,190,3.4
38643,CN0103100000000,01,31,"Coffee County, AL",Mar-20,21114,20505,609,2.9
38644,CN0103300000000,01,33,"Colbert County, AL",Mar-20,23411,22562,849,3.6
38645,CN0103500000000,01,35,"Conecuh County, AL",Mar-20,4466,4294,172,3.9
38646,CN0103700000000,01,37,"Coosa County, AL",Mar-20,4489,4350,139,3.1
38647,CN0103900000000,01,39,"Covington County, AL",Mar-20,15204,14685,519,3.4
38648,CN0104100000000,01,41,"Crenshaw County, AL",Mar-20,6311,6120,191,3.0
38649,CN0104300000000,01,43,"Cullman County, AL",Mar-20,38585,37585,1000,2.6
38650,CN0104500000000,01,45,"Dale County, AL",Mar-20,20443,19853,590,2.9
38651,CN0104700000000,01,47,"Dallas County, AL",Mar-20,14496,13739,757,5.2
38652,CN0104900000000,01,49,"DeKalb County, AL",Mar-20,30906,30025,881,2.9
38653,CN0105100000000,01,51,"Elmore County, AL",Mar-20,37109,36117,992,2.7
38654,CN0105300000000,01,53,"Escambia County, AL",Mar-20,14553,14021,532,3.7
38655,CN0105500000000,01,55,"Etowah County, AL",Mar-20,42791,41082,1709,4.0
38656,CN0105700000000,01,57,"Fayette County, AL",Mar-20,6564,6373,191,2.9
38657,CN0105900000000,01,59,"Franklin County, AL",Mar-20,14540,14133,407,2.8
38658,CN0106100000000,01,61,"Geneva County, AL",Mar-20,10885,10573,312,2.9
38659,CN0106300000000,01,63,"Greene County, AL",Mar-20,2917,2758,159,5.5
38660,CN0106500000000,01,65,"Hale County, AL",Mar-20,6105,5845,260,4.3
38661,CN0106700000000,01,67,"Henry County, AL",Mar-20,6864,6628,236,3.4
38662,CN0106900000000,01,69,"Houston County, AL",Mar-20,45850,44491,1359,3.0
38663,CN0107100000000,01,71,"Jackson County, AL",Mar-20,22904,22133,771,3.4
38664,CN0107300000000,01,73,"Jefferson County, AL",Mar-20,316460,307479,8981,2.8
38665,CN0107500000000,01,75,"Lamar County, AL",Mar-20,5810,5634,176,3.0
38666,CN0107700000000,01,77,"Lauderdale County, AL",Mar-20,42107,40810,1297,3.1
38667,CN0107900000000,01,79,"Lawrence County, AL",Mar-20,14150,13731,419,3.0
38668,CN0108100000000,01,81,"Lee County, AL",Mar-20,76676,74584,2092,2.7
38669,CN0108300000000,01,83,"Limestone County, AL",Mar-20,43808,42674,1134,2.6
38670,CN0108500000000,01,85,"Lowndes County, AL",Mar-20,3509,3328,181,5.2
38671,CN0108700000000,01,87,"Macon County, AL",Mar-20,7904,7578,326,4.1
38672,CN0108900000000,01,89,"Madison County, AL",Mar-20,185227,180617,4610,2.5
38673,CN0109100000000,01,91,"Marengo County, AL",Mar-20,7545,7259,286,3.8
38674,CN0109300000000,01,93,"Marion County, AL",Mar-20,13005,12564,441,3.4
38675,CN0109500000000,01,95,"Marshall County, AL",Mar-20,44162,43071,1091,2.5
38676,CN0109700000000,01,97,"Mobile County, AL",Mar-20,187625,180494,7131,3.8
38677,CN0109900000000,01,99,"Monroe County, AL",Mar-20,7357,6991,366,5.0
38678,CN0110100000000,01,101,"Montgomery County, AL",Mar-20,104519,101200,3319,3.2
38679,CN0110300000000,01,103,"Morgan County, AL",Mar-20,57806,56341,1465,2.5
38680,CN0110500000000,01,105,"Perry County, AL",Mar-20,3287,3122,165,5.0
38681,CN0110700000000,01,107,"Pickens County, AL",Mar-20,7973,7648,325,4.1
38682,CN0110900000000,01,109,"Pike County, AL",Mar-20,15542,15052,490,3.2
38683,CN0111100000000,01,111,"Randolph County, AL",Mar-20,9611,9330,281,2.9
38684,CN0111300000000,01,113,"Russell County, AL",Mar-20,23592,22905,687,2.9
38685,CN0111500000000,01,115,"St. Clair County, AL",Mar-20,40203,39141,1062,2.6
38686,CN0111700000000,01,117,"Shelby County, AL",Mar-20,115142,112608,2534,2.2
38687,CN0111900000000,01,119,"Sumter County, AL",Mar-20,4786,4590,196,4.1
38688,CN0112100000000,01,121,"Talladega County, AL",Mar-20,35536,34317,1219,3.4
38689,CN0112300000000,01,123,"Tallapoosa County, AL",Mar-20,18551,17962,589,3.2
38690,CN0112500000000,01,125,"Tuscaloosa County, AL",Mar-20,105365,102665,2700,2.6
38691,CN0112700000000,01,127,"Walker County, AL",Mar-20,25182,24327,855,3.4
38692,CN0112900000000,01,129,"Washington County, AL",Mar-20,6681,6377,304,4.6
38693,CN0113100000000,01,131,"Wilcox County, AL",Mar-20,2736,2499,237,8.7
38694,CN0113300000000,01,133,"Winston County, AL",Mar-20,10211,9874,337,3.3
38695,CN0201300000000,02,13,"Aleutians East Borough, AK",Mar-20,2870,2805,65,2.3
38696,CN0201600000000,02,16,"Aleutians West Census Area, AK",Mar-20,4571,4478,93,2.0
38697,CN0202000000000,02,20,"Anchorage Borough/municipality, AK",Mar-20,144897,138052,6845,4.7
38698,CN0205000000000,02,50,"Bethel Census Area, AK",Mar-20,6863,6071,792,11.5
38699,CN0206000000000,02,60,"Bristol Bay Borough, AK",Mar-20,238,208,30,12.6
38700,CN0206800000000,02,68,"Denali Borough, AK",Mar-20,576,479,97,16.8
38701,CN0207000000000,02,70,"Dillingham Census Area, AK",Mar-20,1801,1671,130,7.2
38702,CN0209000000000,02,90,"Fairbanks North Star Borough, AK",Mar-20,43731,41555,2176,5.0
38703,CN0210000000000,02,100,"Haines Borough, AK",Mar-20,925,791,134,14.5
38704,CN0210500000000,02,105,"Hoonah-Angoon Census Area, AK",Mar-20,967,825,142,14.7
38705,CN0211000000000,02,110,"Juneau Borough/city, AK",Mar-20,16505,15836,669,4.1
38706,CN0212200000000,02,122,"Kenai Peninsula Borough, AK",Mar-20,24947,23154,1793,7.2
38707,CN0213000000000,02,130,"Ketchikan Gateway Borough, AK",Mar-20,6226,5774,452,7.3
38708,CN0215000000000,02,150,"Kodiak Island Borough, AK",Mar-20,5983,5733,250,4.2
38709,CN0215800000000,02,158,"Kusilvak Census Area, AK",Mar-20,2680,2214,466,17.4
38710,CN0216400000000,02,164,"Lake and Peninsula Borough, AK",Mar-20,615,551,64,10.4
38711,CN0217000000000,02,170,"Matanuska-Susitna Borough, AK",Mar-20,46363,43181,3182,6.9
38712,CN0218000000000,02,180,"Nome Census Area, AK",Mar-20,4105,3713,392,9.5
38713,CN0218500000000,02,185,"North Slope Borough, AK",Mar-20,3724,3562,162,4.4
38714,CN0218800000000,02,188,"Northwest Arctic Borough, AK",Mar-20,2882,2534,348,12.1
38715,CN0219500000000,02,195,"Petersburg Borough, AK",Mar-20,1303,1179,124,9.5
38716,CN0219800000000,02,198,"Prince of Wales-Hyder Census Area, AK",Mar-20,2735,2473,262,9.6
38717,CN0222000000000,02,220,"Sitka Borough/city, AK",Mar-20,4133,3961,172,4.2
38718,CN0223000000000,02,230,"Skagway Municipality, AK",Mar-20,589,489,100,17.0
38719,CN0224000000000,02,240,"Southeast Fairbanks Census Area, AK",Mar-20,2682,2461,221,8.2
38720,CN0226100000000,02,261,"Valdez-Cordova Census Area, AK",Mar-20,4213,3809,404,9.6
38721,CN0227500000000,02,275,"Wrangell Borough/city, AK",Mar-20,935,866,69,7.4
38722,CN0228200000000,02,282,"Yakutat Borough/city, AK",Mar-20,213,190,23,10.8
38723,CN0229000000000,02,290,"Yukon-Koyukuk Census Area, AK",Mar-20,2382,2086,296,12.4
38724,CN0400100000000,04,1,"Apache County, AZ",Mar-20,21128,18198,2930,13.9
38725,CN0400300000000,04,3,"Cochise County, AZ",Mar-20,52093,48245,3848,7.4
38726,CN0400500000000,04,5,"Coconino County, AZ",Mar-20,77165,70937,6228,8.1
38727,CN0400700000000,04,7,"Gila County, AZ",Mar-20,21547,19937,1610,7.5
38728,CN0400900000000,04,9,"Graham County, AZ",Mar-20,15865,14825,1040,6.6
38729,CN0401100000000,04,11,"Greenlee County, AZ",Mar-20,4578,4339,239,5.2
38730,CN0401200000000,04,12,"La Paz County, AZ",Mar-20,9978,9215,763,7.6
38731,CN0401300000000,04,13,"Maricopa County, AZ",Mar-20,2334396,2209663,124733,5.3
38732,CN0401500000000,04,15,"Mohave County, AZ",Mar-20,88261,81466,6795,7.7
38733,CN0401700000000,04,17,"Navajo County, AZ",Mar-20,41510,37205,4305,10.4
38734,CN0401900000000,04,19,"Pima County, AZ",Mar-20,500658,470843,29815,6.0
38735,CN0402100000000,04,21,"Pinal County, AZ",Mar-20,191117,178628,12489,6.5
38736,CN0402300000000,04,23,"Santa Cruz County, AZ",Mar-20,20149,18038,2111,10.5
38737,CN0402500000000,04,25,"Yavapai County, AZ",Mar-20,106535,100271,6264,5.9
38738,CN0402700000000,04,27,"Yuma County, AZ",Mar-20,103472,86192,17280,16.7
38739,CN0500100000000,05,1,"Arkansas County, AR",Mar-20,9608,9223,385,4.0
38740,CN0500300000000,05,3,"Ashley County, AR",Mar-20,7644,6951,693,9.1
38741,CN0500500000000,05,5,"Baxter County, AR",Mar-20,16509,15643,866,5.2
38742,CN0500700000000,05,7,"Benton County, AR",Mar-20,140012,135081,4931,3.5
38743,CN0500900000000,05,9,"Boone County, AR",Mar-20,16427,15700,727,4.4
38744,CN0501100000000,05,11,"Bradley County, AR",Mar-20,4547,4304,243,5.3
38745,CN0501300000000,05,13,"Calhoun County, AR",Mar-20,2506,2351,155,6.2
38746,CN0501500000000,05,15,"Carroll County, AR",Mar-20,12844,12284,560,4.4
38747,CN0501700000000,05,17,"Chicot County, AR",Mar-20,3263,2924,339,10.4
38748,CN0501900000000,05,19,"Clark County, AR",Mar-20,9780,9326,454,4.6
38749,CN0502100000000,05,21,"Clay County, AR",Mar-20,5759,5342,417,7.2
38750,CN0502300000000,05,23,"Cleburne County, AR",Mar-20,9320,8685,635,6.8
38751,CN0502500000000,05,25,"Cleveland County, AR",Mar-20,3265,3062,203,6.2
38752,CN0502700000000,05,27,"Columbia County, AR",Mar-20,9488,8938,550,5.8
38753,CN0502900000000,05,29,"Conway County, AR",Mar-20,8425,7943,482,5.7
38754,CN0503100000000,05,31,"Craighead County, AR",Mar-20,57073,54886,2187,3.8
38755,CN0503300000000,05,33,"Crawford County, AR",Mar-20,26947,25752,1195,4.4
38756,CN0503500000000,05,35,"Crittenden County, AR",Mar-20,21617,20465,1152,5.3
38757,CN0503700000000,05,37,"Cross County, AR",Mar-20,7524,7131,393,5.2
38758,CN0503900000000,05,39,"Dallas County, AR",Mar-20,2834,2669,165,5.8
38759,CN0504100000000,05,41,"Desha County, AR",Mar-20,5427,5095,332,6.1
38760,CN0504300000000,05,43,"Drew County, AR",Mar-20,7960,7398,562,7.1
38761,CN0504500000000,05,45,"Faulkner County, AR",Mar-20,62110,59495,2615,4.2
38762,CN0504700000000,05,47,"Franklin County, AR",Mar-20,7612,7244,368,4.8
38763,CN0504900000000,05,49,"Fulton County, AR",Mar-20,5140,4881,259,5.0
38764,CN0505100000000,05,51,"Garland County, AR",Mar-20,42119,40049,2070,4.9
38765,CN0505300000000,05,53,"Grant County, AR",Mar-20,8389,7984,405,4.8
38766,CN0505500000000,05,55,"Greene County, AR",Mar-20,20503,19504,999,4.9
38767,CN0505700000000,05,57,"Hempstead County, AR",Mar-20,9993,9459,534,5.3
38768,CN0505900000000,05,59,"Hot Spring County, AR",Mar-20,14185,13518,667,4.7
38769,CN0506100000000,05,61,"Howard County, AR",Mar-20,5711,5428,283,5.0
38770,CN0506300000000,05,63,"Independence County, AR",Mar-20,17125,16245,880,5.1
38771,CN0506500000000,05,65,"Izard County, AR",Mar-20,5027,4613,414,8.2
38772,CN0506700000000,05,67,"Jackson County, AR",Mar-20,5854,5362,492,8.4
38773,CN0506900000000,05,69,"Jefferson County, AR",Mar-20,27917,25883,2034,7.3
38774,CN0507100000000,05,71,"Johnson County, AR",Mar-20,10401,9836,565,5.4
38775,CN0507300000000,05,73,"Lafayette County, AR",Mar-20,2492,2332,160,6.4
38776,CN0507500000000,05,75,"Lawrence County, AR",Mar-20,7061,6683,378,5.4
38777,CN0507700000000,05,77,"Lee County, AR",Mar-20,2841,2625,216,7.6
38778,CN0507900000000,05,79,"Lincoln County, AR",Mar-20,3995,3743,252,6.3
38779,CN0508100000000,05,81,"Little River County, AR",Mar-20,5627,5292,335,6.0
38780,CN0508300000000,05,83,"Logan County, AR",Mar-20,8486,8003,483,5.7
38781,CN0508500000000,05,85,"Lonoke County, AR",Mar-20,34512,32776,1736,5.0
38782,CN0508700000000,05,87,"Madison County, AR",Mar-20,7592,7321,271,3.6
38783,CN0508900000000,05,89,"Marion County, AR",Mar-20,6748,6377,371,5.5
38784,CN0509100000000,05,91,"Miller County, AR",Mar-20,20133,19016,1117,5.5
38785,CN0509300000000,05,93,"Mississippi County, AR",Mar-20,17667,16375,1292,7.3
38786,CN0509500000000,05,95,"Monroe County, AR",Mar-20,2807,2637,170,6.1
38787,CN0509700000000,05,97,"Montgomery County, AR",Mar-20,3010,2797,213,7.1
38788,CN0509900000000,05,99,"Nevada County, AR",Mar-20,3671,3475,196,5.3
38789,CN0510100000000,05,101,"Newton County, AR",Mar-20,3429,3259,170,5.0
38790,CN0510300000000,05,103,"Ouachita County, AR",Mar-20,9998,9353,645,6.5
38791,CN0510500000000,05,105,"Perry County, AR",Mar-20,4260,4037,223,5.2
38792,CN0510700000000,05,107,"Phillips County, AR",Mar-20,6404,5878,526,8.2
38793,CN0510900000000,05,109,"Pike County, AR",Mar-20,4318,4083,235,5.4
38794,CN0511100000000,05,111,"Poinsett County, AR",Mar-20,10585,10069,516,4.9
38795,CN0511300000000,05,113,"Polk County, AR",Mar-20,8327,7755,572,6.9
38796,CN0511500000000,05,115,"Pope County, AR",Mar-20,29388,27938,1450,4.9
38797,CN0511700000000,05,117,"Prairie County, AR",Mar-20,3674,3449,225,6.1
38798,CN0511900000000,05,119,"Pulaski County, AR",Mar-20,189472,180437,9035,4.8
38799,CN0512100000000,05,121,"Randolph County, AR",Mar-20,7607,7190,417,5.5
38800,CN0512300000000,05,123,"St. Francis County, AR",Mar-20,8310,7752,558,6.7
38801,CN0512500000000,05,125,"Saline County, AR",Mar-20,58736,56419,2317,3.9
38802,CN0512700000000,05,127,"Scott County, AR",Mar-20,4463,4267,196,4.4
38803,CN0512900000000,05,129,"Searcy County, AR",Mar-20,2946,2747,199,6.8
38804,CN0513100000000,05,131,"Sebastian County, AR",Mar-20,56856,54255,2601,4.6
38805,CN0513300000000,05,133,"Sevier County, AR",Mar-20,5718,5342,376,6.6
38806,CN0513500000000,05,135,"Sharp County, AR",Mar-20,5914,5512,402,6.8
38807,CN0513700000000,05,137,"Stone County, AR",Mar-20,4746,4445,301,6.3
38808,CN0513900000000,05,139,"Union County, AR",Mar-20,16029,14843,1186,7.4
38809,CN0514100000000,05,141,"Van Buren County, AR",Mar-20,5875,5480,395,6.7
38810,CN0514300000000,05,143,"Washington County, AR",Mar-20,127460,123300,4160,3.3
38811,CN0514500000000,05,145,"White County, AR",Mar-20,34629,32391,2238,6.5
38812,CN0514700000000,05,147,"Woodruff County, AR",Mar-20,2793,2604,189,6.8
38813,CN0514900000000,05,149,"Yell County, AR",Mar-20,8580,8170,410,4.8
38814,CN0600100000000,06,1,"Alameda County, CA",Mar-20,835440,802729,32711,3.9
38815,CN0600300000000,06,3,"Alpine County, CA",Mar-20,530,491,39,7.4
38816,CN0600500000000,06,5,"Amador County, CA",Mar-20,14790,13980,810,5.5
38817,CN0600700000000,06,7,"Butte County, CA",Mar-20,99081,92305,6776,6.8
38818,CN0600900000000,06,9,"Calaveras County, CA",Mar-20,21505,20323,1182,5.5
38819,CN0601100000000,06,11,"Colusa County, CA",Mar-20,11471,8775,2696,23.5
38820,CN0601300000000,06,13,"Contra Costa County, CA",Mar-20,555491,532826,22665,4.1
38821,CN0601500000000,06,15,"Del Norte County, CA",Mar-20,9483,8744,739,7.8
38822,CN0601700000000,06,17,"El Dorado County, CA",Mar-20,91743,87418,4325,4.7
38823,CN0601900000000,06,19,"Fresno County, CA",Mar-20,457046,406881,50165,11.0
38824,CN0602100000000,06,21,"Glenn County, CA",Mar-20,13156,11976,1180,9.0
38825,CN0602300000000,06,23,"Humboldt County, CA",Mar-20,61791,58706,3085,5.0
38826,CN0602500000000,06,25,"Imperial County, CA",Mar-20,73121,57905,15216,20.8
38827,CN0602700000000,06,27,"Inyo County, CA",Mar-20,8639,8215,424,4.9
38828,CN0602900000000,06,29,"Kern County, CA",Mar-20,391631,344173,47458,12.1
38829,CN0603100000000,06,31,"Kings County, CA",Mar-20,59193,51848,7345,12.4
38830,CN0603300000000,06,33,"Lake County, CA",Mar-20,29029,26924,2105,7.3
38831,CN0603500000000,06,35,"Lassen County, CA",Mar-20,9311,8606,705,7.6
38832,CN0603700000000,06,37,"Los Angeles County, CA",Mar-20,4996564,4669061,327503,6.6
38833,CN0603900000000,06,39,"Madera County, CA",Mar-20,63367,56618,6749,10.7
38834,CN0604100000000,06,41,"Marin County, CA",Mar-20,137710,133428,4282,3.1
38835,CN0604300000000,06,43,"Mariposa County, CA",Mar-20,7217,6648,569,7.9
38836,CN0604500000000,06,45,"Mendocino County, CA",Mar-20,38643,36342,2301,6.0
38837,CN0604700000000,06,47,"Merced County, CA",Mar-20,116614,101265,15349,13.2
38838,CN0604900000000,06,49,"Modoc County, CA",Mar-20,3128,2763,365,11.7
38839,CN0605100000000,06,51,"Mono County, CA",Mar-20,8790,8358,432,4.9
38840,CN0605300000000,06,53,"Monterey County, CA",Mar-20,219166,192418,26748,12.2
38841,CN0605500000000,06,55,"Napa County, CA",Mar-20,73265,70272,2993,4.1
38842,CN0605700000000,06,57,"Nevada County, CA",Mar-20,47519,45253,2266,4.8
38843,CN0605900000000,06,59,"Orange County, CA",Mar-20,1587658,1528641,59017,3.7
38844,CN0606100000000,06,61,"Placer County, CA",Mar-20,187175,179515,7660,4.1
38845,CN0606300000000,06,63,"Plumas County, CA",Mar-20,7504,6485,1019,13.6
38846,CN0606500000000,06,65,"Riverside County, CA",Mar-20,1098822,1039691,59131,5.4
38847,CN0606700000000,06,67,"Sacramento County, CA",Mar-20,711060,676781,34279,4.8
38848,CN0606900000000,06,69,"San Benito County, CA",Mar-20,31678,29163,2515,7.9
38849,CN0607100000000,06,71,"San Bernardino County, CA",Mar-20,964069,915887,48182,5.0
38850,CN0607300000000,06,73,"San Diego County, CA",Mar-20,1575269,1509148,66121,4.2
38851,CN0607500000000,06,75,"San Francisco County/city, CA",Mar-20,579275,561210,18065,3.1
38852,CN0607700000000,06,77,"San Joaquin County, CA",Mar-20,328619,301050,27569,8.4
38853,CN0607900000000,06,79,"San Luis Obispo County, CA",Mar-20,141756,136309,5447,3.8
38854,CN0608100000000,06,81,"San Mateo County, CA",Mar-20,455940,443115,12825,2.8
38855,CN0608300000000,06,83,"Santa Barbara County, CA",Mar-20,214100,201811,12289,5.7
38856,CN0608500000000,06,85,"Santa Clara County, CA",Mar-20,1042736,1007566,35170,3.4
38857,CN0608700000000,06,87,"Santa Cruz County, CA",Mar-20,141468,130040,11428,8.1
38858,CN0608900000000,06,89,"Shasta County, CA",Mar-20,73439,68383,5056,6.9
38859,CN0609100000000,06,91,"Sierra County, CA",Mar-20,1302,1190,112,8.6
38860,CN0609300000000,06,93,"Siskiyou County, CA",Mar-20,16615,14855,1760,10.6
38861,CN0609500000000,06,95,"Solano County, CA",Mar-20,209032,198441,10591,5.1
38862,CN0609700000000,06,97,"Sonoma County, CA",Mar-20,257131,247585,9546,3.7
38863,CN0609900000000,06,99,"Stanislaus County, CA",Mar-20,245619,224930,20689,8.4
38864,CN0610100000000,06,101,"Sutter County, CA",Mar-20,47419,42067,5352,11.3
38865,CN0610300000000,06,103,"Tehama County, CA",Mar-20,25045,23059,1986,7.9
38866,CN0610500000000,06,105,"Trinity County, CA",Mar-20,4501,4087,414,9.2
38867,CN0610700000000,06,107,"Tulare County, CA",Mar-20,207334,176912,30422,14.7
38868,CN0610900000000,06,109,"Tuolumne County, CA",Mar-20,20942,19588,1354,6.5
38869,CN0611100000000,06,111,"Ventura County, CA",Mar-20,422108,402081,20027,4.7
38870,CN0611300000000,06,113,"Yolo County, CA",Mar-20,108875,102368,6507,6.0
38871,CN0611500000000,06,115,"Yuba County, CA",Mar-20,31192,28502,2690,8.6
38872,CN0800100000000,08,1,"Adams County, CO",Mar-20,274513,258575,15938,5.8
38873,CN0800300000000,08,3,"Alamosa County, CO",Mar-20,8292,7682,610,7.4
38874,CN0800500000000,08,5,"Arapahoe County, CO",Mar-20,366875,347814,19061,5.2
38875,CN0800700000000,08,7,"Archuleta County, CO",Mar-20,6451,6006,445,6.9
38876,CN0800900000000,08,9,"Baca County, CO",Mar-20,1873,1795,78,4.2
38877,CN0801100000000,08,11,"Bent County, CO",Mar-20,1681,1581,100,5.9
38878,CN0801300000000,08,13,"Boulder County, CO",Mar-20,195614,186944,8670,4.4
38879,CN0801400000000,08,14,"Broomfield County/city, CO",Mar-20,40273,38311,1962,4.9
38880,CN0801500000000,08,15,"Chaffee County, CO",Mar-20,9229,8778,451,4.9
38881,CN0801700000000,08,17,"Cheyenne County, CO",Mar-20,1031,995,36,3.5
38882,CN0801900000000,08,19,"Clear Creek County, CO",Mar-20,6067,5775,292,4.8
38883,CN0802100000000,08,21,"Conejos County, CO",Mar-20,3926,3584,342,8.7
38884,CN0802300000000,08,23,"Costilla County, CO",Mar-20,1768,1646,122,6.9
38885,CN0802500000000,08,25,"Crowley County, CO",Mar-20,1457,1337,120,8.2
38886,CN0802700000000,08,27,"Custer County, CO",Mar-20,1932,1807,125,6.5
38887,CN0802900000000,08,29,"Delta County, CO",Mar-20,13571,12494,1077,7.9
38888,CN0803100000000,08,31,"Denver County/city, CO",Mar-20,419778,397597,22181,5.3
38889,CN0803300000000,08,33,"Dolores County, CO",Mar-20,1056,978,78,7.4
38890,CN0803500000000,08,35,"Douglas County, CO",Mar-20,194435,185731,8704,4.5
38891,CN0803700000000,08,37,"Eagle County, CO",Mar-20,37336,35908,1428,3.8
38892,CN0803900000000,08,39,"Elbert County, CO",Mar-20,14979,14289,690,4.6
38893,CN0804100000000,08,41,"El Paso County, CO",Mar-20,344111,322757,21354,6.2
38894,CN0804300000000,08,43,"Fremont County, CO",Mar-20,14611,13297,1314,9.0
38895,CN0804500000000,08,45,"Garfield County, CO",Mar-20,32461,30504,1957,6.0
38896,CN0804700000000,08,47,"Gilpin County, CO",Mar-20,3771,3618,153,4.1
38897,CN0804900000000,08,49,"Grand County, CO",Mar-20,9823,9414,409,4.2
38898,CN0805100000000,08,51,"Gunnison County, CO",Mar-20,11441,10979,462,4.0
38899,CN0805300000000,08,53,"Hinsdale County, CO",Mar-20,354,329,25,7.1
38900,CN0805500000000,08,55,"Huerfano County, CO",Mar-20,2394,2074,320,13.4
38901,CN0805700000000,08,57,"Jackson County, CO",Mar-20,905,849,56,6.2
38902,CN0805900000000,08,59,"Jefferson County, CO",Mar-20,336565,320104,16461,4.9
38903,CN0806100000000,08,61,"Kiowa County, CO",Mar-20,841,816,25,3.0
38904,CN0806300000000,08,63,"Kit Carson County, CO",Mar-20,3811,3666,145,3.8
38905,CN0806500000000,08,65,"Lake County, CO",Mar-20,5080,4894,186,3.7
38906,CN0806700000000,08,67,"La Plata County, CO",Mar-20,30298,28595,1703,5.6
38907,CN0806900000000,08,69,"Larimer County, CO",Mar-20,204452,194807,9645,4.7
38908,CN0807100000000,08,71,"Las Animas County, CO",Mar-20,6347,5863,484,7.6
38909,CN0807300000000,08,73,"Lincoln County, CO",Mar-20,2143,2023,120,5.6
38910,CN0807500000000,08,75,"Logan County, CO",Mar-20,10235,9756,479,4.7
38911,CN0807700000000,08,77,"Mesa County, CO",Mar-20,76111,70786,5325,7.0
38912,CN0807900000000,08,79,"Mineral County, CO",Mar-20,519,500,19,3.7
38913,CN0808100000000,08,81,"Moffat County, CO",Mar-20,7173,6594,579,8.1
38914,CN0808300000000,08,83,"Montezuma County, CO",Mar-20,12364,11131,1233,10.0
38915,CN0808500000000,08,85,"Montrose County, CO",Mar-20,20922,19344,1578,7.5
38916,CN0808700000000,08,87,"Morgan County, CO",Mar-20,15269,14484,785,5.1
38917,CN0808900000000,08,89,"Otero County, CO",Mar-20,7966,7365,601,7.5
38918,CN0809100000000,08,91,"Ouray County, CO",Mar-20,2251,2095,156,6.9
38919,CN0809300000000,08,93,"Park County, CO",Mar-20,11157,10642,515,4.6
38920,CN0809500000000,08,95,"Phillips County, CO",Mar-20,2197,2127,70,3.2
38921,CN0809700000000,08,97,"Pitkin County, CO",Mar-20,11069,10579,490,4.4
38922,CN0809900000000,08,99,"Prowers County, CO",Mar-20,5872,5583,289,4.9
38923,CN0810100000000,08,101,"Pueblo County, CO",Mar-20,76817,70952,5865,7.6
38924,CN0810300000000,08,103,"Rio Blanco County, CO",Mar-20,2900,2686,214,7.4
38925,CN0810500000000,08,105,"Rio Grande County, CO",Mar-20,5063,4579,484,9.6
38926,CN0810700000000,08,107,"Routt County, CO",Mar-20,16423,15758,665,4.0
38927,CN0810900000000,08,109,"Saguache County, CO",Mar-20,3346,3043,303,9.1
38928,CN0811100000000,08,111,"San Juan County, CO",Mar-20,520,487,33,6.3
38929,CN0811300000000,08,113,"San Miguel County, CO",Mar-20,6323,6100,223,3.5
38930,CN0811500000000,08,115,"Sedgwick County, CO",Mar-20,1135,1088,47,4.1
38931,CN0811700000000,08,117,"Summit County, CO",Mar-20,24690,23952,738,3.0
38932,CN0811900000000,08,119,"Teller County, CO",Mar-20,12884,12141,743,5.8
38933,CN0812100000000,08,121,"Washington County, CO",Mar-20,2541,2438,103,4.1
38934,CN0812300000000,08,123,"Weld County, CO",Mar-20,167757,159140,8617,5.1
38935,CN0812500000000,08,125,"Yuma County, CO",Mar-20,5077,4896,181,3.6
38936,CN0900100000000,09,1,"Fairfield County, CT",Mar-20,479809,462891,16918,3.5
38937,CN0900300000000,09,3,"Hartford County, CT",Mar-20,487675,469994,17681,3.6
38938,CN0900500000000,09,5,"Litchfield County, CT",Mar-20,105491,101715,3776,3.6
38939,CN0900700000000,09,7,"Middlesex County, CT",Mar-20,94700,91716,2984,3.2
38940,CN0900900000000,09,9,"New Haven County, CT",Mar-20,463598,446089,17509,3.8
38941,CN0901100000000,09,11,"New London County, CT",Mar-20,136964,132017,4947,3.6
38942,CN0901300000000,09,13,"Tolland County, CT",Mar-20,87945,85220,2725,3.1
38943,CN0901500000000,09,15,"Windham County, CT",Mar-20,64788,62280,2508,3.9
38944,CN1000100000000,10,1,"Kent County, DE",Mar-20,78164,73760,4404,5.6
38945,CN1000300000000,10,3,"New Castle County, DE",Mar-20,295841,281765,14076,4.8
38946,CN1000500000000,10,5,"Sussex County, DE",Mar-20,103150,97545,5605,5.4
38947,CN1100100000000,11,1,District of Columbia,Mar-20,421750,396915,24835,5.9
38948,CN1200100000000,12,1,"Alachua County, FL",Mar-20,141879,136429,5450,3.8
38949,CN1200300000000,12,3,"Baker County, FL",Mar-20,11902,11409,493,4.1
38950,CN1200500000000,12,5,"Bay County, FL",Mar-20,83136,79467,3669,4.4
38951,CN1200700000000,12,7,"Bradford County, FL",Mar-20,11275,10779,496,4.4
38952,CN1200900000000,12,9,"Brevard County, FL",Mar-20,285109,272443,12666,4.4
38953,CN1201100000000,12,11,"Broward County, FL",Mar-20,1036395,992514,43881,4.2
38954,CN1201300000000,12,13,"Calhoun County, FL",Mar-20,4843,4596,247,5.1
38955,CN1201500000000,12,15,"Charlotte County, FL",Mar-20,73987,70383,3604,4.9
38956,CN1201700000000,12,17,"Citrus County, FL",Mar-20,47894,44706,3188,6.7
38957,CN1201900000000,12,19,"Clay County, FL",Mar-20,108226,103708,4518,4.2
38958,CN1202100000000,12,21,"Collier County, FL",Mar-20,185559,178151,7408,4.0
38959,CN1202300000000,12,23,"Columbia County, FL",Mar-20,30183,28858,1325,4.4
38960,CN1202700000000,12,27,"DeSoto County, FL",Mar-20,15184,14479,705,4.6
38961,CN1202900000000,12,29,"Dixie County, FL",Mar-20,5953,5642,311,5.2
38962,CN1203100000000,12,31,"Duval County, FL",Mar-20,495193,472798,22395,4.5
38963,CN1203300000000,12,33,"Escambia County, FL",Mar-20,147562,140877,6685,4.5
38964,CN1203500000000,12,35,"Flagler County, FL",Mar-20,47382,44931,2451,5.2
38965,CN1203700000000,12,37,"Franklin County, FL",Mar-20,4585,4396,189,4.1
38966,CN1203900000000,12,39,"Gadsden County, FL",Mar-20,19157,18086,1071,5.6
38967,CN1204100000000,12,41,"Gilchrist County, FL",Mar-20,7276,6945,331,4.5
38968,CN1204300000000,12,43,"Glades County, FL",Mar-20,5614,5333,281,5.0
38969,CN1204500000000,12,45,"Gulf County, FL",Mar-20,5685,5391,294,5.2
38970,CN1204700000000,12,47,"Hamilton County, FL",Mar-20,4283,4026,257,6.0
38971,CN1204900000000,12,49,"Hardee County, FL",Mar-20,8982,8456,526,5.9
38972,CN1205100000000,12,51,"Hendry County, FL",Mar-20,16441,15338,1103,6.7
38973,CN1205300000000,12,53,"Hernando County, FL",Mar-20,72838,68584,4254,5.8
38974,CN1205500000000,12,55,"Highlands County, FL",Mar-20,36776,34522,2254,6.1
38975,CN1205700000000,12,57,"Hillsborough County, FL",Mar-20,756495,724801,31694,4.2
38976,CN1205900000000,12,59,"Holmes County, FL",Mar-20,7105,6759,346,4.9
38977,CN1206100000000,12,61,"Indian River County, FL",Mar-20,66369,62962,3407,5.1
38978,CN1206300000000,12,63,"Jackson County, FL",Mar-20,17326,16499,827,4.8
38979,CN1206500000000,12,65,"Jefferson County, FL",Mar-20,5643,5389,254,4.5
38980,CN1206700000000,12,67,"Lafayette County, FL",Mar-20,2870,2750,120,4.2
38981,CN1206900000000,12,69,"Lake County, FL",Mar-20,159144,151913,7231,4.5
38982,CN1207100000000,12,71,"Lee County, FL",Mar-20,350463,335311,15152,4.3
38983,CN1207300000000,12,73,"Leon County, FL",Mar-20,155857,149493,6364,4.1
38984,CN1207500000000,12,75,"Levy County, FL",Mar-20,16933,16106,827,4.9
38985,CN1207700000000,12,77,"Liberty County, FL",Mar-20,2645,2518,127,4.8
38986,CN1207900000000,12,79,"Madison County, FL",Mar-20,7499,7138,361,4.8
38987,CN1208100000000,12,81,"Manatee County, FL",Mar-20,182283,174524,7759,4.3
38988,CN1208300000000,12,83,"Marion County, FL",Mar-20,138960,131682,7278,5.2
38989,CN1208500000000,12,85,"Martin County, FL",Mar-20,75312,72151,3161,4.2
38990,CN1208600000000,12,86,"Miami-Dade County, FL",Mar-20,1317241,1267181,50060,3.8
38991,CN1208700000000,12,87,"Monroe County, FL",Mar-20,48214,46881,1333,2.8
38992,CN1208900000000,12,89,"Nassau County, FL",Mar-20,41434,39733,1701,4.1
38993,CN1209100000000,12,91,"Okaloosa County, FL",Mar-20,97635,94036,3599,3.7
38994,CN1209300000000,12,93,"Okeechobee County, FL",Mar-20,18274,17504,770,4.2
38995,CN1209500000000,12,95,"Orange County, FL",Mar-20,761283,730180,31103,4.1
38996,CN1209700000000,12,97,"Osceola County, FL",Mar-20,184155,175674,8481,4.6
38997,CN1209900000000,12,99,"Palm Beach County, FL",Mar-20,733058,700784,32274,4.4
38998,CN1210100000000,12,101,"Pasco County, FL",Mar-20,240209,228629,11580,4.8
38999,CN1210300000000,12,103,"Pinellas County, FL",Mar-20,497772,477195,20577,4.1
39000,CN1210500000000,12,105,"Polk County, FL",Mar-20,308409,293192,15217,4.9
39001,CN1210700000000,12,107,"Putnam County, FL",Mar-20,26883,25259,1624,6.0
39002,CN1210900000000,12,109,"St. Johns County, FL",Mar-20,133173,128229,4944,3.7
39003,CN1211100000000,12,111,"St. Lucie County, FL",Mar-20,147809,139878,7931,5.4
39004,CN1211300000000,12,113,"Santa Rosa County, FL",Mar-20,83466,80116,3350,4.0
39005,CN1211500000000,12,115,"Sarasota County, FL",Mar-20,191497,183377,8120,4.2
39006,CN1211700000000,12,117,"Seminole County, FL",Mar-20,255068,244619,10449,4.1
39007,CN1211900000000,12,119,"Sumter County, FL",Mar-20,33413,31303,2110,6.3
39008,CN1212100000000,12,121,"Suwannee County, FL",Mar-20,18010,17166,844,4.7
39009,CN1212300000000,12,123,"Taylor County, FL",Mar-20,8262,7876,386,4.7
39010,CN1212500000000,12,125,"Union County, FL",Mar-20,4661,4479,182,3.9
39011,CN1212700000000,12,127,"Volusia County, FL",Mar-20,256287,243763,12524,4.9
39012,CN1212900000000,12,129,"Wakulla County, FL",Mar-20,14968,14380,588,3.9
39013,CN1213100000000,12,131,"Walton County, FL",Mar-20,31866,30643,1223,3.8
39014,CN1213300000000,12,133,"Washington County, FL",Mar-20,9692,9246,446,4.6
39015,CN1300100000000,13,1,"Appling County, GA",Mar-20,9805,9359,446,4.5
39016,CN1300300000000,13,3,"Atkinson County, GA",Mar-20,4511,4324,187,4.1
39017,CN1300500000000,13,5,"Bacon County, GA",Mar-20,5016,4766,250,5.0
39018,CN1300700000000,13,7,"Baker County, GA",Mar-20,1200,1138,62,5.2
39019,CN1300900000000,13,9,"Baldwin County, GA",Mar-20,17914,16905,1009,5.6
39020,CN1301100000000,13,11,"Banks County, GA",Mar-20,9946,9566,380,3.8
39021,CN1301300000000,13,13,"Barrow County, GA",Mar-20,40754,39256,1498,3.7
39022,CN1301500000000,13,15,"Bartow County, GA",Mar-20,51088,48912,2176,4.3
39023,CN1301700000000,13,17,"Ben Hill County, GA",Mar-20,5457,5063,394,7.2
39024,CN1301900000000,13,19,"Berrien County, GA",Mar-20,7618,7200,418,5.5
39025,CN1302100000000,13,21,"Bibb County, GA",Mar-20,68109,64833,3276,4.8
39026,CN1302300000000,13,23,"Bleckley County, GA",Mar-20,4573,4289,284,6.2
39027,CN1302500000000,13,25,"Brantley County, GA",Mar-20,7192,6853,339,4.7
39028,CN1302700000000,13,27,"Brooks County, GA",Mar-20,7030,6685,345,4.9
39029,CN1302900000000,13,29,"Bryan County, GA",Mar-20,18342,17589,753,4.1
39030,CN1303100000000,13,31,"Bulloch County, GA",Mar-20,37219,35257,1962,5.3
39031,CN1303300000000,13,33,"Burke County, GA",Mar-20,9278,8755,523,5.6
39032,CN1303500000000,13,35,"Butts County, GA",Mar-20,10878,10387,491,4.5
39033,CN1303700000000,13,37,"Calhoun County, GA",Mar-20,2403,2287,116,4.8
39034,CN1303900000000,13,39,"Camden County, GA",Mar-20,21059,20138,921,4.4
39035,CN1304300000000,13,43,"Candler County, GA",Mar-20,5707,5498,209,3.7
39036,CN1304500000000,13,45,"Carroll County, GA",Mar-20,55870,53298,2572,4.6
39037,CN1304700000000,13,47,"Catoosa County, GA",Mar-20,33959,32751,1208,3.6
39038,CN1304900000000,13,49,"Charlton County, GA",Mar-20,4936,4725,211,4.3
39039,CN1305100000000,13,51,"Chatham County, GA",Mar-20,140403,133907,6496,4.6
39040,CN1305300000000,13,53,"Chattahoochee County, GA",Mar-20,2020,1900,120,5.9
39041,CN1305500000000,13,55,"Chattooga County, GA",Mar-20,10178,9603,575,5.6
39042,CN1305700000000,13,57,"Cherokee County, GA",Mar-20,136789,131930,4859,3.6
39043,CN1305900000000,13,59,"Clarke County, GA",Mar-20,58994,56209,2785,4.7
39044,CN1306100000000,13,61,"Clay County, GA",Mar-20,924,856,68,7.4
39045,CN1306300000000,13,63,"Clayton County, GA",Mar-20,140670,132018,8652,6.2
39046,CN1306500000000,13,65,"Clinch County, GA",Mar-20,2647,2515,132,5.0
39047,CN1306700000000,13,67,"Cobb County, GA",Mar-20,429199,412109,17090,4.0
39048,CN1306900000000,13,69,"Coffee County, GA",Mar-20,19514,18484,1030,5.3
39049,CN1307100000000,13,71,"Colquitt County, GA",Mar-20,21885,20941,944,4.3
39050,CN1307300000000,13,73,"Columbia County, GA",Mar-20,75779,72964,2815,3.7
39051,CN1307500000000,13,75,"Cook County, GA",Mar-20,8244,7914,330,4.0
39052,CN1307700000000,13,77,"Coweta County, GA",Mar-20,75371,72408,2963,3.9
39053,CN1307900000000,13,79,"Crawford County, GA",Mar-20,5623,5389,234,4.2
39054,CN1308100000000,13,81,"Crisp County, GA",Mar-20,9659,9198,461,4.8
39055,CN1308300000000,13,83,"Dade County, GA",Mar-20,8268,7950,318,3.8
39056,CN1308500000000,13,85,"Dawson County, GA",Mar-20,12391,11948,443,3.6
39057,CN1308700000000,13,87,"Decatur County, GA",Mar-20,11802,11279,523,4.4
39058,CN1308900000000,13,89,"DeKalb County, GA",Mar-20,404856,385386,19470,4.8
39059,CN1309100000000,13,91,"Dodge County, GA",Mar-20,7046,6589,457,6.5
39060,CN1309300000000,13,93,"Dooly County, GA",Mar-20,5126,4894,232,4.5
39061,CN1309500000000,13,95,"Dougherty County, GA",Mar-20,38894,36572,2322,6.0
39062,CN1309700000000,13,97,"Douglas County, GA",Mar-20,74107,70573,3534,4.8
39063,CN1309900000000,13,99,"Early County, GA",Mar-20,4537,4310,227,5.0
39064,CN1310100000000,13,101,"Echols County, GA",Mar-20,1956,1883,73,3.7
39065,CN1310300000000,13,103,"Effingham County, GA",Mar-20,30956,29778,1178,3.8
39066,CN1310500000000,13,105,"Elbert County, GA",Mar-20,7921,7482,439,5.5
39067,CN1310700000000,13,107,"Emanuel County, GA",Mar-20,8418,7882,536,6.4
39068,CN1310900000000,13,109,"Evans County, GA",Mar-20,5049,4817,232,4.6
39069,CN1311100000000,13,111,"Fannin County, GA",Mar-20,12461,11963,498,4.0
39070,CN1311300000000,13,113,"Fayette County, GA",Mar-20,58605,56242,2363,4.0
39071,CN1311500000000,13,115,"Floyd County, GA",Mar-20,44435,42457,1978,4.5
39072,CN1311700000000,13,117,"Forsyth County, GA",Mar-20,123004,118677,4327,3.5
39073,CN1311900000000,13,119,"Franklin County, GA",Mar-20,10238,9719,519,5.1
39074,CN1312100000000,13,121,"Fulton County, GA",Mar-20,565140,537282,27858,4.9
39075,CN1312300000000,13,123,"Gilmer County, GA",Mar-20,11735,11217,518,4.4
39076,CN1312500000000,13,125,"Glascock County, GA",Mar-20,1291,1229,62,4.8
39077,CN1312700000000,13,127,"Glynn County, GA",Mar-20,38975,37342,1633,4.2
39078,CN1312900000000,13,129,"Gordon County, GA",Mar-20,28602,27476,1126,3.9
39079,CN1313100000000,13,131,"Grady County, GA",Mar-20,10549,10122,427,4.0
39080,CN1313300000000,13,133,"Greene County, GA",Mar-20,7207,6850,357,5.0
39081,CN1313500000000,13,135,"Gwinnett County, GA",Mar-20,493978,474164,19814,4.0
39082,CN1313700000000,13,137,"Habersham County, GA",Mar-20,18909,18013,896,4.7
39083,CN1313900000000,13,139,"Hall County, GA",Mar-20,102986,99428,3558,3.5
39084,CN1314100000000,13,141,"Hancock County, GA",Mar-20,2553,2369,184,7.2
39085,CN1314300000000,13,143,"Haralson County, GA",Mar-20,12680,12119,561,4.4
39086,CN1314500000000,13,145,"Harris County, GA",Mar-20,16652,16018,634,3.8
39087,CN1314700000000,13,147,"Hart County, GA",Mar-20,11247,10665,582,5.2
39088,CN1314900000000,13,149,"Heard County, GA",Mar-20,5323,5078,245,4.6
39089,CN1315100000000,13,151,"Henry County, GA",Mar-20,117048,111511,5537,4.7
39090,CN1315300000000,13,153,"Houston County, GA",Mar-20,70926,68031,2895,4.1
39091,CN1315500000000,13,155,"Irwin County, GA",Mar-20,3461,3259,202,5.8
39092,CN1315700000000,13,157,"Jackson County, GA",Mar-20,37235,35916,1319,3.5
39093,CN1315900000000,13,159,"Jasper County, GA",Mar-20,7012,6730,282,4.0
39094,CN1316100000000,13,161,"Jeff Davis County, GA",Mar-20,6143,5800,343,5.6
39095,CN1316300000000,13,163,"Jefferson County, GA",Mar-20,6718,6320,398,5.9
39096,CN1316500000000,13,165,"Jenkins County, GA",Mar-20,3200,2998,202,6.3
39097,CN1316700000000,13,167,"Johnson County, GA",Mar-20,4051,3862,189,4.7
39098,CN1316900000000,13,169,"Jones County, GA",Mar-20,13738,13195,543,4.0
39099,CN1317100000000,13,171,"Lamar County, GA",Mar-20,8337,7896,441,5.3
39100,CN1317300000000,13,173,"Lanier County, GA",Mar-20,3751,3572,179,4.8
39101,CN1317500000000,13,175,"Laurens County, GA",Mar-20,19292,18080,1212,6.3
39102,CN1317700000000,13,177,"Lee County, GA",Mar-20,14870,14295,575,3.9
39103,CN1317900000000,13,179,"Liberty County, GA",Mar-20,26606,25337,1269,4.8
39104,CN1318100000000,13,181,"Lincoln County, GA",Mar-20,3627,3447,180,5.0
39105,CN1318300000000,13,183,"Long County, GA",Mar-20,8296,7928,368,4.4
39106,CN1318500000000,13,185,"Lowndes County, GA",Mar-20,51286,48981,2305,4.5
39107,CN1318700000000,13,187,"Lumpkin County, GA",Mar-20,16856,16190,666,4.0
39108,CN1318900000000,13,189,"McDuffie County, GA",Mar-20,8990,8431,559,6.2
39109,CN1319100000000,13,191,"McIntosh County, GA",Mar-20,6153,5885,268,4.4
39110,CN1319300000000,13,193,"Macon County, GA",Mar-20,4806,4529,277,5.8
39111,CN1319500000000,13,195,"Madison County, GA",Mar-20,13219,12687,532,4.0
39112,CN1319700000000,13,197,"Marion County, GA",Mar-20,3322,3140,182,5.5
39113,CN1319900000000,13,199,"Meriwether County, GA",Mar-20,8999,8512,487,5.4
39114,CN1320100000000,13,201,"Miller County, GA",Mar-20,2844,2723,121,4.3
39115,CN1320500000000,13,205,"Mitchell County, GA",Mar-20,8737,8232,505,5.8
39116,CN1320700000000,13,207,"Monroe County, GA",Mar-20,13051,12499,552,4.2
39117,CN1320900000000,13,209,"Montgomery County, GA",Mar-20,3913,3706,207,5.3
39118,CN1321100000000,13,211,"Morgan County, GA",Mar-20,9334,8961,373,4.0
39119,CN1321300000000,13,213,"Murray County, GA",Mar-20,15418,14540,878,5.7
39120,CN1321500000000,13,215,"Muscogee County, GA",Mar-20,77482,73309,4173,5.4
39121,CN1321700000000,13,217,"Newton County, GA",Mar-20,52914,50199,2715,5.1
39122,CN1321900000000,13,219,"Oconee County, GA",Mar-20,19369,18732,637,3.3
39123,CN1322100000000,13,221,"Oglethorpe County, GA",Mar-20,6911,6647,264,3.8
39124,CN1322300000000,13,223,"Paulding County, GA",Mar-20,86815,83423,3392,3.9
39125,CN1322500000000,13,225,"Peach County, GA",Mar-20,11937,11375,562,4.7
39126,CN1322700000000,13,227,"Pickens County, GA",Mar-20,15437,14809,628,4.1
39127,CN1322900000000,13,229,"Pierce County, GA",Mar-20,8677,8332,345,4.0
39128,CN1323100000000,13,231,"Pike County, GA",Mar-20,8993,8625,368,4.1
39129,CN1323300000000,13,233,"Polk County, GA",Mar-20,18564,17682,882,4.8
39130,CN1323500000000,13,235,"Pulaski County, GA",Mar-20,4096,3909,187,4.6
39131,CN1323700000000,13,237,"Putnam County, GA",Mar-20,8193,7740,453,5.5
39132,CN1323900000000,13,239,"Quitman County, GA",Mar-20,818,770,48,5.9
39133,CN1324100000000,13,241,"Rabun County, GA",Mar-20,7032,6693,339,4.8
39134,CN1324300000000,13,243,"Randolph County, GA",Mar-20,2659,2514,145,5.5
39135,CN1324500000000,13,245,"Richmond County, GA",Mar-20,86091,81482,4609,5.4
39136,CN1324700000000,13,247,"Rockdale County, GA",Mar-20,45319,43029,2290,5.1
39137,CN1324900000000,13,249,"Schley County, GA",Mar-20,2279,2183,96,4.2
39138,CN1325100000000,13,251,"Screven County, GA",Mar-20,5125,4813,312,6.1
39139,CN1325300000000,13,253,"Seminole County, GA",Mar-20,3166,3000,166,5.2
39140,CN1325500000000,13,255,"Spalding County, GA",Mar-20,29063,27528,1535,5.3
39141,CN1325700000000,13,257,"Stephens County, GA",Mar-20,10867,10346,521,4.8
39142,CN1325900000000,13,259,"Stewart County, GA",Mar-20,2648,2527,121,4.6
39143,CN1326100000000,13,261,"Sumter County, GA",Mar-20,13293,12508,785,5.9
39144,CN1326300000000,13,263,"Talbot County, GA",Mar-20,2797,2660,137,4.9
39145,CN1326500000000,13,265,"Taliaferro County, GA",Mar-20,587,548,39,6.6
39146,CN1326700000000,13,267,"Tattnall County, GA",Mar-20,9736,9234,502,5.2
39147,CN1326900000000,13,269,"Taylor County, GA",Mar-20,2910,2778,132,4.5
39148,CN1327100000000,13,271,"Telfair County, GA",Mar-20,3947,3499,448,11.4
39149,CN1327300000000,13,273,"Terrell County, GA",Mar-20,3530,3344,186,5.3
39150,CN1327500000000,13,275,"Thomas County, GA",Mar-20,16797,15976,821,4.9
39151,CN1327700000000,13,277,"Tift County, GA",Mar-20,20259,19399,860,4.2
39152,CN1327900000000,13,279,"Toombs County, GA",Mar-20,12058,11360,698,5.8
39153,CN1328100000000,13,281,"Towns County, GA",Mar-20,3765,3522,243,6.5
39154,CN1328300000000,13,283,"Treutlen County, GA",Mar-20,2681,2519,162,6.0
39155,CN1328500000000,13,285,"Troup County, GA",Mar-20,37860,36364,1496,4.0
39156,CN1328700000000,13,287,"Turner County, GA",Mar-20,3251,3069,182,5.6
39157,CN1328900000000,13,289,"Twiggs County, GA",Mar-20,2915,2715,200,6.9
39158,CN1329100000000,13,291,"Union County, GA",Mar-20,10423,10007,416,4.0
39159,CN1329300000000,13,293,"Upson County, GA",Mar-20,11458,10947,511,4.5
39160,CN1329500000000,13,295,"Walker County, GA",Mar-20,31745,30488,1257,4.0
39161,CN1329700000000,13,297,"Walton County, GA",Mar-20,46497,44610,1887,4.1
39162,CN1329900000000,13,299,"Ware County, GA",Mar-20,15604,14858,746,4.8
39163,CN1330100000000,13,301,"Warren County, GA",Mar-20,2888,2743,145,5.0
39164,CN1330300000000,13,303,"Washington County, GA",Mar-20,6929,6561,368,5.3
39165,CN1330500000000,13,305,"Wayne County, GA",Mar-20,11502,10856,646,5.6
39166,CN1330700000000,13,307,"Webster County, GA",Mar-20,1060,998,62,5.8
39167,CN1330900000000,13,309,"Wheeler County, GA",Mar-20,1694,1546,148,8.7
39168,CN1331100000000,13,311,"White County, GA",Mar-20,16699,16122,577,3.5
39169,CN1331300000000,13,313,"Whitfield County, GA",Mar-20,43194,41052,2142,5.0
39170,CN1331500000000,13,315,"Wilcox County, GA",Mar-20,2758,2597,161,5.8
39171,CN1331700000000,13,317,"Wilkes County, GA",Mar-20,3972,3726,246,6.2
39172,CN1331900000000,13,319,"Wilkinson County, GA",Mar-20,4040,3856,184,4.6
39173,CN1332100000000,13,321,"Worth County, GA",Mar-20,9087,8607,480,5.3
39174,CN1500100000000,15,1,"Hawaii County, HI",Mar-20,91563,88915,2648,2.9
39175,CN1500300000000,15,3,"Honolulu County/city, HI",Mar-20,453211,443533,9678,2.1
39176,CN1500700000000,15,7,"Kauai County, HI",Mar-20,36504,35649,855,2.3
39177,CN1500900000000,15,9,"Maui County, HI",Mar-20,86267,84398,1869,2.2
39178,CN1600100000000,16,1,"Ada County, ID",Mar-20,258487,252439,6048,2.3
39179,CN1600300000000,16,3,"Adams County, ID",Mar-20,1695,1540,155,9.1
39180,CN1600500000000,16,5,"Bannock County, ID",Mar-20,43505,42246,1259,2.9
39181,CN1600700000000,16,7,"Bear Lake County, ID",Mar-20,2976,2876,100,3.4
39182,CN1600900000000,16,9,"Benewah County, ID",Mar-20,4129,3808,321,7.8
39183,CN1601100000000,16,11,"Bingham County, ID",Mar-20,23739,23083,656,2.8
39184,CN1601300000000,16,13,"Blaine County, ID",Mar-20,12649,12244,405,3.2
39185,CN1601500000000,16,15,"Boise County, ID",Mar-20,3630,3436,194,5.3
39186,CN1601700000000,16,17,"Bonner County, ID",Mar-20,20510,19397,1113,5.4
39187,CN1601900000000,16,19,"Bonneville County, ID",Mar-20,58307,56820,1487,2.6
39188,CN1602100000000,16,21,"Boundary County, ID",Mar-20,5338,5020,318,6.0
39189,CN1602300000000,16,23,"Butte County, ID",Mar-20,1388,1359,29,2.1
39190,CN1602500000000,16,25,"Camas County, ID",Mar-20,694,673,21,3.0
39191,CN1602700000000,16,27,"Canyon County, ID",Mar-20,105693,102476,3217,3.0
39192,CN1602900000000,16,29,"Caribou County, ID",Mar-20,4088,3963,125,3.1
39193,CN1603100000000,16,31,"Cassia County, ID",Mar-20,12012,11726,286,2.4
39194,CN1603300000000,16,33,"Clark County, ID",Mar-20,359,341,18,5.0
39195,CN1603500000000,16,35,"Clearwater County, ID",Mar-20,2911,2631,280,9.6
39196,CN1603700000000,16,37,"Custer County, ID",Mar-20,1988,1896,92,4.6
39197,CN1603900000000,16,39,"Elmore County, ID",Mar-20,11803,11410,393,3.3
39198,CN1604100000000,16,41,"Franklin County, ID",Mar-20,7088,6918,170,2.4
39199,CN1604300000000,16,43,"Fremont County, ID",Mar-20,7961,7731,230,2.9
39200,CN1604500000000,16,45,"Gem County, ID",Mar-20,8408,8118,290,3.4
39201,CN1604700000000,16,47,"Gooding County, ID",Mar-20,8213,7993,220,2.7
39202,CN1604900000000,16,49,"Idaho County, ID",Mar-20,6631,6273,358,5.4
39203,CN1605100000000,16,51,"Jefferson County, ID",Mar-20,14153,13811,342,2.4
39204,CN1605300000000,16,53,"Jerome County, ID",Mar-20,12068,11734,334,2.8
39205,CN1605500000000,16,55,"Kootenai County, ID",Mar-20,80041,76787,3254,4.1
39206,CN1605700000000,16,57,"Latah County, ID",Mar-20,20864,20279,585,2.8
39207,CN1605900000000,16,59,"Lemhi County, ID",Mar-20,3494,3272,222,6.4
39208,CN1606100000000,16,61,"Lewis County, ID",Mar-20,1637,1530,107,6.5
39209,CN1606300000000,16,63,"Lincoln County, ID",Mar-20,2695,2578,117,4.3
39210,CN1606500000000,16,65,"Madison County, ID",Mar-20,22406,22006,400,1.8
39211,CN1606700000000,16,67,"Minidoka County, ID",Mar-20,11327,11032,295,2.6
39212,CN1606900000000,16,69,"Nez Perce County, ID",Mar-20,20923,20279,644,3.1
39213,CN1607100000000,16,71,"Oneida County, ID",Mar-20,2370,2295,75,3.2
39214,CN1607300000000,16,73,"Owyhee County, ID",Mar-20,5514,5317,197,3.6
39215,CN1607500000000,16,75,"Payette County, ID",Mar-20,11839,11443,396,3.3
39216,CN1607700000000,16,77,"Power County, ID",Mar-20,3926,3809,117,3.0
39217,CN1607900000000,16,79,"Shoshone County, ID",Mar-20,5185,4824,361,7.0
39218,CN1608100000000,16,81,"Teton County, ID",Mar-20,6150,6014,136,2.2
39219,CN1608300000000,16,83,"Twin Falls County, ID",Mar-20,40884,39666,1218,3.0
39220,CN1608500000000,16,85,"Valley County, ID",Mar-20,5553,5305,248,4.5
39221,CN1608700000000,16,87,"Washington County, ID",Mar-20,4670,4475,195,4.2
39222,CN1700100000000,17,1,"Adams County, IL",Mar-20,29968,29227,741,2.5
39223,CN1700300000000,17,3,"Alexander County, IL",Mar-20,1920,1825,95,4.9
39224,CN1700500000000,17,5,"Bond County, IL",Mar-20,7185,6989,196,2.7
39225,CN1700700000000,17,7,"Boone County, IL",Mar-20,23910,22770,1140,4.8
39226,CN1700900000000,17,9,"Brown County, IL",Mar-20,2820,2770,50,1.8
39227,CN1701100000000,17,11,"Bureau County, IL",Mar-20,15905,15282,623,3.9
39228,CN1701300000000,17,13,"Calhoun County, IL",Mar-20,2152,2079,73,3.4
39229,CN1701500000000,17,15,"Carroll County, IL",Mar-20,6770,6535,235,3.5
39230,CN1701700000000,17,17,"Cass County, IL",Mar-20,5625,5447,178,3.2
39231,CN1701900000000,17,19,"Champaign County, IL",Mar-20,104582,102067,2515,2.4
39232,CN1702100000000,17,21,"Christian County, IL",Mar-20,13265,12758,507,3.8
39233,CN1702300000000,17,23,"Clark County, IL",Mar-20,7130,6872,258,3.6
39234,CN1702500000000,17,25,"Clay County, IL",Mar-20,5892,5669,223,3.8
39235,CN1702700000000,17,27,"Clinton County, IL",Mar-20,19034,18607,427,2.2
39236,CN1702900000000,17,29,"Coles County, IL",Mar-20,22614,22015,599,2.6
39237,CN1703100000000,17,31,"Cook County, IL",Mar-20,2615106,2488391,126715,4.8
39238,CN1703300000000,17,33,"Crawford County, IL",Mar-20,8084,7822,262,3.2
39239,CN1703500000000,17,35,"Cumberland County, IL",Mar-20,5760,5614,146,2.5
39240,CN1703700000000,17,37,"DeKalb County, IL",Mar-20,51532,49881,1651,3.2
39241,CN1703900000000,17,39,"De Witt County, IL",Mar-20,6862,6653,209,3.0
39242,CN1704100000000,17,41,"Douglas County, IL",Mar-20,9588,9361,227,2.4
39243,CN1704300000000,17,43,"DuPage County, IL",Mar-20,510213,491122,19091,3.7
39244,CN1704500000000,17,45,"Edgar County, IL",Mar-20,7955,7717,238,3.0
39245,CN1704700000000,17,47,"Edwards County, IL",Mar-20,2520,2427,93,3.7
39246,CN1704900000000,17,49,"Effingham County, IL",Mar-20,18207,17779,428,2.4
39247,CN1705100000000,17,51,"Fayette County, IL",Mar-20,9144,8836,308,3.4
39248,CN1705300000000,17,53,"Ford County, IL",Mar-20,6070,5884,186,3.1
39249,CN1705500000000,17,55,"Franklin County, IL",Mar-20,15325,14702,623,4.1
39250,CN1705700000000,17,57,"Fulton County, IL",Mar-20,14040,13366,674,4.8
39251,CN1705900000000,17,59,"Gallatin County, IL",Mar-20,2185,2096,89,4.1
39252,CN1706100000000,17,61,"Greene County, IL",Mar-20,5612,5443,169,3.0
39253,CN1706300000000,17,63,"Grundy County, IL",Mar-20,25646,24119,1527,6.0
39254,CN1706500000000,17,65,"Hamilton County, IL",Mar-20,4120,4000,120,2.9
39255,CN1706700000000,17,67,"Hancock County, IL",Mar-20,7695,7395,300,3.9
39256,CN1706900000000,17,69,"Hardin County, IL",Mar-20,1227,1166,61,5.0
39257,CN1707100000000,17,71,"Henderson County, IL",Mar-20,3372,3239,133,3.9
39258,CN1707300000000,17,73,"Henry County, IL",Mar-20,23075,22197,878,3.8
39259,CN1707500000000,17,75,"Iroquois County, IL",Mar-20,13272,12816,456,3.4
39260,CN1707700000000,17,77,"Jackson County, IL",Mar-20,26348,25665,683,2.6
39261,CN1707900000000,17,79,"Jasper County, IL",Mar-20,4514,4377,137,3.0
39262,CN1708100000000,17,81,"Jefferson County, IL",Mar-20,16270,15765,505,3.1
39263,CN1708300000000,17,83,"Jersey County, IL",Mar-20,10256,9942,314,3.1
39264,CN1708500000000,17,85,"Jo Daviess County, IL",Mar-20,9780,9380,400,4.1
39265,CN1708700000000,17,87,"Johnson County, IL",Mar-20,4011,3833,178,4.4
39266,CN1708900000000,17,89,"Kane County, IL",Mar-20,256167,246640,9527,3.7
39267,CN1709100000000,17,91,"Kankakee County, IL",Mar-20,52708,50603,2105,4.0
39268,CN1709300000000,17,93,"Kendall County, IL",Mar-20,68854,65736,3118,4.5
39269,CN1709500000000,17,95,"Knox County, IL",Mar-20,19874,19083,791,4.0
39270,CN1709700000000,17,97,"Lake County, IL",Mar-20,347558,335435,12123,3.5
39271,CN1709900000000,17,99,"LaSalle County, IL",Mar-20,50927,48722,2205,4.3
39272,CN1710100000000,17,101,"Lawrence County, IL",Mar-20,5483,5285,198,3.6
39273,CN1710300000000,17,103,"Lee County, IL",Mar-20,16423,15952,471,2.9
39274,CN1710500000000,17,105,"Livingston County, IL",Mar-20,15152,14662,490,3.2
39275,CN1710700000000,17,107,"Logan County, IL",Mar-20,11707,11343,364,3.1
39276,CN1710900000000,17,109,"McDonough County, IL",Mar-20,12416,11932,484,3.9
39277,CN1711100000000,17,111,"McHenry County, IL",Mar-20,166916,159254,7662,4.6
39278,CN1711300000000,17,113,"McLean County, IL",Mar-20,81858,79735,2123,2.6
39279,CN1711500000000,17,115,"Macon County, IL",Mar-20,44958,43083,1875,4.2
39280,CN1711700000000,17,117,"Macoupin County, IL",Mar-20,21410,20729,681,3.2
39281,CN1711900000000,17,119,"Madison County, IL",Mar-20,125727,122309,3418,2.7
39282,CN1712100000000,17,121,"Marion County, IL",Mar-20,16234,15713,521,3.2
39283,CN1712300000000,17,123,"Marshall County, IL",Mar-20,4819,4617,202,4.2
39284,CN1712500000000,17,125,"Mason County, IL",Mar-20,5808,5566,242,4.2
39285,CN1712700000000,17,127,"Massac County, IL",Mar-20,5322,5113,209,3.9
39286,CN1712900000000,17,129,"Menard County, IL",Mar-20,6045,5866,179,3.0
39287,CN1713100000000,17,131,"Mercer County, IL",Mar-20,7472,7136,336,4.5
39288,CN1713300000000,17,133,"Monroe County, IL",Mar-20,17591,17223,368,2.1
39289,CN1713500000000,17,135,"Montgomery County, IL",Mar-20,10890,10419,471,4.3
39290,CN1713700000000,17,137,"Morgan County, IL",Mar-20,15310,14831,479,3.1
39291,CN1713900000000,17,139,"Moultrie County, IL",Mar-20,7100,6942,158,2.2
39292,CN1714100000000,17,141,"Ogle County, IL",Mar-20,22871,22007,864,3.8
39293,CN1714300000000,17,143,"Peoria County, IL",Mar-20,77054,73895,3159,4.1
39294,CN1714500000000,17,145,"Perry County, IL",Mar-20,7783,7519,264,3.4
39295,CN1714700000000,17,147,"Piatt County, IL",Mar-20,8173,7984,189,2.3
39296,CN1714900000000,17,149,"Pike County, IL",Mar-20,6426,6198,228,3.5
39297,CN1715100000000,17,151,"Pope County, IL",Mar-20,1594,1529,65,4.1
39298,CN1715300000000,17,153,"Pulaski County, IL",Mar-20,1822,1715,107,5.9
39299,CN1715500000000,17,155,"Putnam County, IL",Mar-20,2946,2819,127,4.3
39300,CN1715700000000,17,157,"Randolph County, IL",Mar-20,13350,13019,331,2.5
39301,CN1715900000000,17,159,"Richland County, IL",Mar-20,6764,6561,203,3.0
39302,CN1716100000000,17,161,"Rock Island County, IL",Mar-20,66355,63842,2513,3.8
39303,CN1716300000000,17,163,"St. Clair County, IL",Mar-20,118499,114893,3606,3.0
39304,CN1716500000000,17,165,"Saline County, IL",Mar-20,9081,8687,394,4.3
39305,CN1716700000000,17,167,"Sangamon County, IL",Mar-20,94239,91497,2742,2.9
39306,CN1716900000000,17,169,"Schuyler County, IL",Mar-20,2960,2857,103,3.5
39307,CN1717100000000,17,171,"Scott County, IL",Mar-20,2354,2261,93,4.0
39308,CN1717300000000,17,173,"Shelby County, IL",Mar-20,9822,9546,276,2.8
39309,CN1717500000000,17,175,"Stark County, IL",Mar-20,2246,2147,99,4.4
39310,CN1717700000000,17,177,"Stephenson County, IL",Mar-20,20134,19441,693,3.4
39311,CN1717900000000,17,179,"Tazewell County, IL",Mar-20,57796,55731,2065,3.6
39312,CN1718100000000,17,181,"Union County, IL",Mar-20,7058,6723,335,4.7
39313,CN1718300000000,17,183,"Vermilion County, IL",Mar-20,30564,29465,1099,3.6
39314,CN1718500000000,17,185,"Wabash County, IL",Mar-20,5654,5496,158,2.8
39315,CN1718700000000,17,187,"Warren County, IL",Mar-20,7815,7574,241,3.1
39316,CN1718900000000,17,189,"Washington County, IL",Mar-20,9297,9138,159,1.7
39317,CN1719100000000,17,191,"Wayne County, IL",Mar-20,6526,6301,225,3.4
39318,CN1719300000000,17,193,"White County, IL",Mar-20,6136,5955,181,2.9
39319,CN1719500000000,17,195,"Whiteside County, IL",Mar-20,26427,25587,840,3.2
39320,CN1719700000000,17,197,"Will County, IL",Mar-20,359755,340890,18865,5.2
39321,CN1719900000000,17,199,"Williamson County, IL",Mar-20,30290,29282,1008,3.3
39322,CN1720100000000,17,201,"Winnebago County, IL",Mar-20,126954,121480,5474,4.3
39323,CN1720300000000,17,203,"Woodford County, IL",Mar-20,16962,16473,489,2.9
39324,CN1800100000000,18,1,"Adams County, IN",Mar-20,16288,15858,430,2.6
39325,CN1800300000000,18,3,"Allen County, IN",Mar-20,180077,174567,5510,3.1
39326,CN1800500000000,18,5,"Bartholomew County, IN",Mar-20,43594,42562,1032,2.4
39327,CN1800700000000,18,7,"Benton County, IN",Mar-20,4417,4297,120,2.7
39328,CN1800900000000,18,9,"Blackford County, IN",Mar-20,4696,4500,196,4.2
39329,CN1801100000000,18,11,"Boone County, IN",Mar-20,35084,34271,813,2.3
39330,CN1801300000000,18,13,"Brown County, IN",Mar-20,7466,7234,232,3.1
39331,CN1801500000000,18,15,"Carroll County, IN",Mar-20,10120,9799,321,3.2
39332,CN1801700000000,18,17,"Cass County, IN",Mar-20,17007,16368,639,3.8
39333,CN1801900000000,18,19,"Clark County, IN",Mar-20,59999,58167,1832,3.1
39334,CN1802100000000,18,21,"Clay County, IN",Mar-20,11649,11227,422,3.6
39335,CN1802300000000,18,23,"Clinton County, IN",Mar-20,16682,16263,419,2.5
39336,CN1802500000000,18,25,"Crawford County, IN",Mar-20,4704,4494,210,4.5
39337,CN1802700000000,18,27,"Daviess County, IN",Mar-20,16234,15818,416,2.6
39338,CN1802900000000,18,29,"Dearborn County, IN",Mar-20,24773,23885,888,3.6
39339,CN1803100000000,18,31,"Decatur County, IN",Mar-20,14691,14278,413,2.8
39340,CN1803300000000,18,33,"DeKalb County, IN",Mar-20,21909,21299,610,2.8
39341,CN1803500000000,18,35,"Delaware County, IN",Mar-20,52957,50960,1997,3.8
39342,CN1803700000000,18,37,"Dubois County, IN",Mar-20,22288,21787,501,2.2
39343,CN1803900000000,18,39,"Elkhart County, IN",Mar-20,108468,105585,2883,2.7
39344,CN1804100000000,18,41,"Fayette County, IN",Mar-20,8216,7841,375,4.6
39345,CN1804300000000,18,43,"Floyd County, IN",Mar-20,40508,39316,1192,2.9
39346,CN1804500000000,18,45,"Fountain County, IN",Mar-20,7588,7335,253,3.3
39347,CN1804700000000,18,47,"Franklin County, IN",Mar-20,10886,10498,388,3.6
39348,CN1804900000000,18,49,"Fulton County, IN",Mar-20,9141,8805,336,3.7
39349,CN1805100000000,18,51,"Gibson County, IN",Mar-20,19350,18870,480,2.5
39350,CN1805300000000,18,53,"Grant County, IN",Mar-20,31282,30177,1105,3.5
39351,CN1805500000000,18,55,"Greene County, IN",Mar-20,13161,12602,559,4.2
39352,CN1805700000000,18,57,"Hamilton County, IN",Mar-20,178797,174723,4074,2.3
39353,CN1805900000000,18,59,"Hancock County, IN",Mar-20,39091,38023,1068,2.7
39354,CN1806100000000,18,61,"Harrison County, IN",Mar-20,19736,19119,617,3.1
39355,CN1806300000000,18,63,"Hendricks County, IN",Mar-20,87649,85487,2162,2.5
39356,CN1806500000000,18,65,"Henry County, IN",Mar-20,21442,20755,687,3.2
39357,CN1806700000000,18,67,"Howard County, IN",Mar-20,35710,34323,1387,3.9
39358,CN1806900000000,18,69,"Huntington County, IN",Mar-20,17579,17018,561,3.2
39359,CN1807100000000,18,71,"Jackson County, IN",Mar-20,22092,21548,544,2.5
39360,CN1807300000000,18,73,"Jasper County, IN",Mar-20,15696,15014,682,4.3
39361,CN1807500000000,18,75,"Jay County, IN",Mar-20,8855,8577,278,3.1
39362,CN1807700000000,18,77,"Jefferson County, IN",Mar-20,14636,14160,476,3.3
39363,CN1807900000000,18,79,"Jennings County, IN",Mar-20,13213,12768,445,3.4
39364,CN1808100000000,18,81,"Johnson County, IN",Mar-20,80675,78623,2052,2.5
39365,CN1808300000000,18,83,"Knox County, IN",Mar-20,17720,17204,516,2.9
39366,CN1808500000000,18,85,"Kosciusko County, IN",Mar-20,40980,39874,1106,2.7
39367,CN1808700000000,18,87,"LaGrange County, IN",Mar-20,18714,18265,449,2.4
39368,CN1808900000000,18,89,"Lake County, IN",Mar-20,224502,213299,11203,5.0
39369,CN1809100000000,18,91,"LaPorte County, IN",Mar-20,46104,44110,1994,4.3
39370,CN1809300000000,18,93,"Lawrence County, IN",Mar-20,20641,19932,709,3.4
39371,CN1809500000000,18,95,"Madison County, IN",Mar-20,57621,55395,2226,3.9
39372,CN1809700000000,18,97,"Marion County, IN",Mar-20,478180,463519,14661,3.1
39373,CN1809900000000,18,99,"Marshall County, IN",Mar-20,22122,21459,663,3.0
39374,CN1810100000000,18,101,"Martin County, IN",Mar-20,5194,5063,131,2.5
39375,CN1810300000000,18,103,"Miami County, IN",Mar-20,14675,14071,604,4.1
39376,CN1810500000000,18,105,"Monroe County, IN",Mar-20,68913,66784,2129,3.1
39377,CN1810700000000,18,107,"Montgomery County, IN",Mar-20,18176,17656,520,2.9
39378,CN1810900000000,18,109,"Morgan County, IN",Mar-20,35247,34214,1033,2.9
39379,CN1811100000000,18,111,"Newton County, IN",Mar-20,6666,6358,308,4.6
39380,CN1811300000000,18,113,"Noble County, IN",Mar-20,22418,21736,682,3.0
39381,CN1811500000000,18,115,"Ohio County, IN",Mar-20,3063,2960,103,3.4
39382,CN1811700000000,18,117,"Orange County, IN",Mar-20,8497,8204,293,3.4
39383,CN1811900000000,18,119,"Owen County, IN",Mar-20,9127,8781,346,3.8
39384,CN1812100000000,18,121,"Parke County, IN",Mar-20,6535,6305,230,3.5
39385,CN1812300000000,18,123,"Perry County, IN",Mar-20,8787,8522,265,3.0
39386,CN1812500000000,18,125,"Pike County, IN",Mar-20,5898,5700,198,3.4
39387,CN1812700000000,18,127,"Porter County, IN",Mar-20,84555,81253,3302,3.9
39388,CN1812900000000,18,129,"Posey County, IN",Mar-20,13042,12705,337,2.6
39389,CN1813100000000,18,131,"Pulaski County, IN",Mar-20,6103,5890,213,3.5
39390,CN1813300000000,18,133,"Putnam County, IN",Mar-20,16214,15683,531,3.3
39391,CN1813500000000,18,135,"Randolph County, IN",Mar-20,10693,10278,415,3.9
39392,CN1813700000000,18,137,"Ripley County, IN",Mar-20,13866,13416,450,3.2
39393,CN1813900000000,18,139,"Rush County, IN",Mar-20,8457,8225,232,2.7
39394,CN1814100000000,18,141,"St. Joseph County, IN",Mar-20,132105,127395,4710,3.6
39395,CN1814300000000,18,143,"Scott County, IN",Mar-20,10257,9924,333,3.2
39396,CN1814500000000,18,145,"Shelby County, IN",Mar-20,22531,21828,703,3.1
39397,CN1814700000000,18,147,"Spencer County, IN",Mar-20,10122,9802,320,3.2
39398,CN1814900000000,18,149,"Starke County, IN",Mar-20,9390,8951,439,4.7
39399,CN1815100000000,18,151,"Steuben County, IN",Mar-20,20016,19533,483,2.4
39400,CN1815300000000,18,153,"Sullivan County, IN",Mar-20,8056,7714,342,4.2
39401,CN1815500000000,18,155,"Switzerland County, IN",Mar-20,4703,4544,159,3.4
39402,CN1815700000000,18,157,"Tippecanoe County, IN",Mar-20,100229,97473,2756,2.7
39403,CN1815900000000,18,159,"Tipton County, IN",Mar-20,8823,8588,235,2.7
39404,CN1816100000000,18,161,"Union County, IN",Mar-20,3374,3270,104,3.1
39405,CN1816300000000,18,163,"Vanderburgh County, IN",Mar-20,91647,88984,2663,2.9
39406,CN1816500000000,18,165,"Vermillion County, IN",Mar-20,6694,6367,327,4.9
39407,CN1816700000000,18,167,"Vigo County, IN",Mar-20,46683,44880,1803,3.9
39408,CN1816900000000,18,169,"Wabash County, IN",Mar-20,14486,14046,440,3.0
39409,CN1817100000000,18,171,"Warren County, IN",Mar-20,3997,3877,120,3.0
39410,CN1817300000000,18,173,"Warrick County, IN",Mar-20,31944,31101,843,2.6
39411,CN1817500000000,18,175,"Washington County, IN",Mar-20,13111,12655,456,3.5
39412,CN1817700000000,18,177,"Wayne County, IN",Mar-20,30076,29025,1051,3.5
39413,CN1817900000000,18,179,"Wells County, IN",Mar-20,13835,13447,388,2.8
39414,CN1818100000000,18,181,"White County, IN",Mar-20,13114,12763,351,2.7
39415,CN1818300000000,18,183,"Whitley County, IN",Mar-20,17145,16665,480,2.8
39416,CN1900100000000,19,1,"Adair County, IA",Mar-20,4213,4074,139,3.3
39417,CN1900300000000,19,3,"Adams County, IA",Mar-20,2148,2097,51,2.4
39418,CN1900500000000,19,5,"Allamakee County, IA",Mar-20,7530,7097,433,5.8
39419,CN1900700000000,19,7,"Appanoose County, IA",Mar-20,5978,5723,255,4.3
39420,CN1900900000000,19,9,"Audubon County, IA",Mar-20,3076,2980,96,3.1
39421,CN1901100000000,19,11,"Benton County, IA",Mar-20,13496,13001,495,3.7
39422,CN1901300000000,19,13,"Black Hawk County, IA",Mar-20,68936,66048,2888,4.2
39423,CN1901500000000,19,15,"Boone County, IA",Mar-20,14899,14470,429,2.9
39424,CN1901700000000,19,17,"Bremer County, IA",Mar-20,13833,13393,440,3.2
39425,CN1901900000000,19,19,"Buchanan County, IA",Mar-20,11201,10756,445,4.0
39426,CN1902100000000,19,21,"Buena Vista County, IA",Mar-20,12059,11730,329,2.7
39427,CN1902300000000,19,23,"Butler County, IA",Mar-20,7949,7582,367,4.6
39428,CN1902500000000,19,25,"Calhoun County, IA",Mar-20,4222,4091,131,3.1
39429,CN1902700000000,19,27,"Carroll County, IA",Mar-20,10821,10565,256,2.4
39430,CN1902900000000,19,29,"Cass County, IA",Mar-20,6888,6636,252,3.7
39431,CN1903100000000,19,31,"Cedar County, IA",Mar-20,10897,10508,389,3.6
39432,CN1903300000000,19,33,"Cerro Gordo County, IA",Mar-20,23471,22646,825,3.5
39433,CN1903500000000,19,35,"Cherokee County, IA",Mar-20,6189,5975,214,3.5
39434,CN1903700000000,19,37,"Chickasaw County, IA",Mar-20,6577,6288,289,4.4
39435,CN1903900000000,19,39,"Clarke County, IA",Mar-20,4910,4710,200,4.1
39436,CN1904100000000,19,41,"Clay County, IA",Mar-20,8491,8174,317,3.7
39437,CN1904300000000,19,43,"Clayton County, IA",Mar-20,10129,9469,660,6.5
39438,CN1904500000000,19,45,"Clinton County, IA",Mar-20,22735,21703,1032,4.5
39439,CN1904700000000,19,47,"Crawford County, IA",Mar-20,8291,7832,459,5.5
39440,CN1904900000000,19,49,"Dallas County, IA",Mar-20,49504,48315,1189,2.4
39441,CN1905100000000,19,51,"Davis County, IA",Mar-20,4273,4135,138,3.2
39442,CN1905300000000,19,53,"Decatur County, IA",Mar-20,4464,4334,130,2.9
39443,CN1905500000000,19,55,"Delaware County, IA",Mar-20,10640,10271,369,3.5
39444,CN1905700000000,19,57,"Des Moines County, IA",Mar-20,19185,18083,1102,5.7
39445,CN1905900000000,19,59,"Dickinson County, IA",Mar-20,9695,9254,441,4.5
39446,CN1906100000000,19,61,"Dubuque County, IA",Mar-20,55959,53808,2151,3.8
39447,CN1906300000000,19,63,"Emmet County, IA",Mar-20,5262,5073,189,3.6
39448,CN1906500000000,19,65,"Fayette County, IA",Mar-20,10915,10349,566,5.2
39449,CN1906700000000,19,67,"Floyd County, IA",Mar-20,8711,8197,514,5.9
39450,CN1906900000000,19,69,"Franklin County, IA",Mar-20,5684,5479,205,3.6
39451,CN1907100000000,19,71,"Fremont County, IA",Mar-20,3663,3572,91,2.5
39452,CN1907300000000,19,73,"Greene County, IA",Mar-20,5448,5313,135,2.5
39453,CN1907500000000,19,75,"Grundy County, IA",Mar-20,6518,6275,243,3.7
39454,CN1907700000000,19,77,"Guthrie County, IA",Mar-20,5661,5427,234,4.1
39455,CN1907900000000,19,79,"Hamilton County, IA",Mar-20,6912,6645,267,3.9
39456,CN1908100000000,19,81,"Hancock County, IA",Mar-20,5923,5727,196,3.3
39457,CN1908300000000,19,83,"Hardin County, IA",Mar-20,7998,7704,294,3.7
39458,CN1908500000000,19,85,"Harrison County, IA",Mar-20,7458,7221,237,3.2
39459,CN1908700000000,19,87,"Henry County, IA",Mar-20,9914,9558,356,3.6
39460,CN1908900000000,19,89,"Howard County, IA",Mar-20,5261,5034,227,4.3
39461,CN1909100000000,19,91,"Humboldt County, IA",Mar-20,5121,4923,198,3.9
39462,CN1909300000000,19,93,"Ida County, IA",Mar-20,4199,4064,135,3.2
39463,CN1909500000000,19,95,"Iowa County, IA",Mar-20,10518,10167,351,3.3
39464,CN1909700000000,19,97,"Jackson County, IA",Mar-20,11017,10488,529,4.8
39465,CN1909900000000,19,99,"Jasper County, IA",Mar-20,19867,19134,733,3.7
39466,CN1910100000000,19,101,"Jefferson County, IA",Mar-20,10388,10093,295,2.8
39467,CN1910300000000,19,103,"Johnson County, IA",Mar-20,85525,83414,2111,2.5
39468,CN1910500000000,19,105,"Jones County, IA",Mar-20,10838,10276,562,5.2
39469,CN1910700000000,19,107,"Keokuk County, IA",Mar-20,5294,5053,241,4.6
39470,CN1910900000000,19,109,"Kossuth County, IA",Mar-20,8415,8148,267,3.2
39471,CN1911100000000,19,111,"Lee County, IA",Mar-20,16148,15390,758,4.7
39472,CN1911300000000,19,113,"Linn County, IA",Mar-20,122148,117479,4669,3.8
39473,CN1911500000000,19,115,"Louisa County, IA",Mar-20,6144,5886,258,4.2
39474,CN1911700000000,19,117,"Lucas County, IA",Mar-20,4693,4550,143,3.0
39475,CN1911900000000,19,119,"Lyon County, IA",Mar-20,7033,6848,185,2.6
39476,CN1912100000000,19,121,"Madison County, IA",Mar-20,8611,8229,382,4.4
39477,CN1912300000000,19,123,"Mahaska County, IA",Mar-20,11923,11529,394,3.3
39478,CN1912500000000,19,125,"Marion County, IA",Mar-20,18524,18011,513,2.8
39479,CN1912700000000,19,127,"Marshall County, IA",Mar-20,18237,16853,1384,7.6
39480,CN1912900000000,19,129,"Mills County, IA",Mar-20,7453,7255,198,2.7
39481,CN1913100000000,19,131,"Mitchell County, IA",Mar-20,7125,6962,163,2.3
39482,CN1913300000000,19,133,"Monona County, IA",Mar-20,4477,4291,186,4.2
39483,CN1913500000000,19,135,"Monroe County, IA",Mar-20,4084,3930,154,3.8
39484,CN1913700000000,19,137,"Montgomery County, IA",Mar-20,5020,4859,161,3.2
39485,CN1913900000000,19,139,"Muscatine County, IA",Mar-20,22014,21224,790,3.6
39486,CN1914100000000,19,141,"O'Brien County, IA",Mar-20,8322,8089,233,2.8
39487,CN1914300000000,19,143,"Osceola County, IA",Mar-20,3505,3417,88,2.5
39488,CN1914500000000,19,145,"Page County, IA",Mar-20,6423,6216,207,3.2
39489,CN1914700000000,19,147,"Palo Alto County, IA",Mar-20,4796,4625,171,3.6
39490,CN1914900000000,19,149,"Plymouth County, IA",Mar-20,14787,14411,376,2.5
39491,CN1915100000000,19,151,"Pocahontas County, IA",Mar-20,4506,4396,110,2.4
39492,CN1915300000000,19,153,"Polk County, IA",Mar-20,269581,260093,9488,3.5
39493,CN1915500000000,19,155,"Pottawattamie County, IA",Mar-20,49092,47575,1517,3.1
39494,CN1915700000000,19,157,"Poweshiek County, IA",Mar-20,10774,10372,402,3.7
39495,CN1915900000000,19,159,"Ringgold County, IA",Mar-20,2452,2372,80,3.3
39496,CN1916100000000,19,161,"Sac County, IA",Mar-20,5269,5108,161,3.1
39497,CN1916300000000,19,163,"Scott County, IA",Mar-20,88548,84910,3638,4.1
39498,CN1916500000000,19,165,"Shelby County, IA",Mar-20,6699,6505,194,2.9
39499,CN1916700000000,19,167,"Sioux County, IA",Mar-20,21440,20816,624,2.9
39500,CN1916900000000,19,169,"Story County, IA",Mar-20,59076,57851,1225,2.1
39501,CN1917100000000,19,171,"Tama County, IA",Mar-20,9573,9100,473,4.9
39502,CN1917300000000,19,173,"Taylor County, IA",Mar-20,3202,3128,74,2.3
39503,CN1917500000000,19,175,"Union County, IA",Mar-20,6373,6106,267,4.2
39504,CN1917700000000,19,177,"Van Buren County, IA",Mar-20,3625,3495,130,3.6
39505,CN1917900000000,19,179,"Wapello County, IA",Mar-20,17950,17200,750,4.2
39506,CN1918100000000,19,181,"Warren County, IA",Mar-20,28382,27449,933,3.3
39507,CN1918300000000,19,183,"Washington County, IA",Mar-20,11995,11587,408,3.4
39508,CN1918500000000,19,185,"Wayne County, IA",Mar-20,2847,2764,83,2.9
39509,CN1918700000000,19,187,"Webster County, IA",Mar-20,19530,18789,741,3.8
39510,CN1918900000000,19,189,"Winnebago County, IA",Mar-20,5217,5036,181,3.5
39511,CN1919100000000,19,191,"Winneshiek County, IA",Mar-20,12547,11990,557,4.4
39512,CN1919300000000,19,193,"Woodbury County, IA",Mar-20,55799,53835,1964,3.5
39513,CN1919500000000,19,195,"Worth County, IA",Mar-20,4258,4091,167,3.9
39514,CN1919700000000,19,197,"Wright County, IA",Mar-20,7145,6904,241,3.4
39515,CN2000100000000,20,1,"Allen County, KS",Mar-20,6677,6475,202,3.0
39516,CN2000300000000,20,3,"Anderson County, KS",Mar-20,4291,4169,122,2.8
39517,CN2000500000000,20,5,"Atchison County, KS",Mar-20,7173,6844,329,4.6
39518,CN2000700000000,20,7,"Barber County, KS",Mar-20,2355,2303,52,2.2
39519,CN2000900000000,20,9,"Barton County, KS",Mar-20,14164,13757,407,2.9
39520,CN2001100000000,20,11,"Bourbon County, KS",Mar-20,6766,6523,243,3.6
39521,CN2001300000000,20,13,"Brown County, KS",Mar-20,5487,5341,146,2.7
39522,CN2001500000000,20,15,"Butler County, KS",Mar-20,32811,31839,972,3.0
39523,CN2001700000000,20,17,"Chase County, KS",Mar-20,1637,1592,45,2.7
39524,CN2001900000000,20,19,"Chautauqua County, KS",Mar-20,1491,1445,46,3.1
39525,CN2002100000000,20,21,"Cherokee County, KS",Mar-20,10257,9969,288,2.8
39526,CN2002300000000,20,23,"Cheyenne County, KS",Mar-20,1301,1271,30,2.3
39527,CN2002500000000,20,25,"Clark County, KS",Mar-20,1080,1056,24,2.2
39528,CN2002700000000,20,27,"Clay County, KS",Mar-20,3819,3719,100,2.6
39529,CN2002900000000,20,29,"Cloud County, KS",Mar-20,3876,3777,99,2.6
39530,CN2003100000000,20,31,"Coffey County, KS",Mar-20,4084,3931,153,3.7
39531,CN2003300000000,20,33,"Comanche County, KS",Mar-20,876,855,21,2.4
39532,CN2003500000000,20,35,"Cowley County, KS",Mar-20,16732,16212,520,3.1
39533,CN2003700000000,20,37,"Crawford County, KS",Mar-20,19446,18813,633,3.3
39534,CN2003900000000,20,39,"Decatur County, KS",Mar-20,1235,1202,33,2.7
39535,CN2004100000000,20,41,"Dickinson County, KS",Mar-20,9089,8723,366,4.0
39536,CN2004300000000,20,43,"Doniphan County, KS",Mar-20,4088,3958,130,3.2
39537,CN2004500000000,20,45,"Douglas County, KS",Mar-20,66172,64399,1773,2.7
39538,CN2004700000000,20,47,"Edwards County, KS",Mar-20,1307,1277,30,2.3
39539,CN2004900000000,20,49,"Elk County, KS",Mar-20,1189,1157,32,2.7
39540,CN2005100000000,20,51,"Ellis County, KS",Mar-20,17395,17080,315,1.8
39541,CN2005300000000,20,53,"Ellsworth County, KS",Mar-20,2736,2671,65,2.4
39542,CN2005500000000,20,55,"Finney County, KS",Mar-20,21106,20710,396,1.9
39543,CN2005700000000,20,57,"Ford County, KS",Mar-20,17416,17050,366,2.1
39544,CN2005900000000,20,59,"Franklin County, KS",Mar-20,14497,14068,429,3.0
39545,CN2006100000000,20,61,"Geary County, KS",Mar-20,11649,11151,498,4.3
39546,CN2006300000000,20,63,"Gove County, KS",Mar-20,1515,1485,30,2.0
39547,CN2006500000000,20,65,"Graham County, KS",Mar-20,1117,1090,27,2.4
39548,CN2006700000000,20,67,"Grant County, KS",Mar-20,3138,3063,75,2.4
39549,CN2006900000000,20,69,"Gray County, KS",Mar-20,3281,3217,64,2.0
39550,CN2007100000000,20,71,"Greeley County, KS",Mar-20,822,809,13,1.6
39551,CN2007300000000,20,73,"Greenwood County, KS",Mar-20,3304,3197,107,3.2
39552,CN2007500000000,20,75,"Hamilton County, KS",Mar-20,1608,1581,27,1.7
39553,CN2007700000000,20,77,"Harper County, KS",Mar-20,3006,2933,73,2.4
39554,CN2007900000000,20,79,"Harvey County, KS",Mar-20,17158,16694,464,2.7
39555,CN2008100000000,20,81,"Haskell County, KS",Mar-20,2235,2195,40,1.8
39556,CN2008300000000,20,83,"Hodgeman County, KS",Mar-20,1012,987,25,2.5
39557,CN2008500000000,20,85,"Jackson County, KS",Mar-20,7207,6994,213,3.0
39558,CN2008700000000,20,87,"Jefferson County, KS",Mar-20,10127,9831,296,2.9
39559,CN2008900000000,20,89,"Jewell County, KS",Mar-20,1272,1242,30,2.4
39560,CN2009100000000,20,91,"Johnson County, KS",Mar-20,338736,330309,8427,2.5
39561,CN2009300000000,20,93,"Kearny County, KS",Mar-20,2056,2023,33,1.6
39562,CN2009500000000,20,95,"Kingman County, KS",Mar-20,3434,3342,92,2.7
39563,CN2009700000000,20,97,"Kiowa County, KS",Mar-20,1273,1246,27,2.1
39564,CN2009900000000,20,99,"Labette County, KS",Mar-20,10221,9843,378,3.7
39565,CN2010100000000,20,101,"Lane County, KS",Mar-20,753,732,21,2.8
39566,CN2010300000000,20,103,"Leavenworth County, KS",Mar-20,36538,35310,1228,3.4
39567,CN2010500000000,20,105,"Lincoln County, KS",Mar-20,1722,1687,35,2.0
39568,CN2010700000000,20,107,"Linn County, KS",Mar-20,4441,4175,266,6.0
39569,CN2010900000000,20,109,"Logan County, KS",Mar-20,1694,1667,27,1.6
39570,CN2011100000000,20,111,"Lyon County, KS",Mar-20,17521,17023,498,2.8
39571,CN2011300000000,20,113,"McPherson County, KS",Mar-20,17611,17252,359,2.0
39572,CN2011500000000,20,115,"Marion County, KS",Mar-20,6135,5982,153,2.5
39573,CN2011700000000,20,117,"Marshall County, KS",Mar-20,5562,5433,129,2.3
39574,CN2011900000000,20,119,"Meade County, KS",Mar-20,2163,2120,43,2.0
39575,CN2012100000000,20,121,"Miami County, KS",Mar-20,17499,16936,563,3.2
39576,CN2012300000000,20,123,"Mitchell County, KS",Mar-20,3409,3344,65,1.9
39577,CN2012500000000,20,125,"Montgomery County, KS",Mar-20,14912,14319,593,4.0
39578,CN2012700000000,20,127,"Morris County, KS",Mar-20,3047,2960,87,2.9
39579,CN2012900000000,20,129,"Morton County, KS",Mar-20,1123,1096,27,2.4
39580,CN2013100000000,20,131,"Nemaha County, KS",Mar-20,5294,5167,127,2.4
39581,CN2013300000000,20,133,"Neosho County, KS",Mar-20,6190,5947,243,3.9
39582,CN2013500000000,20,135,"Ness County, KS",Mar-20,1351,1316,35,2.6
39583,CN2013700000000,20,137,"Norton County, KS",Mar-20,2684,2632,52,1.9
39584,CN2013900000000,20,139,"Osage County, KS",Mar-20,7981,7719,262,3.3
39585,CN2014100000000,20,141,"Osborne County, KS",Mar-20,2032,1986,46,2.3
39586,CN2014300000000,20,143,"Ottawa County, KS",Mar-20,3086,3010,76,2.5
39587,CN2014500000000,20,145,"Pawnee County, KS",Mar-20,2826,2737,89,3.1
39588,CN2014700000000,20,147,"Phillips County, KS",Mar-20,2675,2615,60,2.2
39589,CN2014900000000,20,149,"Pottawatomie County, KS",Mar-20,12452,12132,320,2.6
39590,CN2015100000000,20,151,"Pratt County, KS",Mar-20,5046,4933,113,2.2
39591,CN2015300000000,20,153,"Rawlins County, KS",Mar-20,1517,1488,29,1.9
39592,CN2015500000000,20,155,"Reno County, KS",Mar-20,30738,29890,848,2.8
39593,CN2015700000000,20,157,"Republic County, KS",Mar-20,2268,2216,52,2.3
39594,CN2015900000000,20,159,"Rice County, KS",Mar-20,5449,5322,127,2.3
39595,CN2016100000000,20,161,"Riley County, KS",Mar-20,35146,34317,829,2.4
39596,CN2016300000000,20,163,"Rooks County, KS",Mar-20,2528,2458,70,2.8
39597,CN2016500000000,20,165,"Rush County, KS",Mar-20,1633,1582,51,3.1
39598,CN2016700000000,20,167,"Russell County, KS",Mar-20,3294,3213,81,2.5
39599,CN2016900000000,20,169,"Saline County, KS",Mar-20,31028,30126,902,2.9
39600,CN2017100000000,20,171,"Scott County, KS",Mar-20,2829,2783,46,1.6
39601,CN2017300000000,20,173,"Sedgwick County, KS",Mar-20,254263,245749,8514,3.3
39602,CN2017500000000,20,175,"Seward County, KS",Mar-20,9579,9334,245,2.6
39603,CN2017700000000,20,177,"Shawnee County, KS",Mar-20,90711,87960,2751,3.0
39604,CN2017900000000,20,179,"Sheridan County, KS",Mar-20,1428,1404,24,1.7
39605,CN2018100000000,20,181,"Sherman County, KS",Mar-20,2851,2779,72,2.5
39606,CN2018300000000,20,183,"Smith County, KS",Mar-20,2031,1982,49,2.4
39607,CN2018500000000,20,185,"Stafford County, KS",Mar-20,2027,1970,57,2.8
39608,CN2018700000000,20,187,"Stanton County, KS",Mar-20,983,959,24,2.4
39609,CN2018900000000,20,189,"Stevens County, KS",Mar-20,2806,2741,65,2.3
39610,CN2019100000000,20,191,"Sumner County, KS",Mar-20,11007,10649,358,3.3
39611,CN2019300000000,20,193,"Thomas County, KS",Mar-20,4320,4234,86,2.0
39612,CN2019500000000,20,195,"Trego County, KS",Mar-20,1388,1343,45,3.2
39613,CN2019700000000,20,197,"Wabaunsee County, KS",Mar-20,3647,3534,113,3.1
39614,CN2019900000000,20,199,"Wallace County, KS",Mar-20,984,968,16,1.6
39615,CN2020100000000,20,201,"Washington County, KS",Mar-20,3006,2949,57,1.9
39616,CN2020300000000,20,203,"Wichita County, KS",Mar-20,1290,1268,22,1.7
39617,CN2020500000000,20,205,"Wilson County, KS",Mar-20,4060,3887,173,4.3
39618,CN2020700000000,20,207,"Woodson County, KS",Mar-20,1657,1600,57,3.4
39619,CN2020900000000,20,209,"Wyandotte County, KS",Mar-20,77021,74112,2909,3.8
39620,CN2100100000000,21,1,"Adair County, KY",Mar-20,7213,6732,481,6.7
39621,CN2100300000000,21,3,"Allen County, KY",Mar-20,8982,8540,442,4.9
39622,CN2100500000000,21,5,"Anderson County, KY",Mar-20,12117,11521,596,4.9
39623,CN2100700000000,21,7,"Ballard County, KY",Mar-20,3523,3292,231,6.6
39624,CN2100900000000,21,9,"Barren County, KY",Mar-20,18932,17880,1052,5.6
39625,CN2101100000000,21,11,"Bath County, KY",Mar-20,4674,4265,409,8.8
39626,CN2101300000000,21,13,"Bell County, KY",Mar-20,8595,7892,703,8.2
39627,CN2101500000000,21,15,"Boone County, KY",Mar-20,70337,67393,2944,4.2
39628,CN2101700000000,21,17,"Bourbon County, KY",Mar-20,9475,9004,471,5.0
39629,CN2101900000000,21,19,"Boyd County, KY",Mar-20,17990,16762,1228,6.8
39630,CN2102100000000,21,21,"Boyle County, KY",Mar-20,12518,11832,686,5.5
39631,CN2102300000000,21,23,"Bracken County, KY",Mar-20,3830,3580,250,6.5
39632,CN2102500000000,21,25,"Breathitt County, KY",Mar-20,3542,3123,419,11.8
39633,CN2102700000000,21,27,"Breckinridge County, KY",Mar-20,7980,7391,589,7.4
39634,CN2102900000000,21,29,"Bullitt County, KY",Mar-20,42931,40889,2042,4.8
39635,CN2103100000000,21,31,"Butler County, KY",Mar-20,5198,4888,310,6.0
39636,CN2103300000000,21,33,"Caldwell County, KY",Mar-20,5565,5194,371,6.7
39637,CN2103500000000,21,35,"Calloway County, KY",Mar-20,19250,18106,1144,5.9
39638,CN2103700000000,21,37,"Campbell County, KY",Mar-20,50492,48281,2211,4.4
39639,CN2103900000000,21,39,"Carlisle County, KY",Mar-20,2275,2163,112,4.9
39640,CN2104100000000,21,41,"Carroll County, KY",Mar-20,5238,4980,258,4.9
39641,CN2104300000000,21,43,"Carter County, KY",Mar-20,9927,9040,887,8.9
39642,CN2104500000000,21,45,"Casey County, KY",Mar-20,6825,6351,474,6.9
39643,CN2104700000000,21,47,"Christian County, KY",Mar-20,25696,24038,1658,6.5
39644,CN2104900000000,21,49,"Clark County, KY",Mar-20,17020,16135,885,5.2
39645,CN2105100000000,21,51,"Clay County, KY",Mar-20,5259,4806,453,8.6
39646,CN2105300000000,21,53,"Clinton County, KY",Mar-20,4023,3767,256,6.4
39647,CN2105500000000,21,55,"Crittenden County, KY",Mar-20,3850,3635,215,5.6
39648,CN2105700000000,21,57,"Cumberland County, KY",Mar-20,3246,3044,202,6.2
39649,CN2105900000000,21,59,"Daviess County, KY",Mar-20,46917,44658,2259,4.8
39650,CN2106100000000,21,61,"Edmonson County, KY",Mar-20,4882,4564,318,6.5
39651,CN2106300000000,21,63,"Elliott County, KY",Mar-20,2105,1874,231,11.0
39652,CN2106500000000,21,65,"Estill County, KY",Mar-20,5486,5117,369,6.7
39653,CN2106700000000,21,67,"Fayette County, KY",Mar-20,172236,165183,7053,4.1
39654,CN2106900000000,21,69,"Fleming County, KY",Mar-20,6130,5720,410,6.7
39655,CN2107100000000,21,71,"Floyd County, KY",Mar-20,11156,10174,982,8.8
39656,CN2107300000000,21,73,"Franklin County, KY",Mar-20,25303,24160,1143,4.5
39657,CN2107500000000,21,75,"Fulton County, KY",Mar-20,2047,1922,125,6.1
39658,CN2107700000000,21,77,"Gallatin County, KY",Mar-20,4043,3844,199,4.9
39659,CN2107900000000,21,79,"Garrard County, KY",Mar-20,7668,7225,443,5.8
39660,CN2108100000000,21,81,"Grant County, KY",Mar-20,11664,11058,606,5.2
39661,CN2108300000000,21,83,"Graves County, KY",Mar-20,16105,15227,878,5.5
39662,CN2108500000000,21,85,"Grayson County, KY",Mar-20,11215,10489,726,6.5
39663,CN2108700000000,21,87,"Green County, KY",Mar-20,5081,4833,248,4.9
39664,CN2108900000000,21,89,"Greenup County, KY",Mar-20,13613,12456,1157,8.5
39665,CN2109100000000,21,91,"Hancock County, KY",Mar-20,3926,3745,181,4.6
39666,CN2109300000000,21,93,"Hardin County, KY",Mar-20,49173,46607,2566,5.2
39667,CN2109500000000,21,95,"Harlan County, KY",Mar-20,6873,5954,919,13.4
39668,CN2109700000000,21,97,"Harrison County, KY",Mar-20,8797,8360,437,5.0
39669,CN2109900000000,21,99,"Hart County, KY",Mar-20,8081,7524,557,6.9
39670,CN2110100000000,21,101,"Henderson County, KY",Mar-20,22005,20953,1052,4.8
39671,CN2110300000000,21,103,"Henry County, KY",Mar-20,8228,7855,373,4.5
39672,CN2110500000000,21,105,"Hickman County, KY",Mar-20,1709,1609,100,5.9
39673,CN2110700000000,21,107,"Hopkins County, KY",Mar-20,18640,17453,1187,6.4
39674,CN2110900000000,21,109,"Jackson County, KY",Mar-20,4124,3799,325,7.9
39675,CN2111100000000,21,111,"Jefferson County, KY",Mar-20,402015,383268,18747,4.7
39676,CN2111300000000,21,113,"Jessamine County, KY",Mar-20,26208,25059,1149,4.4
39677,CN2111500000000,21,115,"Johnson County, KY",Mar-20,6821,6227,594,8.7
39678,CN2111700000000,21,117,"Kenton County, KY",Mar-20,87150,83302,3848,4.4
39679,CN2111900000000,21,119,"Knott County, KY",Mar-20,4551,4121,430,9.4
39680,CN2112100000000,21,121,"Knox County, KY",Mar-20,9860,9207,653,6.6
39681,CN2112300000000,21,123,"Larue County, KY",Mar-20,6025,5687,338,5.6
39682,CN2112500000000,21,125,"Laurel County, KY",Mar-20,24615,23129,1486,6.0
39683,CN2112700000000,21,127,"Lawrence County, KY",Mar-20,5395,4902,493,9.1
39684,CN2112900000000,21,129,"Lee County, KY",Mar-20,2134,1971,163,7.6
39685,CN2113100000000,21,131,"Leslie County, KY",Mar-20,2794,2448,346,12.4
39686,CN2113300000000,21,133,"Letcher County, KY",Mar-20,6563,5877,686,10.5
39687,CN2113500000000,21,135,"Lewis County, KY",Mar-20,4707,4201,506,10.7
39688,CN2113700000000,21,137,"Lincoln County, KY",Mar-20,9329,8733,596,6.4
39689,CN2113900000000,21,139,"Livingston County, KY",Mar-20,3683,3422,261,7.1
39690,CN2114100000000,21,141,"Logan County, KY",Mar-20,12681,12054,627,4.9
39691,CN2114300000000,21,143,"Lyon County, KY",Mar-20,3058,2881,177,5.8
39692,CN2114500000000,21,145,"McCracken County, KY",Mar-20,29374,27668,1706,5.8
39693,CN2114700000000,21,147,"McCreary County, KY",Mar-20,4730,4356,374,7.9
39694,CN2114900000000,21,149,"McLean County, KY",Mar-20,4146,3924,222,5.4
39695,CN2115100000000,21,151,"Madison County, KY",Mar-20,47482,45213,2269,4.8
39696,CN2115300000000,21,153,"Magoffin County, KY",Mar-20,3458,2864,594,17.2
39697,CN2115500000000,21,155,"Marion County, KY",Mar-20,9646,9240,406,4.2
39698,CN2115700000000,21,157,"Marshall County, KY",Mar-20,15378,14505,873,5.7
39699,CN2115900000000,21,159,"Martin County, KY",Mar-20,2861,2538,323,11.3
39700,CN2116100000000,21,161,"Mason County, KY",Mar-20,6993,6537,456,6.5
39701,CN2116300000000,21,163,"Meade County, KY",Mar-20,12307,11578,729,5.9
39702,CN2116500000000,21,165,"Menifee County, KY",Mar-20,2355,2130,225,9.6
39703,CN2116700000000,21,167,"Mercer County, KY",Mar-20,10048,9478,570,5.7
39704,CN2116900000000,21,169,"Metcalfe County, KY",Mar-20,4129,3871,258,6.2
39705,CN2117100000000,21,171,"Monroe County, KY",Mar-20,4687,4451,236,5.0
39706,CN2117300000000,21,173,"Montgomery County, KY",Mar-20,11704,10927,777,6.6
39707,CN2117500000000,21,175,"Morgan County, KY",Mar-20,4671,4318,353,7.6
39708,CN2117700000000,21,177,"Muhlenberg County, KY",Mar-20,10642,9787,855,8.0
39709,CN2117900000000,21,179,"Nelson County, KY",Mar-20,23340,22166,1174,5.0
39710,CN2118100000000,21,181,"Nicholas County, KY",Mar-20,3302,3110,192,5.8
39711,CN2118300000000,21,183,"Ohio County, KY",Mar-20,9844,9163,681,6.9
39712,CN2118500000000,21,185,"Oldham County, KY",Mar-20,33365,32107,1258,3.8
39713,CN2118700000000,21,187,"Owen County, KY",Mar-20,5080,4827,253,5.0
39714,CN2118900000000,21,189,"Owsley County, KY",Mar-20,1155,1056,99,8.6
39715,CN2119100000000,21,191,"Pendleton County, KY",Mar-20,6999,6625,374,5.3
39716,CN2119300000000,21,193,"Perry County, KY",Mar-20,8458,7700,758,9.0
39717,CN2119500000000,21,195,"Pike County, KY",Mar-20,19990,18319,1671,8.4
39718,CN2119700000000,21,197,"Powell County, KY",Mar-20,5025,4654,371,7.4
39719,CN2119900000000,21,199,"Pulaski County, KY",Mar-20,26801,25220,1581,5.9
39720,CN2120100000000,21,201,"Robertson County, KY",Mar-20,821,768,53,6.5
39721,CN2120300000000,21,203,"Rockcastle County, KY",Mar-20,6728,6321,407,6.0
39722,CN2120500000000,21,205,"Rowan County, KY",Mar-20,10926,10230,696,6.4
39723,CN2120700000000,21,207,"Russell County, KY",Mar-20,6260,5830,430,6.9
39724,CN2120900000000,21,209,"Scott County, KY",Mar-20,28659,27426,1233,4.3
39725,CN2121100000000,21,211,"Shelby County, KY",Mar-20,25505,24459,1046,4.1
39726,CN2121300000000,21,213,"Simpson County, KY",Mar-20,9010,8545,465,5.2
39727,CN2121500000000,21,215,"Spencer County, KY",Mar-20,10260,9823,437,4.3
39728,CN2121700000000,21,217,"Taylor County, KY",Mar-20,12670,12053,617,4.9
39729,CN2121900000000,21,219,"Todd County, KY",Mar-20,5476,5212,264,4.8
39730,CN2122100000000,21,221,"Trigg County, KY",Mar-20,6161,5777,384,6.2
39731,CN2122300000000,21,223,"Trimble County, KY",Mar-20,3876,3682,194,5.0
39732,CN2122500000000,21,225,"Union County, KY",Mar-20,6145,5792,353,5.7
39733,CN2122700000000,21,227,"Warren County, KY",Mar-20,65553,62325,3228,4.9
39734,CN2122900000000,21,229,"Washington County, KY",Mar-20,6270,5988,282,4.5
39735,CN2123100000000,21,231,"Wayne County, KY",Mar-20,7405,6898,507,6.8
39736,CN2123300000000,21,233,"Webster County, KY",Mar-20,5543,5203,340,6.1
39737,CN2123500000000,21,235,"Whitley County, KY",Mar-20,13633,12794,839,6.2
39738,CN2123700000000,21,237,"Wolfe County, KY",Mar-20,2054,1868,186,9.1
39739,CN2123900000000,21,239,"Woodford County, KY",Mar-20,14487,13886,601,4.1
39740,CN2200100000000,22,1,"Acadia Parish, LA",Mar-20,24036,22364,1672,7.0
39741,CN2200300000000,22,3,"Allen Parish, LA",Mar-20,9076,8376,700,7.7
39742,CN2200500000000,22,5,"Ascension Parish, LA",Mar-20,66163,62681,3482,5.3
39743,CN2200700000000,22,7,"Assumption Parish, LA",Mar-20,9122,8412,710,7.8
39744,CN2200900000000,22,9,"Avoyelles Parish, LA",Mar-20,15532,14340,1192,7.7
39745,CN2201100000000,22,11,"Beauregard Parish, LA",Mar-20,14961,13851,1110,7.4
39746,CN2201300000000,22,13,"Bienville Parish, LA",Mar-20,5697,5225,472,8.3
39747,CN2201500000000,22,15,"Bossier Parish, LA",Mar-20,58383,55121,3262,5.6
39748,CN2201700000000,22,17,"Caddo Parish, LA",Mar-20,105143,97807,7336,7.0
39749,CN2201900000000,22,19,"Calcasieu Parish, LA",Mar-20,103917,97696,6221,6.0
39750,CN2202100000000,22,21,"Caldwell Parish, LA",Mar-20,3894,3535,359,9.2
39751,CN2202300000000,22,23,"Cameron Parish, LA",Mar-20,3844,3639,205,5.3
39752,CN2202500000000,22,25,"Catahoula Parish, LA",Mar-20,3484,3217,267,7.7
39753,CN2202700000000,22,27,"Claiborne Parish, LA",Mar-20,6017,5537,480,8.0
39754,CN2202900000000,22,29,"Concordia Parish, LA",Mar-20,7357,6719,638,8.7
39755,CN2203100000000,22,31,"De Soto Parish, LA",Mar-20,11101,10211,890,8.0
39756,CN2203300000000,22,33,"East Baton Rouge Parish, LA",Mar-20,238382,225204,13178,5.5
39757,CN2203500000000,22,35,"East Carroll Parish, LA",Mar-20,1953,1666,287,14.7
39758,CN2203700000000,22,37,"East Feliciana Parish, LA",Mar-20,8236,7767,469,5.7
39759,CN2203900000000,22,39,"Evangeline Parish, LA",Mar-20,12061,11158,903,7.5
39760,CN2204100000000,22,41,"Franklin Parish, LA",Mar-20,7629,6908,721,9.5
39761,CN2204300000000,22,43,"Grant Parish, LA",Mar-20,8341,7695,646,7.7
39762,CN2204500000000,22,45,"Iberia Parish, LA",Mar-20,28430,26271,2159,7.6
39763,CN2204700000000,22,47,"Iberville Parish, LA",Mar-20,14654,13528,1126,7.7
39764,CN2204900000000,22,49,"Jackson Parish, LA",Mar-20,7043,6584,459,6.5
39765,CN2205100000000,22,51,"Jefferson Parish, LA",Mar-20,214778,202921,11857,5.5
39766,CN2205300000000,22,53,"Jefferson Davis Parish, LA",Mar-20,13302,12461,841,6.3
39767,CN2205500000000,22,55,"Lafayette Parish, LA",Mar-20,113977,107302,6675,5.9
39768,CN2205700000000,22,57,"Lafourche Parish, LA",Mar-20,42141,39684,2457,5.8
39769,CN2205900000000,22,59,"LaSalle Parish, LA",Mar-20,6935,6548,387,5.6
39770,CN2206100000000,22,61,"Lincoln Parish, LA",Mar-20,22835,21355,1480,6.5
39771,CN2206300000000,22,63,"Livingston Parish, LA",Mar-20,71038,67338,3700,5.2
39772,CN2206500000000,22,65,"Madison Parish, LA",Mar-20,3609,3245,364,10.1
39773,CN2206700000000,22,67,"Morehouse Parish, LA",Mar-20,10502,9289,1213,11.6
39774,CN2206900000000,22,69,"Natchitoches Parish, LA",Mar-20,17148,15943,1205,7.0
39775,CN2207100000000,22,71,"Orleans Parish, LA",Mar-20,179911,168498,11413,6.3
39776,CN2207300000000,22,73,"Ouachita Parish, LA",Mar-20,71948,66873,5075,7.1
39777,CN2207500000000,22,75,"Plaquemines Parish, LA",Mar-20,10115,9564,551,5.4
39778,CN2207700000000,22,77,"Pointe Coupee Parish, LA",Mar-20,10225,9551,674,6.6
39779,CN2207900000000,22,79,"Rapides Parish, LA",Mar-20,55880,52305,3575,6.4
39780,CN2208100000000,22,81,"Red River Parish, LA",Mar-20,3877,3592,285,7.4
39781,CN2208300000000,22,83,"Richland Parish, LA",Mar-20,8437,7683,754,8.9
39782,CN2208500000000,22,85,"Sabine Parish, LA",Mar-20,9432,8829,603,6.4
39783,CN2208700000000,22,87,"St. Bernard Parish, LA",Mar-20,19991,18709,1282,6.4
39784,CN2208900000000,22,89,"St. Charles Parish, LA",Mar-20,25269,23836,1433,5.7
39785,CN2209100000000,22,91,"St. Helena Parish, LA",Mar-20,4428,4102,326,7.4
39786,CN2209300000000,22,93,"St. James Parish, LA",Mar-20,9343,8615,728,7.8
39787,CN2209500000000,22,95,"St. John the Baptist Parish, LA",Mar-20,19852,18388,1464,7.4
39788,CN2209700000000,22,97,"St. Landry Parish, LA",Mar-20,32771,30079,2692,8.2
39789,CN2209900000000,22,99,"St. Martin Parish, LA",Mar-20,22375,20849,1526,6.8
39790,CN2210100000000,22,101,"St. Mary Parish, LA",Mar-20,20320,18758,1562,7.7
39791,CN2210300000000,22,103,"St. Tammany Parish, LA",Mar-20,119673,113214,6459,5.4
39792,CN2210500000000,22,105,"Tangipahoa Parish, LA",Mar-20,55524,51596,3928,7.1
39793,CN2210700000000,22,107,"Tensas Parish, LA",Mar-20,1449,1267,182,12.6
39794,CN2210900000000,22,109,"Terrebonne Parish, LA",Mar-20,46567,43716,2851,6.1
39795,CN2211100000000,22,111,"Union Parish, LA",Mar-20,9418,8662,756,8.0
39796,CN2211300000000,22,113,"Vermilion Parish, LA",Mar-20,24246,22582,1664,6.9
39797,CN2211500000000,22,115,"Vernon Parish, LA",Mar-20,16808,15236,1572,9.4
39798,CN2211700000000,22,117,"Washington Parish, LA",Mar-20,17093,15824,1269,7.4
39799,CN2211900000000,22,119,"Webster Parish, LA",Mar-20,14838,13610,1228,8.3
39800,CN2212100000000,22,121,"West Baton Rouge Parish, LA",Mar-20,14113,13318,795,5.6
39801,CN2212300000000,22,123,"West Carroll Parish, LA",Mar-20,3851,3233,618,16.0
39802,CN2212500000000,22,125,"West Feliciana Parish, LA",Mar-20,5566,5274,292,5.2
39803,CN2212700000000,22,127,"Winn Parish, LA",Mar-20,5036,4603,433,8.6
39804,CN2300100000000,23,1,"Androscoggin County, ME",Mar-20,55762,53981,1781,3.2
39805,CN2300300000000,23,3,"Aroostook County, ME",Mar-20,30201,28610,1591,5.3
39806,CN2300500000000,23,5,"Cumberland County, ME",Mar-20,163068,158847,4221,2.6
39807,CN2300700000000,23,7,"Franklin County, ME",Mar-20,14494,13919,575,4.0
39808,CN2300900000000,23,9,"Hancock County, ME",Mar-20,27341,25797,1544,5.6
39809,CN2301100000000,23,11,"Kennebec County, ME",Mar-20,62038,59921,2117,3.4
39810,CN2301300000000,23,13,"Knox County, ME",Mar-20,19382,18582,800,4.1
39811,CN2301500000000,23,15,"Lincoln County, ME",Mar-20,16066,15436,630,3.9
39812,CN2301700000000,23,17,"Oxford County, ME",Mar-20,26690,25567,1123,4.2
39813,CN2301900000000,23,19,"Penobscot County, ME",Mar-20,78000,74969,3031,3.9
39814,CN2302100000000,23,21,"Piscataquis County, ME",Mar-20,7257,6913,344,4.7
39815,CN2302300000000,23,23,"Sagadahoc County, ME",Mar-20,19414,18869,545,2.8
39816,CN2302500000000,23,25,"Somerset County, ME",Mar-20,22186,20950,1236,5.6
39817,CN2302700000000,23,27,"Waldo County, ME",Mar-20,20390,19548,842,4.1
39818,CN2302900000000,23,29,"Washington County, ME",Mar-20,13459,12557,902,6.7
39819,CN2303100000000,23,31,"York County, ME",Mar-20,112529,108751,3778,3.4
39820,CN2400100000000,24,1,"Allegany County, MD",Mar-20,32475,30742,1733,5.3
39821,CN2400300000000,24,3,"Anne Arundel County, MD",Mar-20,318746,309357,9389,2.9
39822,CN2400500000000,24,5,"Baltimore County, MD",Mar-20,458919,442393,16526,3.6
39823,CN2400900000000,24,9,"Calvert County, MD",Mar-20,51201,49735,1466,2.9
39824,CN2401100000000,24,11,"Caroline County, MD",Mar-20,18214,17558,656,3.6
39825,CN2401300000000,24,13,"Carroll County, MD",Mar-20,97057,94356,2701,2.8
39826,CN2401500000000,24,15,"Cecil County, MD",Mar-20,54082,51957,2125,3.9
39827,CN2401700000000,24,17,"Charles County, MD",Mar-20,89557,86377,3180,3.6
39828,CN2401900000000,24,19,"Dorchester County, MD",Mar-20,15362,14561,801,5.2
39829,CN2402100000000,24,21,"Frederick County, MD",Mar-20,135947,131823,4124,3.0
39830,CN2402300000000,24,23,"Garrett County, MD",Mar-20,15729,14901,828,5.3
39831,CN2402500000000,24,25,"Harford County, MD",Mar-20,142684,137980,4704,3.3
39832,CN2402700000000,24,27,"Howard County, MD",Mar-20,189491,184655,4836,2.6
39833,CN2402900000000,24,29,"Kent County, MD",Mar-20,10285,9846,439,4.3
39834,CN2403100000000,24,31,"Montgomery County, MD",Mar-20,565509,549604,15905,2.8
39835,CN2403300000000,24,33,"Prince George's County, MD",Mar-20,522403,503225,19178,3.7
39836,CN2403500000000,24,35,"Queen Anne's County, MD",Mar-20,28410,27552,858,3.0
39837,CN2403700000000,24,37,"St. Mary's County, MD",Mar-20,58117,56298,1819,3.1
39838,CN2403900000000,24,39,"Somerset County, MD",Mar-20,9277,8731,546,5.9
39839,CN2404100000000,24,41,"Talbot County, MD",Mar-20,18971,18276,695,3.7
39840,CN2404300000000,24,43,"Washington County, MD",Mar-20,75220,72199,3021,4.0
39841,CN2404500000000,24,45,"Wicomico County, MD",Mar-20,51252,48795,2457,4.8
39842,CN2404700000000,24,47,"Worcester County, MD",Mar-20,26161,23712,2449,9.4
39843,CN2451000000000,24,510,"Baltimore city, MD",Mar-20,291181,276898,14283,4.9
39844,CN2500100000000,25,1,"Barnstable County, MA",Mar-20,106531,100918,5613,5.3
39845,CN2500300000000,25,3,"Berkshire County, MA",Mar-20,62705,60273,2432,3.9
39846,CN2500500000000,25,5,"Bristol County, MA",Mar-20,300557,288609,11948,4.0
39847,CN2500700000000,25,7,"Dukes County, MA",Mar-20,8367,7866,501,6.0
39848,CN2500900000000,25,9,"Essex County, MA",Mar-20,423430,410676,12754,3.0
39849,CN2501100000000,25,11,"Franklin County, MA",Mar-20,41048,39856,1192,2.9
39850,CN2501300000000,25,13,"Hampden County, MA",Mar-20,227623,219078,8545,3.8
39851,CN2501500000000,25,15,"Hampshire County, MA",Mar-20,90104,87769,2335,2.6
39852,CN2501700000000,25,17,"Middlesex County, MA",Mar-20,918161,897428,20733,2.3
39853,CN2501900000000,25,19,"Nantucket County/town, MA",Mar-20,6323,5750,573,9.1
39854,CN2502100000000,25,21,"Norfolk County, MA",Mar-20,391253,381324,9929,2.5
39855,CN2502300000000,25,23,"Plymouth County, MA",Mar-20,282819,273540,9279,3.3
39856,CN2502500000000,25,25,"Suffolk County, MA",Mar-20,455982,444404,11578,2.5
39857,CN2502700000000,25,27,"Worcester County, MA",Mar-20,448648,434624,14024,3.1
39858,CN2600100000000,26,1,"Alcona County, MI",Mar-20,3732,3477,255,6.8
39859,CN2600300000000,26,3,"Alger County, MI",Mar-20,2996,2773,223,7.4
39860,CN2600500000000,26,5,"Allegan County, MI",Mar-20,61305,59521,1784,2.9
39861,CN2600700000000,26,7,"Alpena County, MI",Mar-20,13130,12548,582,4.4
39862,CN2600900000000,26,9,"Antrim County, MI",Mar-20,9916,9381,535,5.4
39863,CN2601100000000,26,11,"Arenac County, MI",Mar-20,5862,5456,406,6.9
39864,CN2601300000000,26,13,"Baraga County, MI",Mar-20,3186,2990,196,6.2
39865,CN2601500000000,26,15,"Barry County, MI",Mar-20,31453,30442,1011,3.2
39866,CN2601700000000,26,17,"Bay County, MI",Mar-20,48492,46287,2205,4.5
39867,CN2601900000000,26,19,"Benzie County, MI",Mar-20,8577,8095,482,5.6
39868,CN2602100000000,26,21,"Berrien County, MI",Mar-20,72699,70099,2600,3.6
39869,CN2602300000000,26,23,"Branch County, MI",Mar-20,18997,18387,610,3.2
39870,CN2602500000000,26,25,"Calhoun County, MI",Mar-20,61451,59257,2194,3.6
39871,CN2602700000000,26,27,"Cass County, MI",Mar-20,24153,23262,891,3.7
39872,CN2602900000000,26,29,"Charlevoix County, MI",Mar-20,12048,11440,608,5.0
39873,CN2603100000000,26,31,"Cheboygan County, MI",Mar-20,9746,8468,1278,13.1
39874,CN2603300000000,26,33,"Chippewa County, MI",Mar-20,15793,14839,954,6.0
39875,CN2603500000000,26,35,"Clare County, MI",Mar-20,11424,10693,731,6.4
39876,CN2603700000000,26,37,"Clinton County, MI",Mar-20,41000,39942,1058,2.6
39877,CN2603900000000,26,39,"Crawford County, MI",Mar-20,5483,5159,324,5.9
39878,CN2604100000000,26,41,"Delta County, MI",Mar-20,16721,15868,853,5.1
39879,CN2604300000000,26,43,"Dickinson County, MI",Mar-20,11972,11460,512,4.3
39880,CN2604500000000,26,45,"Eaton County, MI",Mar-20,57190,55470,1720,3.0
39881,CN2604700000000,26,47,"Emmet County, MI",Mar-20,16726,15736,990,5.9
39882,CN2604900000000,26,49,"Genesee County, MI",Mar-20,180757,173256,7501,4.1
39883,CN2605100000000,26,51,"Gladwin County, MI",Mar-20,9621,9079,542,5.6
39884,CN2605300000000,26,53,"Gogebic County, MI",Mar-20,5922,5670,252,4.3
39885,CN2605500000000,26,55,"Grand Traverse County, MI",Mar-20,47905,46210,1695,3.5
39886,CN2605700000000,26,57,"Gratiot County, MI",Mar-20,17954,17278,676,3.8
39887,CN2605900000000,26,59,"Hillsdale County, MI",Mar-20,20022,19255,767,3.8
39888,CN2606100000000,26,61,"Houghton County, MI",Mar-20,16301,15574,727,4.5
39889,CN2606300000000,26,63,"Huron County, MI",Mar-20,14943,14281,662,4.4
39890,CN2606500000000,26,65,"Ingham County, MI",Mar-20,150764,146426,4338,2.9
39891,CN2606700000000,26,67,"Ionia County, MI",Mar-20,29970,29086,884,2.9
39892,CN2606900000000,26,69,"Iosco County, MI",Mar-20,9958,9297,661,6.6
39893,CN2607100000000,26,71,"Iron County, MI",Mar-20,5020,4718,302,6.0
39894,CN2607300000000,26,73,"Isabella County, MI",Mar-20,34263,32997,1266,3.7
39895,CN2607500000000,26,75,"Jackson County, MI",Mar-20,73061,70591,2470,3.4
39896,CN2607700000000,26,77,"Kalamazoo County, MI",Mar-20,131892,128173,3719,2.8
39897,CN2607900000000,26,79,"Kalkaska County, MI",Mar-20,7653,7192,461,6.0
39898,CN2608100000000,26,81,"Kent County, MI",Mar-20,356891,348007,8884,2.5
39899,CN2608300000000,26,83,"Keweenaw County, MI",Mar-20,881,830,51,5.8
39900,CN2608500000000,26,85,"Lake County, MI",Mar-20,3776,3566,210,5.6
39901,CN2608700000000,26,87,"Lapeer County, MI",Mar-20,41900,39147,2753,6.6
39902,CN2608900000000,26,89,"Leelanau County, MI",Mar-20,10138,9721,417,4.1
39903,CN2609100000000,26,91,"Lenawee County, MI",Mar-20,45671,44101,1570,3.4
39904,CN2609300000000,26,93,"Livingston County, MI",Mar-20,104406,100542,3864,3.7
39905,CN2609500000000,26,95,"Luce County, MI",Mar-20,2254,2123,131,5.8
39906,CN2609700000000,26,97,"Mackinac County, MI",Mar-20,4190,3484,706,16.8
39907,CN2609900000000,26,99,"Macomb County, MI",Mar-20,452204,431443,20761,4.6
39908,CN2610100000000,26,101,"Manistee County, MI",Mar-20,9949,9383,566,5.7
39909,CN2610300000000,26,103,"Marquette County, MI",Mar-20,32374,30899,1475,4.6
39910,CN2610500000000,26,105,"Mason County, MI",Mar-20,12956,12309,647,5.0
39911,CN2610700000000,26,107,"Mecosta County, MI",Mar-20,18105,17283,822,4.5
39912,CN2610900000000,26,109,"Menominee County, MI",Mar-20,10799,10394,405,3.8
39913,CN2611100000000,26,111,"Midland County, MI",Mar-20,39617,38137,1480,3.7
39914,CN2611300000000,26,113,"Missaukee County, MI",Mar-20,6817,6480,337,4.9
39915,CN2611500000000,26,115,"Monroe County, MI",Mar-20,73674,71280,2394,3.2
39916,CN2611700000000,26,117,"Montcalm County, MI",Mar-20,28037,27008,1029,3.7
39917,CN2611900000000,26,119,"Montmorency County, MI",Mar-20,2885,2636,249,8.6
39918,CN2612100000000,26,121,"Muskegon County, MI",Mar-20,75550,72568,2982,3.9
39919,CN2612300000000,26,123,"Newaygo County, MI",Mar-20,23088,22205,883,3.8
39920,CN2612500000000,26,125,"Oakland County, MI",Mar-20,680858,655986,24872,3.7
39921,CN2612700000000,26,127,"Oceana County, MI",Mar-20,11370,10662,708,6.2
39922,CN2612900000000,26,129,"Ogemaw County, MI",Mar-20,7668,7106,562,7.3
39923,CN2613100000000,26,131,"Ontonagon County, MI",Mar-20,2035,1895,140,6.9
39924,CN2613300000000,26,133,"Osceola County, MI",Mar-20,11251,10828,423,3.8
39925,CN2613500000000,26,135,"Oscoda County, MI",Mar-20,2888,2702,186,6.4
39926,CN2613700000000,26,137,"Otsego County, MI",Mar-20,11301,10735,566,5.0
39927,CN2613900000000,26,139,"Ottawa County, MI",Mar-20,159582,155773,3809,2.4
39928,CN2614100000000,26,141,"Presque Isle County, MI",Mar-20,4765,4332,433,9.1
39929,CN2614300000000,26,143,"Roscommon County, MI",Mar-20,7297,6718,579,7.9
39930,CN2614500000000,26,145,"Saginaw County, MI",Mar-20,85165,81504,3661,4.3
39931,CN2614700000000,26,147,"St. Clair County, MI",Mar-20,76716,72377,4339,5.7
39932,CN2614900000000,26,149,"St. Joseph County, MI",Mar-20,27046,26128,918,3.4
39933,CN2615100000000,26,151,"Sanilac County, MI",Mar-20,19046,18164,882,4.6
39934,CN2615300000000,26,153,"Schoolcraft County, MI",Mar-20,3188,2943,245,7.7
39935,CN2615500000000,26,155,"Shiawassee County, MI",Mar-20,33173,31913,1260,3.8
39936,CN2615700000000,26,157,"Tuscola County, MI",Mar-20,23625,22494,1131,4.8
39937,CN2615900000000,26,159,"Van Buren County, MI",Mar-20,34541,33086,1455,4.2
39938,CN2616100000000,26,161,"Washtenaw County, MI",Mar-20,198310,193724,4586,2.3
39939,CN2616300000000,26,163,"Wayne County, MI",Mar-20,808989,765197,43792,5.4
39940,CN2616500000000,26,165,"Wexford County, MI",Mar-20,14651,13982,669,4.6
39941,CN2700100000000,27,1,"Aitkin County, MN",Mar-20,7189,6670,519,7.2
39942,CN2700300000000,27,3,"Anoka County, MN",Mar-20,198612,192116,6496,3.3
39943,CN2700500000000,27,5,"Becker County, MN",Mar-20,18391,17513,878,4.8
39944,CN2700700000000,27,7,"Beltrami County, MN",Mar-20,24569,23433,1136,4.6
39945,CN2700900000000,27,9,"Benton County, MN",Mar-20,22230,21198,1032,4.6
39946,CN2701100000000,27,11,"Big Stone County, MN",Mar-20,2361,2226,135,5.7
39947,CN2701300000000,27,13,"Blue Earth County, MN",Mar-20,41446,40245,1201,2.9
39948,CN2701500000000,27,15,"Brown County, MN",Mar-20,14129,13487,642,4.5
39949,CN2701700000000,27,17,"Carlton County, MN",Mar-20,17844,16953,891,5.0
39950,CN2701900000000,27,19,"Carver County, MN",Mar-20,58556,56882,1674,2.9
39951,CN2702100000000,27,21,"Cass County, MN",Mar-20,13837,12865,972,7.0
39952,CN2702300000000,27,23,"Chippewa County, MN",Mar-20,6868,6596,272,4.0
39953,CN2702500000000,27,25,"Chisago County, MN",Mar-20,30272,28821,1451,4.8
39954,CN2702700000000,27,27,"Clay County, MN",Mar-20,36571,35357,1214,3.3
39955,CN2702900000000,27,29,"Clearwater County, MN",Mar-20,4492,4024,468,10.4
39956,CN2703100000000,27,31,"Cook County, MN",Mar-20,2878,2728,150,5.2
39957,CN2703300000000,27,33,"Cottonwood County, MN",Mar-20,5952,5740,212,3.6
39958,CN2703500000000,27,35,"Crow Wing County, MN",Mar-20,31712,30057,1655,5.2
39959,CN2703700000000,27,37,"Dakota County, MN",Mar-20,242629,235387,7242,3.0
39960,CN2703900000000,27,39,"Dodge County, MN",Mar-20,11816,11353,463,3.9
39961,CN2704100000000,27,41,"Douglas County, MN",Mar-20,20918,20164,754,3.6
39962,CN2704300000000,27,43,"Faribault County, MN",Mar-20,6775,6445,330,4.9
39963,CN2704500000000,27,45,"Fillmore County, MN",Mar-20,11371,10897,474,4.2
39964,CN2704700000000,27,47,"Freeborn County, MN",Mar-20,16110,15521,589,3.7
39965,CN2704900000000,27,49,"Goodhue County, MN",Mar-20,26992,26075,917,3.4
39966,CN2705100000000,27,51,"Grant County, MN",Mar-20,3184,3023,161,5.1
39967,CN2705300000000,27,53,"Hennepin County, MN",Mar-20,707798,688721,19077,2.7
39968,CN2705500000000,27,55,"Houston County, MN",Mar-20,10355,9958,397,3.8
39969,CN2705700000000,27,57,"Hubbard County, MN",Mar-20,9720,9109,611,6.3
39970,CN2705900000000,27,59,"Isanti County, MN",Mar-20,21554,20450,1104,5.1
39971,CN2706100000000,27,61,"Itasca County, MN",Mar-20,22216,20763,1453,6.5
39972,CN2706300000000,27,63,"Jackson County, MN",Mar-20,5598,5406,192,3.4
39973,CN2706500000000,27,65,"Kanabec County, MN",Mar-20,9083,8366,717,7.9
39974,CN2706700000000,27,67,"Kandiyohi County, MN",Mar-20,23934,22973,961,4.0
39975,CN2706900000000,27,69,"Kittson County, MN",Mar-20,2287,2198,89,3.9
39976,CN2707100000000,27,71,"Koochiching County, MN",Mar-20,5766,5401,365,6.3
39977,CN2707300000000,27,73,"Lac qui Parle County, MN",Mar-20,3472,3315,157,4.5
39978,CN2707500000000,27,75,"Lake County, MN",Mar-20,5349,5140,209,3.9
39979,CN2707700000000,27,77,"Lake of the Woods County, MN",Mar-20,2553,2462,91,3.6
39980,CN2707900000000,27,79,"Le Sueur County, MN",Mar-20,16248,15299,949,5.8
39981,CN2708100000000,27,81,"Lincoln County, MN",Mar-20,3108,2951,157,5.1
39982,CN2708300000000,27,83,"Lyon County, MN",Mar-20,14192,13686,506,3.6
39983,CN2708500000000,27,85,"McLeod County, MN",Mar-20,19042,18241,801,4.2
39984,CN2708700000000,27,87,"Mahnomen County, MN",Mar-20,2282,2146,136,6.0
39985,CN2708900000000,27,89,"Marshall County, MN",Mar-20,5258,4866,392,7.5
39986,CN2709100000000,27,91,"Martin County, MN",Mar-20,9676,9320,356,3.7
39987,CN2709300000000,27,93,"Meeker County, MN",Mar-20,13281,12666,615,4.6
39988,CN2709500000000,27,95,"Mille Lacs County, MN",Mar-20,13098,12201,897,6.8
39989,CN2709700000000,27,97,"Morrison County, MN",Mar-20,17317,16203,1114,6.4
39990,CN2709900000000,27,99,"Mower County, MN",Mar-20,20288,19618,670,3.3
39991,CN2710100000000,27,101,"Murray County, MN",Mar-20,4611,4355,256,5.6
39992,CN2710300000000,27,103,"Nicollet County, MN",Mar-20,21282,20722,560,2.6
39993,CN2710500000000,27,105,"Nobles County, MN",Mar-20,11031,10707,324,2.9
39994,CN2710700000000,27,107,"Norman County, MN",Mar-20,3109,2930,179,5.8
39995,CN2710900000000,27,109,"Olmsted County, MN",Mar-20,89006,86619,2387,2.7
39996,CN2711100000000,27,111,"Otter Tail County, MN",Mar-20,31063,29520,1543,5.0
39997,CN2711300000000,27,113,"Pennington County, MN",Mar-20,8667,8197,470,5.4
39998,CN2711500000000,27,115,"Pine County, MN",Mar-20,15078,14044,1034,6.9
39999,CN2711700000000,27,117,"Pipestone County, MN",Mar-20,4744,4540,204,4.3
40000,CN2711900000000,27,119,"Polk County, MN",Mar-20,16413,15660,753,4.6
40001,CN2712100000000,27,121,"Pope County, MN",Mar-20,6442,6224,218,3.4
40002,CN2712300000000,27,123,"Ramsey County, MN",Mar-20,290494,281678,8816,3.0
40003,CN2712500000000,27,125,"Red Lake County, MN",Mar-20,2170,2035,135,6.2
40004,CN2712700000000,27,127,"Redwood County, MN",Mar-20,7443,7135,308,4.1
40005,CN2712900000000,27,129,"Renville County, MN",Mar-20,8207,7745,462,5.6
40006,CN2713100000000,27,131,"Rice County, MN",Mar-20,37454,36129,1325,3.5
40007,CN2713300000000,27,133,"Rock County, MN",Mar-20,5485,5362,123,2.2
40008,CN2713500000000,27,135,"Roseau County, MN",Mar-20,7802,7512,290,3.7
40009,CN2713700000000,27,137,"St. Louis County, MN",Mar-20,101889,97555,4334,4.3
40010,CN2713900000000,27,139,"Scott County, MN",Mar-20,83845,81443,2402,2.9
40011,CN2714100000000,27,141,"Sherburne County, MN",Mar-20,52824,50674,2150,4.1
40012,CN2714300000000,27,143,"Sibley County, MN",Mar-20,8339,7975,364,4.4
40013,CN2714500000000,27,145,"Stearns County, MN",Mar-20,90963,87727,3236,3.6
40014,CN2714700000000,27,147,"Steele County, MN",Mar-20,21474,20752,722,3.4
40015,CN2714900000000,27,149,"Stevens County, MN",Mar-20,5217,5047,170,3.3
40016,CN2715100000000,27,151,"Swift County, MN",Mar-20,4729,4499,230,4.9
40017,CN2715300000000,27,153,"Todd County, MN",Mar-20,13459,12795,664,4.9
40018,CN2715500000000,27,155,"Traverse County, MN",Mar-20,1680,1596,84,5.0
40019,CN2715700000000,27,157,"Wabasha County, MN",Mar-20,12139,11656,483,4.0
40020,CN2715900000000,27,159,"Wadena County, MN",Mar-20,6013,5568,445,7.4
40021,CN2716100000000,27,161,"Waseca County, MN",Mar-20,8842,8413,429,4.9
40022,CN2716300000000,27,163,"Washington County, MN",Mar-20,143937,139623,4314,3.0
40023,CN2716500000000,27,165,"Watonwan County, MN",Mar-20,6240,5975,265,4.2
40024,CN2716700000000,27,167,"Wilkin County, MN",Mar-20,3342,3230,112,3.4
40025,CN2716900000000,27,169,"Winona County, MN",Mar-20,28753,27870,883,3.1
40026,CN2717100000000,27,171,"Wright County, MN",Mar-20,76026,73169,2857,3.8
40027,CN2717300000000,27,173,"Yellow Medicine County, MN",Mar-20,5210,5014,196,3.8
40028,CN2800100000000,28,1,"Adams County, MS",Mar-20,11240,10527,713,6.3
40029,CN2800300000000,28,3,"Alcorn County, MS",Mar-20,16167,15496,671,4.2
40030,CN2800500000000,28,5,"Amite County, MS",Mar-20,4473,4197,276,6.2
40031,CN2800700000000,28,7,"Attala County, MS",Mar-20,7049,6650,399,5.7
40032,CN2800900000000,28,9,"Benton County, MS",Mar-20,3013,2854,159,5.3
40033,CN2801100000000,28,11,"Bolivar County, MS",Mar-20,12206,11432,774,6.3
40034,CN2801300000000,28,13,"Calhoun County, MS",Mar-20,5744,5451,293,5.1
40035,CN2801500000000,28,15,"Carroll County, MS",Mar-20,3514,3315,199,5.7
40036,CN2801700000000,28,17,"Chickasaw County, MS",Mar-20,6847,6515,332,4.8
40037,CN2801900000000,28,19,"Choctaw County, MS",Mar-20,3727,3544,183,4.9
40038,CN2802100000000,28,21,"Claiborne County, MS",Mar-20,2974,2710,264,8.9
40039,CN2802300000000,28,23,"Clarke County, MS",Mar-20,5935,5599,336,5.7
40040,CN2802500000000,28,25,"Clay County, MS",Mar-20,7774,7254,520,6.7
40041,CN2802700000000,28,27,"Coahoma County, MS",Mar-20,8332,7748,584,7.0
40042,CN2802900000000,28,29,"Copiah County, MS",Mar-20,11073,10463,610,5.5
40043,CN2803100000000,28,31,"Covington County, MS",Mar-20,8112,7748,364,4.5
40044,CN2803300000000,28,33,"DeSoto County, MS",Mar-20,90323,86881,3442,3.8
40045,CN2803500000000,28,35,"Forrest County, MS",Mar-20,33359,31907,1452,4.4
40046,CN2803700000000,28,37,"Franklin County, MS",Mar-20,2788,2621,167,6.0
40047,CN2803900000000,28,39,"George County, MS",Mar-20,8836,8294,542,6.1
40048,CN2804100000000,28,41,"Greene County, MS",Mar-20,4390,4094,296,6.7
40049,CN2804300000000,28,43,"Grenada County, MS",Mar-20,9380,8963,417,4.4
40050,CN2804500000000,28,45,"Hancock County, MS",Mar-20,18728,17814,914,4.9
40051,CN2804700000000,28,47,"Harrison County, MS",Mar-20,86077,82136,3941,4.6
40052,CN2804900000000,28,49,"Hinds County, MS",Mar-20,105526,100501,5025,4.8
40053,CN2805100000000,28,51,"Holmes County, MS",Mar-20,5696,5204,492,8.6
40054,CN2805300000000,28,53,"Humphreys County, MS",Mar-20,2311,2088,223,9.6
40055,CN2805500000000,28,55,"Issaquena County, MS",Mar-20,389,358,31,8.0
40056,CN2805700000000,28,57,"Itawamba County, MS",Mar-20,10536,10091,445,4.2
40057,CN2805900000000,28,59,"Jackson County, MS",Mar-20,58106,55052,3054,5.3
40058,CN2806100000000,28,61,"Jasper County, MS",Mar-20,6188,5766,422,6.8
40059,CN2806300000000,28,63,"Jefferson County, MS",Mar-20,1950,1716,234,12.0
40060,CN2806500000000,28,65,"Jefferson Davis County, MS",Mar-20,4140,3886,254,6.1
40061,CN2806700000000,28,67,"Jones County, MS",Mar-20,26021,24761,1260,4.8
40062,CN2806900000000,28,69,"Kemper County, MS",Mar-20,3587,3325,262,7.3
40063,CN2807100000000,28,71,"Lafayette County, MS",Mar-20,28542,27465,1077,3.8
40064,CN2807300000000,28,73,"Lamar County, MS",Mar-20,30877,29699,1178,3.8
40065,CN2807500000000,28,75,"Lauderdale County, MS",Mar-20,30257,28858,1399,4.6
40066,CN2807700000000,28,77,"Lawrence County, MS",Mar-20,4572,4293,279,6.1
40067,CN2807900000000,28,79,"Leake County, MS",Mar-20,7976,7593,383,4.8
40068,CN2808100000000,28,81,"Lee County, MS",Mar-20,41009,39413,1596,3.9
40069,CN2808300000000,28,83,"Leflore County, MS",Mar-20,10039,9383,656,6.5
40070,CN2808500000000,28,85,"Lincoln County, MS",Mar-20,14482,13782,700,4.8
40071,CN2808700000000,28,87,"Lowndes County, MS",Mar-20,25184,23995,1189,4.7
40072,CN2808900000000,28,89,"Madison County, MS",Mar-20,52626,50539,2087,4.0
40073,CN2809100000000,28,91,"Marion County, MS",Mar-20,9975,9500,475,4.8
40074,CN2809300000000,28,93,"Marshall County, MS",Mar-20,14321,13640,681,4.8
40075,CN2809500000000,28,95,"Monroe County, MS",Mar-20,15529,14804,725,4.7
40076,CN2809700000000,28,97,"Montgomery County, MS",Mar-20,3934,3719,215,5.5
40077,CN2809900000000,28,99,"Neshoba County, MS",Mar-20,10250,9703,547,5.3
40078,CN2810100000000,28,101,"Newton County, MS",Mar-20,8877,8441,436,4.9
40079,CN2810300000000,28,103,"Noxubee County, MS",Mar-20,3838,3589,249,6.5
40080,CN2810500000000,28,105,"Oktibbeha County, MS",Mar-20,22027,20969,1058,4.8
40081,CN2810700000000,28,107,"Panola County, MS",Mar-20,12382,11666,716,5.8
40082,CN2810900000000,28,109,"Pearl River County, MS",Mar-20,23674,22604,1070,4.5
40083,CN2811100000000,28,111,"Perry County, MS",Mar-20,4326,4065,261,6.0
40084,CN2811300000000,28,113,"Pike County, MS",Mar-20,14537,13722,815,5.6
40085,CN2811500000000,28,115,"Pontotoc County, MS",Mar-20,14762,14203,559,3.8
40086,CN2811700000000,28,117,"Prentiss County, MS",Mar-20,11326,10819,507,4.5
40087,CN2811900000000,28,119,"Quitman County, MS",Mar-20,2399,2246,153,6.4
40088,CN2812100000000,28,121,"Rankin County, MS",Mar-20,75138,72492,2646,3.5
40089,CN2812300000000,28,123,"Scott County, MS",Mar-20,12723,12229,494,3.9
40090,CN2812500000000,28,125,"Sharkey County, MS",Mar-20,1635,1513,122,7.5
40091,CN2812700000000,28,127,"Simpson County, MS",Mar-20,10688,10175,513,4.8
40092,CN2812900000000,28,129,"Smith County, MS",Mar-20,6930,6607,323,4.7
40093,CN2813100000000,28,131,"Stone County, MS",Mar-20,6946,6557,389,5.6
40094,CN2813300000000,28,133,"Sunflower County, MS",Mar-20,7814,7192,622,8.0
40095,CN2813500000000,28,135,"Tallahatchie County, MS",Mar-20,5329,5042,287,5.4
40096,CN2813700000000,28,137,"Tate County, MS",Mar-20,12297,11715,582,4.7
40097,CN2813900000000,28,139,"Tippah County, MS",Mar-20,9394,8981,413,4.4
40098,CN2814100000000,28,141,"Tishomingo County, MS",Mar-20,8590,8177,413,4.8
40099,CN2814300000000,28,143,"Tunica County, MS",Mar-20,4455,4212,243,5.5
40100,CN2814500000000,28,145,"Union County, MS",Mar-20,14376,13835,541,3.8
40101,CN2814700000000,28,147,"Walthall County, MS",Mar-20,4823,4512,311,6.4
40102,CN2814900000000,28,149,"Warren County, MS",Mar-20,20031,19039,992,5.0
40103,CN2815100000000,28,151,"Washington County, MS",Mar-20,16951,15832,1119,6.6
40104,CN2815300000000,28,153,"Wayne County, MS",Mar-20,7553,7143,410,5.4
40105,CN2815500000000,28,155,"Webster County, MS",Mar-20,3981,3764,217,5.5
40106,CN2815700000000,28,157,"Wilkinson County, MS",Mar-20,2788,2546,242,8.7
40107,CN2815900000000,28,159,"Winston County, MS",Mar-20,7440,7038,402,5.4
40108,CN2816100000000,28,161,"Yalobusha County, MS",Mar-20,4932,4699,233,4.7
40109,CN2816300000000,28,163,"Yazoo County, MS",Mar-20,9403,8889,514,5.5
40110,CN2900100000000,29,1,"Adair County, MO",Mar-20,10400,9989,411,4.0
40111,CN2900300000000,29,3,"Andrew County, MO",Mar-20,9865,9538,327,3.3
40112,CN2900500000000,29,5,"Atchison County, MO",Mar-20,2769,2681,88,3.2
40113,CN2900700000000,29,7,"Audrain County, MO",Mar-20,10844,10444,400,3.7
40114,CN2900900000000,29,9,"Barry County, MO",Mar-20,16255,15401,854,5.3
40115,CN2901100000000,29,11,"Barton County, MO",Mar-20,5308,5102,206,3.9
40116,CN2901300000000,29,13,"Bates County, MO",Mar-20,8028,7650,378,4.7
40117,CN2901500000000,29,15,"Benton County, MO",Mar-20,7371,6944,427,5.8
40118,CN2901700000000,29,17,"Bollinger County, MO",Mar-20,5576,5339,237,4.3
40119,CN2901900000000,29,19,"Boone County, MO",Mar-20,100786,98180,2606,2.6
40120,CN2902100000000,29,21,"Buchanan County, MO",Mar-20,45170,43501,1669,3.7
40121,CN2902300000000,29,23,"Butler County, MO",Mar-20,18699,17755,944,5.0
40122,CN2902500000000,29,25,"Caldwell County, MO",Mar-20,4452,4266,186,4.2
40123,CN2902700000000,29,27,"Callaway County, MO",Mar-20,21597,20853,744,3.4
40124,CN2902900000000,29,29,"Camden County, MO",Mar-20,18536,17384,1152,6.2
40125,CN2903100000000,29,31,"Cape Girardeau County, MO",Mar-20,41710,40172,1538,3.7
40126,CN2903300000000,29,33,"Carroll County, MO",Mar-20,4847,4657,190,3.9
40127,CN2903500000000,29,35,"Carter County, MO",Mar-20,2627,2464,163,6.2
40128,CN2903700000000,29,37,"Cass County, MO",Mar-20,55668,53607,2061,3.7
40129,CN2903900000000,29,39,"Cedar County, MO",Mar-20,5940,5707,233,3.9
40130,CN2904100000000,29,41,"Chariton County, MO",Mar-20,3874,3719,155,4.0
40131,CN2904300000000,29,43,"Christian County, MO",Mar-20,46073,44563,1510,3.3
40132,CN2904500000000,29,45,"Clark County, MO",Mar-20,3269,3124,145,4.4
40133,CN2904700000000,29,47,"Clay County, MO",Mar-20,138243,133639,4604,3.3
40134,CN2904900000000,29,49,"Clinton County, MO",Mar-20,10871,10497,374,3.4
40135,CN2905100000000,29,51,"Cole County, MO",Mar-20,39443,38191,1252,3.2
40136,CN2905300000000,29,53,"Cooper County, MO",Mar-20,7542,7252,290,3.8
40137,CN2905500000000,29,55,"Crawford County, MO",Mar-20,11307,10739,568,5.0
40138,CN2905700000000,29,57,"Dade County, MO",Mar-20,3669,3526,143,3.9
40139,CN2905900000000,29,59,"Dallas County, MO",Mar-20,7214,6891,323,4.5
40140,CN2906100000000,29,61,"Daviess County, MO",Mar-20,4239,4084,155,3.7
40141,CN2906300000000,29,63,"DeKalb County, MO",Mar-20,4912,4720,192,3.9
40142,CN2906500000000,29,65,"Dent County, MO",Mar-20,6552,6280,272,4.2
40143,CN2906700000000,29,67,"Douglas County, MO",Mar-20,5220,4950,270,5.2
40144,CN2906900000000,29,69,"Dunklin County, MO",Mar-20,11937,11075,862,7.2
40145,CN2907100000000,29,71,"Franklin County, MO",Mar-20,54195,51948,2247,4.1
40146,CN2907300000000,29,73,"Gasconade County, MO",Mar-20,7865,7589,276,3.5
40147,CN2907500000000,29,75,"Gentry County, MO",Mar-20,3567,3461,106,3.0
40148,CN2907700000000,29,77,"Greene County, MO",Mar-20,155382,150267,5115,3.3
40149,CN2907900000000,29,79,"Grundy County, MO",Mar-20,4470,4317,153,3.4
40150,CN2908100000000,29,81,"Harrison County, MO",Mar-20,3978,3802,176,4.4
40151,CN2908300000000,29,83,"Henry County, MO",Mar-20,9999,9603,396,4.0
40152,CN2908500000000,29,85,"Hickory County, MO",Mar-20,3900,3708,192,4.9
40153,CN2908700000000,29,87,"Holt County, MO",Mar-20,2602,2533,69,2.7
40154,CN2908900000000,29,89,"Howard County, MO",Mar-20,4975,4818,157,3.2
40155,CN2909100000000,29,91,"Howell County, MO",Mar-20,16961,16213,748,4.4
40156,CN2909300000000,29,93,"Iron County, MO",Mar-20,3680,3443,237,6.4
40157,CN2909500000000,29,95,"Jackson County, MO",Mar-20,368459,352353,16106,4.4
40158,CN2909700000000,29,97,"Jasper County, MO",Mar-20,58158,56138,2020,3.5
40159,CN2909900000000,29,99,"Jefferson County, MO",Mar-20,120251,115406,4845,4.0
40160,CN2910100000000,29,101,"Johnson County, MO",Mar-20,24103,23063,1040,4.3
40161,CN2910300000000,29,103,"Knox County, MO",Mar-20,1806,1739,67,3.7
40162,CN2910500000000,29,105,"Laclede County, MO",Mar-20,17551,16493,1058,6.0
40163,CN2910700000000,29,107,"Lafayette County, MO",Mar-20,17116,16464,652,3.8
40164,CN2910900000000,29,109,"Lawrence County, MO",Mar-20,18677,17813,864,4.6
40165,CN2911100000000,29,111,"Lewis County, MO",Mar-20,5117,4935,182,3.6
40166,CN2911300000000,29,113,"Lincoln County, MO",Mar-20,28895,27739,1156,4.0
40167,CN2911500000000,29,115,"Linn County, MO",Mar-20,5268,4980,288,5.5
40168,CN2911700000000,29,117,"Livingston County, MO",Mar-20,7599,7374,225,3.0
40169,CN2911900000000,29,119,"McDonald County, MO",Mar-20,11123,10670,453,4.1
40170,CN2912100000000,29,121,"Macon County, MO",Mar-20,7745,7406,339,4.4
40171,CN2912300000000,29,123,"Madison County, MO",Mar-20,5757,5461,296,5.1
40172,CN2912500000000,29,125,"Maries County, MO",Mar-20,3983,3834,149,3.7
40173,CN2912700000000,29,127,"Marion County, MO",Mar-20,14820,14260,560,3.8
40174,CN2912900000000,29,129,"Mercer County, MO",Mar-20,1956,1887,69,3.5
40175,CN2913100000000,29,131,"Miller County, MO",Mar-20,12516,11779,737,5.9
40176,CN2913300000000,29,133,"Mississippi County, MO",Mar-20,5975,5660,315,5.3
40177,CN2913500000000,29,135,"Moniteau County, MO",Mar-20,7425,7145,280,3.8
40178,CN2913700000000,29,137,"Monroe County, MO",Mar-20,3852,3666,186,4.8
40179,CN2913900000000,29,139,"Montgomery County, MO",Mar-20,5906,5685,221,3.7
40180,CN2914100000000,29,141,"Morgan County, MO",Mar-20,8209,7760,449,5.5
40181,CN2914300000000,29,143,"New Madrid County, MO",Mar-20,8675,8226,449,5.2
40182,CN2914500000000,29,145,"Newton County, MO",Mar-20,27824,26770,1054,3.8
40183,CN2914700000000,29,147,"Nodaway County, MO",Mar-20,11435,11051,384,3.4
40184,CN2914900000000,29,149,"Oregon County, MO",Mar-20,4180,3943,237,5.7
40185,CN2915100000000,29,151,"Osage County, MO",Mar-20,7191,6972,219,3.0
40186,CN2915300000000,29,153,"Ozark County, MO",Mar-20,3520,3332,188,5.3
40187,CN2915500000000,29,155,"Pemiscot County, MO",Mar-20,6622,6230,392,5.9
40188,CN2915700000000,29,157,"Perry County, MO",Mar-20,10160,9845,315,3.1
40189,CN2915900000000,29,159,"Pettis County, MO",Mar-20,21910,20742,1168,5.3
40190,CN2916100000000,29,161,"Phelps County, MO",Mar-20,20383,19595,788,3.9
40191,CN2916300000000,29,163,"Pike County, MO",Mar-20,7738,7428,310,4.0
40192,CN2916500000000,29,165,"Platte County, MO",Mar-20,59422,57649,1773,3.0
40193,CN2916700000000,29,167,"Polk County, MO",Mar-20,14836,14319,517,3.5
40194,CN2916900000000,29,169,"Pulaski County, MO",Mar-20,15090,14453,637,4.2
40195,CN2917100000000,29,171,"Putnam County, MO",Mar-20,2316,2226,90,3.9
40196,CN2917300000000,29,173,"Ralls County, MO",Mar-20,5746,5548,198,3.4
40197,CN2917500000000,29,175,"Randolph County, MO",Mar-20,10694,10234,460,4.3
40198,CN2917700000000,29,177,"Ray County, MO",Mar-20,11136,10711,425,3.8
40199,CN2917900000000,29,179,"Reynolds County, MO",Mar-20,3051,2908,143,4.7
40200,CN2918100000000,29,181,"Ripley County, MO",Mar-20,5093,4840,253,5.0
40201,CN2918300000000,29,183,"St. Charles County, MO",Mar-20,230397,223260,7137,3.1
40202,CN2918500000000,29,185,"St. Clair County, MO",Mar-20,3839,3669,170,4.4
40203,CN2918600000000,29,186,"Ste. Genevieve County, MO",Mar-20,9407,9045,362,3.8
40204,CN2918700000000,29,187,"St. Francois County, MO",Mar-20,27443,26044,1399,5.1
40205,CN2918900000000,29,189,"St. Louis County, MO",Mar-20,540304,520981,19323,3.6
40206,CN2919500000000,29,195,"Saline County, MO",Mar-20,11194,10788,406,3.6
40207,CN2919700000000,29,197,"Schuyler County, MO",Mar-20,1971,1873,98,5.0
40208,CN2919900000000,29,199,"Scotland County, MO",Mar-20,2428,2350,78,3.2
40209,CN2920100000000,29,201,"Scott County, MO",Mar-20,20446,19545,901,4.4
40210,CN2920300000000,29,203,"Shannon County, MO",Mar-20,3339,3106,233,7.0
40211,CN2920500000000,29,205,"Shelby County, MO",Mar-20,3237,3080,157,4.9
40212,CN2920700000000,29,207,"Stoddard County, MO",Mar-20,13651,12885,766,5.6
40213,CN2920900000000,29,209,"Stone County, MO",Mar-20,13867,12899,968,7.0
40214,CN2921100000000,29,211,"Sullivan County, MO",Mar-20,2816,2679,137,4.9
40215,CN2921300000000,29,213,"Taney County, MO",Mar-20,27293,25189,2104,7.7
40216,CN2921500000000,29,215,"Texas County, MO",Mar-20,9131,8643,488,5.3
40217,CN2921700000000,29,217,"Vernon County, MO",Mar-20,9743,9365,378,3.9
40218,CN2921900000000,29,219,"Warren County, MO",Mar-20,18290,17596,694,3.8
40219,CN2922100000000,29,221,"Washington County, MO",Mar-20,10623,9980,643,6.1
40220,CN2922300000000,29,223,"Wayne County, MO",Mar-20,5236,4964,272,5.2
40221,CN2922500000000,29,225,"Webster County, MO",Mar-20,17714,17001,713,4.0
40222,CN2922700000000,29,227,"Worth County, MO",Mar-20,1187,1152,35,2.9
40223,CN2922900000000,29,229,"Wright County, MO",Mar-20,7630,7193,437,5.7
40224,CN2951000000000,29,510,"St. Louis city, MO",Mar-20,155432,148348,7084,4.6
40225,CN3000100000000,30,1,"Beaverhead County, MT",Mar-20,5095,4920,175,3.4
40226,CN3000300000000,30,3,"Big Horn County, MT",Mar-20,4755,4391,364,7.7
40227,CN3000500000000,30,5,"Blaine County, MT",Mar-20,2549,2441,108,4.2
40228,CN3000700000000,30,7,"Broadwater County, MT",Mar-20,2597,2468,129,5.0
40229,CN3000900000000,30,9,"Carbon County, MT",Mar-20,5515,5266,249,4.5
40230,CN3001100000000,30,11,"Carter County, MT",Mar-20,651,634,17,2.6
40231,CN3001300000000,30,13,"Cascade County, MT",Mar-20,37866,36434,1432,3.8
40232,CN3001500000000,30,15,"Chouteau County, MT",Mar-20,2479,2395,84,3.4
40233,CN3001700000000,30,17,"Custer County, MT",Mar-20,6062,5825,237,3.9
40234,CN3001900000000,30,19,"Daniels County, MT",Mar-20,898,870,28,3.1
40235,CN3002100000000,30,21,"Dawson County, MT",Mar-20,4558,4415,143,3.1
40236,CN3002300000000,30,23,"Deer Lodge County, MT",Mar-20,5053,4845,208,4.1
40237,CN3002500000000,30,25,"Fallon County, MT",Mar-20,1685,1645,40,2.4
40238,CN3002700000000,30,27,"Fergus County, MT",Mar-20,5898,5634,264,4.5
40239,CN3002900000000,30,29,"Flathead County, MT",Mar-20,48195,45236,2959,6.1
40240,CN3003100000000,30,31,"Gallatin County, MT",Mar-20,69133,67345,1788,2.6
40241,CN3003300000000,30,33,"Garfield County, MT",Mar-20,747,723,24,3.2
40242,CN3003500000000,30,35,"Glacier County, MT",Mar-20,5538,5090,448,8.1
40243,CN3003700000000,30,37,"Golden Valley County, MT",Mar-20,371,352,19,5.1
40244,CN3003900000000,30,39,"Granite County, MT",Mar-20,1771,1644,127,7.2
40245,CN3004100000000,30,41,"Hill County, MT",Mar-20,7618,7335,283,3.7
40246,CN3004300000000,30,43,"Jefferson County, MT",Mar-20,5753,5512,241,4.2
40247,CN3004500000000,30,45,"Judith Basin County, MT",Mar-20,1072,1029,43,4.0
40248,CN3004700000000,30,47,"Lake County, MT",Mar-20,13364,12669,695,5.2
40249,CN3004900000000,30,49,"Lewis and Clark County, MT",Mar-20,35991,34750,1241,3.4
40250,CN3005100000000,30,51,"Liberty County, MT",Mar-20,994,967,27,2.7
40251,CN3005300000000,30,53,"Lincoln County, MT",Mar-20,8088,7212,876,10.8
40252,CN3005500000000,30,55,"McCone County, MT",Mar-20,950,930,20,2.1
40253,CN3005700000000,30,57,"Madison County, MT",Mar-20,5397,5201,196,3.6
40254,CN3005900000000,30,59,"Meagher County, MT",Mar-20,993,961,32,3.2
40255,CN3006100000000,30,61,"Mineral County, MT",Mar-20,1785,1594,191,10.7
40256,CN3006300000000,30,63,"Missoula County, MT",Mar-20,64332,61734,2598,4.0
40257,CN3006500000000,30,65,"Musselshell County, MT",Mar-20,2263,2148,115,5.1
40258,CN3006700000000,30,67,"Park County, MT",Mar-20,8801,8382,419,4.8
40259,CN3006900000000,30,69,"Petroleum County, MT",Mar-20,280,269,11,3.9
40260,CN3007100000000,30,71,"Phillips County, MT",Mar-20,1900,1816,84,4.4
40261,CN3007300000000,30,73,"Pondera County, MT",Mar-20,2664,2561,103,3.9
40262,CN3007500000000,30,75,"Powder River County, MT",Mar-20,971,939,32,3.3
40263,CN3007700000000,30,77,"Powell County, MT",Mar-20,2874,2734,140,4.9
40264,CN3007900000000,30,79,"Prairie County, MT",Mar-20,477,454,23,4.8
40265,CN3008100000000,30,81,"Ravalli County, MT",Mar-20,20403,19408,995,4.9
40266,CN3008300000000,30,83,"Richland County, MT",Mar-20,5749,5557,192,3.3
40267,CN3008500000000,30,85,"Roosevelt County, MT",Mar-20,4427,4202,225,5.1
40268,CN3008700000000,30,87,"Rosebud County, MT",Mar-20,3754,3573,181,4.8
40269,CN3008900000000,30,89,"Sanders County, MT",Mar-20,4870,4507,363,7.5
40270,CN3009100000000,30,91,"Sheridan County, MT",Mar-20,1779,1722,57,3.2
40271,CN3009300000000,30,93,"Silver Bow County, MT",Mar-20,17067,16266,801,4.7
40272,CN3009500000000,30,95,"Stillwater County, MT",Mar-20,5401,5224,177,3.3
40273,CN3009700000000,30,97,"Sweet Grass County, MT",Mar-20,1806,1750,56,3.1
40274,CN3009900000000,30,99,"Teton County, MT",Mar-20,2758,2647,111,4.0
40275,CN3010100000000,30,101,"Toole County, MT",Mar-20,2100,2027,73,3.5
40276,CN3010300000000,30,103,"Treasure County, MT",Mar-20,341,333,8,2.3
40277,CN3010500000000,30,105,"Valley County, MT",Mar-20,4069,3914,155,3.8
40278,CN3010700000000,30,107,"Wheatland County, MT",Mar-20,796,756,40,5.0
40279,CN3010900000000,30,109,"Wibaux County, MT",Mar-20,444,427,17,3.8
40280,CN3011100000000,30,111,"Yellowstone County, MT",Mar-20,81396,78417,2979,3.7
40281,CN3100100000000,31,1,"Adams County, NE",Mar-20,16954,16223,731,4.3
40282,CN3100300000000,31,3,"Antelope County, NE",Mar-20,3705,3578,127,3.4
40283,CN3100500000000,31,5,"Arthur County, NE",Mar-20,243,227,16,6.6
40284,CN3100700000000,31,7,"Banner County, NE",Mar-20,403,385,18,4.5
40285,CN3100900000000,31,9,"Blaine County, NE",Mar-20,285,267,18,6.3
40286,CN3101100000000,31,11,"Boone County, NE",Mar-20,3082,2973,109,3.5
40287,CN3101300000000,31,13,"Box Butte County, NE",Mar-20,5445,5190,255,4.7
40288,CN3101500000000,31,15,"Boyd County, NE",Mar-20,1147,1103,44,3.8
40289,CN3101700000000,31,17,"Brown County, NE",Mar-20,1436,1376,60,4.2
40290,CN3101900000000,31,19,"Buffalo County, NE",Mar-20,27863,26859,1004,3.6
40291,CN3102100000000,31,21,"Burt County, NE",Mar-20,3559,3372,187,5.3
40292,CN3102300000000,31,23,"Butler County, NE",Mar-20,4636,4443,193,4.2
40293,CN3102500000000,31,25,"Cass County, NE",Mar-20,13966,13280,686,4.9
40294,CN3102700000000,31,27,"Cedar County, NE",Mar-20,4643,4474,169,3.6
40295,CN3102900000000,31,29,"Chase County, NE",Mar-20,2389,2318,71,3.0
40296,CN3103100000000,31,31,"Cherry County, NE",Mar-20,3499,3384,115,3.3
40297,CN3103300000000,31,33,"Cheyenne County, NE",Mar-20,4368,4153,215,4.9
40298,CN3103500000000,31,35,"Clay County, NE",Mar-20,3402,3255,147,4.3
40299,CN3103700000000,31,37,"Colfax County, NE",Mar-20,5676,5476,200,3.5
40300,CN3103900000000,31,39,"Cuming County, NE",Mar-20,4826,4646,180,3.7
40301,CN3104100000000,31,41,"Custer County, NE",Mar-20,6627,6414,213,3.2
40302,CN3104300000000,31,43,"Dakota County, NE",Mar-20,10995,10384,611,5.6
40303,CN3104500000000,31,45,"Dawes County, NE",Mar-20,5052,4865,187,3.7
40304,CN3104700000000,31,47,"Dawson County, NE",Mar-20,13425,12899,526,3.9
40305,CN3104900000000,31,49,"Deuel County, NE",Mar-20,983,941,42,4.3
40306,CN3105100000000,31,51,"Dixon County, NE",Mar-20,3151,3007,144,4.6
40307,CN3105300000000,31,53,"Dodge County, NE",Mar-20,19899,19057,842,4.2
40308,CN3105500000000,31,55,"Douglas County, NE",Mar-20,306479,292228,14251,4.6
40309,CN3105700000000,31,57,"Dundy County, NE",Mar-20,1238,1198,40,3.2
40310,CN3105900000000,31,59,"Fillmore County, NE",Mar-20,3222,3104,118,3.7
40311,CN3106100000000,31,61,"Franklin County, NE",Mar-20,1511,1451,60,4.0
40312,CN3106300000000,31,63,"Frontier County, NE",Mar-20,1706,1628,78,4.6
40313,CN3106500000000,31,65,"Furnas County, NE",Mar-20,2642,2542,100,3.8
40314,CN3106700000000,31,67,"Gage County, NE",Mar-20,11271,10749,522,4.6
40315,CN3106900000000,31,69,"Garden County, NE",Mar-20,1131,1069,62,5.5
40316,CN3107100000000,31,71,"Garfield County, NE",Mar-20,1180,1140,40,3.4
40317,CN3107300000000,31,73,"Gosper County, NE",Mar-20,1127,1089,38,3.4
40318,CN3107500000000,31,75,"Grant County, NE",Mar-20,452,439,13,2.9
40319,CN3107700000000,31,77,"Greeley County, NE",Mar-20,1284,1231,53,4.1
40320,CN3107900000000,31,79,"Hall County, NE",Mar-20,32165,30601,1564,4.9
40321,CN3108100000000,31,81,"Hamilton County, NE",Mar-20,4870,4663,207,4.3
40322,CN3108300000000,31,83,"Harlan County, NE",Mar-20,1838,1760,78,4.2
40323,CN3108500000000,31,85,"Hayes County, NE",Mar-20,659,635,24,3.6
40324,CN3108700000000,31,87,"Hitchcock County, NE",Mar-20,1304,1244,60,4.6
40325,CN3108900000000,31,89,"Holt County, NE",Mar-20,5991,5793,198,3.3
40326,CN3109100000000,31,91,"Hooker County, NE",Mar-20,403,385,18,4.5
40327,CN3109300000000,31,93,"Howard County, NE",Mar-20,3410,3270,140,4.1
40328,CN3109500000000,31,95,"Jefferson County, NE",Mar-20,4273,4126,147,3.4
40329,CN3109700000000,31,97,"Johnson County, NE",Mar-20,2126,2026,100,4.7
40330,CN3109900000000,31,99,"Kearney County, NE",Mar-20,3899,3772,127,3.3
40331,CN3110100000000,31,101,"Keith County, NE",Mar-20,4577,4393,184,4.0
40332,CN3110300000000,31,103,"Keya Paha County, NE",Mar-20,648,628,20,3.1
40333,CN3110500000000,31,105,"Kimball County, NE",Mar-20,2061,1974,87,4.2
40334,CN3110700000000,31,107,"Knox County, NE",Mar-20,4789,4589,200,4.2
40335,CN3110900000000,31,109,"Lancaster County, NE",Mar-20,182330,175602,6728,3.7
40336,CN3111100000000,31,111,"Lincoln County, NE",Mar-20,18580,17756,824,4.4
40337,CN3111300000000,31,113,"Logan County, NE",Mar-20,497,479,18,3.6
40338,CN3111500000000,31,115,"Loup County, NE",Mar-20,433,413,20,4.6
40339,CN3111700000000,31,117,"McPherson County, NE",Mar-20,465,445,20,4.3
40340,CN3111900000000,31,119,"Madison County, NE",Mar-20,20095,19289,806,4.0
40341,CN3112100000000,31,121,"Merrick County, NE",Mar-20,4067,3918,149,3.7
40342,CN3112300000000,31,123,"Morrill County, NE",Mar-20,2722,2598,124,4.6
40343,CN3112500000000,31,125,"Nance County, NE",Mar-20,2051,1967,84,4.1
40344,CN3112700000000,31,127,"Nemaha County, NE",Mar-20,3713,3555,158,4.3
40345,CN3112900000000,31,129,"Nuckolls County, NE",Mar-20,2520,2413,107,4.2
40346,CN3113100000000,31,131,"Otoe County, NE",Mar-20,8674,8319,355,4.1
40347,CN3113300000000,31,133,"Pawnee County, NE",Mar-20,1528,1475,53,3.5
40348,CN3113500000000,31,135,"Perkins County, NE",Mar-20,1885,1829,56,3.0
40349,CN3113700000000,31,137,"Phelps County, NE",Mar-20,5134,4970,164,3.2
40350,CN3113900000000,31,139,"Pierce County, NE",Mar-20,4179,4024,155,3.7
40351,CN3114100000000,31,141,"Platte County, NE",Mar-20,17991,17307,684,3.8
40352,CN3114300000000,31,143,"Polk County, NE",Mar-20,3048,2933,115,3.8
40353,CN3114500000000,31,145,"Red Willow County, NE",Mar-20,5985,5765,220,3.7
40354,CN3114700000000,31,147,"Richardson County, NE",Mar-20,4350,4175,175,4.0
40355,CN3114900000000,31,149,"Rock County, NE",Mar-20,922,891,31,3.4
40356,CN3115100000000,31,151,"Saline County, NE",Mar-20,7627,7263,364,4.8
40357,CN3115300000000,31,153,"Sarpy County, NE",Mar-20,98595,94579,4016,4.1
40358,CN3115500000000,31,155,"Saunders County, NE",Mar-20,11475,11024,451,3.9
40359,CN3115700000000,31,157,"Scotts Bluff County, NE",Mar-20,18321,17426,895,4.9
40360,CN3115900000000,31,159,"Seward County, NE",Mar-20,9300,8922,378,4.1
40361,CN3116100000000,31,161,"Sheridan County, NE",Mar-20,2775,2673,102,3.7
40362,CN3116300000000,31,163,"Sherman County, NE",Mar-20,1726,1664,62,3.6
40363,CN3116500000000,31,165,"Sioux County, NE",Mar-20,772,745,27,3.5
40364,CN3116700000000,31,167,"Stanton County, NE",Mar-20,3607,3463,144,4.0
40365,CN3116900000000,31,169,"Thayer County, NE",Mar-20,2848,2748,100,3.5
40366,CN3117100000000,31,171,"Thomas County, NE",Mar-20,460,427,33,7.2
40367,CN3117300000000,31,173,"Thurston County, NE",Mar-20,3178,3023,155,4.9
40368,CN3117500000000,31,175,"Valley County, NE",Mar-20,2182,2098,84,3.8
40369,CN3117700000000,31,177,"Washington County, NE",Mar-20,11588,11102,486,4.2
40370,CN3117900000000,31,179,"Wayne County, NE",Mar-20,6047,5820,227,3.8
40371,CN3118100000000,31,181,"Webster County, NE",Mar-20,1742,1658,84,4.8
40372,CN3118300000000,31,183,"Wheeler County, NE",Mar-20,607,589,18,3.0
40373,CN3118500000000,31,185,"York County, NE",Mar-20,7376,7107,269,3.6
40374,CN3200100000000,32,1,"Churchill County, NV",Mar-20,11478,10783,695,6.1
40375,CN3200300000000,32,3,"Clark County, NV",Mar-20,1143825,1061723,82102,7.2
40376,CN3200500000000,32,5,"Douglas County, NV",Mar-20,23445,21847,1598,6.8
40377,CN3200700000000,32,7,"Elko County, NV",Mar-20,27343,25942,1401,5.1
40378,CN3200900000000,32,9,"Esmeralda County, NV",Mar-20,461,434,27,5.9
40379,CN3201100000000,32,11,"Eureka County, NV",Mar-20,1177,1130,47,4.0
40380,CN3201300000000,32,13,"Humboldt County, NV",Mar-20,8501,8062,439,5.2
40381,CN3201500000000,32,15,"Lander County, NV",Mar-20,3284,3092,192,5.8
40382,CN3201700000000,32,17,"Lincoln County, NV",Mar-20,2203,2068,135,6.1
40383,CN3201900000000,32,19,"Lyon County, NV",Mar-20,23918,21967,1951,8.2
40384,CN3202100000000,32,21,"Mineral County, NV",Mar-20,2104,1969,135,6.4
40385,CN3202300000000,32,23,"Nye County, NV",Mar-20,18014,16509,1505,8.4
40386,CN3202700000000,32,27,"Pershing County, NV",Mar-20,2709,2527,182,6.7
40387,CN3202900000000,32,29,"Storey County, NV",Mar-20,2065,1933,132,6.4
40388,CN3203100000000,32,31,"Washoe County, NV",Mar-20,259454,244886,14568,5.6
40389,CN3203300000000,32,33,"White Pine County, NV",Mar-20,4725,4478,247,5.2
40390,CN3251000000000,32,510,"Carson City, NV",Mar-20,26797,24900,1897,7.1
40391,CN3300100000000,33,1,"Belknap County, NH",Mar-20,30332,29447,885,2.9
40392,CN3300300000000,33,3,"Carroll County, NH",Mar-20,23041,22362,679,2.9
40393,CN3300500000000,33,5,"Cheshire County, NH",Mar-20,40444,39326,1118,2.8
40394,CN3300700000000,33,7,"Coos County, NH",Mar-20,14255,13745,510,3.6
40395,CN3300900000000,33,9,"Grafton County, NH",Mar-20,49741,48605,1136,2.3
40396,CN3301100000000,33,11,"Hillsborough County, NH",Mar-20,241765,234897,6868,2.8
40397,CN3301300000000,33,13,"Merrimack County, NH",Mar-20,82924,80949,1975,2.4
40398,CN3301500000000,33,15,"Rockingham County, NH",Mar-20,185243,179699,5544,3.0
40399,CN3301700000000,33,17,"Strafford County, NH",Mar-20,73866,72052,1814,2.5
40400,CN3301900000000,33,19,"Sullivan County, NH",Mar-20,22595,22049,546,2.4
40401,CN3400100000000,34,1,"Atlantic County, NJ",Mar-20,120344,113532,6812,5.7
40402,CN3400300000000,34,3,"Bergen County, NJ",Mar-20,494799,480046,14753,3.0
40403,CN3400500000000,34,5,"Burlington County, NJ",Mar-20,236872,229286,7586,3.2
40404,CN3400700000000,34,7,"Camden County, NJ",Mar-20,260261,249933,10328,4.0
40405,CN3400900000000,34,9,"Cape May County, NJ",Mar-20,41426,36903,4523,10.9
40406,CN3401100000000,34,11,"Cumberland County, NJ",Mar-20,66372,62405,3967,6.0
40407,CN3401300000000,34,13,"Essex County, NJ",Mar-20,373831,356621,17210,4.6
40408,CN3401500000000,34,15,"Gloucester County, NJ",Mar-20,154124,148401,5723,3.7
40409,CN3401700000000,34,17,"Hudson County, NJ",Mar-20,370880,358576,12304,3.3
40410,CN3401900000000,34,19,"Hunterdon County, NJ",Mar-20,65151,63250,1901,2.9
40411,CN3402100000000,34,21,"Mercer County, NJ",Mar-20,208308,201768,6540,3.1
40412,CN3402300000000,34,23,"Middlesex County, NJ",Mar-20,441081,427153,13928,3.2
40413,CN3402500000000,34,25,"Monmouth County, NJ",Mar-20,330098,319208,10890,3.3
40414,CN3402700000000,34,27,"Morris County, NJ",Mar-20,259899,252406,7493,2.9
40415,CN3402900000000,34,29,"Ocean County, NJ",Mar-20,276776,265826,10950,4.0
40416,CN3403100000000,34,31,"Passaic County, NJ",Mar-20,249188,237780,11408,4.6
40417,CN3403300000000,34,33,"Salem County, NJ",Mar-20,29909,28389,1520,5.1
40418,CN3403500000000,34,35,"Somerset County, NJ",Mar-20,173473,168167,5306,3.1
40419,CN3403700000000,34,37,"Sussex County, NJ",Mar-20,75027,72114,2913,3.9
40420,CN3403900000000,34,39,"Union County, NJ",Mar-20,280328,269468,10860,3.9
40421,CN3404100000000,34,41,"Warren County, NJ",Mar-20,57388,55337,2051,3.6
40422,CN3500100000000,35,1,"Bernalillo County, NM",Mar-20,335193,316658,18535,5.5
40423,CN3500300000000,35,3,"Catron County, NM",Mar-20,1105,1002,103,9.3
40424,CN3500500000000,35,5,"Chaves County, NM",Mar-20,27446,25764,1682,6.1
40425,CN3500600000000,35,6,"Cibola County, NM",Mar-20,9070,8365,705,7.8
40426,CN3500700000000,35,7,"Colfax County, NM",Mar-20,5289,4987,302,5.7
40427,CN3500900000000,35,9,"Curry County, NM",Mar-20,21650,20599,1051,4.9
40428,CN3501100000000,35,11,"De Baca County, NM",Mar-20,704,666,38,5.4
40429,CN3501300000000,35,13,"Dona Ana County, NM",Mar-20,99588,91727,7861,7.9
40430,CN3501500000000,35,15,"Eddy County, NM",Mar-20,36485,35071,1414,3.9
40431,CN3501700000000,35,17,"Grant County, NM",Mar-20,12228,11519,709,5.8
40432,CN3501900000000,35,19,"Guadalupe County, NM",Mar-20,1477,1390,87,5.9
40433,CN3502100000000,35,21,"Harding County, NM",Mar-20,283,269,14,4.9
40434,CN3502300000000,35,23,"Hidalgo County, NM",Mar-20,2021,1904,117,5.8
40435,CN3502500000000,35,25,"Lea County, NM",Mar-20,32632,30906,1726,5.3
40436,CN3502700000000,35,27,"Lincoln County, NM",Mar-20,8738,8204,534,6.1
40437,CN3502800000000,35,28,"Los Alamos County, NM",Mar-20,9481,9114,367,3.9
40438,CN3502900000000,35,29,"Luna County, NM",Mar-20,10809,8547,2262,20.9
40439,CN3503100000000,35,31,"McKinley County, NM",Mar-20,24580,22459,2121,8.6
40440,CN3503300000000,35,33,"Mora County, NM",Mar-20,2091,1910,181,8.7
40441,CN3503500000000,35,35,"Otero County, NM",Mar-20,24979,23479,1500,6.0
40442,CN3503700000000,35,37,"Quay County, NM",Mar-20,3161,2962,199,6.3
40443,CN3503900000000,35,39,"Rio Arriba County, NM",Mar-20,16771,15607,1164,6.9
40444,CN3504100000000,35,41,"Roosevelt County, NM",Mar-20,8034,7561,473,5.9
40445,CN3504300000000,35,43,"Sandoval County, NM",Mar-20,66413,62490,3923,5.9
40446,CN3504500000000,35,45,"San Juan County, NM",Mar-20,51977,47965,4012,7.7
40447,CN3504700000000,35,47,"San Miguel County, NM",Mar-20,11132,10343,789,7.1
40448,CN3504900000000,35,49,"Santa Fe County, NM",Mar-20,75958,72309,3649,4.8
40449,CN3505100000000,35,51,"Sierra County, NM",Mar-20,3824,3433,391,10.2
40450,CN3505300000000,35,53,"Socorro County, NM",Mar-20,6341,5922,419,6.6
40451,CN3505500000000,35,55,"Taos County, NM",Mar-20,15655,14501,1154,7.4
40452,CN3505700000000,35,57,"Torrance County, NM",Mar-20,5458,5005,453,8.3
40453,CN3505900000000,35,59,"Union County, NM",Mar-20,1681,1596,85,5.1
40454,CN3506100000000,35,61,"Valencia County, NM",Mar-20,30744,28718,2026,6.6
40455,CN3600100000000,36,1,"Albany County, NY",Mar-20,159471,153548,5923,3.7
40456,CN3600300000000,36,3,"Allegany County, NY",Mar-20,19963,18700,1263,6.3
40457,CN3600500000000,36,5,"Bronx County, NY",Mar-20,583312,551402,31910,5.5
40458,CN3600700000000,36,7,"Broome County, NY",Mar-20,84103,79559,4544,5.4
40459,CN3600900000000,36,9,"Cattaraugus County, NY",Mar-20,34580,32397,2183,6.3
40460,CN3601100000000,36,11,"Cayuga County, NY",Mar-20,35218,33411,1807,5.1
40461,CN3601300000000,36,13,"Chautauqua County, NY",Mar-20,54544,51368,3176,5.8
40462,CN3601500000000,36,15,"Chemung County, NY",Mar-20,35286,33612,1674,4.7
40463,CN3601700000000,36,17,"Chenango County, NY",Mar-20,21873,20651,1222,5.6
40464,CN3601900000000,36,19,"Clinton County, NY",Mar-20,36224,34330,1894,5.2
40465,CN3602100000000,36,21,"Columbia County, NY",Mar-20,30547,29375,1172,3.8
40466,CN3602300000000,36,23,"Cortland County, NY",Mar-20,23175,21836,1339,5.8
40467,CN3602500000000,36,25,"Delaware County, NY",Mar-20,18724,17694,1030,5.5
40468,CN3602700000000,36,27,"Dutchess County, NY",Mar-20,144688,139125,5563,3.8
40469,CN3602900000000,36,29,"Erie County, NY",Mar-20,442848,421689,21159,4.8
40470,CN3603100000000,36,31,"Essex County, NY",Mar-20,17211,16138,1073,6.2
40471,CN3603300000000,36,33,"Franklin County, NY",Mar-20,19640,18493,1147,5.8
40472,CN3603500000000,36,35,"Fulton County, NY",Mar-20,22861,21526,1335,5.8
40473,CN3603700000000,36,37,"Genesee County, NY",Mar-20,29251,27807,1444,4.9
40474,CN3603900000000,36,39,"Greene County, NY",Mar-20,20602,19578,1024,5.0
40475,CN3604100000000,36,41,"Hamilton County, NY",Mar-20,2112,1917,195,9.2
40476,CN3604300000000,36,43,"Herkimer County, NY",Mar-20,27882,26235,1647,5.9
40477,CN3604500000000,36,45,"Jefferson County, NY",Mar-20,43619,40495,3124,7.2
40478,CN3604700000000,36,47,"Kings County, NY",Mar-20,1171517,1122762,48755,4.2
40479,CN3604900000000,36,49,"Lewis County, NY",Mar-20,11599,10724,875,7.5
40480,CN3605100000000,36,51,"Livingston County, NY",Mar-20,30558,29063,1495,4.9
40481,CN3605300000000,36,53,"Madison County, NY",Mar-20,32704,30963,1741,5.3
40482,CN3605500000000,36,55,"Monroe County, NY",Mar-20,363028,346904,16124,4.4
40483,CN3605700000000,36,57,"Montgomery County, NY",Mar-20,22243,20864,1379,6.2
40484,CN3605900000000,36,59,"Nassau County, NY",Mar-20,707360,682024,25336,3.6
40485,CN3606100000000,36,61,"New York County, NY",Mar-20,892124,859612,32512,3.6
40486,CN3606300000000,36,63,"Niagara County, NY",Mar-20,99331,93454,5877,5.9
40487,CN3606500000000,36,65,"Oneida County, NY",Mar-20,100750,96046,4704,4.7
40488,CN3606700000000,36,67,"Onondaga County, NY",Mar-20,221594,212063,9531,4.3
40489,CN3606900000000,36,69,"Ontario County, NY",Mar-20,55555,53009,2546,4.6
40490,CN3607100000000,36,71,"Orange County, NY",Mar-20,183813,176253,7560,4.1
40491,CN3607300000000,36,73,"Orleans County, NY",Mar-20,17311,16376,935,5.4
40492,CN3607500000000,36,75,"Oswego County, NY",Mar-20,53297,49999,3298,6.2
40493,CN3607700000000,36,77,"Otsego County, NY",Mar-20,27972,26523,1449,5.2
40494,CN3607900000000,36,79,"Putnam County, NY",Mar-20,51666,49594,2072,4.0
40495,CN3608100000000,36,81,"Queens County, NY",Mar-20,1113178,1073696,39482,3.5
40496,CN3608300000000,36,83,"Rensselaer County, NY",Mar-20,82364,78948,3416,4.1
40497,CN3608500000000,36,85,"Richmond County, NY",Mar-20,216525,208215,8310,3.8
40498,CN3608700000000,36,87,"Rockland County, NY",Mar-20,155070,149347,5723,3.7
40499,CN3608900000000,36,89,"St. Lawrence County, NY",Mar-20,43664,40898,2766,6.3
40500,CN3609100000000,36,91,"Saratoga County, NY",Mar-20,120700,116249,4451,3.7
40501,CN3609300000000,36,93,"Schenectady County, NY",Mar-20,77148,74008,3140,4.1
40502,CN3609500000000,36,95,"Schoharie County, NY",Mar-20,14780,13928,852,5.8
40503,CN3609700000000,36,97,"Schuyler County, NY",Mar-20,7935,7425,510,6.4
40504,CN3609900000000,36,99,"Seneca County, NY",Mar-20,15950,15179,771,4.8
40505,CN3610100000000,36,101,"Steuben County, NY",Mar-20,42076,39827,2249,5.3
40506,CN3610300000000,36,103,"Suffolk County, NY",Mar-20,777487,745919,31568,4.1
40507,CN3610500000000,36,105,"Sullivan County, NY",Mar-20,36917,35214,1703,4.6
40508,CN3610700000000,36,107,"Tioga County, NY",Mar-20,22817,21654,1163,5.1
40509,CN3610900000000,36,109,"Tompkins County, NY",Mar-20,49865,48118,1747,3.5
40510,CN3611100000000,36,111,"Ulster County, NY",Mar-20,88609,84988,3621,4.1
40511,CN3611300000000,36,113,"Warren County, NY",Mar-20,31146,29370,1776,5.7
40512,CN3611500000000,36,115,"Washington County, NY",Mar-20,27205,25872,1333,4.9
40513,CN3611700000000,36,117,"Wayne County, NY",Mar-20,43643,41478,2165,5.0
40514,CN3611900000000,36,119,"Westchester County, NY",Mar-20,485174,465825,19349,4.0
40515,CN3612100000000,36,121,"Wyoming County, NY",Mar-20,17600,16531,1069,6.1
40516,CN3612300000000,36,123,"Yates County, NY",Mar-20,11625,11044,581,5.0
40517,CN3700100000000,37,1,"Alamance County, NC",Mar-20,81202,77849,3353,4.1
40518,CN3700300000000,37,3,"Alexander County, NC",Mar-20,17731,17109,622,3.5
40519,CN3700500000000,37,5,"Alleghany County, NC",Mar-20,4304,4047,257,6.0
40520,CN3700700000000,37,7,"Anson County, NC",Mar-20,10728,10190,538,5.0
40521,CN3700900000000,37,9,"Ashe County, NC",Mar-20,12562,12001,561,4.5
40522,CN3701100000000,37,11,"Avery County, NC",Mar-20,7337,7014,323,4.4
40523,CN3701300000000,37,13,"Beaufort County, NC",Mar-20,19231,18269,962,5.0
40524,CN3701500000000,37,15,"Bertie County, NC",Mar-20,7669,7222,447,5.8
40525,CN3701700000000,37,17,"Bladen County, NC",Mar-20,14566,13781,785,5.4
40526,CN3701900000000,37,19,"Brunswick County, NC",Mar-20,52764,49706,3058,5.8
40527,CN3702100000000,37,21,"Buncombe County, NC",Mar-20,137859,133117,4742,3.4
40528,CN3702300000000,37,23,"Burke County, NC",Mar-20,40394,38733,1661,4.1
40529,CN3702500000000,37,25,"Cabarrus County, NC",Mar-20,108115,103871,4244,3.9
40530,CN3702700000000,37,27,"Caldwell County, NC",Mar-20,35955,34432,1523,4.2
40531,CN3702900000000,37,29,"Camden County, NC",Mar-20,4574,4380,194,4.2
40532,CN3703100000000,37,31,"Carteret County, NC",Mar-20,31105,29645,1460,4.7
40533,CN3703300000000,37,33,"Caswell County, NC",Mar-20,9790,9292,498,5.1
40534,CN3703500000000,37,35,"Catawba County, NC",Mar-20,77841,74739,3102,4.0
40535,CN3703700000000,37,37,"Chatham County, NC",Mar-20,35286,33969,1317,3.7
40536,CN3703900000000,37,39,"Cherokee County, NC",Mar-20,11216,10672,544,4.9
40537,CN3704100000000,37,41,"Chowan County, NC",Mar-20,5477,5224,253,4.6
40538,CN3704300000000,37,43,"Clay County, NC",Mar-20,4155,3950,205,4.9
40539,CN3704500000000,37,45,"Cleveland County, NC",Mar-20,48269,46037,2232,4.6
40540,CN3704700000000,37,47,"Columbus County, NC",Mar-20,22986,21747,1239,5.4
40541,CN3704900000000,37,49,"Craven County, NC",Mar-20,40896,39126,1770,4.3
40542,CN3705100000000,37,51,"Cumberland County, NC",Mar-20,125807,118757,7050,5.6
40543,CN3705300000000,37,53,"Currituck County, NC",Mar-20,13770,13192,578,4.2
40544,CN3705500000000,37,55,"Dare County, NC",Mar-20,17684,16346,1338,7.6
40545,CN3705700000000,37,57,"Davidson County, NC",Mar-20,79795,76406,3389,4.2
40546,CN3705900000000,37,59,"Davie County, NC",Mar-20,20343,19571,772,3.8
40547,CN3706100000000,37,61,"Duplin County, NC",Mar-20,24978,23868,1110,4.4
40548,CN3706300000000,37,63,"Durham County, NC",Mar-20,169900,163679,6221,3.7
40549,CN3706500000000,37,65,"Edgecombe County, NC",Mar-20,20806,19506,1300,6.2
40550,CN3706700000000,37,67,"Forsyth County, NC",Mar-20,184933,177364,7569,4.1
40551,CN3706900000000,37,69,"Franklin County, NC",Mar-20,31215,29837,1378,4.4
40552,CN3707100000000,37,71,"Gaston County, NC",Mar-20,110369,105467,4902,4.4
40553,CN3707300000000,37,73,"Gates County, NC",Mar-20,5237,4994,243,4.6
40554,CN3707500000000,37,75,"Graham County, NC",Mar-20,3167,2969,198,6.3
40555,CN3707700000000,37,77,"Granville County, NC",Mar-20,29948,28851,1097,3.7
40556,CN3707900000000,37,79,"Greene County, NC",Mar-20,9495,9115,380,4.0
40557,CN3708100000000,37,81,"Guilford County, NC",Mar-20,258519,246928,11591,4.5
40558,CN3708300000000,37,83,"Halifax County, NC",Mar-20,20239,18926,1313,6.5
40559,CN3708500000000,37,85,"Harnett County, NC",Mar-20,52972,50400,2572,4.9
40560,CN3708700000000,37,87,"Haywood County, NC",Mar-20,29449,28291,1158,3.9
40561,CN3708900000000,37,89,"Henderson County, NC",Mar-20,54101,52080,2021,3.7
40562,CN3709100000000,37,91,"Hertford County, NC",Mar-20,9063,8550,513,5.7
40563,CN3709300000000,37,93,"Hoke County, NC",Mar-20,19802,18732,1070,5.4
40564,CN3709500000000,37,95,"Hyde County, NC",Mar-20,1844,1614,230,12.5
40565,CN3709700000000,37,97,"Iredell County, NC",Mar-20,88762,85183,3579,4.0
40566,CN3709900000000,37,99,"Jackson County, NC",Mar-20,20247,19337,910,4.5
40567,CN3710100000000,37,101,"Johnston County, NC",Mar-20,98716,94814,3902,4.0
40568,CN3710300000000,37,103,"Jones County, NC",Mar-20,4305,4128,177,4.1
40569,CN3710500000000,37,105,"Lee County, NC",Mar-20,25911,24704,1207,4.7
40570,CN3710700000000,37,107,"Lenoir County, NC",Mar-20,27627,26487,1140,4.1
40571,CN3710900000000,37,109,"Lincoln County, NC",Mar-20,43074,41367,1707,4.0
40572,CN3711100000000,37,111,"McDowell County, NC",Mar-20,20270,19386,884,4.4
40573,CN3711300000000,37,113,"Macon County, NC",Mar-20,15132,14453,679,4.5
40574,CN3711500000000,37,115,"Madison County, NC",Mar-20,9990,9581,409,4.1
40575,CN3711700000000,37,117,"Martin County, NC",Mar-20,8996,8515,481,5.3
40576,CN3711900000000,37,119,"Mecklenburg County, NC",Mar-20,616239,591550,24689,4.0
40577,CN3712100000000,37,121,"Mitchell County, NC",Mar-20,5927,5611,316,5.3
40578,CN3712300000000,37,123,"Montgomery County, NC",Mar-20,11271,10781,490,4.3
40579,CN3712500000000,37,125,"Moore County, NC",Mar-20,41880,40164,1716,4.1
40580,CN3712700000000,37,127,"Nash County, NC",Mar-20,42279,40101,2178,5.2
40581,CN3712900000000,37,129,"New Hanover County, NC",Mar-20,121467,116687,4780,3.9
40582,CN3713100000000,37,131,"Northampton County, NC",Mar-20,7699,7228,471,6.1
40583,CN3713300000000,37,133,"Onslow County, NC",Mar-20,64589,61434,3155,4.9
40584,CN3713500000000,37,135,"Orange County, NC",Mar-20,78075,75355,2720,3.5
40585,CN3713700000000,37,137,"Pamlico County, NC",Mar-20,5241,5022,219,4.2
40586,CN3713900000000,37,139,"Pasquotank County, NC",Mar-20,16489,15655,834,5.1
40587,CN3714100000000,37,141,"Pender County, NC",Mar-20,28314,27080,1234,4.4
40588,CN3714300000000,37,143,"Perquimans County, NC",Mar-20,4890,4620,270,5.5
40589,CN3714500000000,37,145,"Person County, NC",Mar-20,18297,17493,804,4.4
40590,CN3714700000000,37,147,"Pitt County, NC",Mar-20,88929,84979,3950,4.4
40591,CN3714900000000,37,149,"Polk County, NC",Mar-20,8779,8418,361,4.1
40592,CN3715100000000,37,151,"Randolph County, NC",Mar-20,65274,62529,2745,4.2
40593,CN3715300000000,37,153,"Richmond County, NC",Mar-20,16352,15385,967,5.9
40594,CN3715500000000,37,155,"Robeson County, NC",Mar-20,49308,46369,2939,6.0
40595,CN3715700000000,37,157,"Rockingham County, NC",Mar-20,39546,37619,1927,4.9
40596,CN3715900000000,37,159,"Rowan County, NC",Mar-20,65662,62723,2939,4.5
40597,CN3716100000000,37,161,"Rutherford County, NC",Mar-20,24872,23456,1416,5.7
40598,CN3716300000000,37,163,"Sampson County, NC",Mar-20,29077,27824,1253,4.3
40599,CN3716500000000,37,165,"Scotland County, NC",Mar-20,11514,10647,867,7.5
40600,CN3716700000000,37,167,"Stanly County, NC",Mar-20,29893,28597,1296,4.3
40601,CN3716900000000,37,169,"Stokes County, NC",Mar-20,21377,20501,876,4.1
40602,CN3717100000000,37,171,"Surry County, NC",Mar-20,33133,31711,1422,4.3
40603,CN3717300000000,37,173,"Swain County, NC",Mar-20,6893,6545,348,5.0
40604,CN3717500000000,37,175,"Transylvania County, NC",Mar-20,14262,13669,593,4.2
40605,CN3717700000000,37,177,"Tyrrell County, NC",Mar-20,1315,1214,101,7.7
40606,CN3717900000000,37,179,"Union County, NC",Mar-20,122685,117954,4731,3.9
40607,CN3718100000000,37,181,"Vance County, NC",Mar-20,17338,16275,1063,6.1
40608,CN3718300000000,37,183,"Wake County, NC",Mar-20,593306,571732,21574,3.6
40609,CN3718500000000,37,185,"Warren County, NC",Mar-20,6535,6124,411,6.3
40610,CN3718700000000,37,187,"Washington County, NC",Mar-20,4400,4083,317,7.2
40611,CN3718900000000,37,189,"Watauga County, NC",Mar-20,28390,27308,1082,3.8
40612,CN3719100000000,37,191,"Wayne County, NC",Mar-20,50874,48568,2306,4.5
40613,CN3719300000000,37,193,"Wilkes County, NC",Mar-20,28687,27345,1342,4.7
40614,CN3719500000000,37,195,"Wilson County, NC",Mar-20,34068,31977,2091,6.1
40615,CN3719700000000,37,197,"Yadkin County, NC",Mar-20,17488,16802,686,3.9
40616,CN3719900000000,37,199,"Yancey County, NC",Mar-20,8327,7954,373,4.5
40617,CN3800100000000,38,1,"Adams County, ND",Mar-20,1059,1033,26,2.5
40618,CN3800300000000,38,3,"Barnes County, ND",Mar-20,5152,5024,128,2.5
40619,CN3800500000000,38,5,"Benson County, ND",Mar-20,2340,2227,113,4.8
40620,CN3800700000000,38,7,"Billings County, ND",Mar-20,370,359,11,3.0
40621,CN3800900000000,38,9,"Bottineau County, ND",Mar-20,2878,2757,121,4.2
40622,CN3801100000000,38,11,"Bowman County, ND",Mar-20,1616,1585,31,1.9
40623,CN3801300000000,38,13,"Burke County, ND",Mar-20,1040,1006,34,3.3
40624,CN3801500000000,38,15,"Burleigh County, ND",Mar-20,49057,47748,1309,2.7
40625,CN3801700000000,38,17,"Cass County, ND",Mar-20,102982,100654,2328,2.3
40626,CN3801900000000,38,19,"Cavalier County, ND",Mar-20,1892,1834,58,3.1
40627,CN3802100000000,38,21,"Dickey County, ND",Mar-20,2287,2246,41,1.8
40628,CN3802300000000,38,23,"Divide County, ND",Mar-20,1381,1364,17,1.2
40629,CN3802500000000,38,25,"Dunn County, ND",Mar-20,3352,3300,52,1.6
40630,CN3802700000000,38,27,"Eddy County, ND",Mar-20,1222,1169,53,4.3
40631,CN3802900000000,38,29,"Emmons County, ND",Mar-20,1452,1370,82,5.6
40632,CN3803100000000,38,31,"Foster County, ND",Mar-20,1491,1446,45,3.0
40633,CN3803300000000,38,33,"Golden Valley County, ND",Mar-20,837,823,14,1.7
40634,CN3803500000000,38,35,"Grand Forks County, ND",Mar-20,37068,36169,899,2.4
40635,CN3803700000000,38,37,"Grant County, ND",Mar-20,1208,1188,20,1.7
40636,CN3803900000000,38,39,"Griggs County, ND",Mar-20,1034,1008,26,2.5
40637,CN3804100000000,38,41,"Hettinger County, ND",Mar-20,1388,1347,41,3.0
40638,CN3804300000000,38,43,"Kidder County, ND",Mar-20,1273,1217,56,4.4
40639,CN3804500000000,38,45,"LaMoure County, ND",Mar-20,2046,2007,39,1.9
40640,CN3804700000000,38,47,"Logan County, ND",Mar-20,886,864,22,2.5
40641,CN3804900000000,38,49,"McHenry County, ND",Mar-20,3106,2961,145,4.7
40642,CN3805100000000,38,51,"McIntosh County, ND",Mar-20,1116,1081,35,3.1
40643,CN3805300000000,38,53,"McKenzie County, ND",Mar-20,9844,9605,239,2.4
40644,CN3805500000000,38,55,"McLean County, ND",Mar-20,4681,4498,183,3.9
40645,CN3805700000000,38,57,"Mercer County, ND",Mar-20,3480,3328,152,4.4
40646,CN3805900000000,38,59,"Morton County, ND",Mar-20,16225,15672,553,3.4
40647,CN3806100000000,38,61,"Mountrail County, ND",Mar-20,7340,7228,112,1.5
40648,CN3806300000000,38,63,"Nelson County, ND",Mar-20,1372,1320,52,3.8
40649,CN3806500000000,38,65,"Oliver County, ND",Mar-20,872,832,40,4.6
40650,CN3806700000000,38,67,"Pembina County, ND",Mar-20,3294,3161,133,4.0
40651,CN3806900000000,38,69,"Pierce County, ND",Mar-20,1672,1609,63,3.8
40652,CN3807100000000,38,71,"Ramsey County, ND",Mar-20,5517,5345,172,3.1
40653,CN3807300000000,38,73,"Ransom County, ND",Mar-20,2797,2745,52,1.9
40654,CN3807500000000,38,75,"Renville County, ND",Mar-20,1211,1171,40,3.3
40655,CN3807700000000,38,77,"Richland County, ND",Mar-20,8534,8341,193,2.3
40656,CN3807900000000,38,79,"Rolette County, ND",Mar-20,4570,4171,399,8.7
40657,CN3808100000000,38,81,"Sargent County, ND",Mar-20,2710,2665,45,1.7
40658,CN3808300000000,38,83,"Sheridan County, ND",Mar-20,677,633,44,6.5
40659,CN3808500000000,38,85,"Sioux County, ND",Mar-20,1217,1183,34,2.8
40660,CN3808700000000,38,87,"Slope County, ND",Mar-20,390,383,7,1.8
40661,CN3808900000000,38,89,"Stark County, ND",Mar-20,18438,17999,439,2.4
40662,CN3809100000000,38,91,"Steele County, ND",Mar-20,984,969,15,1.5
40663,CN3809300000000,38,93,"Stutsman County, ND",Mar-20,10316,10074,242,2.3
40664,CN3809500000000,38,95,"Towner County, ND",Mar-20,1093,1071,22,2.0
40665,CN3809700000000,38,97,"Traill County, ND",Mar-20,4401,4252,149,3.4
40666,CN3809900000000,38,99,"Walsh County, ND",Mar-20,5082,4912,170,3.3
40667,CN3810100000000,38,101,"Ward County, ND",Mar-20,31329,30414,915,2.9
40668,CN3810300000000,38,103,"Wells County, ND",Mar-20,1927,1839,88,4.6
40669,CN3810500000000,38,105,"Williams County, ND",Mar-20,23212,22705,507,2.2
40670,CN3900100000000,39,1,"Adams County, OH",Mar-20,10801,9813,988,9.1
40671,CN3900300000000,39,3,"Allen County, OH",Mar-20,47532,44944,2588,5.4
40672,CN3900500000000,39,5,"Ashland County, OH",Mar-20,27043,25670,1373,5.1
40673,CN3900700000000,39,7,"Ashtabula County, OH",Mar-20,44063,41266,2797,6.3
40674,CN3900900000000,39,9,"Athens County, OH",Mar-20,29178,27446,1732,5.9
40675,CN3901100000000,39,11,"Auglaize County, OH",Mar-20,24861,23906,955,3.8
40676,CN3901300000000,39,13,"Belmont County, OH",Mar-20,29740,27287,2453,8.2
40677,CN3901500000000,39,15,"Brown County, OH",Mar-20,19598,18306,1292,6.6
40678,CN3901700000000,39,17,"Butler County, OH",Mar-20,193121,184551,8570,4.4
40679,CN3901900000000,39,19,"Carroll County, OH",Mar-20,13001,12087,914,7.0
40680,CN3902100000000,39,21,"Champaign County, OH",Mar-20,20128,19211,917,4.6
40681,CN3902300000000,39,23,"Clark County, OH",Mar-20,63706,60324,3382,5.3
40682,CN3902500000000,39,25,"Clermont County, OH",Mar-20,105793,101013,4780,4.5
40683,CN3902700000000,39,27,"Clinton County, OH",Mar-20,17932,16910,1022,5.7
40684,CN3902900000000,39,29,"Columbiana County, OH",Mar-20,47059,44018,3041,6.5
40685,CN3903100000000,39,31,"Coshocton County, OH",Mar-20,14142,13050,1092,7.7
40686,CN3903300000000,39,33,"Crawford County, OH",Mar-20,18131,17073,1058,5.8
40687,CN3903500000000,39,35,"Cuyahoga County, OH",Mar-20,589480,546884,42596,7.2
40688,CN3903700000000,39,37,"Darke County, OH",Mar-20,25844,24598,1246,4.8
40689,CN3903900000000,39,39,"Defiance County, OH",Mar-20,17817,16939,878,4.9
40690,CN3904100000000,39,41,"Delaware County, OH",Mar-20,109842,105935,3907,3.6
40691,CN3904300000000,39,43,"Erie County, OH",Mar-20,35147,32836,2311,6.6
40692,CN3904500000000,39,45,"Fairfield County, OH",Mar-20,78080,74635,3445,4.4
40693,CN3904700000000,39,47,"Fayette County, OH",Mar-20,13912,13238,674,4.8
40694,CN3904900000000,39,49,"Franklin County, OH",Mar-20,695289,667221,28068,4.0
40695,CN3905100000000,39,51,"Fulton County, OH",Mar-20,22513,21240,1273,5.7
40696,CN3905300000000,39,53,"Gallia County, OH",Mar-20,12331,11426,905,7.3
40697,CN3905500000000,39,55,"Geauga County, OH",Mar-20,47256,44181,3075,6.5
40698,CN3905700000000,39,57,"Greene County, OH",Mar-20,83048,79551,3497,4.2
40699,CN3905900000000,39,59,"Guernsey County, OH",Mar-20,18524,17088,1436,7.8
40700,CN3906100000000,39,61,"Hamilton County, OH",Mar-20,411045,393058,17987,4.4
40701,CN3906300000000,39,63,"Hancock County, OH",Mar-20,41576,40003,1573,3.8
40702,CN3906500000000,39,65,"Hardin County, OH",Mar-20,13793,13081,712,5.2
40703,CN3906700000000,39,67,"Harrison County, OH",Mar-20,6659,6116,543,8.2
40704,CN3906900000000,39,69,"Henry County, OH",Mar-20,13181,12313,868,6.6
40705,CN3907100000000,39,71,"Highland County, OH",Mar-20,17138,15995,1143,6.7
40706,CN3907300000000,39,73,"Hocking County, OH",Mar-20,13141,12361,780,5.9
40707,CN3907500000000,39,75,"Holmes County, OH",Mar-20,20637,19889,748,3.6
40708,CN3907700000000,39,77,"Huron County, OH",Mar-20,27932,25561,2371,8.5
40709,CN3907900000000,39,79,"Jackson County, OH",Mar-20,12806,11690,1116,8.7
40710,CN3908100000000,39,81,"Jefferson County, OH",Mar-20,27447,25362,2085,7.6
40711,CN3908300000000,39,83,"Knox County, OH",Mar-20,31521,29999,1522,4.8
40712,CN3908500000000,39,85,"Lake County, OH",Mar-20,121865,113460,8405,6.9
40713,CN3908700000000,39,87,"Lawrence County, OH",Mar-20,23840,22416,1424,6.0
40714,CN3908900000000,39,89,"Licking County, OH",Mar-20,90564,86499,4065,4.5
40715,CN3909100000000,39,91,"Logan County, OH",Mar-20,22864,21830,1034,4.5
40716,CN3909300000000,39,93,"Lorain County, OH",Mar-20,148866,137342,11524,7.7
40717,CN3909500000000,39,95,"Lucas County, OH",Mar-20,208122,196422,11700,5.6
40718,CN3909700000000,39,97,"Madison County, OH",Mar-20,20909,20072,837,4.0
40719,CN3909900000000,39,99,"Mahoning County, OH",Mar-20,101167,94134,7033,7.0
40720,CN3910100000000,39,101,"Marion County, OH",Mar-20,27961,26689,1272,4.5
40721,CN3910300000000,39,103,"Medina County, OH",Mar-20,93681,87932,5749,6.1
40722,CN3910500000000,39,105,"Meigs County, OH",Mar-20,9170,8309,861,9.4
40723,CN3910700000000,39,107,"Mercer County, OH",Mar-20,23136,22368,768,3.3
40724,CN3910900000000,39,109,"Miami County, OH",Mar-20,54235,51815,2420,4.5
40725,CN3911100000000,39,111,"Monroe County, OH",Mar-20,5420,4778,642,11.8
40726,CN3911300000000,39,113,"Montgomery County, OH",Mar-20,251917,239835,12082,4.8
40727,CN3911500000000,39,115,"Morgan County, OH",Mar-20,6812,6150,662,9.7
40728,CN3911700000000,39,117,"Morrow County, OH",Mar-20,16891,16003,888,5.3
40729,CN3911900000000,39,119,"Muskingum County, OH",Mar-20,39536,36873,2663,6.7
40730,CN3912100000000,39,121,"Noble County, OH",Mar-20,4692,4240,452,9.6
40731,CN3912300000000,39,123,"Ottawa County, OH",Mar-20,20117,18373,1744,8.7
40732,CN3912500000000,39,125,"Paulding County, OH",Mar-20,8533,8136,397,4.7
40733,CN3912700000000,39,127,"Perry County, OH",Mar-20,16149,15009,1140,7.1
40734,CN3912900000000,39,129,"Pickaway County, OH",Mar-20,26608,25278,1330,5.0
40735,CN3913100000000,39,131,"Pike County, OH",Mar-20,10854,9943,911,8.4
40736,CN3913300000000,39,133,"Portage County, OH",Mar-20,86216,81485,4731,5.5
40737,CN3913500000000,39,135,"Preble County, OH",Mar-20,21017,19997,1020,4.9
40738,CN3913700000000,39,137,"Putnam County, OH",Mar-20,18692,17959,733,3.9
40739,CN3913900000000,39,139,"Richland County, OH",Mar-20,51428,48498,2930,5.7
40740,CN3914100000000,39,141,"Ross County, OH",Mar-20,35481,33431,2050,5.8
40741,CN3914300000000,39,143,"Sandusky County, OH",Mar-20,30141,28512,1629,5.4
40742,CN3914500000000,39,145,"Scioto County, OH",Mar-20,29010,26720,2290,7.9
40743,CN3914700000000,39,147,"Seneca County, OH",Mar-20,27103,25734,1369,5.1
40744,CN3914900000000,39,149,"Shelby County, OH",Mar-20,23695,22644,1051,4.4
40745,CN3915100000000,39,151,"Stark County, OH",Mar-20,184139,173495,10644,5.8
40746,CN3915300000000,39,153,"Summit County, OH",Mar-20,268292,253944,14348,5.3
40747,CN3915500000000,39,155,"Trumbull County, OH",Mar-20,85070,78828,6242,7.3
40748,CN3915700000000,39,157,"Tuscarawas County, OH",Mar-20,44389,41763,2626,5.9
40749,CN3915900000000,39,159,"Union County, OH",Mar-20,28973,27922,1051,3.6
40750,CN3916100000000,39,161,"Van Wert County, OH",Mar-20,15060,14434,626,4.2
40751,CN3916300000000,39,163,"Vinton County, OH",Mar-20,5688,5181,507,8.9
40752,CN3916500000000,39,165,"Warren County, OH",Mar-20,117783,112996,4787,4.1
40753,CN3916700000000,39,167,"Washington County, OH",Mar-20,27274,25350,1924,7.1
40754,CN3916900000000,39,169,"Wayne County, OH",Mar-20,62625,60219,2406,3.8
40755,CN3917100000000,39,171,"Williams County, OH",Mar-20,18716,17922,794,4.2
40756,CN3917300000000,39,173,"Wood County, OH",Mar-20,70331,67283,3048,4.3
40757,CN3917500000000,39,175,"Wyandot County, OH",Mar-20,13049,12541,508,3.9
40758,CN4000100000000,40,1,"Adair County, OK",Mar-20,8057,7753,304,3.8
40759,CN4000300000000,40,3,"Alfalfa County, OK",Mar-20,2698,2643,55,2.0
40760,CN4000500000000,40,5,"Atoka County, OK",Mar-20,4940,4729,211,4.3
40761,CN4000700000000,40,7,"Beaver County, OK",Mar-20,2786,2736,50,1.8
40762,CN4000900000000,40,9,"Beckham County, OK",Mar-20,9524,9127,397,4.2
40763,CN4001100000000,40,11,"Blaine County, OK",Mar-20,4579,4468,111,2.4
40764,CN4001300000000,40,13,"Bryan County, OK",Mar-20,21600,21015,585,2.7
40765,CN4001500000000,40,15,"Caddo County, OK",Mar-20,11733,11335,398,3.4
40766,CN4001700000000,40,17,"Canadian County, OK",Mar-20,73832,71856,1976,2.7
40767,CN4001900000000,40,19,"Carter County, OK",Mar-20,21031,20377,654,3.1
40768,CN4002100000000,40,21,"Cherokee County, OK",Mar-20,18823,18166,657,3.5
40769,CN4002300000000,40,23,"Choctaw County, OK",Mar-20,5391,5136,255,4.7
40770,CN4002500000000,40,25,"Cimarron County, OK",Mar-20,1327,1306,21,1.6
40771,CN4002700000000,40,27,"Cleveland County, OK",Mar-20,141716,138239,3477,2.5
40772,CN4002900000000,40,29,"Coal County, OK",Mar-20,2409,2304,105,4.4
40773,CN4003100000000,40,31,"Comanche County, OK",Mar-20,47990,46572,1418,3.0
40774,CN4003300000000,40,33,"Cotton County, OK",Mar-20,2713,2638,75,2.8
40775,CN4003500000000,40,35,"Craig County, OK",Mar-20,5770,5579,191,3.3
40776,CN4003700000000,40,37,"Creek County, OK",Mar-20,31298,30277,1021,3.3
40777,CN4003900000000,40,39,"Custer County, OK",Mar-20,15610,15193,417,2.7
40778,CN4004100000000,40,41,"Delaware County, OK",Mar-20,18313,17709,604,3.3
40779,CN4004300000000,40,43,"Dewey County, OK",Mar-20,2914,2852,62,2.1
40780,CN4004500000000,40,45,"Ellis County, OK",Mar-20,2057,2005,52,2.5
40781,CN4004700000000,40,47,"Garfield County, OK",Mar-20,26378,25581,797,3.0
40782,CN4004900000000,40,49,"Garvin County, OK",Mar-20,12392,11974,418,3.4
40783,CN4005100000000,40,51,"Grady County, OK",Mar-20,26355,25552,803,3.0
40784,CN4005300000000,40,53,"Grant County, OK",Mar-20,2591,2534,57,2.2
40785,CN4005500000000,40,55,"Greer County, OK",Mar-20,1792,1730,62,3.5
40786,CN4005700000000,40,57,"Harmon County, OK",Mar-20,1192,1162,30,2.5
40787,CN4005900000000,40,59,"Harper County, OK",Mar-20,1730,1687,43,2.5
40788,CN4006100000000,40,61,"Haskell County, OK",Mar-20,4205,3987,218,5.2
40789,CN4006300000000,40,63,"Hughes County, OK",Mar-20,5350,5099,251,4.7
40790,CN4006500000000,40,65,"Jackson County, OK",Mar-20,10782,10509,273,2.5
40791,CN4006700000000,40,67,"Jefferson County, OK",Mar-20,2474,2395,79,3.2
40792,CN4006900000000,40,69,"Johnston County, OK",Mar-20,3232,3070,162,5.0
40793,CN4007100000000,40,71,"Kay County, OK",Mar-20,17901,17220,681,3.8
40794,CN4007300000000,40,73,"Kingfisher County, OK",Mar-20,8831,8644,187,2.1
40795,CN4007500000000,40,75,"Kiowa County, OK",Mar-20,3337,3240,97,2.9
40796,CN4007700000000,40,77,"Latimer County, OK",Mar-20,3090,2884,206,6.7
40797,CN4007900000000,40,79,"Le Flore County, OK",Mar-20,18765,18018,747,4.0
40798,CN4008100000000,40,81,"Lincoln County, OK",Mar-20,15647,15149,498,3.2
40799,CN4008300000000,40,83,"Logan County, OK",Mar-20,21948,21360,588,2.7
40800,CN4008500000000,40,85,"Love County, OK",Mar-20,6096,5967,129,2.1
40801,CN4008700000000,40,87,"McClain County, OK",Mar-20,19506,19009,497,2.5
40802,CN4008900000000,40,89,"McCurtain County, OK",Mar-20,14812,14180,632,4.3
40803,CN4009100000000,40,91,"McIntosh County, OK",Mar-20,7260,6869,391,5.4
40804,CN4009300000000,40,93,"Major County, OK",Mar-20,3737,3659,78,2.1
40805,CN4009500000000,40,95,"Marshall County, OK",Mar-20,6940,6701,239,3.4
40806,CN4009700000000,40,97,"Mayes County, OK",Mar-20,19393,18874,519,2.7
40807,CN4009900000000,40,99,"Murray County, OK",Mar-20,6334,6154,180,2.8
40808,CN4010100000000,40,101,"Muskogee County, OK",Mar-20,29851,28845,1006,3.4
40809,CN4010300000000,40,103,"Noble County, OK",Mar-20,5587,5455,132,2.4
40810,CN4010500000000,40,105,"Nowata County, OK",Mar-20,4589,4459,130,2.8
40811,CN4010700000000,40,107,"Okfuskee County, OK",Mar-20,4535,4324,211,4.7
40812,CN4010900000000,40,109,"Oklahoma County, OK",Mar-20,381427,371135,10292,2.7
40813,CN4011100000000,40,111,"Okmulgee County, OK",Mar-20,15523,14855,668,4.3
40814,CN4011300000000,40,113,"Osage County, OK",Mar-20,20531,19809,722,3.5
40815,CN4011500000000,40,115,"Ottawa County, OK",Mar-20,14407,14002,405,2.8
40816,CN4011700000000,40,117,"Pawnee County, OK",Mar-20,7279,7029,250,3.4
40817,CN4011900000000,40,119,"Payne County, OK",Mar-20,38184,37199,985,2.6
40818,CN4012100000000,40,121,"Pittsburg County, OK",Mar-20,16898,16203,695,4.1
40819,CN4012300000000,40,123,"Pontotoc County, OK",Mar-20,19173,18674,499,2.6
40820,CN4012500000000,40,125,"Pottawatomie County, OK",Mar-20,32278,31281,997,3.1
40821,CN4012700000000,40,127,"Pushmataha County, OK",Mar-20,4242,4037,205,4.8
40822,CN4012900000000,40,129,"Roger Mills County, OK",Mar-20,1800,1745,55,3.1
40823,CN4013100000000,40,131,"Rogers County, OK",Mar-20,44750,43518,1232,2.8
40824,CN4013300000000,40,133,"Seminole County, OK",Mar-20,9484,9080,404,4.3
40825,CN4013500000000,40,135,"Sequoyah County, OK",Mar-20,15998,15392,606,3.8
40826,CN4013700000000,40,137,"Stephens County, OK",Mar-20,18501,17773,728,3.9
40827,CN4013900000000,40,139,"Texas County, OK",Mar-20,11843,11635,208,1.8
40828,CN4014100000000,40,141,"Tillman County, OK",Mar-20,2978,2886,92,3.1
40829,CN4014300000000,40,143,"Tulsa County, OK",Mar-20,320615,311483,9132,2.8
40830,CN4014500000000,40,145,"Wagoner County, OK",Mar-20,37678,36588,1090,2.9
40831,CN4014700000000,40,147,"Washington County, OK",Mar-20,22020,21344,676,3.1
40832,CN4014900000000,40,149,"Washita County, OK",Mar-20,4999,4815,184,3.7
40833,CN4015100000000,40,151,"Woods County, OK",Mar-20,4623,4537,86,1.9
40834,CN4015300000000,40,153,"Woodward County, OK",Mar-20,8667,8389,278,3.2
40835,CN4100100000000,41,1,"Baker County, OR",Mar-20,7045,6672,373,5.3
40836,CN4100300000000,41,3,"Benton County, OR",Mar-20,49525,48072,1453,2.9
40837,CN4100500000000,41,5,"Clackamas County, OR",Mar-20,220069,212263,7806,3.5
40838,CN4100700000000,41,7,"Clatsop County, OR",Mar-20,19071,18294,777,4.1
40839,CN4100900000000,41,9,"Columbia County, OR",Mar-20,24552,23441,1111,4.5
40840,CN4101100000000,41,11,"Coos County, OR",Mar-20,26068,24794,1274,4.9
40841,CN4101300000000,41,13,"Crook County, OR",Mar-20,9499,8956,543,5.7
40842,CN4101500000000,41,15,"Curry County, OR",Mar-20,8679,8184,495,5.7
40843,CN4101700000000,41,17,"Deschutes County, OR",Mar-20,95746,91919,3827,4.0
40844,CN4101900000000,41,19,"Douglas County, OR",Mar-20,46322,44000,2322,5.0
40845,CN4102100000000,41,21,"Gilliam County, OR",Mar-20,898,853,45,5.0
40846,CN4102300000000,41,23,"Grant County, OR",Mar-20,3112,2833,279,9.0
40847,CN4102500000000,41,25,"Harney County, OR",Mar-20,3466,3265,201,5.8
40848,CN4102700000000,41,27,"Hood River County, OR",Mar-20,13673,13250,423,3.1
40849,CN4102900000000,41,29,"Jackson County, OR",Mar-20,101891,97103,4788,4.7
40850,CN4103100000000,41,31,"Jefferson County, OR",Mar-20,9900,9368,532,5.4
40851,CN4103300000000,41,33,"Josephine County, OR",Mar-20,35824,33969,1855,5.2
40852,CN4103500000000,41,35,"Klamath County, OR",Mar-20,28632,26581,2051,7.2
40853,CN4103700000000,41,37,"Lake County, OR",Mar-20,3512,3333,179,5.1
40854,CN4103900000000,41,39,"Lane County, OR",Mar-20,182681,175268,7413,4.1
40855,CN4104100000000,41,41,"Lincoln County, OR",Mar-20,20298,19338,960,4.7
40856,CN4104300000000,41,43,"Linn County, OR",Mar-20,59180,56490,2690,4.5
40857,CN4104500000000,41,45,"Malheur County, OR",Mar-20,12285,11802,483,3.9
40858,CN4104700000000,41,47,"Marion County, OR",Mar-20,162222,155653,6569,4.0
40859,CN4104900000000,41,49,"Morrow County, OR",Mar-20,5603,5359,244,4.4
40860,CN4105100000000,41,51,"Multnomah County, OR",Mar-20,456871,441066,15805,3.5
40861,CN4105300000000,41,53,"Polk County, OR",Mar-20,39965,38336,1629,4.1
40862,CN4105500000000,41,55,"Sherman County, OR",Mar-20,946,897,49,5.2
40863,CN4105700000000,41,57,"Tillamook County, OR",Mar-20,11767,11286,481,4.1
40864,CN4105900000000,41,59,"Umatilla County, OR",Mar-20,35953,34273,1680,4.7
40865,CN4106100000000,41,61,"Union County, OR",Mar-20,11917,11265,652,5.5
40866,CN4106300000000,41,63,"Wallowa County, OR",Mar-20,3272,3032,240,7.3
40867,CN4106500000000,41,65,"Wasco County, OR",Mar-20,12281,11687,594,4.8
40868,CN4106700000000,41,67,"Washington County, OR",Mar-20,325863,315696,10167,3.1
40869,CN4106900000000,41,69,"Wheeler County, OR",Mar-20,724,699,25,3.5
40870,CN4107100000000,41,71,"Yamhill County, OR",Mar-20,54828,52878,1950,3.6
40871,CN4200100000000,42,1,"Adams County, PA",Mar-20,54765,52544,2221,4.1
40872,CN4200300000000,42,3,"Allegheny County, PA",Mar-20,647292,611231,36061,5.6
40873,CN4200500000000,42,5,"Armstrong County, PA",Mar-20,32671,30025,2646,8.1
40874,CN4200700000000,42,7,"Beaver County, PA",Mar-20,84413,78820,5593,6.6
40875,CN4200900000000,42,9,"Bedford County, PA",Mar-20,23540,21868,1672,7.1
40876,CN4201100000000,42,11,"Berks County, PA",Mar-20,217276,204809,12467,5.7
40877,CN4201300000000,42,13,"Blair County, PA",Mar-20,59126,55555,3571,6.0
40878,CN4201500000000,42,15,"Bradford County, PA",Mar-20,28924,27131,1793,6.2
40879,CN4201700000000,42,17,"Bucks County, PA",Mar-20,343365,325858,17507,5.1
40880,CN4201900000000,42,19,"Butler County, PA",Mar-20,99808,94157,5651,5.7
40881,CN4202100000000,42,21,"Cambria County, PA",Mar-20,58314,53933,4381,7.5
40882,CN4202300000000,42,23,"Cameron County, PA",Mar-20,2079,1883,196,9.4
40883,CN4202500000000,42,25,"Carbon County, PA",Mar-20,32435,30041,2394,7.4
40884,CN4202700000000,42,27,"Centre County, PA",Mar-20,80846,77344,3502,4.3
40885,CN4202900000000,42,29,"Chester County, PA",Mar-20,282616,271295,11321,4.0
40886,CN4203100000000,42,31,"Clarion County, PA",Mar-20,17394,16130,1264,7.3
40887,CN4203300000000,42,33,"Clearfield County, PA",Mar-20,36596,33783,2813,7.7
40888,CN4203500000000,42,35,"Clinton County, PA",Mar-20,18543,17093,1450,7.8
40889,CN4203700000000,42,37,"Columbia County, PA",Mar-20,34123,31894,2229,6.5
40890,CN4203900000000,42,39,"Crawford County, PA",Mar-20,38546,35947,2599,6.7
40891,CN4204100000000,42,41,"Cumberland County, PA",Mar-20,132005,126445,5560,4.2
40892,CN4204300000000,42,43,"Dauphin County, PA",Mar-20,144772,137326,7446,5.1
40893,CN4204500000000,42,45,"Delaware County, PA",Mar-20,302209,286927,15282,5.1
40894,CN4204700000000,42,47,"Elk County, PA",Mar-20,15632,14403,1229,7.9
40895,CN4204900000000,42,49,"Erie County, PA",Mar-20,128613,120024,8589,6.7
40896,CN4205100000000,42,51,"Fayette County, PA",Mar-20,58071,52783,5288,9.1
40897,CN4205300000000,42,53,"Forest County, PA",Mar-20,1812,1630,182,10.0
40898,CN4205500000000,42,55,"Franklin County, PA",Mar-20,78212,74097,4115,5.3
40899,CN4205700000000,42,57,"Fulton County, PA",Mar-20,8012,7443,569,7.1
40900,CN4205900000000,42,59,"Greene County, PA",Mar-20,16923,15598,1325,7.8
40901,CN4206100000000,42,61,"Huntingdon County, PA",Mar-20,20251,18413,1838,9.1
40902,CN4206300000000,42,63,"Indiana County, PA",Mar-20,39630,36855,2775,7.0
40903,CN4206500000000,42,65,"Jefferson County, PA",Mar-20,20651,19244,1407,6.8
40904,CN4206700000000,42,67,"Juniata County, PA",Mar-20,12657,11874,783,6.2
40905,CN4206900000000,42,69,"Lackawanna County, PA",Mar-20,105755,98863,6892,6.5
40906,CN4207100000000,42,71,"Lancaster County, PA",Mar-20,283179,270919,12260,4.3
40907,CN4207300000000,42,73,"Lawrence County, PA",Mar-20,41166,37586,3580,8.7
40908,CN4207500000000,42,75,"Lebanon County, PA",Mar-20,72414,68766,3648,5.0
40909,CN4207700000000,42,77,"Lehigh County, PA",Mar-20,193193,181839,11354,5.9
40910,CN4207900000000,42,79,"Luzerne County, PA",Mar-20,159210,146925,12285,7.7
40911,CN4208100000000,42,81,"Lycoming County, PA",Mar-20,56890,52804,4086,7.2
40912,CN4208300000000,42,83,"McKean County, PA",Mar-20,17493,16027,1466,8.4
40913,CN4208500000000,42,85,"Mercer County, PA",Mar-20,48372,45059,3313,6.8
40914,CN4208700000000,42,87,"Mifflin County, PA",Mar-20,21302,19890,1412,6.6
40915,CN4208900000000,42,89,"Monroe County, PA",Mar-20,83514,77486,6028,7.2
40916,CN4209100000000,42,91,"Montgomery County, PA",Mar-20,452939,432390,20549,4.5
40917,CN4209300000000,42,93,"Montour County, PA",Mar-20,9231,8781,450,4.9
40918,CN4209500000000,42,95,"Northampton County, PA",Mar-20,161692,152282,9410,5.8
40919,CN4209700000000,42,97,"Northumberland County, PA",Mar-20,43128,39731,3397,7.9
40920,CN4209900000000,42,99,"Perry County, PA",Mar-20,24476,23270,1206,4.9
40921,CN4210100000000,42,101,"Philadelphia County/city, PA",Mar-20,736461,685164,51297,7.0
40922,CN4210300000000,42,103,"Pike County, PA",Mar-20,25109,23117,1992,7.9
40923,CN4210500000000,42,105,"Potter County, PA",Mar-20,7286,6551,735,10.1
40924,CN4210700000000,42,107,"Schuylkill County, PA",Mar-20,66728,62127,4601,6.9
40925,CN4210900000000,42,109,"Snyder County, PA",Mar-20,20474,19149,1325,6.5
40926,CN4211100000000,42,111,"Somerset County, PA",Mar-20,34110,31375,2735,8.0
40927,CN4211300000000,42,113,"Sullivan County, PA",Mar-20,2634,2423,211,8.0
40928,CN4211500000000,42,115,"Susquehanna County, PA",Mar-20,20508,19144,1364,6.7
40929,CN4211700000000,42,117,"Tioga County, PA",Mar-20,19355,17764,1591,8.2
40930,CN4211900000000,42,119,"Union County, PA",Mar-20,19961,18972,989,5.0
40931,CN4212100000000,42,121,"Venango County, PA",Mar-20,22381,20712,1669,7.5
40932,CN4212300000000,42,123,"Warren County, PA",Mar-20,19019,17682,1337,7.0
40933,CN4212500000000,42,125,"Washington County, PA",Mar-20,107511,100445,7066,6.6
40934,CN4212700000000,42,127,"Wayne County, PA",Mar-20,22078,20351,1727,7.8
40935,CN4212900000000,42,129,"Westmoreland County, PA",Mar-20,181428,169847,11581,6.4
40936,CN4213100000000,42,131,"Wyoming County, PA",Mar-20,13719,12742,977,7.1
40937,CN4213300000000,42,133,"York County, PA",Mar-20,235902,224485,11417,4.8
40938,CN4400100000000,44,1,"Bristol County, RI",Mar-20,26182,25110,1072,4.1
40939,CN4400300000000,44,3,"Kent County, RI",Mar-20,91626,87412,4214,4.6
40940,CN4400500000000,44,5,"Newport County, RI",Mar-20,44825,42707,2118,4.7
40941,CN4400700000000,44,7,"Providence County, RI",Mar-20,328967,311492,17475,5.3
40942,CN4400900000000,44,9,"Washington County, RI",Mar-20,69244,66198,3046,4.4
40943,CN4500100000000,45,1,"Abbeville County, SC",Mar-20,10150,9763,387,3.8
40944,CN4500300000000,45,3,"Aiken County, SC",Mar-20,76160,73880,2280,3.0
40945,CN4500500000000,45,5,"Allendale County, SC",Mar-20,2639,2464,175,6.6
40946,CN4500700000000,45,7,"Anderson County, SC",Mar-20,92571,89906,2665,2.9
40947,CN4500900000000,45,9,"Bamberg County, SC",Mar-20,4986,4665,321,6.4
40948,CN4501100000000,45,11,"Barnwell County, SC",Mar-20,8160,7761,399,4.9
40949,CN4501300000000,45,13,"Beaufort County, SC",Mar-20,79536,77362,2174,2.7
40950,CN4501500000000,45,15,"Berkeley County, SC",Mar-20,104833,101948,2885,2.8
40951,CN4501700000000,45,17,"Calhoun County, SC",Mar-20,6679,6438,241,3.6
40952,CN4501900000000,45,19,"Charleston County, SC",Mar-20,212870,207646,5224,2.5
40953,CN4502100000000,45,21,"Cherokee County, SC",Mar-20,25818,24931,887,3.4
40954,CN4502300000000,45,23,"Chester County, SC",Mar-20,13691,13055,636,4.6
40955,CN4502500000000,45,25,"Chesterfield County, SC",Mar-20,22238,21549,689,3.1
40956,CN4502700000000,45,27,"Clarendon County, SC",Mar-20,12729,12202,527,4.1
40957,CN4502900000000,45,29,"Colleton County, SC",Mar-20,16934,16360,574,3.4
40958,CN4503100000000,45,31,"Darlington County, SC",Mar-20,30646,29617,1029,3.4
40959,CN4503300000000,45,33,"Dillon County, SC",Mar-20,13306,12755,551,4.1
40960,CN4503500000000,45,35,"Dorchester County, SC",Mar-20,78655,76584,2071,2.6
40961,CN4503700000000,45,37,"Edgefield County, SC",Mar-20,10848,10520,328,3.0
40962,CN4503900000000,45,39,"Fairfield County, SC",Mar-20,9757,9319,438,4.5
40963,CN4504100000000,45,41,"Florence County, SC",Mar-20,67814,65697,2117,3.1
40964,CN4504300000000,45,43,"Georgetown County, SC",Mar-20,25996,24919,1077,4.1
40965,CN4504500000000,45,45,"Greenville County, SC",Mar-20,258732,252042,6690,2.6
40966,CN4504700000000,45,47,"Greenwood County, SC",Mar-20,31597,30499,1098,3.5
40967,CN4504900000000,45,49,"Hampton County, SC",Mar-20,8431,8190,241,2.9
40968,CN4505100000000,45,51,"Horry County, SC",Mar-20,149105,143233,5872,3.9
40969,CN4505300000000,45,53,"Jasper County, SC",Mar-20,12911,12576,335,2.6
40970,CN4505500000000,45,55,"Kershaw County, SC",Mar-20,29817,28830,987,3.3
40971,CN4505700000000,45,57,"Lancaster County, SC",Mar-20,42034,40501,1533,3.6
40972,CN4505900000000,45,59,"Laurens County, SC",Mar-20,30624,29624,1000,3.3
40973,CN4506100000000,45,61,"Lee County, SC",Mar-20,6722,6377,345,5.1
40974,CN4506300000000,45,63,"Lexington County, SC",Mar-20,152742,149016,3726,2.4
40975,CN4506500000000,45,65,"McCormick County, SC",Mar-20,3393,3256,137,4.0
40976,CN4506700000000,45,67,"Marion County, SC",Mar-20,13012,12425,587,4.5
40977,CN4506900000000,45,69,"Marlboro County, SC",Mar-20,9246,8798,448,4.8
40978,CN4507100000000,45,71,"Newberry County, SC",Mar-20,19038,18502,536,2.8
40979,CN4507300000000,45,73,"Oconee County, SC",Mar-20,35468,34454,1014,2.9
40980,CN4507500000000,45,75,"Orangeburg County, SC",Mar-20,35459,33742,1717,4.8
40981,CN4507700000000,45,77,"Pickens County, SC",Mar-20,58314,56594,1720,2.9
40982,CN4507900000000,45,79,"Richland County, SC",Mar-20,202793,197020,5773,2.8
40983,CN4508100000000,45,81,"Saluda County, SC",Mar-20,8903,8647,256,2.9
40984,CN4508300000000,45,83,"Spartanburg County, SC",Mar-20,156207,151913,4294,2.7
40985,CN4508500000000,45,85,"Sumter County, SC",Mar-20,44621,42953,1668,3.7
40986,CN4508700000000,45,87,"Union County, SC",Mar-20,11921,11447,474,4.0
40987,CN4508900000000,45,89,"Williamsburg County, SC",Mar-20,12115,11515,600,5.0
40988,CN4509100000000,45,91,"York County, SC",Mar-20,142802,138675,4127,2.9
40989,CN4600300000000,46,3,"Aurora County, SD",Mar-20,1506,1466,40,2.7
40990,CN4600500000000,46,5,"Beadle County, SD",Mar-20,9522,9221,301,3.2
40991,CN4600700000000,46,7,"Bennett County, SD",Mar-20,1077,1027,50,4.6
40992,CN4600900000000,46,9,"Bon Homme County, SD",Mar-20,2901,2814,87,3.0
40993,CN4601100000000,46,11,"Brookings County, SD",Mar-20,19542,18959,583,3.0
40994,CN4601300000000,46,13,"Brown County, SD",Mar-20,20842,20196,646,3.1
40995,CN4601500000000,46,15,"Brule County, SD",Mar-20,2419,2344,75,3.1
40996,CN4601700000000,46,17,"Buffalo County, SD",Mar-20,646,614,32,5.0
40997,CN4601900000000,46,19,"Butte County, SD",Mar-20,5073,4894,179,3.5
40998,CN4602100000000,46,21,"Campbell County, SD",Mar-20,802,765,37,4.6
40999,CN4602300000000,46,23,"Charles Mix County, SD",Mar-20,3749,3622,127,3.4
41000,CN4602500000000,46,25,"Clark County, SD",Mar-20,1929,1835,94,4.9
41001,CN4602700000000,46,27,"Clay County, SD",Mar-20,7825,7606,219,2.8
41002,CN4602900000000,46,29,"Codington County, SD",Mar-20,15680,15182,498,3.2
41003,CN4603100000000,46,31,"Corson County, SD",Mar-20,1380,1313,67,4.9
41004,CN4603300000000,46,33,"Custer County, SD",Mar-20,4047,3847,200,4.9
41005,CN4603500000000,46,35,"Davison County, SD",Mar-20,11066,10704,362,3.3
41006,CN4603700000000,46,37,"Day County, SD",Mar-20,2763,2599,164,5.9
41007,CN4603900000000,46,39,"Deuel County, SD",Mar-20,2173,2031,142,6.5
41008,CN4604100000000,46,41,"Dewey County, SD",Mar-20,2232,2092,140,6.3
41009,CN4604300000000,46,43,"Douglas County, SD",Mar-20,1584,1534,50,3.2
41010,CN4604500000000,46,45,"Edmunds County, SD",Mar-20,2067,2007,60,2.9
41011,CN4604700000000,46,47,"Fall River County, SD",Mar-20,2979,2835,144,4.8
41012,CN4604900000000,46,49,"Faulk County, SD",Mar-20,1077,1040,37,3.4
41013,CN4605100000000,46,51,"Grant County, SD",Mar-20,4504,4294,210,4.7
41014,CN4605300000000,46,53,"Gregory County, SD",Mar-20,2015,1945,70,3.5
41015,CN4605500000000,46,55,"Haakon County, SD",Mar-20,1070,1038,32,3.0
41016,CN4605700000000,46,57,"Hamlin County, SD",Mar-20,3359,3247,112,3.3
41017,CN4605900000000,46,59,"Hand County, SD",Mar-20,1781,1736,45,2.5
41018,CN4606100000000,46,61,"Hanson County, SD",Mar-20,1766,1666,100,5.7
41019,CN4606300000000,46,63,"Harding County, SD",Mar-20,739,721,18,2.4
41020,CN4606500000000,46,65,"Hughes County, SD",Mar-20,9874,9590,284,2.9
41021,CN4606700000000,46,67,"Hutchinson County, SD",Mar-20,3737,3592,145,3.9
41022,CN4606900000000,46,69,"Hyde County, SD",Mar-20,705,685,20,2.8
41023,CN4607100000000,46,71,"Jackson County, SD",Mar-20,1172,1110,62,5.3
41024,CN4607300000000,46,73,"Jerauld County, SD",Mar-20,1159,1132,27,2.3
41025,CN4607500000000,46,75,"Jones County, SD",Mar-20,520,503,17,3.3
41026,CN4607700000000,46,77,"Kingsbury County, SD",Mar-20,2691,2599,92,3.4
41027,CN4607900000000,46,79,"Lake County, SD",Mar-20,6732,6518,214,3.2
41028,CN4608100000000,46,81,"Lawrence County, SD",Mar-20,13665,13276,389,2.8
41029,CN4608300000000,46,83,"Lincoln County, SD",Mar-20,34646,33758,888,2.6
41030,CN4608500000000,46,85,"Lyman County, SD",Mar-20,1648,1570,78,4.7
41031,CN4608700000000,46,87,"McCook County, SD",Mar-20,3120,3020,100,3.2
41032,CN4608900000000,46,89,"McPherson County, SD",Mar-20,1013,965,48,4.7
41033,CN4609100000000,46,91,"Marshall County, SD",Mar-20,2388,2271,117,4.9
41034,CN4609300000000,46,93,"Meade County, SD",Mar-20,14028,13545,483,3.4
41035,CN4609500000000,46,95,"Mellette County, SD",Mar-20,759,717,42,5.5
41036,CN4609700000000,46,97,"Miner County, SD",Mar-20,1184,1152,32,2.7
41037,CN4609900000000,46,99,"Minnehaha County, SD",Mar-20,113477,109947,3530,3.1
41038,CN4610100000000,46,101,"Moody County, SD",Mar-20,4092,3945,147,3.6
41039,CN4610200000000,46,102,"Oglala Lakota County, SD",Mar-20,3521,3252,269,7.6
41040,CN4610300000000,46,103,"Pennington County, SD",Mar-20,56328,54369,1959,3.5
41041,CN4610500000000,46,105,"Perkins County, SD",Mar-20,1450,1410,40,2.8
41042,CN4610700000000,46,107,"Potter County, SD",Mar-20,1014,981,33,3.3
41043,CN4610900000000,46,109,"Roberts County, SD",Mar-20,4969,4683,286,5.8
41044,CN4611100000000,46,111,"Sanborn County, SD",Mar-20,1198,1153,45,3.8
41045,CN4611500000000,46,115,"Spink County, SD",Mar-20,3222,3082,140,4.3
41046,CN4611700000000,46,117,"Stanley County, SD",Mar-20,1850,1782,68,3.7
41047,CN4611900000000,46,119,"Sully County, SD",Mar-20,810,787,23,2.8
41048,CN4612100000000,46,121,"Todd County, SD",Mar-20,3177,2992,185,5.8
41049,CN4612300000000,46,123,"Tripp County, SD",Mar-20,3098,3015,83,2.7
41050,CN4612500000000,46,125,"Turner County, SD",Mar-20,4771,4606,165,3.5
41051,CN4612700000000,46,127,"Union County, SD",Mar-20,8503,8232,271,3.2
41052,CN4612900000000,46,129,"Walworth County, SD",Mar-20,2158,2016,142,6.6
41053,CN4613500000000,46,135,"Yankton County, SD",Mar-20,11852,11505,347,2.9
41054,CN4613700000000,46,137,"Ziebach County, SD",Mar-20,936,903,33,3.5
41055,CN4700100000000,47,1,"Anderson County, TN",Mar-20,35136,34002,1134,3.2
41056,CN4700300000000,47,3,"Bedford County, TN",Mar-20,21276,20528,748,3.5
41057,CN4700500000000,47,5,"Benton County, TN",Mar-20,7126,6780,346,4.9
41058,CN4700700000000,47,7,"Bledsoe County, TN",Mar-20,4422,4188,234,5.3
41059,CN4700900000000,47,9,"Blount County, TN",Mar-20,64527,62539,1988,3.1
41060,CN4701100000000,47,11,"Bradley County, TN",Mar-20,53492,51723,1769,3.3
41061,CN4701300000000,47,13,"Campbell County, TN",Mar-20,15047,14396,651,4.3
41062,CN4701500000000,47,15,"Cannon County, TN",Mar-20,6785,6593,192,2.8
41063,CN4701700000000,47,17,"Carroll County, TN",Mar-20,12202,11653,549,4.5
41064,CN4701900000000,47,19,"Carter County, TN",Mar-20,24489,23575,914,3.7
41065,CN4702100000000,47,21,"Cheatham County, TN",Mar-20,22551,21989,562,2.5
41066,CN4702300000000,47,23,"Chester County, TN",Mar-20,8647,8389,258,3.0
41067,CN4702500000000,47,25,"Claiborne County, TN",Mar-20,13279,12744,535,4.0
41068,CN4702700000000,47,27,"Clay County, TN",Mar-20,2790,2618,172,6.2
41069,CN4702900000000,47,29,"Cocke County, TN",Mar-20,15094,14385,709,4.7
41070,CN4703100000000,47,31,"Coffee County, TN",Mar-20,26106,25223,883,3.4
41071,CN4703300000000,47,33,"Crockett County, TN",Mar-20,7096,6815,281,4.0
41072,CN4703500000000,47,35,"Cumberland County, TN",Mar-20,23806,22675,1131,4.8
41073,CN4703700000000,47,37,"Davidson County, TN",Mar-20,417697,407562,10135,2.4
41074,CN4703900000000,47,39,"Decatur County, TN",Mar-20,4650,4399,251,5.4
41075,CN4704100000000,47,41,"DeKalb County, TN",Mar-20,7774,7463,311,4.0
41076,CN4704300000000,47,43,"Dickson County, TN",Mar-20,27874,27104,770,2.8
41077,CN4704500000000,47,45,"Dyer County, TN",Mar-20,16728,15992,736,4.4
41078,CN4704700000000,47,47,"Fayette County, TN",Mar-20,19342,18711,631,3.3
41079,CN4704900000000,47,49,"Fentress County, TN",Mar-20,7546,7246,300,4.0
41080,CN4705100000000,47,51,"Franklin County, TN",Mar-20,20784,20073,711,3.4
41081,CN4705300000000,47,53,"Gibson County, TN",Mar-20,22488,21640,848,3.8
41082,CN4705500000000,47,55,"Giles County, TN",Mar-20,15305,14669,636,4.2
41083,CN4705700000000,47,57,"Grainger County, TN",Mar-20,9659,9261,398,4.1
41084,CN4705900000000,47,59,"Greene County, TN",Mar-20,29635,28375,1260,4.3
41085,CN4706100000000,47,61,"Grundy County, TN",Mar-20,5065,4854,211,4.2
41086,CN4706300000000,47,63,"Hamblen County, TN",Mar-20,28629,27587,1042,3.6
41087,CN4706500000000,47,65,"Hamilton County, TN",Mar-20,188600,182767,5833,3.1
41088,CN4706700000000,47,67,"Hancock County, TN",Mar-20,2119,2010,109,5.1
41089,CN4706900000000,47,69,"Hardeman County, TN",Mar-20,9574,9144,430,4.5
41090,CN4707100000000,47,71,"Hardin County, TN",Mar-20,10696,10217,479,4.5
41091,CN4707300000000,47,73,"Hawkins County, TN",Mar-20,24076,23090,986,4.1
41092,CN4707500000000,47,75,"Haywood County, TN",Mar-20,7773,7433,340,4.4
41093,CN4707700000000,47,77,"Henderson County, TN",Mar-20,12482,11965,517,4.1
41094,CN4707900000000,47,79,"Henry County, TN",Mar-20,14306,13685,621,4.3
41095,CN4708100000000,47,81,"Hickman County, TN",Mar-20,11782,11431,351,3.0
41096,CN4708300000000,47,83,"Houston County, TN",Mar-20,3389,3207,182,5.4
41097,CN4708500000000,47,85,"Humphreys County, TN",Mar-20,9166,8811,355,3.9
41098,CN4708700000000,47,87,"Jackson County, TN",Mar-20,4780,4567,213,4.5
41099,CN4708900000000,47,89,"Jefferson County, TN",Mar-20,25031,24137,894,3.6
41100,CN4709100000000,47,91,"Johnson County, TN",Mar-20,7808,7527,281,3.6
41101,CN4709300000000,47,93,"Knox County, TN",Mar-20,247852,241139,6713,2.7
41102,CN4709500000000,47,95,"Lake County, TN",Mar-20,1752,1655,97,5.5
41103,CN4709700000000,47,97,"Lauderdale County, TN",Mar-20,9851,9361,490,5.0
41104,CN4709900000000,47,99,"Lawrence County, TN",Mar-20,19545,18825,720,3.7
41105,CN4710100000000,47,101,"Lewis County, TN",Mar-20,5179,5007,172,3.3
41106,CN4710300000000,47,103,"Lincoln County, TN",Mar-20,16477,15468,1009,6.1
41107,CN4710500000000,47,105,"Loudon County, TN",Mar-20,23810,23003,807,3.4
41108,CN4710700000000,47,107,"McMinn County, TN",Mar-20,24347,23465,882,3.6
41109,CN4710900000000,47,109,"McNairy County, TN",Mar-20,8599,8166,433,5.0
41110,CN4711100000000,47,111,"Macon County, TN",Mar-20,11529,11188,341,3.0
41111,CN4711300000000,47,113,"Madison County, TN",Mar-20,49714,48136,1578,3.2
41112,CN4711500000000,47,115,"Marion County, TN",Mar-20,12765,12278,487,3.8
41113,CN4711700000000,47,117,"Marshall County, TN",Mar-20,15967,15433,534,3.3
41114,CN4711900000000,47,119,"Maury County, TN",Mar-20,50930,49506,1424,2.8
41115,CN4712100000000,47,121,"Meigs County, TN",Mar-20,5299,5058,241,4.5
41116,CN4712300000000,47,123,"Monroe County, TN",Mar-20,20495,19749,746,3.6
41117,CN4712500000000,47,125,"Montgomery County, TN",Mar-20,88641,85479,3162,3.6
41118,CN4712700000000,47,127,"Moore County, TN",Mar-20,3677,3572,105,2.9
41119,CN4712900000000,47,129,"Morgan County, TN",Mar-20,8014,7683,331,4.1
41120,CN4713100000000,47,131,"Obion County, TN",Mar-20,12731,12187,544,4.3
41121,CN4713300000000,47,133,"Overton County, TN",Mar-20,10216,9826,390,3.8
41122,CN4713500000000,47,135,"Perry County, TN",Mar-20,3080,2941,139,4.5
41123,CN4713700000000,47,137,"Pickett County, TN",Mar-20,2394,2299,95,4.0
41124,CN4713900000000,47,139,"Polk County, TN",Mar-20,7695,7416,279,3.6
41125,CN4714100000000,47,141,"Putnam County, TN",Mar-20,35858,34707,1151,3.2
41126,CN4714300000000,47,143,"Rhea County, TN",Mar-20,13739,13033,706,5.1
41127,CN4714500000000,47,145,"Roane County, TN",Mar-20,23767,22838,929,3.9
41128,CN4714700000000,47,147,"Robertson County, TN",Mar-20,39108,38067,1041,2.7
41129,CN4714900000000,47,149,"Rutherford County, TN",Mar-20,190119,185613,4506,2.4
41130,CN4715100000000,47,151,"Scott County, TN",Mar-20,8465,7993,472,5.6
41131,CN4715300000000,47,153,"Sequatchie County, TN",Mar-20,6333,6084,249,3.9
41132,CN4715500000000,47,155,"Sevier County, TN",Mar-20,54645,52732,1913,3.5
41133,CN4715700000000,47,157,"Shelby County, TN",Mar-20,452253,435368,16885,3.7
41134,CN4715900000000,47,159,"Smith County, TN",Mar-20,9757,9454,303,3.1
41135,CN4716100000000,47,161,"Stewart County, TN",Mar-20,5639,5400,239,4.2
41136,CN4716300000000,47,163,"Sullivan County, TN",Mar-20,71150,68648,2502,3.5
41137,CN4716500000000,47,165,"Sumner County, TN",Mar-20,105724,102998,2726,2.6
41138,CN4716700000000,47,167,"Tipton County, TN",Mar-20,28601,27525,1076,3.8
41139,CN4716900000000,47,169,"Trousdale County, TN",Mar-20,5591,5429,162,2.9
41140,CN4717100000000,47,171,"Unicoi County, TN",Mar-20,7237,6872,365,5.0
41141,CN4717300000000,47,173,"Union County, TN",Mar-20,7714,7436,278,3.6
41142,CN4717500000000,47,175,"Van Buren County, TN",Mar-20,2095,1996,99,4.7
41143,CN4717700000000,47,177,"Warren County, TN",Mar-20,16562,15923,639,3.9
41144,CN4717900000000,47,179,"Washington County, TN",Mar-20,61724,59724,2000,3.2
41145,CN4718100000000,47,181,"Wayne County, TN",Mar-20,6272,5991,281,4.5
41146,CN4718300000000,47,183,"Weakley County, TN",Mar-20,16238,15716,522,3.2
41147,CN4718500000000,47,185,"White County, TN",Mar-20,12455,12012,443,3.6
41148,CN4718700000000,47,187,"Williamson County, TN",Mar-20,132632,129439,3193,2.4
41149,CN4718900000000,47,189,"Wilson County, TN",Mar-20,79110,77085,2025,2.6
41150,CN4800100000000,48,1,"Anderson County, TX",Mar-20,23894,22884,1010,4.2
41151,CN4800300000000,48,3,"Andrews County, TX",Mar-20,9784,9443,341,3.5
41152,CN4800500000000,48,5,"Angelina County, TX",Mar-20,35766,33639,2127,5.9
41153,CN4800700000000,48,7,"Aransas County, TX",Mar-20,9378,8781,597,6.4
41154,CN4800900000000,48,9,"Archer County, TX",Mar-20,4066,3899,167,4.1
41155,CN4801100000000,48,11,"Armstrong County, TX",Mar-20,933,894,39,4.2
41156,CN4801300000000,48,13,"Atascosa County, TX",Mar-20,21693,20531,1162,5.4
41157,CN4801500000000,48,15,"Austin County, TX",Mar-20,14134,13400,734,5.2
41158,CN4801700000000,48,17,"Bailey County, TX",Mar-20,2468,2336,132,5.3
41159,CN4801900000000,48,19,"Bandera County, TX",Mar-20,10025,9552,473,4.7
41160,CN4802100000000,48,21,"Bastrop County, TX",Mar-20,42881,41081,1800,4.2
41161,CN4802300000000,48,23,"Baylor County, TX",Mar-20,1769,1702,67,3.8
41162,CN4802500000000,48,25,"Bee County, TX",Mar-20,9926,9255,671,6.8
41163,CN4802700000000,48,27,"Bell County, TX",Mar-20,144059,136459,7600,5.3
41164,CN4802900000000,48,29,"Bexar County, TX",Mar-20,944253,901508,42745,4.5
41165,CN4803100000000,48,31,"Blanco County, TX",Mar-20,6508,6289,219,3.4
41166,CN4803300000000,48,33,"Borden County, TX",Mar-20,434,417,17,3.9
41167,CN4803500000000,48,35,"Bosque County, TX",Mar-20,8302,7874,428,5.2
41168,CN4803700000000,48,37,"Bowie County, TX",Mar-20,39607,37308,2299,5.8
41169,CN4803900000000,48,39,"Brazoria County, TX",Mar-20,180324,169216,11108,6.2
41170,CN4804100000000,48,41,"Brazos County, TX",Mar-20,120912,116323,4589,3.8
41171,CN4804300000000,48,43,"Brewster County, TX",Mar-20,4248,4068,180,4.2
41172,CN4804500000000,48,45,"Briscoe County, TX",Mar-20,580,547,33,5.7
41173,CN4804700000000,48,47,"Brooks County, TX",Mar-20,2714,2484,230,8.5
41174,CN4804900000000,48,49,"Brown County, TX",Mar-20,15595,14674,921,5.9
41175,CN4805100000000,48,51,"Burleson County, TX",Mar-20,8558,8133,425,5.0
41176,CN4805300000000,48,53,"Burnet County, TX",Mar-20,23521,22600,921,3.9
41177,CN4805500000000,48,55,"Caldwell County, TX",Mar-20,19677,18769,908,4.6
41178,CN4805700000000,48,57,"Calhoun County, TX",Mar-20,12280,11716,564,4.6
41179,CN4805900000000,48,59,"Callahan County, TX",Mar-20,6068,5792,276,4.5
41180,CN4806100000000,48,61,"Cameron County, TX",Mar-20,168821,155303,13518,8.0
41181,CN4806300000000,48,63,"Camp County, TX",Mar-20,4996,4697,299,6.0
41182,CN4806500000000,48,65,"Carson County, TX",Mar-20,3015,2898,117,3.9
41183,CN4806700000000,48,67,"Cass County, TX",Mar-20,12528,11733,795,6.3
41184,CN4806900000000,48,69,"Castro County, TX",Mar-20,3434,3299,135,3.9
41185,CN4807100000000,48,71,"Chambers County, TX",Mar-20,19619,18297,1322,6.7
41186,CN4807300000000,48,73,"Cherokee County, TX",Mar-20,20819,19632,1187,5.7
41187,CN4807500000000,48,75,"Childress County, TX",Mar-20,2886,2767,119,4.1
41188,CN4807700000000,48,77,"Clay County, TX",Mar-20,4853,4638,215,4.4
41189,CN4807900000000,48,79,"Cochran County, TX",Mar-20,1133,1076,57,5.0
41190,CN4808100000000,48,81,"Coke County, TX",Mar-20,1441,1382,59,4.1
41191,CN4808300000000,48,83,"Coleman County, TX",Mar-20,2876,2676,200,7.0
41192,CN4808500000000,48,85,"Collin County, TX",Mar-20,563411,538583,24828,4.4
41193,CN4808700000000,48,87,"Collingsworth County, TX",Mar-20,1138,1081,57,5.0
41194,CN4808900000000,48,89,"Colorado County, TX",Mar-20,9792,9325,467,4.8
41195,CN4809100000000,48,91,"Comal County, TX",Mar-20,73050,69711,3339,4.6
41196,CN4809300000000,48,93,"Comanche County, TX",Mar-20,5639,5333,306,5.4
41197,CN4809500000000,48,95,"Concho County, TX",Mar-20,1354,1300,54,4.0
41198,CN4809700000000,48,97,"Cooke County, TX",Mar-20,19810,18927,883,4.5
41199,CN4809900000000,48,99,"Coryell County, TX",Mar-20,24174,22854,1320,5.5
41200,CN4810100000000,48,101,"Cottle County, TX",Mar-20,552,517,35,6.3
41201,CN4810300000000,48,103,"Crane County, TX",Mar-20,1559,1446,113,7.2
41202,CN4810500000000,48,105,"Crockett County, TX",Mar-20,1641,1541,100,6.1
41203,CN4810700000000,48,107,"Crosby County, TX",Mar-20,2486,2367,119,4.8
41204,CN4810900000000,48,109,"Culberson County, TX",Mar-20,1040,992,48,4.6
41205,CN4811100000000,48,111,"Dallam County, TX",Mar-20,3860,3743,117,3.0
41206,CN4811300000000,48,113,"Dallas County, TX",Mar-20,1363851,1298570,65281,4.8
41207,CN4811500000000,48,115,"Dawson County, TX",Mar-20,4711,4431,280,5.9
41208,CN4811700000000,48,117,"Deaf Smith County, TX",Mar-20,8483,8151,332,3.9
41209,CN4811900000000,48,119,"Delta County, TX",Mar-20,2440,2319,121,5.0
41210,CN4812100000000,48,121,"Denton County, TX",Mar-20,494392,473282,21110,4.3
41211,CN4812300000000,48,123,"DeWitt County, TX",Mar-20,9830,9454,376,3.8
41212,CN4812500000000,48,125,"Dickens County, TX",Mar-20,670,631,39,5.8
41213,CN4812700000000,48,127,"Dimmit County, TX",Mar-20,7438,7156,282,3.8
41214,CN4812900000000,48,129,"Donley County, TX",Mar-20,1385,1318,67,4.8
41215,CN4813100000000,48,131,"Duval County, TX",Mar-20,4922,4562,360,7.3
41216,CN4813300000000,48,133,"Eastland County, TX",Mar-20,8118,7710,408,5.0
41217,CN4813500000000,48,135,"Ector County, TX",Mar-20,86622,82541,4081,4.7
41218,CN4813700000000,48,137,"Edwards County, TX",Mar-20,1140,1105,35,3.1
41219,CN4813900000000,48,139,"Ellis County, TX",Mar-20,92707,88547,4160,4.5
41220,CN4814100000000,48,141,"El Paso County, TX",Mar-20,363872,344345,19527,5.4
41221,CN4814300000000,48,143,"Erath County, TX",Mar-20,21024,20047,977,4.6
41222,CN4814500000000,48,145,"Falls County, TX",Mar-20,6560,6237,323,4.9
41223,CN4814700000000,48,147,"Fannin County, TX",Mar-20,17391,16718,673,3.9
41224,CN4814900000000,48,149,"Fayette County, TX",Mar-20,11989,11514,475,4.0
41225,CN4815100000000,48,151,"Fisher County, TX",Mar-20,1610,1547,63,3.9
41226,CN4815300000000,48,153,"Floyd County, TX",Mar-20,2595,2404,191,7.4
41227,CN4815500000000,48,155,"Foard County, TX",Mar-20,583,561,22,3.8
41228,CN4815700000000,48,157,"Fort Bend County, TX",Mar-20,392075,372374,19701,5.0
41229,CN4815900000000,48,159,"Franklin County, TX",Mar-20,4637,4416,221,4.8
41230,CN4816100000000,48,161,"Freestone County, TX",Mar-20,6424,5951,473,7.4
41231,CN4816300000000,48,163,"Frio County, TX",Mar-20,10350,9940,410,4.0
41232,CN4816500000000,48,165,"Gaines County, TX",Mar-20,9826,9451,375,3.8
41233,CN4816700000000,48,167,"Galveston County, TX",Mar-20,165687,156198,9489,5.7
41234,CN4816900000000,48,169,"Garza County, TX",Mar-20,2162,2064,98,4.5
41235,CN4817100000000,48,171,"Gillespie County, TX",Mar-20,13462,12974,488,3.6
41236,CN4817300000000,48,173,"Glasscock County, TX",Mar-20,790,766,24,3.0
41237,CN4817500000000,48,175,"Goliad County, TX",Mar-20,3220,3040,180,5.6
41238,CN4817700000000,48,177,"Gonzales County, TX",Mar-20,9644,9242,402,4.2
41239,CN4817900000000,48,179,"Gray County, TX",Mar-20,8030,7576,454,5.7
41240,CN4818100000000,48,181,"Grayson County, TX",Mar-20,64022,61063,2959,4.6
41241,CN4818300000000,48,183,"Gregg County, TX",Mar-20,56963,53704,3259,5.7
41242,CN4818500000000,48,185,"Grimes County, TX",Mar-20,11345,10622,723,6.4
41243,CN4818700000000,48,187,"Guadalupe County, TX",Mar-20,80927,77547,3380,4.2
41244,CN4818900000000,48,189,"Hale County, TX",Mar-20,11926,11179,747,6.3
41245,CN4819100000000,48,191,"Hall County, TX",Mar-20,1063,993,70,6.6
41246,CN4819300000000,48,193,"Hamilton County, TX",Mar-20,3641,3474,167,4.6
41247,CN4819500000000,48,195,"Hansford County, TX",Mar-20,2703,2616,87,3.2
41248,CN4819700000000,48,197,"Hardeman County, TX",Mar-20,1722,1650,72,4.2
41249,CN4819900000000,48,199,"Hardin County, TX",Mar-20,25077,23388,1689,6.7
41250,CN4820100000000,48,201,"Harris County, TX",Mar-20,2321037,2191290,129747,5.6
41251,CN4820300000000,48,203,"Harrison County, TX",Mar-20,29220,27449,1771,6.1
41252,CN4820500000000,48,205,"Hartley County, TX",Mar-20,2765,2698,67,2.4
41253,CN4820700000000,48,207,"Haskell County, TX",Mar-20,2273,2167,106,4.7
41254,CN4820900000000,48,209,"Hays County, TX",Mar-20,119743,115065,4678,3.9
41255,CN4821100000000,48,211,"Hemphill County, TX",Mar-20,1858,1778,80,4.3
41256,CN4821300000000,48,213,"Henderson County, TX",Mar-20,36557,34647,1910,5.2
41257,CN4821500000000,48,215,"Hidalgo County, TX",Mar-20,359346,325686,33660,9.4
41258,CN4821700000000,48,217,"Hill County, TX",Mar-20,16382,15581,801,4.9
41259,CN4821900000000,48,219,"Hockley County, TX",Mar-20,11177,10684,493,4.4
41260,CN4822100000000,48,221,"Hood County, TX",Mar-20,27445,26056,1389,5.1
41261,CN4822300000000,48,223,"Hopkins County, TX",Mar-20,17508,16724,784,4.5
41262,CN4822500000000,48,225,"Houston County, TX",Mar-20,10320,9799,521,5.0
41263,CN4822700000000,48,227,"Howard County, TX",Mar-20,14086,13420,666,4.7
41264,CN4822900000000,48,229,"Hudspeth County, TX",Mar-20,1837,1735,102,5.6
41265,CN4823100000000,48,231,"Hunt County, TX",Mar-20,43535,41279,2256,5.2
41266,CN4823300000000,48,233,"Hutchinson County, TX",Mar-20,8705,8152,553,6.4
41267,CN4823500000000,48,235,"Irion County, TX",Mar-20,755,725,30,4.0
41268,CN4823700000000,48,237,"Jack County, TX",Mar-20,3360,3165,195,5.8
41269,CN4823900000000,48,239,"Jackson County, TX",Mar-20,7614,7275,339,4.5
41270,CN4824100000000,48,241,"Jasper County, TX",Mar-20,12932,11708,1224,9.5
41271,CN4824300000000,48,243,"Jeff Davis County, TX",Mar-20,1018,972,46,4.5
41272,CN4824500000000,48,245,"Jefferson County, TX",Mar-20,106763,97534,9229,8.6
41273,CN4824700000000,48,247,"Jim Hogg County, TX",Mar-20,1838,1721,117,6.4
41274,CN4824900000000,48,249,"Jim Wells County, TX",Mar-20,16797,15458,1339,8.0
41275,CN4825100000000,48,251,"Johnson County, TX",Mar-20,81681,77832,3849,4.7
41276,CN4825300000000,48,253,"Jones County, TX",Mar-20,5735,5386,349,6.1
41277,CN4825500000000,48,255,"Karnes County, TX",Mar-20,7347,7076,271,3.7
41278,CN4825700000000,48,257,"Kaufman County, TX",Mar-20,64650,61617,3033,4.7
41279,CN4825900000000,48,259,"Kendall County, TX",Mar-20,21998,21117,881,4.0
41280,CN4826100000000,48,261,"Kenedy County, TX",Mar-20,208,197,11,5.3
41281,CN4826300000000,48,263,"Kent County, TX",Mar-20,486,460,26,5.3
41282,CN4826500000000,48,265,"Kerr County, TX",Mar-20,22147,21148,999,4.5
41283,CN4826700000000,48,267,"Kimble County, TX",Mar-20,1819,1732,87,4.8
41284,CN4826900000000,48,269,"King County, TX",Mar-20,238,231,7,2.9
41285,CN4827100000000,48,271,"Kinney County, TX",Mar-20,1417,1328,89,6.3
41286,CN4827300000000,48,273,"Kleberg County, TX",Mar-20,13679,12798,881,6.4
41287,CN4827500000000,48,275,"Knox County, TX",Mar-20,1437,1359,78,5.4
41288,CN4827700000000,48,277,"Lamar County, TX",Mar-20,24216,23133,1083,4.5
41289,CN4827900000000,48,279,"Lamb County, TX",Mar-20,5372,5081,291,5.4
41290,CN4828100000000,48,281,"Lampasas County, TX",Mar-20,9223,8787,436,4.7
41291,CN4828300000000,48,283,"La Salle County, TX",Mar-20,4383,4194,189,4.3
41292,CN4828500000000,48,285,"Lavaca County, TX",Mar-20,8319,7963,356,4.3
41293,CN4828700000000,48,287,"Lee County, TX",Mar-20,9967,9550,417,4.2
41294,CN4828900000000,48,289,"Leon County, TX",Mar-20,6322,5907,415,6.6
41295,CN4829100000000,48,291,"Liberty County, TX",Mar-20,33566,30924,2642,7.9
41296,CN4829300000000,48,293,"Limestone County, TX",Mar-20,8629,8143,486,5.6
41297,CN4829500000000,48,295,"Lipscomb County, TX",Mar-20,1634,1575,59,3.6
41298,CN4829700000000,48,297,"Live Oak County, TX",Mar-20,5643,5380,263,4.7
41299,CN4829900000000,48,299,"Llano County, TX",Mar-20,8721,8285,436,5.0
41300,CN4830100000000,48,301,"Loving County, TX",Mar-20,711,705,6,0.8
41301,CN4830300000000,48,303,"Lubbock County, TX",Mar-20,156202,150119,6083,3.9
41302,CN4830500000000,48,305,"Lynn County, TX",Mar-20,2789,2650,139,5.0
41303,CN4830700000000,48,307,"McCulloch County, TX",Mar-20,3317,3107,210,6.3
41304,CN4830900000000,48,309,"McLennan County, TX",Mar-20,118957,113167,5790,4.9
41305,CN4831100000000,48,311,"McMullen County, TX",Mar-20,898,881,17,1.9
41306,CN4831300000000,48,313,"Madison County, TX",Mar-20,4486,4226,260,5.8
41307,CN4831500000000,48,315,"Marion County, TX",Mar-20,4196,3907,289,6.9
41308,CN4831700000000,48,317,"Martin County, TX",Mar-20,2850,2737,113,4.0
41309,CN4831900000000,48,319,"Mason County, TX",Mar-20,1768,1681,87,4.9
41310,CN4832100000000,48,321,"Matagorda County, TX",Mar-20,16970,15648,1322,7.8
41311,CN4832300000000,48,323,"Maverick County, TX",Mar-20,24809,21696,3113,12.5
41312,CN4832500000000,48,325,"Medina County, TX",Mar-20,21785,20750,1035,4.8
41313,CN4832700000000,48,327,"Menard County, TX",Mar-20,859,820,39,4.5
41314,CN4832900000000,48,329,"Midland County, TX",Mar-20,105392,101854,3538,3.4
41315,CN4833100000000,48,331,"Milam County, TX",Mar-20,9630,9027,603,6.3
41316,CN4833300000000,48,333,"Mills County, TX",Mar-20,1902,1820,82,4.3
41317,CN4833500000000,48,335,"Mitchell County, TX",Mar-20,2308,2202,106,4.6
41318,CN4833700000000,48,337,"Montague County, TX",Mar-20,9278,8852,426,4.6
41319,CN4833900000000,48,339,"Montgomery County, TX",Mar-20,284136,269808,14328,5.0
41320,CN4834100000000,48,341,"Moore County, TX",Mar-20,10672,10294,378,3.5
41321,CN4834300000000,48,343,"Morris County, TX",Mar-20,4830,4480,350,7.2
41322,CN4834500000000,48,345,"Motley County, TX",Mar-20,479,451,28,5.8
41323,CN4834700000000,48,347,"Nacogdoches County, TX",Mar-20,27972,26418,1554,5.6
41324,CN4834900000000,48,349,"Navarro County, TX",Mar-20,23888,22674,1214,5.1
41325,CN4835100000000,48,351,"Newton County, TX",Mar-20,5211,4707,504,9.7
41326,CN4835300000000,48,353,"Nolan County, TX",Mar-20,7248,6933,315,4.3
41327,CN4835500000000,48,355,"Nueces County, TX",Mar-20,165989,156151,9838,5.9
41328,CN4835700000000,48,357,"Ochiltree County, TX",Mar-20,4277,4067,210,4.9
41329,CN4835900000000,48,359,"Oldham County, TX",Mar-20,916,881,35,3.8
41330,CN4836100000000,48,361,"Orange County, TX",Mar-20,36154,33412,2742,7.6
41331,CN4836300000000,48,363,"Palo Pinto County, TX",Mar-20,13399,12789,610,4.6
41332,CN4836500000000,48,365,"Panola County, TX",Mar-20,10208,9554,654,6.4
41333,CN4836700000000,48,367,"Parker County, TX",Mar-20,66960,63981,2979,4.4
41334,CN4836900000000,48,369,"Parmer County, TX",Mar-20,4817,4658,159,3.3
41335,CN4837100000000,48,371,"Pecos County, TX",Mar-20,6341,6000,341,5.4
41336,CN4837300000000,48,373,"Polk County, TX",Mar-20,18256,16973,1283,7.0
41337,CN4837500000000,48,375,"Potter County, TX",Mar-20,54939,52857,2082,3.8
41338,CN4837700000000,48,377,"Presidio County, TX",Mar-20,3212,2863,349,10.9
41339,CN4837900000000,48,379,"Rains County, TX",Mar-20,6108,5848,260,4.3
41340,CN4838100000000,48,381,"Randall County, TX",Mar-20,71851,69324,2527,3.5
41341,CN4838300000000,48,383,"Reagan County, TX",Mar-20,1913,1833,80,4.2
41342,CN4838500000000,48,385,"Real County, TX",Mar-20,1030,958,72,7.0
41343,CN4838700000000,48,387,"Red River County, TX",Mar-20,5119,4793,326,6.4
41344,CN4838900000000,48,389,"Reeves County, TX",Mar-20,12358,11976,382,3.1
41345,CN4839100000000,48,391,"Refugio County, TX",Mar-20,3138,2971,167,5.3
41346,CN4839300000000,48,393,"Roberts County, TX",Mar-20,419,399,20,4.8
41347,CN4839500000000,48,395,"Robertson County, TX",Mar-20,7822,7418,404,5.2
41348,CN4839700000000,48,397,"Rockwall County, TX",Mar-20,51985,49756,2229,4.3
41349,CN4839900000000,48,399,"Runnels County, TX",Mar-20,4601,4386,215,4.7
41350,CN4840100000000,48,401,"Rusk County, TX",Mar-20,22561,21297,1264,5.6
41351,CN4840300000000,48,403,"Sabine County, TX",Mar-20,3728,3363,365,9.8
41352,CN4840500000000,48,405,"San Augustine County, TX",Mar-20,3545,3295,250,7.1
41353,CN4840700000000,48,407,"San Jacinto County, TX",Mar-20,11794,11038,756,6.4
41354,CN4840900000000,48,409,"San Patricio County, TX",Mar-20,29831,27530,2301,7.7
41355,CN4841100000000,48,411,"San Saba County, TX",Mar-20,2551,2421,130,5.1
41356,CN4841300000000,48,413,"Schleicher County, TX",Mar-20,1303,1242,61,4.7
41357,CN4841500000000,48,415,"Scurry County, TX",Mar-20,6690,6332,358,5.4
41358,CN4841700000000,48,417,"Shackelford County, TX",Mar-20,1880,1806,74,3.9
41359,CN4841900000000,48,419,"Shelby County, TX",Mar-20,11105,10458,647,5.8
41360,CN4842100000000,48,421,"Sherman County, TX",Mar-20,1383,1333,50,3.6
41361,CN4842300000000,48,423,"Smith County, TX",Mar-20,105512,100345,5167,4.9
41362,CN4842500000000,48,425,"Somervell County, TX",Mar-20,4340,4118,222,5.1
41363,CN4842700000000,48,427,"Starr County, TX",Mar-20,27069,22393,4676,17.3
41364,CN4842900000000,48,429,"Stephens County, TX",Mar-20,4052,3861,191,4.7
41365,CN4843100000000,48,431,"Sterling County, TX",Mar-20,578,550,28,4.8
41366,CN4843300000000,48,433,"Stonewall County, TX",Mar-20,567,543,24,4.2
41367,CN4843500000000,48,435,"Sutton County, TX",Mar-20,1336,1260,76,5.7
41368,CN4843700000000,48,437,"Swisher County, TX",Mar-20,2591,2459,132,5.1
41369,CN4843900000000,48,439,"Tarrant County, TX",Mar-20,1075094,1024230,50864,4.7
41370,CN4844100000000,48,441,"Taylor County, TX",Mar-20,66326,63554,2772,4.2
41371,CN4844300000000,48,443,"Terrell County, TX",Mar-20,370,348,22,5.9
41372,CN4844500000000,48,445,"Terry County, TX",Mar-20,4901,4640,261,5.3
41373,CN4844700000000,48,447,"Throckmorton County, TX",Mar-20,641,609,32,5.0
41374,CN4844900000000,48,449,"Titus County, TX",Mar-20,13091,12320,771,5.9
41375,CN4845100000000,48,451,"Tom Green County, TX",Mar-20,53699,51381,2318,4.3
41376,CN4845300000000,48,453,"Travis County, TX",Mar-20,739887,712454,27433,3.7
41377,CN4845500000000,48,455,"Trinity County, TX",Mar-20,5331,4960,371,7.0
41378,CN4845700000000,48,457,"Tyler County, TX",Mar-20,7217,6611,606,8.4
41379,CN4845900000000,48,459,"Upshur County, TX",Mar-20,17534,16512,1022,5.8
41380,CN4846100000000,48,461,"Upton County, TX",Mar-20,1696,1624,72,4.2
41381,CN4846300000000,48,463,"Uvalde County, TX",Mar-20,11417,10837,580,5.1
41382,CN4846500000000,48,465,"Val Verde County, TX",Mar-20,23184,21882,1302,5.6
41383,CN4846700000000,48,467,"Van Zandt County, TX",Mar-20,25988,24733,1255,4.8
41384,CN4846900000000,48,469,"Victoria County, TX",Mar-20,42016,39719,2297,5.5
41385,CN4847100000000,48,471,"Walker County, TX",Mar-20,24192,22844,1348,5.6
41386,CN4847300000000,48,473,"Waller County, TX",Mar-20,23541,22243,1298,5.5
41387,CN4847500000000,48,475,"Ward County, TX",Mar-20,7879,7577,302,3.8
41388,CN4847700000000,48,477,"Washington County, TX",Mar-20,15314,14533,781,5.1
41389,CN4847900000000,48,479,"Webb County, TX",Mar-20,118469,111869,6600,5.6
41390,CN4848100000000,48,481,"Wharton County, TX",Mar-20,21770,20628,1142,5.2
41391,CN4848300000000,48,483,"Wheeler County, TX",Mar-20,2261,2153,108,4.8
41392,CN4848500000000,48,485,"Wichita County, TX",Mar-20,55223,52703,2520,4.6
41393,CN4848700000000,48,487,"Wilbarger County, TX",Mar-20,4968,4697,271,5.5
41394,CN4848900000000,48,489,"Willacy County, TX",Mar-20,6959,6190,769,11.1
41395,CN4849100000000,48,491,"Williamson County, TX",Mar-20,313796,301244,12552,4.0
41396,CN4849300000000,48,493,"Wilson County, TX",Mar-20,24770,23704,1066,4.3
41397,CN4849500000000,48,495,"Winkler County, TX",Mar-20,3986,3795,191,4.8
41398,CN4849700000000,48,497,"Wise County, TX",Mar-20,31965,30218,1747,5.5
41399,CN4849900000000,48,499,"Wood County, TX",Mar-20,17817,16777,1040,5.8
41400,CN4850100000000,48,501,"Yoakum County, TX",Mar-20,3765,3580,185,4.9
41401,CN4850300000000,48,503,"Young County, TX",Mar-20,7874,7520,354,4.5
41402,CN4850500000000,48,505,"Zapata County, TX",Mar-20,4874,4455,419,8.6
41403,CN4850700000000,48,507,"Zavala County, TX",Mar-20,3478,3055,423,12.2
41404,CN4900100000000,49,1,"Beaver County, UT",Mar-20,2919,2801,118,4.0
41405,CN4900300000000,49,3,"Box Elder County, UT",Mar-20,26045,24991,1054,4.0
41406,CN4900500000000,49,5,"Cache County, UT",Mar-20,64488,62431,2057,3.2
41407,CN4900700000000,49,7,"Carbon County, UT",Mar-20,8571,8071,500,5.8
41408,CN4900900000000,49,9,"Daggett County, UT",Mar-20,353,331,22,6.2
41409,CN4901100000000,49,11,"Davis County, UT",Mar-20,174132,167640,6492,3.7
41410,CN4901300000000,49,13,"Duchesne County, UT",Mar-20,7777,7221,556,7.1
41411,CN4901500000000,49,15,"Emery County, UT",Mar-20,4380,4082,298,6.8
41412,CN4901700000000,49,17,"Garfield County, UT",Mar-20,2618,2271,347,13.3
41413,CN4901900000000,49,19,"Grand County, UT",Mar-20,6299,5859,440,7.0
41414,CN4902100000000,49,21,"Iron County, UT",Mar-20,25180,24108,1072,4.3
41415,CN4902300000000,49,23,"Juab County, UT",Mar-20,5812,5592,220,3.8
41416,CN4902500000000,49,25,"Kane County, UT",Mar-20,3690,3497,193,5.2
41417,CN4902700000000,49,27,"Millard County, UT",Mar-20,6124,5879,245,4.0
41418,CN4902900000000,49,29,"Morgan County, UT",Mar-20,5568,5368,200,3.6
41419,CN4903100000000,49,31,"Piute County, UT",Mar-20,485,447,38,7.8
41420,CN4903300000000,49,33,"Rich County, UT",Mar-20,1004,944,60,6.0
41421,CN4903500000000,49,35,"Salt Lake County, UT",Mar-20,637855,612450,25405,4.0
41422,CN4903700000000,49,37,"San Juan County, UT",Mar-20,5778,5229,549,9.5
41423,CN4903900000000,49,39,"Sanpete County, UT",Mar-20,12561,11945,616,4.9
41424,CN4904100000000,49,41,"Sevier County, UT",Mar-20,9776,9260,516,5.3
41425,CN4904300000000,49,43,"Summit County, UT",Mar-20,26701,25785,916,3.4
41426,CN4904500000000,49,45,"Tooele County, UT",Mar-20,34190,32711,1479,4.3
41427,CN4904700000000,49,47,"Uintah County, UT",Mar-20,13571,12506,1065,7.8
41428,CN4904900000000,49,49,"Utah County, UT",Mar-20,312307,300919,11388,3.6
41429,CN4905100000000,49,51,"Wasatch County, UT",Mar-20,16453,15762,691,4.2
41430,CN4905300000000,49,53,"Washington County, UT",Mar-20,77664,74169,3495,4.5
41431,CN4905500000000,49,55,"Wayne County, UT",Mar-20,1452,1279,173,11.9
41432,CN4905700000000,49,57,"Weber County, UT",Mar-20,128251,122477,5774,4.5
41433,CN5000100000000,50,1,"Addison County, VT",Mar-20,20591,19883,708,3.4
41434,CN5000300000000,50,3,"Bennington County, VT",Mar-20,17743,17005,738,4.2
41435,CN5000500000000,50,5,"Caledonia County, VT",Mar-20,14345,13713,632,4.4
41436,CN5000700000000,50,7,"Chittenden County, VT",Mar-20,95057,92688,2369,2.5
41437,CN5000900000000,50,9,"Essex County, VT",Mar-20,2667,2517,150,5.6
41438,CN5001100000000,50,11,"Franklin County, VT",Mar-20,26893,25997,896,3.3
41439,CN5001300000000,50,13,"Grand Isle County, VT",Mar-20,4030,3841,189,4.7
41440,CN5001500000000,50,15,"Lamoille County, VT",Mar-20,13742,13068,674,4.9
41441,CN5001700000000,50,17,"Orange County, VT",Mar-20,15912,15272,640,4.0
41442,CN5001900000000,50,19,"Orleans County, VT",Mar-20,13145,12191,954,7.3
41443,CN5002100000000,50,21,"Rutland County, VT",Mar-20,30267,29175,1092,3.6
41444,CN5002300000000,50,23,"Washington County, VT",Mar-20,34870,33742,1128,3.2
41445,CN5002500000000,50,25,"Windham County, VT",Mar-20,21949,21282,667,3.0
41446,CN5002700000000,50,27,"Windsor County, VT",Mar-20,28674,27898,776,2.7
41447,CN5100100000000,51,1,"Accomack County, VA",Mar-20,16332,15545,787,4.8
41448,CN5100300000000,51,3,"Albemarle County, VA",Mar-20,58584,56943,1641,2.8
41449,CN5100500000000,51,5,"Alleghany County, VA",Mar-20,6983,6673,310,4.4
41450,CN5100700000000,51,7,"Amelia County, VA",Mar-20,6290,6063,227,3.6
41451,CN5100900000000,51,9,"Amherst County, VA",Mar-20,15202,14611,591,3.9
41452,CN5101100000000,51,11,"Appomattox County, VA",Mar-20,7226,6914,312,4.3
41453,CN5101300000000,51,13,"Arlington County, VA",Mar-20,157198,153757,3441,2.2
41454,CN5101500000000,51,15,"Augusta County, VA",Mar-20,37479,36391,1088,2.9
41455,CN5101700000000,51,17,"Bath County, VA",Mar-20,2485,2407,78,3.1
41456,CN5101900000000,51,19,"Bedford County, VA",Mar-20,38859,37505,1354,3.5
41457,CN5102100000000,51,21,"Bland County, VA",Mar-20,2914,2796,118,4.0
41458,CN5102300000000,51,23,"Botetourt County, VA",Mar-20,17584,17047,537,3.1
41459,CN5102500000000,51,25,"Brunswick County, VA",Mar-20,5997,5674,323,5.4
41460,CN5102700000000,51,27,"Buchanan County, VA",Mar-20,6763,6208,555,8.2
41461,CN5102900000000,51,29,"Buckingham County, VA",Mar-20,6592,6248,344,5.2
41462,CN5103100000000,51,31,"Campbell County, VA",Mar-20,26327,25326,1001,3.8
41463,CN5103300000000,51,33,"Caroline County, VA",Mar-20,15484,14902,582,3.8
41464,CN5103500000000,51,35,"Carroll County, VA",Mar-20,13531,12719,812,6.0
41465,CN5103600000000,51,36,"Charles City County, VA",Mar-20,3682,3539,143,3.9
41466,CN5103700000000,51,37,"Charlotte County, VA",Mar-20,5307,5066,241,4.5
41467,CN5104100000000,51,41,"Chesterfield County, VA",Mar-20,190718,184639,6079,3.2
41468,CN5104300000000,51,43,"Clarke County, VA",Mar-20,7618,7404,214,2.8
41469,CN5104500000000,51,45,"Craig County, VA",Mar-20,2312,2232,80,3.5
41470,CN5104700000000,51,47,"Culpeper County, VA",Mar-20,24880,24079,801,3.2
41471,CN5104900000000,51,49,"Cumberland County, VA",Mar-20,4656,4495,161,3.5
41472,CN5105100000000,51,51,"Dickenson County, VA",Mar-20,4901,4542,359,7.3
41473,CN5105300000000,51,53,"Dinwiddie County, VA",Mar-20,13795,13264,531,3.8
41474,CN5105700000000,51,57,"Essex County, VA",Mar-20,5524,5270,254,4.6
41475,CN5105900000000,51,59,"Fairfax County, VA",Mar-20,646716,629555,17161,2.7
41476,CN5106100000000,51,61,"Fauquier County, VA",Mar-20,37510,36440,1070,2.9
41477,CN5106300000000,51,63,"Floyd County, VA",Mar-20,8155,7870,285,3.5
41478,CN5106500000000,51,65,"Fluvanna County, VA",Mar-20,14323,13917,406,2.8
41479,CN5106700000000,51,67,"Franklin County, VA",Mar-20,26592,25620,972,3.7
41480,CN5106900000000,51,69,"Frederick County, VA",Mar-20,48695,47341,1354,2.8
41481,CN5107100000000,51,71,"Giles County, VA",Mar-20,8031,7663,368,4.6
41482,CN5107300000000,51,73,"Gloucester County, VA",Mar-20,19713,19109,604,3.1
41483,CN5107500000000,51,75,"Goochland County, VA",Mar-20,11306,10960,346,3.1
41484,CN5107700000000,51,77,"Grayson County, VA",Mar-20,8368,7927,441,5.3
41485,CN5107900000000,51,79,"Greene County, VA",Mar-20,10743,10455,288,2.7
41486,CN5108100000000,51,81,"Greensville County, VA",Mar-20,4290,4121,169,3.9
41487,CN5108300000000,51,83,"Halifax County, VA",Mar-20,15735,14965,770,4.9
41488,CN5108500000000,51,85,"Hanover County, VA",Mar-20,60104,58402,1702,2.8
41489,CN5108700000000,51,87,"Henrico County, VA",Mar-20,185290,179338,5952,3.2
41490,CN5108900000000,51,89,"Henry County, VA",Mar-20,24020,23048,972,4.0
41491,CN5109100000000,51,91,"Highland County, VA",Mar-20,1123,1079,44,3.9
41492,CN5109300000000,51,93,"Isle of Wight County, VA",Mar-20,19541,18906,635,3.2
41493,CN5109500000000,51,95,"James City County, VA",Mar-20,37000,35829,1171,3.2
41494,CN5109700000000,51,97,"King and Queen County, VA",Mar-20,3858,3738,120,3.1
41495,CN5109900000000,51,99,"King George County, VA",Mar-20,13830,13379,451,3.3
41496,CN5110100000000,51,101,"King William County, VA",Mar-20,9255,8949,306,3.3
41497,CN5110300000000,51,103,"Lancaster County, VA",Mar-20,5564,5171,393,7.1
41498,CN5110500000000,51,105,"Lee County, VA",Mar-20,8382,7956,426,5.1
41499,CN5110700000000,51,107,"Loudoun County, VA",Mar-20,226550,220544,6006,2.7
41500,CN5110900000000,51,109,"Louisa County, VA",Mar-20,20443,19796,647,3.2
41501,CN5111100000000,51,111,"Lunenburg County, VA",Mar-20,5274,5091,183,3.5
41502,CN5111300000000,51,113,"Madison County, VA",Mar-20,7410,7225,185,2.5
41503,CN5111500000000,51,115,"Mathews County, VA",Mar-20,4181,4036,145,3.5
41504,CN5111700000000,51,117,"Mecklenburg County, VA",Mar-20,12226,11639,587,4.8
41505,CN5111900000000,51,119,"Middlesex County, VA",Mar-20,5264,5090,174,3.3
41506,CN5112100000000,51,121,"Montgomery County, VA",Mar-20,50999,49273,1726,3.4
41507,CN5112500000000,51,125,"Nelson County, VA",Mar-20,7528,7283,245,3.3
41508,CN5112700000000,51,127,"New Kent County, VA",Mar-20,12618,12288,330,2.6
41509,CN5113100000000,51,131,"Northampton County, VA",Mar-20,5180,4877,303,5.8
41510,CN5113300000000,51,133,"Northumberland County, VA",Mar-20,5646,5244,402,7.1
41511,CN5113500000000,51,135,"Nottoway County, VA",Mar-20,7358,7122,236,3.2
41512,CN5113700000000,51,137,"Orange County, VA",Mar-20,17559,16972,587,3.3
41513,CN5113900000000,51,139,"Page County, VA",Mar-20,11978,11269,709,5.9
41514,CN5114100000000,51,141,"Patrick County, VA",Mar-20,7118,6792,326,4.6
41515,CN5114300000000,51,143,"Pittsylvania County, VA",Mar-20,30092,28783,1309,4.3
41516,CN5114500000000,51,145,"Powhatan County, VA",Mar-20,14349,13914,435,3.0
41517,CN5114700000000,51,147,"Prince Edward County, VA",Mar-20,10499,10011,488,4.6
41518,CN5114900000000,51,149,"Prince George County, VA",Mar-20,15343,14752,591,3.9
41519,CN5115300000000,51,153,"Prince William County, VA",Mar-20,250553,243069,7484,3.0
41520,CN5115500000000,51,155,"Pulaski County, VA",Mar-20,16679,15687,992,5.9
41521,CN5115700000000,51,157,"Rappahannock County, VA",Mar-20,3679,3572,107,2.9
41522,CN5115900000000,51,159,"Richmond County, VA",Mar-20,4096,3951,145,3.5
41523,CN5116100000000,51,161,"Roanoke County, VA",Mar-20,50091,48526,1565,3.1
41524,CN5116300000000,51,163,"Rockbridge County, VA",Mar-20,10795,10447,348,3.2
41525,CN5116500000000,51,165,"Rockingham County, VA",Mar-20,41655,40471,1184,2.8
41526,CN5116700000000,51,167,"Russell County, VA",Mar-20,11417,10755,662,5.8
41527,CN5116900000000,51,169,"Scott County, VA",Mar-20,9204,8836,368,4.0
41528,CN5117100000000,51,171,"Shenandoah County, VA",Mar-20,22624,21917,707,3.1
41529,CN5117300000000,51,173,"Smyth County, VA",Mar-20,13821,13163,658,4.8
41530,CN5117500000000,51,175,"Southampton County, VA",Mar-20,8975,8667,308,3.4
41531,CN5117700000000,51,177,"Spotsylvania County, VA",Mar-20,68243,65988,2255,3.3
41532,CN5117900000000,51,179,"Stafford County, VA",Mar-20,73538,71212,2326,3.2
41533,CN5118100000000,51,181,"Surry County, VA",Mar-20,3641,3498,143,3.9
41534,CN5118300000000,51,183,"Sussex County, VA",Mar-20,3745,3547,198,5.3
41535,CN5118500000000,51,185,"Tazewell County, VA",Mar-20,15729,14830,899,5.7
41536,CN5118700000000,51,187,"Warren County, VA",Mar-20,20740,20060,680,3.3
41537,CN5119100000000,51,191,"Washington County, VA",Mar-20,26968,25902,1066,4.0
41538,CN5119300000000,51,193,"Westmoreland County, VA",Mar-20,9492,9059,433,4.6
41539,CN5119500000000,51,195,"Wise County, VA",Mar-20,13720,12888,832,6.1
41540,CN5119700000000,51,197,"Wythe County, VA",Mar-20,13725,13009,716,5.2
41541,CN5119900000000,51,199,"York County, VA",Mar-20,33188,32166,1022,3.1
41542,CN5151000000000,51,510,"Alexandria city, VA",Mar-20,103295,100688,2607,2.5
41543,CN5152000000000,51,520,"Bristol city, VA",Mar-20,7276,6951,325,4.5
41544,CN5153000000000,51,530,"Buena Vista city, VA",Mar-20,3727,3618,109,2.9
41545,CN5154000000000,51,540,"Charlottesville city, VA",Mar-20,27218,26496,722,2.7
41546,CN5155000000000,51,550,"Chesapeake city, VA",Mar-20,124318,120172,4146,3.3
41547,CN5157000000000,51,570,"Colonial Heights city, VA",Mar-20,8945,8635,310,3.5
41548,CN5158000000000,51,580,"Covington city, VA",Mar-20,2466,2308,158,6.4
41549,CN5159000000000,51,590,"Danville city, VA",Mar-20,19303,18072,1231,6.4
41550,CN5159500000000,51,595,"Emporia city, VA",Mar-20,2272,2156,116,5.1
41551,CN5160000000000,51,600,"Fairfax city, VA",Mar-20,13691,13350,341,2.5
41552,CN5161000000000,51,610,"Falls Church city, VA",Mar-20,8742,8543,199,2.3
41553,CN5162000000000,51,620,"Franklin city, VA",Mar-20,3580,3431,149,4.2
41554,CN5163000000000,51,630,"Fredericksburg city, VA",Mar-20,14443,13910,533,3.7
41555,CN5164000000000,51,640,"Galax city, VA",Mar-20,3007,2809,198,6.6
41556,CN5165000000000,51,650,"Hampton city, VA",Mar-20,65352,62495,2857,4.4
41557,CN5166000000000,51,660,"Harrisonburg city, VA",Mar-20,25179,24233,946,3.8
41558,CN5167000000000,51,670,"Hopewell city, VA",Mar-20,9885,9399,486,4.9
41559,CN5167800000000,51,678,"Lexington city, VA",Mar-20,2145,2040,105,4.9
41560,CN5168000000000,51,680,"Lynchburg city, VA",Mar-20,36901,35300,1601,4.3
41561,CN5168300000000,51,683,"Manassas city, VA",Mar-20,22505,21827,678,3.0
41562,CN5168500000000,51,685,"Manassas Park city, VA",Mar-20,9537,9265,272,2.9
41563,CN5169000000000,51,690,"Martinsville city, VA",Mar-20,5540,5255,285,5.1
41564,CN5170000000000,51,700,"Newport News city, VA",Mar-20,90356,86569,3787,4.2
41565,CN5171000000000,51,710,"Norfolk city, VA",Mar-20,113317,108819,4498,4.0
41566,CN5172000000000,51,720,"Norton city, VA",Mar-20,1712,1620,92,5.4
41567,CN5173000000000,51,730,"Petersburg city, VA",Mar-20,13356,12462,894,6.7
41568,CN5173500000000,51,735,"Poquoson city, VA",Mar-20,6419,6234,185,2.9
41569,CN5174000000000,51,740,"Portsmouth city, VA",Mar-20,44950,42947,2003,4.5
41570,CN5175000000000,51,750,"Radford city, VA",Mar-20,8861,8462,399,4.5
41571,CN5176000000000,51,760,"Richmond city, VA",Mar-20,120511,115874,4637,3.8
41572,CN5177000000000,51,770,"Roanoke city, VA",Mar-20,49944,48095,1849,3.7
41573,CN5177500000000,51,775,"Salem city, VA",Mar-20,13202,12749,453,3.4
41574,CN5179000000000,51,790,"Staunton city, VA",Mar-20,12335,11952,383,3.1
41575,CN5180000000000,51,800,"Suffolk city, VA",Mar-20,45235,43636,1599,3.5
41576,CN5181000000000,51,810,"Virginia Beach city, VA",Mar-20,236016,228594,7422,3.1
41577,CN5182000000000,51,820,"Waynesboro city, VA",Mar-20,10796,10441,355,3.3
41578,CN5183000000000,51,830,"Williamsburg city, VA",Mar-20,6807,6488,319,4.7
41579,CN5184000000000,51,840,"Winchester city, VA",Mar-20,14923,14432,491,3.3
41580,CN5300100000000,53,1,"Adams County, WA",Mar-20,8464,7979,485,5.7
41581,CN5300300000000,53,3,"Asotin County, WA",Mar-20,10220,9846,374,3.7
41582,CN5300500000000,53,5,"Benton County, WA",Mar-20,103923,98678,5245,5.0
41583,CN5300700000000,53,7,"Chelan County, WA",Mar-20,42624,40402,2222,5.2
41584,CN5300900000000,53,9,"Clallam County, WA",Mar-20,28217,26549,1668,5.9
41585,CN5301100000000,53,11,"Clark County, WA",Mar-20,242747,232047,10700,4.4
41586,CN5301300000000,53,13,"Columbia County, WA",Mar-20,1728,1636,92,5.3
41587,CN5301500000000,53,15,"Cowlitz County, WA",Mar-20,47986,45262,2724,5.7
41588,CN5301700000000,53,17,"Douglas County, WA",Mar-20,20499,19290,1209,5.9
41589,CN5301900000000,53,19,"Ferry County, WA",Mar-20,2357,2061,296,12.6
41590,CN5302100000000,53,21,"Franklin County, WA",Mar-20,42158,39561,2597,6.2
41591,CN5302300000000,53,23,"Garfield County, WA",Mar-20,770,725,45,5.8
41592,CN5302500000000,53,25,"Grant County, WA",Mar-20,44589,41488,3101,7.0
41593,CN5302700000000,53,27,"Grays Harbor County, WA",Mar-20,28568,26631,1937,6.8
41594,CN5302900000000,53,29,"Island County, WA",Mar-20,36034,34362,1672,4.6
41595,CN5303100000000,53,31,"Jefferson County, WA",Mar-20,12908,12225,683,5.3
41596,CN5303300000000,53,33,"King County, WA",Mar-20,1282512,1211129,71383,5.6
41597,CN5303500000000,53,35,"Kitsap County, WA",Mar-20,129623,124196,5427,4.2
41598,CN5303700000000,53,37,"Kittitas County, WA",Mar-20,23677,22383,1294,5.5
41599,CN5303900000000,53,39,"Klickitat County, WA",Mar-20,9580,9051,529,5.5
41600,CN5304100000000,53,41,"Lewis County, WA",Mar-20,34412,32290,2122,6.2
41601,CN5304300000000,53,43,"Lincoln County, WA",Mar-20,4586,4330,256,5.6
41602,CN5304500000000,53,45,"Mason County, WA",Mar-20,25326,23777,1549,6.1
41603,CN5304700000000,53,47,"Okanogan County, WA",Mar-20,18333,16891,1442,7.9
41604,CN5304900000000,53,49,"Pacific County, WA",Mar-20,8358,7800,558,6.7
41605,CN5305100000000,53,51,"Pend Oreille County, WA",Mar-20,5016,4623,393,7.8
41606,CN5305300000000,53,53,"Pierce County, WA",Mar-20,445908,423923,21985,4.9
41607,CN5305500000000,53,55,"San Juan County, WA",Mar-20,8135,7789,346,4.3
41608,CN5305700000000,53,57,"Skagit County, WA",Mar-20,62319,59096,3223,5.2
41609,CN5305900000000,53,59,"Skamania County, WA",Mar-20,5520,5240,280,5.1
41610,CN5306100000000,53,61,"Snohomish County, WA",Mar-20,436723,411131,25592,5.9
41611,CN5306300000000,53,63,"Spokane County, WA",Mar-20,257345,244261,13084,5.1
41612,CN5306500000000,53,65,"Stevens County, WA",Mar-20,18932,17465,1467,7.7
41613,CN5306700000000,53,67,"Thurston County, WA",Mar-20,145437,138675,6762,4.6
41614,CN5306900000000,53,69,"Wahkiakum County, WA",Mar-20,1325,1233,92,6.9
41615,CN5307100000000,53,71,"Walla Walla County, WA",Mar-20,29844,28515,1329,4.5
41616,CN5307300000000,53,73,"Whatcom County, WA",Mar-20,115692,110210,5482,4.7
41617,CN5307500000000,53,75,"Whitman County, WA",Mar-20,23788,22897,891,3.7
41618,CN5307700000000,53,77,"Yakima County, WA",Mar-20,128874,120207,8667,6.7
41619,CN5400100000000,54,1,"Barbour County, WV",Mar-20,7576,7004,572,7.6
41620,CN5400300000000,54,3,"Berkeley County, WV",Mar-20,58770,56583,2187,3.7
41621,CN5400500000000,54,5,"Boone County, WV",Mar-20,7668,7078,590,7.7
41622,CN5400700000000,54,7,"Braxton County, WV",Mar-20,5497,4845,652,11.9
41623,CN5400900000000,54,9,"Brooke County, WV",Mar-20,10082,9396,686,6.8
41624,CN5401100000000,54,11,"Cabell County, WV",Mar-20,42334,40382,1952,4.6
41625,CN5401300000000,54,13,"Calhoun County, WV",Mar-20,2762,2209,553,20.0
41626,CN5401500000000,54,15,"Clay County, WV",Mar-20,3321,2892,429,12.9
41627,CN5401700000000,54,17,"Doddridge County, WV",Mar-20,4076,3847,229,5.6
41628,CN5401900000000,54,19,"Fayette County, WV",Mar-20,16586,15233,1353,8.2
41629,CN5402100000000,54,21,"Gilmer County, WV",Mar-20,2516,2272,244,9.7
41630,CN5402300000000,54,23,"Grant County, WV",Mar-20,6056,5681,375,6.2
41631,CN5402500000000,54,25,"Greenbrier County, WV",Mar-20,16145,15146,999,6.2
41632,CN5402700000000,54,27,"Hampshire County, WV",Mar-20,10993,10514,479,4.4
41633,CN5402900000000,54,29,"Hancock County, WV",Mar-20,13155,12305,850,6.5
41634,CN5403100000000,54,31,"Hardy County, WV",Mar-20,5913,5552,361,6.1
41635,CN5403300000000,54,33,"Harrison County, WV",Mar-20,35374,33355,2019,5.7
41636,CN5403500000000,54,35,"Jackson County, WV",Mar-20,13618,12710,908,6.7
41637,CN5403700000000,54,37,"Jefferson County, WV",Mar-20,30664,29660,1004,3.3
41638,CN5403900000000,54,39,"Kanawha County, WV",Mar-20,83690,79107,4583,5.5
41639,CN5404100000000,54,41,"Lewis County, WV",Mar-20,6704,6128,576,8.6
41640,CN5404300000000,54,43,"Lincoln County, WV",Mar-20,7466,6839,627,8.4
41641,CN5404500000000,54,45,"Logan County, WV",Mar-20,11785,10752,1033,8.8
41642,CN5404700000000,54,47,"McDowell County, WV",Mar-20,4721,4153,568,12.0
41643,CN5404900000000,54,49,"Marion County, WV",Mar-20,26374,24814,1560,5.9
41644,CN5405100000000,54,51,"Marshall County, WV",Mar-20,14316,13026,1290,9.0
41645,CN5405300000000,54,53,"Mason County, WV",Mar-20,10510,9727,783,7.5
41646,CN5405500000000,54,55,"Mercer County, WV",Mar-20,21596,20135,1461,6.8
41647,CN5405700000000,54,57,"Mineral County, WV",Mar-20,12814,12012,802,6.3
41648,CN5405900000000,54,59,"Mingo County, WV",Mar-20,7307,6461,846,11.6
41649,CN5406100000000,54,61,"Monongalia County, WV",Mar-20,56437,54219,2218,3.9
41650,CN5406300000000,54,63,"Monroe County, WV",Mar-20,6171,5776,395,6.4
41651,CN5406500000000,54,65,"Morgan County, WV",Mar-20,8260,7899,361,4.4
41652,CN5406700000000,54,67,"Nicholas County, WV",Mar-20,9895,8943,952,9.6
41653,CN5406900000000,54,69,"Ohio County, WV",Mar-20,21112,19889,1223,5.8
41654,CN5407100000000,54,71,"Pendleton County, WV",Mar-20,3774,3609,165,4.4
41655,CN5407300000000,54,73,"Pleasants County, WV",Mar-20,3018,2742,276,9.1
41656,CN5407500000000,54,75,"Pocahontas County, WV",Mar-20,4187,3918,269,6.4
41657,CN5407700000000,54,77,"Preston County, WV",Mar-20,16186,15250,936,5.8
41658,CN5407900000000,54,79,"Putnam County, WV",Mar-20,27351,25956,1395,5.1
41659,CN5408100000000,54,81,"Raleigh County, WV",Mar-20,30732,28863,1869,6.1
41660,CN5408300000000,54,83,"Randolph County, WV",Mar-20,12550,11643,907,7.2
41661,CN5408500000000,54,85,"Ritchie County, WV",Mar-20,4551,4177,374,8.2
41662,CN5408700000000,54,87,"Roane County, WV",Mar-20,5401,4745,656,12.1
41663,CN5408900000000,54,89,"Summers County, WV",Mar-20,4413,4086,327,7.4
41664,CN5409100000000,54,91,"Taylor County, WV",Mar-20,8104,7607,497,6.1
41665,CN5409300000000,54,93,"Tucker County, WV",Mar-20,3425,3186,239,7.0
41666,CN5409500000000,54,95,"Tyler County, WV",Mar-20,3216,2889,327,10.2
41667,CN5409700000000,54,97,"Upshur County, WV",Mar-20,9816,9075,741,7.5
41668,CN5409900000000,54,99,"Wayne County, WV",Mar-20,16277,15174,1103,6.8
41669,CN5410100000000,54,101,"Webster County, WV",Mar-20,3493,3158,335,9.6
41670,CN5410300000000,54,103,"Wetzel County, WV",Mar-20,6836,6195,641,9.4
41671,CN5410500000000,54,105,"Wirt County, WV",Mar-20,2406,2139,267,11.1
41672,CN5410700000000,54,107,"Wood County, WV",Mar-20,37735,35305,2430,6.4
41673,CN5410900000000,54,109,"Wyoming County, WV",Mar-20,6840,6227,613,9.0
41674,CN5500100000000,55,1,"Adams County, WI",Mar-20,8000,7495,505,6.3
41675,CN5500300000000,55,3,"Ashland County, WI",Mar-20,7597,7211,386,5.1
41676,CN5500500000000,55,5,"Barron County, WI",Mar-20,23943,22828,1115,4.7
41677,CN5500700000000,55,7,"Bayfield County, WI",Mar-20,7322,6850,472,6.4
41678,CN5500900000000,55,9,"Brown County, WI",Mar-20,140385,136293,4092,2.9
41679,CN5501100000000,55,11,"Buffalo County, WI",Mar-20,6360,6020,340,5.3
41680,CN5501300000000,55,13,"Burnett County, WI",Mar-20,6945,6468,477,6.9
41681,CN5501500000000,55,15,"Calumet County, WI",Mar-20,27084,26377,707,2.6
41682,CN5501700000000,55,17,"Chippewa County, WI",Mar-20,33367,31789,1578,4.7
41683,CN5501900000000,55,19,"Clark County, WI",Mar-20,17506,16895,611,3.5
41684,CN5502100000000,55,21,"Columbia County, WI",Mar-20,31654,30620,1034,3.3
41685,CN5502300000000,55,23,"Crawford County, WI",Mar-20,7408,6997,411,5.5
41686,CN5502500000000,55,25,"Dane County, WI",Mar-20,321488,314587,6901,2.1
41687,CN5502700000000,55,27,"Dodge County, WI",Mar-20,46946,45486,1460,3.1
41688,CN5502900000000,55,29,"Door County, WI",Mar-20,13811,13131,680,4.9
41689,CN5503100000000,55,31,"Douglas County, WI",Mar-20,22875,21690,1185,5.2
41690,CN5503300000000,55,33,"Dunn County, WI",Mar-20,24521,23529,992,4.0
41691,CN5503500000000,55,35,"Eau Claire County, WI",Mar-20,58685,56993,1692,2.9
41692,CN5503700000000,55,37,"Florence County, WI",Mar-20,2161,2055,106,4.9
41693,CN5503900000000,55,39,"Fond du Lac County, WI",Mar-20,56591,54900,1691,3.0
41694,CN5504100000000,55,41,"Forest County, WI",Mar-20,3976,3749,227,5.7
41695,CN5504300000000,55,43,"Grant County, WI",Mar-20,28129,27161,968,3.4
41696,CN5504500000000,55,45,"Green County, WI",Mar-20,21053,20391,662,3.1
41697,CN5504700000000,55,47,"Green Lake County, WI",Mar-20,9002,8584,418,4.6
41698,CN5504900000000,55,49,"Iowa County, WI",Mar-20,13754,13264,490,3.6
41699,CN5505100000000,55,51,"Iron County, WI",Mar-20,2500,2342,158,6.3
41700,CN5505300000000,55,53,"Jackson County, WI",Mar-20,10091,9596,495,4.9
41701,CN5505500000000,55,55,"Jefferson County, WI",Mar-20,45650,44161,1489,3.3
41702,CN5505700000000,55,57,"Juneau County, WI",Mar-20,13360,12831,529,4.0
41703,CN5505900000000,55,59,"Kenosha County, WI",Mar-20,86918,83500,3418,3.9
41704,CN5506100000000,55,61,"Kewaunee County, WI",Mar-20,10883,10529,354,3.3
41705,CN5506300000000,55,63,"La Crosse County, WI",Mar-20,65856,64101,1755,2.7
41706,CN5506500000000,55,65,"Lafayette County, WI",Mar-20,10082,9781,301,3.0
41707,CN5506700000000,55,67,"Langlade County, WI",Mar-20,9201,8770,431,4.7
41708,CN5506900000000,55,69,"Lincoln County, WI",Mar-20,15022,14369,653,4.3
41709,CN5507100000000,55,71,"Manitowoc County, WI",Mar-20,40686,39236,1450,3.6
41710,CN5507300000000,55,73,"Marathon County, WI",Mar-20,73692,71668,2024,2.7
41711,CN5507500000000,55,75,"Marinette County, WI",Mar-20,19212,18240,972,5.1
41712,CN5507700000000,55,77,"Marquette County, WI",Mar-20,7710,7355,355,4.6
41713,CN5507800000000,55,78,"Menominee County, WI",Mar-20,1560,1467,93,6.0
41714,CN5507900000000,55,79,"Milwaukee County, WI",Mar-20,462615,445666,16949,3.7
41715,CN5508100000000,55,81,"Monroe County, WI",Mar-20,23176,22479,697,3.0
41716,CN5508300000000,55,83,"Oconto County, WI",Mar-20,20494,19590,904,4.4
41717,CN5508500000000,55,85,"Oneida County, WI",Mar-20,17047,16129,918,5.4
41718,CN5508700000000,55,87,"Outagamie County, WI",Mar-20,101547,98710,2837,2.8
41719,CN5508900000000,55,89,"Ozaukee County, WI",Mar-20,48449,47255,1194,2.5
41720,CN5509100000000,55,91,"Pepin County, WI",Mar-20,4032,3860,172,4.3
41721,CN5509300000000,55,93,"Pierce County, WI",Mar-20,25073,24053,1020,4.1
41722,CN5509500000000,55,95,"Polk County, WI",Mar-20,24460,23094,1366,5.6
41723,CN5509700000000,55,97,"Portage County, WI",Mar-20,38678,37363,1315,3.4
41724,CN5509900000000,55,99,"Price County, WI",Mar-20,6347,6054,293,4.6
41725,CN5510100000000,55,101,"Racine County, WI",Mar-20,96984,92966,4018,4.1
41726,CN5510300000000,55,103,"Richland County, WI",Mar-20,9080,8765,315,3.5
41727,CN5510500000000,55,105,"Rock County, WI",Mar-20,84583,81348,3235,3.8
41728,CN5510700000000,55,107,"Rusk County, WI",Mar-20,6597,6255,342,5.2
41729,CN5510900000000,55,109,"St. Croix County, WI",Mar-20,49911,47907,2004,4.0
41730,CN5511100000000,55,111,"Sauk County, WI",Mar-20,34994,33859,1135,3.2
41731,CN5511300000000,55,113,"Sawyer County, WI",Mar-20,7603,7169,434,5.7
41732,CN5511500000000,55,115,"Shawano County, WI",Mar-20,20642,19896,746,3.6
41733,CN5511700000000,55,117,"Sheboygan County, WI",Mar-20,60703,59011,1692,2.8
41734,CN5511900000000,55,119,"Taylor County, WI",Mar-20,10881,10369,512,4.7
41735,CN5512100000000,55,121,"Trempealeau County, WI",Mar-20,15774,15094,680,4.3
41736,CN5512300000000,55,123,"Vernon County, WI",Mar-20,15128,14540,588,3.9
41737,CN5512500000000,55,125,"Vilas County, WI",Mar-20,9526,9002,524,5.5
41738,CN5512700000000,55,127,"Walworth County, WI",Mar-20,57080,55199,1881,3.3
41739,CN5512900000000,55,129,"Washburn County, WI",Mar-20,7717,7309,408,5.3
41740,CN5513100000000,55,131,"Washington County, WI",Mar-20,76567,74452,2115,2.8
41741,CN5513300000000,55,133,"Waukesha County, WI",Mar-20,222810,216817,5993,2.7
41742,CN5513500000000,55,135,"Waupaca County, WI",Mar-20,25574,24700,874,3.4
41743,CN5513700000000,55,137,"Waushara County, WI",Mar-20,11233,10714,519,4.6
41744,CN5513900000000,55,139,"Winnebago County, WI",Mar-20,90159,87717,2442,2.7
41745,CN5514100000000,55,141,"Wood County, WI",Mar-20,34891,33497,1394,4.0
41746,CN5600100000000,56,1,"Albany County, WY",Mar-20,22029,21339,690,3.1
41747,CN5600300000000,56,3,"Big Horn County, WY",Mar-20,5189,4903,286,5.5
41748,CN5600500000000,56,5,"Campbell County, WY",Mar-20,23566,22600,966,4.1
41749,CN5600700000000,56,7,"Carbon County, WY",Mar-20,7655,7328,327,4.3
41750,CN5600900000000,56,9,"Converse County, WY",Mar-20,8997,8700,297,3.3
41751,CN5601100000000,56,11,"Crook County, WY",Mar-20,3581,3449,132,3.7
41752,CN5601300000000,56,13,"Fremont County, WY",Mar-20,19127,18115,1012,5.3
41753,CN5601500000000,56,15,"Goshen County, WY",Mar-20,6433,6180,253,3.9
41754,CN5601700000000,56,17,"Hot Springs County, WY",Mar-20,2227,2130,97,4.4
41755,CN5601900000000,56,19,"Johnson County, WY",Mar-20,4033,3849,184,4.6
41756,CN5602100000000,56,21,"Laramie County, WY",Mar-20,49303,47371,1932,3.9
41757,CN5602300000000,56,23,"Lincoln County, WY",Mar-20,8992,8588,404,4.5
41758,CN5602500000000,56,25,"Natrona County, WY",Mar-20,39310,37489,1821,4.6
41759,CN5602700000000,56,27,"Niobrara County, WY",Mar-20,1183,1148,35,3.0
41760,CN5602900000000,56,29,"Park County, WY",Mar-20,14646,13894,752,5.1
41761,CN5603100000000,56,31,"Platte County, WY",Mar-20,4549,4349,200,4.4
41762,CN5603300000000,56,33,"Sheridan County, WY",Mar-20,15795,15091,704,4.5
41763,CN5603500000000,56,35,"Sublette County, WY",Mar-20,4050,3785,265,6.5
41764,CN5603700000000,56,37,"Sweetwater County, WY",Mar-20,21297,20097,1200,5.6
41765,CN5603900000000,56,39,"Teton County, WY",Mar-20,14961,14527,434,2.9
41766,CN5604100000000,56,41,"Uinta County, WY",Mar-20,9026,8589,437,4.8
41767,CN5604300000000,56,43,"Washakie County, WY",Mar-20,3840,3638,202,5.3
41768,CN5604500000000,56,45,"Weston County, WY",Mar-20,3816,3691,125,3.3
41769,CN7200100000000,72,1,"Adjuntas Municipio, PR",Mar-20,0,0,0,0.0
41770,CN7200300000000,72,3,"Aguada Municipio, PR",Mar-20,0,0,0,0.0
41771,CN7200500000000,72,5,"Aguadilla Municipio, PR",Mar-20,0,0,0,0.0
41772,CN7200700000000,72,7,"Aguas Buenas Municipio, PR",Mar-20,0,0,0,0.0
41773,CN7200900000000,72,9,"Aibonito Municipio, PR",Mar-20,0,0,0,0.0
41774,CN7201100000000,72,11,"Anasco Municipio, PR",Mar-20,0,0,0,0.0
41775,CN7201300000000,72,13,"Arecibo Municipio, PR",Mar-20,0,0,0,0.0
41776,CN7201500000000,72,15,"Arroyo Municipio, PR",Mar-20,0,0,0,0.0
41777,CN7201700000000,72,17,"Barceloneta Municipio, PR",Mar-20,0,0,0,0.0
41778,CN7201900000000,72,19,"Barranquitas Municipio, PR",Mar-20,0,0,0,0.0
41779,CN7202100000000,72,21,"Bayamon Municipio, PR",Mar-20,0,0,0,0.0
41780,CN7202300000000,72,23,"Cabo Rojo Municipio, PR",Mar-20,0,0,0,0.0
41781,CN7202500000000,72,25,"Caguas Municipio, PR",Mar-20,0,0,0,0.0
41782,CN7202700000000,72,27,"Camuy Municipio, PR",Mar-20,0,0,0,0.0
41783,CN7202900000000,72,29,"Canovanas Municipio, PR",Mar-20,0,0,0,0.0
41784,CN7203100000000,72,31,"Carolina Municipio, PR",Mar-20,0,0,0,0.0
41785,CN7203300000000,72,33,"Catano Municipio, PR",Mar-20,0,0,0,0.0
41786,CN7203500000000,72,35,"Cayey Municipio, PR",Mar-20,0,0,0,0.0
41787,CN7203700000000,72,37,"Ceiba Municipio, PR",Mar-20,0,0,0,0.0
41788,CN7203900000000,72,39,"Ciales Municipio, PR",Mar-20,0,0,0,0.0
41789,CN7204100000000,72,41,"Cidra Municipio, PR",Mar-20,0,0,0,0.0
41790,CN7204300000000,72,43,"Coamo Municipio, PR",Mar-20,0,0,0,0.0
41791,CN7204500000000,72,45,"Comerio Municipio, PR",Mar-20,0,0,0,0.0
41792,CN7204700000000,72,47,"Corozal Municipio, PR",Mar-20,0,0,0,0.0
41793,CN7204900000000,72,49,"Culebra Municipio, PR",Mar-20,0,0,0,0.0
41794,CN7205100000000,72,51,"Dorado Municipio, PR",Mar-20,0,0,0,0.0
41795,CN7205300000000,72,53,"Fajardo Municipio, PR",Mar-20,0,0,0,0.0
41796,CN7205400000000,72,54,"Florida Municipio, PR",Mar-20,0,0,0,0.0
41797,CN7205500000000,72,55,"Guanica Municipio, PR",Mar-20,0,0,0,0.0
41798,CN7205700000000,72,57,"Guayama Municipio, PR",Mar-20,0,0,0,0.0
41799,CN7205900000000,72,59,"Guayanilla Municipio, PR",Mar-20,0,0,0,0.0
41800,CN7206100000000,72,61,"Guaynabo Municipio, PR",Mar-20,0,0,0,0.0
41801,CN7206300000000,72,63,"Gurabo Municipio, PR",Mar-20,0,0,0,0.0
41802,CN7206500000000,72,65,"Hatillo Municipio, PR",Mar-20,0,0,0,0.0
41803,CN7206700000000,72,67,"Hormigueros Municipio, PR",Mar-20,0,0,0,0.0
41804,CN7206900000000,72,69,"Humacao Municipio, PR",Mar-20,0,0,0,0.0
41805,CN7207100000000,72,71,"Isabela Municipio, PR",Mar-20,0,0,0,0.0
41806,CN7207300000000,72,73,"Jayuya Municipio, PR",Mar-20,0,0,0,0.0
41807,CN7207500000000,72,75,"Juana Diaz Municipio, PR",Mar-20,0,0,0,0.0
41808,CN7207700000000,72,77,"Juncos Municipio, PR",Mar-20,0,0,0,0.0
41809,CN7207900000000,72,79,"Lajas Municipio, PR",Mar-20,0,0,0,0.0
41810,CN7208100000000,72,81,"Lares Municipio, PR",Mar-20,0,0,0,0.0
41811,CN7208300000000,72,83,"Las Marias Municipio, PR",Mar-20,0,0,0,0.0
41812,CN7208500000000,72,85,"Las Piedras Municipio, PR",Mar-20,0,0,0,0.0
41813,CN7208700000000,72,87,"Loiza Municipio, PR",Mar-20,0,0,0,0.0
41814,CN7208900000000,72,89,"Luquillo Municipio, PR",Mar-20,0,0,0,0.0
41815,CN7209100000000,72,91,"Manati Municipio, PR",Mar-20,0,0,0,0.0
41816,CN7209300000000,72,93,"Maricao Municipio, PR",Mar-20,0,0,0,0.0
41817,CN7209500000000,72,95,"Maunabo Municipio, PR",Mar-20,0,0,0,0.0
41818,CN7209700000000,72,97,"Mayaguez Municipio, PR",Mar-20,0,0,0,0.0
41819,CN7209900000000,72,99,"Moca Municipio, PR",Mar-20,0,0,0,0.0
41820,CN7210100000000,72,101,"Morovis Municipio, PR",Mar-20,0,0,0,0.0
41821,CN7210300000000,72,103,"Naguabo Municipio, PR",Mar-20,0,0,0,0.0
41822,CN7210500000000,72,105,"Naranjito Municipio, PR",Mar-20,0,0,0,0.0
41823,CN7210700000000,72,107,"Orocovis Municipio, PR",Mar-20,0,0,0,0.0
41824,CN7210900000000,72,109,"Patillas Municipio, PR",Mar-20,0,0,0,0.0
41825,CN7211100000000,72,111,"Penuelas Municipio, PR",Mar-20,0,0,0,0.0
41826,CN7211300000000,72,113,"Ponce Municipio, PR",Mar-20,0,0,0,0.0
41827,CN7211500000000,72,115,"Quebradillas Municipio, PR",Mar-20,0,0,0,0.0
41828,CN7211700000000,72,117,"Rincon Municipio, PR",Mar-20,0,0,0,0.0
41829,CN7211900000000,72,119,"Rio Grande Municipio, PR",Mar-20,0,0,0,0.0
41830,CN7212100000000,72,121,"Sabana Grande Municipio, PR",Mar-20,0,0,0,0.0
41831,CN7212300000000,72,123,"Salinas Municipio, PR",Mar-20,0,0,0,0.0
41832,CN7212500000000,72,125,"San German Municipio, PR",Mar-20,0,0,0,0.0
41833,CN7212700000000,72,127,"San Juan Municipio, PR",Mar-20,0,0,0,0.0
41834,CN7212900000000,72,129,"San Lorenzo Municipio, PR",Mar-20,0,0,0,0.0
41835,CN7213100000000,72,131,"San Sebastian Municipio, PR",Mar-20,0,0,0,0.0
41836,CN7213300000000,72,133,"Santa Isabel Municipio, PR",Mar-20,0,0,0,0.0
41837,CN7213500000000,72,135,"Toa Alta Municipio, PR",Mar-20,0,0,0,0.0
41838,CN7213700000000,72,137,"Toa Baja Municipio, PR",Mar-20,0,0,0,0.0
41839,CN7213900000000,72,139,"Trujillo Alto Municipio, PR",Mar-20,0,0,0,0.0
41840,CN7214100000000,72,141,"Utuado Municipio, PR",Mar-20,0,0,0,0.0
41841,CN7214300000000,72,143,"Vega Alta Municipio, PR",Mar-20,0,0,0,0.0
41842,CN7214500000000,72,145,"Vega Baja Municipio, PR",Mar-20,0,0,0,0.0
41843,CN7214700000000,72,147,"Vieques Municipio, PR",Mar-20,0,0,0,0.0
41844,CN7214900000000,72,149,"Villalba Municipio, PR",Mar-20,0,0,0,0.0
41845,CN7215100000000,72,151,"Yabucoa Municipio, PR",Mar-20,0,0,0,0.0
41846,CN7215300000000,72,153,"Yauco Municipio, PR",Mar-20,0,0,0,0.0
41847,CN0100100000000,01,1,"Autauga County, AL",Apr-20 p,25215,22321,2894,11.5
41848,CN0100300000000,01,3,"Baldwin County, AL",Apr-20 p,91688,77301,14387,15.7
41849,CN0100500000000,01,5,"Barbour County, AL",Apr-20 p,8101,7292,809,10.0
41850,CN0100700000000,01,7,"Bibb County, AL",Apr-20 p,9041,7437,1604,17.7
41851,CN0100900000000,01,9,"Blount County, AL",Apr-20 p,23980,21711,2269,9.5
41852,CN0101100000000,01,11,"Bullock County, AL",Apr-20 p,4335,3942,393,9.1
41853,CN0101300000000,01,13,"Butler County, AL",Apr-20 p,9617,7714,1903,19.8
41854,CN0101500000000,01,15,"Calhoun County, AL",Apr-20 p,47701,38939,8762,18.4
41855,CN0101700000000,01,17,"Chambers County, AL",Apr-20 p,16287,13776,2511,15.4
41856,CN0101900000000,01,19,"Cherokee County, AL",Apr-20 p,12493,11071,1422,11.4
41857,CN0102100000000,01,21,"Chilton County, AL",Apr-20 p,19351,16993,2358,12.2
41858,CN0102300000000,01,23,"Choctaw County, AL",Apr-20 p,4283,3774,509,11.9
41859,CN0102500000000,01,25,"Clarke County, AL",Apr-20 p,7403,6296,1107,15.0
41860,CN0102700000000,01,27,"Clay County, AL",Apr-20 p,5782,5247,535,9.3
41861,CN0102900000000,01,29,"Cleburne County, AL",Apr-20 p,5503,4815,688,12.5
41862,CN0103100000000,01,31,"Coffee County, AL",Apr-20 p,20174,18267,1907,9.5
41863,CN0103300000000,01,33,"Colbert County, AL",Apr-20 p,23701,19788,3913,16.5
41864,CN0103500000000,01,35,"Conecuh County, AL",Apr-20 p,4483,3818,665,14.8
41865,CN0103700000000,01,37,"Coosa County, AL",Apr-20 p,4441,3862,579,13.0
41866,CN0103900000000,01,39,"Covington County, AL",Apr-20 p,14576,13034,1542,10.6
41867,CN0104100000000,01,41,"Crenshaw County, AL",Apr-20 p,6447,5441,1006,15.6
41868,CN0104300000000,01,43,"Cullman County, AL",Apr-20 p,37900,33450,4450,11.7
41869,CN0104500000000,01,45,"Dale County, AL",Apr-20 p,19387,17547,1840,9.5
41870,CN0104700000000,01,47,"Dallas County, AL",Apr-20 p,15427,12202,3225,20.9
41871,CN0104900000000,01,49,"DeKalb County, AL",Apr-20 p,30168,26644,3524,11.7
41872,CN0105100000000,01,51,"Elmore County, AL",Apr-20 p,36122,32104,4018,11.1
41873,CN0105300000000,01,53,"Escambia County, AL",Apr-20 p,14046,12448,1598,11.4
41874,CN0105500000000,01,55,"Etowah County, AL",Apr-20 p,44060,35776,8284,18.8
41875,CN0105700000000,01,57,"Fayette County, AL",Apr-20 p,6332,5631,701,11.1
41876,CN0105900000000,01,59,"Franklin County, AL",Apr-20 p,14118,12529,1589,11.3
41877,CN0106100000000,01,61,"Geneva County, AL",Apr-20 p,10044,9235,809,8.1
41878,CN0106300000000,01,63,"Greene County, AL",Apr-20 p,3114,2424,690,22.2
41879,CN0106500000000,01,65,"Hale County, AL",Apr-20 p,6374,5044,1330,20.9
41880,CN0106700000000,01,67,"Henry County, AL",Apr-20 p,6372,5784,588,9.2
41881,CN0106900000000,01,69,"Houston County, AL",Apr-20 p,43726,38906,4820,11.0
41882,CN0107100000000,01,71,"Jackson County, AL",Apr-20 p,22696,19685,3011,13.3
41883,CN0107300000000,01,73,"Jefferson County, AL",Apr-20 p,313537,273910,39627,12.6
41884,CN0107500000000,01,75,"Lamar County, AL",Apr-20 p,5614,4988,626,11.2
41885,CN0107700000000,01,77,"Lauderdale County, AL",Apr-20 p,41834,35740,6094,14.6
41886,CN0107900000000,01,79,"Lawrence County, AL",Apr-20 p,13405,11832,1573,11.7
41887,CN0108100000000,01,81,"Lee County, AL",Apr-20 p,74057,64841,9216,12.4
41888,CN0108300000000,01,83,"Limestone County, AL",Apr-20 p,42808,37910,4898,11.4
41889,CN0108500000000,01,85,"Lowndes County, AL",Apr-20 p,4006,2964,1042,26.0
41890,CN0108700000000,01,87,"Macon County, AL",Apr-20 p,8269,6718,1551,18.8
41891,CN0108900000000,01,89,"Madison County, AL",Apr-20 p,179201,160476,18725,10.4
41892,CN0109100000000,01,91,"Marengo County, AL",Apr-20 p,7330,6459,871,11.9
41893,CN0109300000000,01,93,"Marion County, AL",Apr-20 p,12517,11127,1390,11.1
41894,CN0109500000000,01,95,"Marshall County, AL",Apr-20 p,42915,38192,4723,11.0
41895,CN0109700000000,01,97,"Mobile County, AL",Apr-20 p,186844,158671,28173,15.1
41896,CN0109900000000,01,99,"Monroe County, AL",Apr-20 p,7401,6224,1177,15.9
41897,CN0110100000000,01,101,"Montgomery County, AL",Apr-20 p,106077,90087,15990,15.1
41898,CN0110300000000,01,103,"Morgan County, AL",Apr-20 p,54744,48573,6171,11.3
41899,CN0110500000000,01,105,"Perry County, AL",Apr-20 p,3532,2795,737,20.9
41900,CN0110700000000,01,107,"Pickens County, AL",Apr-20 p,7688,6589,1099,14.3
41901,CN0110900000000,01,109,"Pike County, AL",Apr-20 p,14774,13431,1343,9.1
41902,CN0111100000000,01,111,"Randolph County, AL",Apr-20 p,9361,8210,1151,12.3
41903,CN0111300000000,01,113,"Russell County, AL",Apr-20 p,22199,19924,2275,10.2
41904,CN0111500000000,01,115,"St. Clair County, AL",Apr-20 p,40125,34839,5286,13.2
41905,CN0111700000000,01,117,"Shelby County, AL",Apr-20 p,110465,100282,10183,9.2
41906,CN0111900000000,01,119,"Sumter County, AL",Apr-20 p,4675,4090,585,12.5
41907,CN0112100000000,01,121,"Talladega County, AL",Apr-20 p,37932,30391,7541,19.9
41908,CN0112300000000,01,123,"Tallapoosa County, AL",Apr-20 p,19109,15985,3124,16.3
41909,CN0112500000000,01,125,"Tuscaloosa County, AL",Apr-20 p,106255,88367,17888,16.8
41910,CN0112700000000,01,127,"Walker County, AL",Apr-20 p,24827,21624,3203,12.9
41911,CN0112900000000,01,129,"Washington County, AL",Apr-20 p,6466,5654,812,12.6
41912,CN0113100000000,01,131,"Wilcox County, AL",Apr-20 p,2886,2227,659,22.8
41913,CN0113300000000,01,133,"Winston County, AL",Apr-20 p,9827,8807,1020,10.4
41914,CN0201300000000,02,13,"Aleutians East Borough, AK",Apr-20 p,2159,1935,224,10.4
41915,CN0201600000000,02,16,"Aleutians West Census Area, AK",Apr-20 p,3847,3674,173,4.5
41916,CN0202000000000,02,20,"Anchorage Borough/municipality, AK",Apr-20 p,143916,123911,20005,13.9
41917,CN0205000000000,02,50,"Bethel Census Area, AK",Apr-20 p,6678,5835,843,12.6
41918,CN0206000000000,02,60,"Bristol Bay Borough, AK",Apr-20 p,406,365,41,10.1
41919,CN0206800000000,02,68,"Denali Borough, AK",Apr-20 p,673,508,165,24.5
41920,CN0207000000000,02,70,"Dillingham Census Area, AK",Apr-20 p,1837,1661,176,9.6
41921,CN0209000000000,02,90,"Fairbanks North Star Borough, AK",Apr-20 p,42769,37960,4809,11.2
41922,CN0210000000000,02,100,"Haines Borough, AK",Apr-20 p,1022,743,279,27.3
41923,CN0210500000000,02,105,"Hoonah-Angoon Census Area, AK",Apr-20 p,942,772,170,18.0
41924,CN0211000000000,02,110,"Juneau Borough/city, AK",Apr-20 p,16338,14577,1761,10.8
41925,CN0212200000000,02,122,"Kenai Peninsula Borough, AK",Apr-20 p,24197,20041,4156,17.2
41926,CN0213000000000,02,130,"Ketchikan Gateway Borough, AK",Apr-20 p,6241,5163,1078,17.3
41927,CN0215000000000,02,150,"Kodiak Island Borough, AK",Apr-20 p,5497,4913,584,10.6
41928,CN0215800000000,02,158,"Kusilvak Census Area, AK",Apr-20 p,2536,2019,517,20.4
41929,CN0216400000000,02,164,"Lake and Peninsula Borough, AK",Apr-20 p,614,527,87,14.2
41930,CN0217000000000,02,170,"Matanuska-Susitna Borough, AK",Apr-20 p,45913,38775,7138,15.5
41931,CN0218000000000,02,180,"Nome Census Area, AK",Apr-20 p,3897,3405,492,12.6
41932,CN0218500000000,02,185,"North Slope Borough, AK",Apr-20 p,3289,3107,182,5.5
41933,CN0218800000000,02,188,"Northwest Arctic Borough, AK",Apr-20 p,2768,2367,401,14.5
41934,CN0219500000000,02,195,"Petersburg Borough, AK",Apr-20 p,1293,1092,201,15.5
41935,CN0219800000000,02,198,"Prince of Wales-Hyder Census Area, AK",Apr-20 p,2639,2281,358,13.6
41936,CN0222000000000,02,220,"Sitka Borough/city, AK",Apr-20 p,4063,3544,519,12.8
41937,CN0223000000000,02,230,"Skagway Municipality, AK",Apr-20 p,671,460,211,31.4
41938,CN0224000000000,02,240,"Southeast Fairbanks Census Area, AK",Apr-20 p,2570,2300,270,10.5
41939,CN0226100000000,02,261,"Valdez-Cordova Census Area, AK",Apr-20 p,4352,3744,608,14.0
41940,CN0227500000000,02,275,"Wrangell Borough/city, AK",Apr-20 p,939,801,138,14.7
41941,CN0228200000000,02,282,"Yakutat Borough/city, AK",Apr-20 p,311,283,28,9.0
41942,CN0229000000000,02,290,"Yukon-Koyukuk Census Area, AK",Apr-20 p,2368,2004,364,15.4
41943,CN0400100000000,04,1,"Apache County, AZ",Apr-20 p,20206,17086,3120,15.4
41944,CN0400300000000,04,3,"Cochise County, AZ",Apr-20 p,51362,45833,5529,10.8
41945,CN0400500000000,04,5,"Coconino County, AZ",Apr-20 p,72728,60426,12302,16.9
41946,CN0400700000000,04,7,"Gila County, AZ",Apr-20 p,21275,18816,2459,11.6
41947,CN0400900000000,04,9,"Graham County, AZ",Apr-20 p,15506,14337,1169,7.5
41948,CN0401100000000,04,11,"Greenlee County, AZ",Apr-20 p,4595,4353,242,5.3
41949,CN0401200000000,04,12,"La Paz County, AZ",Apr-20 p,9131,8357,774,8.5
41950,CN0401300000000,04,13,"Maricopa County, AZ",Apr-20 p,2309037,2023872,285165,12.3
41951,CN0401500000000,04,15,"Mohave County, AZ",Apr-20 p,88406,72209,16197,18.3
41952,CN0401700000000,04,17,"Navajo County, AZ",Apr-20 p,40409,34728,5681,14.1
41953,CN0401900000000,04,19,"Pima County, AZ",Apr-20 p,496958,434139,62819,12.6
41954,CN0402100000000,04,21,"Pinal County, AZ",Apr-20 p,183823,161994,21829,11.9
41955,CN0402300000000,04,23,"Santa Cruz County, AZ",Apr-20 p,19555,16513,3042,15.6
41956,CN0402500000000,04,25,"Yavapai County, AZ",Apr-20 p,110896,95552,15344,13.8
41957,CN0402700000000,04,27,"Yuma County, AZ",Apr-20 p,97390,74908,22482,23.1
41958,CN0500100000000,05,1,"Arkansas County, AR",Apr-20 p,8817,8368,449,5.1
41959,CN0500300000000,05,3,"Ashley County, AR",Apr-20 p,7234,6320,914,12.6
41960,CN0500500000000,05,5,"Baxter County, AR",Apr-20 p,15910,14207,1703,10.7
41961,CN0500700000000,05,7,"Benton County, AR",Apr-20 p,130669,120253,10416,8.0
41962,CN0500900000000,05,9,"Boone County, AR",Apr-20 p,15883,14181,1702,10.7
41963,CN0501100000000,05,11,"Bradley County, AR",Apr-20 p,4393,3919,474,10.8
41964,CN0501300000000,05,13,"Calhoun County, AR",Apr-20 p,2311,2139,172,7.4
41965,CN0501500000000,05,15,"Carroll County, AR",Apr-20 p,12569,11231,1338,10.6
41966,CN0501700000000,05,17,"Chicot County, AR",Apr-20 p,3075,2644,431,14.0
41967,CN0501900000000,05,19,"Clark County, AR",Apr-20 p,9312,8452,860,9.2
41968,CN0502100000000,05,21,"Clay County, AR",Apr-20 p,5334,4859,475,8.9
41969,CN0502300000000,05,23,"Cleburne County, AR",Apr-20 p,9334,7844,1490,16.0
41970,CN0502500000000,05,25,"Cleveland County, AR",Apr-20 p,3021,2745,276,9.1
41971,CN0502700000000,05,27,"Columbia County, AR",Apr-20 p,8983,8131,852,9.5
41972,CN0502900000000,05,29,"Conway County, AR",Apr-20 p,8107,7194,913,11.3
41973,CN0503100000000,05,31,"Craighead County, AR",Apr-20 p,54418,49399,5019,9.2
41974,CN0503300000000,05,33,"Crawford County, AR",Apr-20 p,25653,23208,2445,9.5
41975,CN0503500000000,05,35,"Crittenden County, AR",Apr-20 p,20921,18020,2901,13.9
41976,CN0503700000000,05,37,"Cross County, AR",Apr-20 p,7240,6478,762,10.5
41977,CN0503900000000,05,39,"Dallas County, AR",Apr-20 p,2656,2411,245,9.2
41978,CN0504100000000,05,41,"Desha County, AR",Apr-20 p,5106,4617,489,9.6
41979,CN0504300000000,05,43,"Drew County, AR",Apr-20 p,7528,6712,816,10.8
41980,CN0504500000000,05,45,"Faulkner County, AR",Apr-20 p,60024,53537,6487,10.8
41981,CN0504700000000,05,47,"Franklin County, AR",Apr-20 p,7186,6553,633,8.8
41982,CN0504900000000,05,49,"Fulton County, AR",Apr-20 p,4781,4420,361,7.6
41983,CN0505100000000,05,51,"Garland County, AR",Apr-20 p,40003,33887,6116,15.3
41984,CN0505300000000,05,53,"Grant County, AR",Apr-20 p,7851,7200,651,8.3
41985,CN0505500000000,05,55,"Greene County, AR",Apr-20 p,19693,17578,2115,10.7
41986,CN0505700000000,05,57,"Hempstead County, AR",Apr-20 p,9412,8596,816,8.7
41987,CN0505900000000,05,59,"Hot Spring County, AR",Apr-20 p,13492,12075,1417,10.5
41988,CN0506100000000,05,61,"Howard County, AR",Apr-20 p,5333,4898,435,8.2
41989,CN0506300000000,05,63,"Independence County, AR",Apr-20 p,16688,14711,1977,11.8
41990,CN0506500000000,05,65,"Izard County, AR",Apr-20 p,4814,4152,662,13.8
41991,CN0506700000000,05,67,"Jackson County, AR",Apr-20 p,5402,4835,567,10.5
41992,CN0506900000000,05,69,"Jefferson County, AR",Apr-20 p,26039,23272,2767,10.6
41993,CN0507100000000,05,71,"Johnson County, AR",Apr-20 p,9989,8857,1132,11.3
41994,CN0507300000000,05,73,"Lafayette County, AR",Apr-20 p,2360,2114,246,10.4
41995,CN0507500000000,05,75,"Lawrence County, AR",Apr-20 p,6697,6060,637,9.5
41996,CN0507700000000,05,77,"Lee County, AR",Apr-20 p,2648,2383,265,10.0
41997,CN0507900000000,05,79,"Lincoln County, AR",Apr-20 p,3693,3352,341,9.2
41998,CN0508100000000,05,81,"Little River County, AR",Apr-20 p,5143,4586,557,10.8
41999,CN0508300000000,05,83,"Logan County, AR",Apr-20 p,8235,7208,1027,12.5
42000,CN0508500000000,05,85,"Lonoke County, AR",Apr-20 p,32581,29506,3075,9.4
42001,CN0508700000000,05,87,"Madison County, AR",Apr-20 p,6911,6507,404,5.8
42002,CN0508900000000,05,89,"Marion County, AR",Apr-20 p,6331,5763,568,9.0
42003,CN0509100000000,05,91,"Miller County, AR",Apr-20 p,19080,16444,2636,13.8
42004,CN0509300000000,05,93,"Mississippi County, AR",Apr-20 p,17062,14822,2240,13.1
42005,CN0509500000000,05,95,"Monroe County, AR",Apr-20 p,2611,2391,220,8.4
42006,CN0509700000000,05,97,"Montgomery County, AR",Apr-20 p,2773,2483,290,10.5
42007,CN0509900000000,05,99,"Nevada County, AR",Apr-20 p,3478,3159,319,9.2
42008,CN0510100000000,05,101,"Newton County, AR",Apr-20 p,3228,2933,295,9.1
42009,CN0510300000000,05,103,"Ouachita County, AR",Apr-20 p,9436,8523,913,9.7
42010,CN0510500000000,05,105,"Perry County, AR",Apr-20 p,4022,3625,397,9.9
42011,CN0510700000000,05,107,"Phillips County, AR",Apr-20 p,6170,5312,858,13.9
42012,CN0510900000000,05,109,"Pike County, AR",Apr-20 p,4075,3716,359,8.8
42013,CN0511100000000,05,111,"Poinsett County, AR",Apr-20 p,9840,9059,781,7.9
42014,CN0511300000000,05,113,"Polk County, AR",Apr-20 p,7806,6988,818,10.5
42015,CN0511500000000,05,115,"Pope County, AR",Apr-20 p,28071,25390,2681,9.6
42016,CN0511700000000,05,117,"Prairie County, AR",Apr-20 p,3379,3129,250,7.4
42017,CN0511900000000,05,119,"Pulaski County, AR",Apr-20 p,184178,162476,21702,11.8
42018,CN0512100000000,05,121,"Randolph County, AR",Apr-20 p,7196,6493,703,9.8
42019,CN0512300000000,05,123,"St. Francis County, AR",Apr-20 p,7961,7013,948,11.9
42020,CN0512500000000,05,125,"Saline County, AR",Apr-20 p,55862,50789,5073,9.1
42021,CN0512700000000,05,127,"Scott County, AR",Apr-20 p,4100,3846,254,6.2
42022,CN0512900000000,05,129,"Searcy County, AR",Apr-20 p,2793,2488,305,10.9
42023,CN0513100000000,05,131,"Sebastian County, AR",Apr-20 p,54975,48886,6089,11.1
42024,CN0513300000000,05,133,"Sevier County, AR",Apr-20 p,5226,4790,436,8.3
42025,CN0513500000000,05,135,"Sharp County, AR",Apr-20 p,5619,4980,639,11.4
42026,CN0513700000000,05,137,"Stone County, AR",Apr-20 p,4584,4041,543,11.8
42027,CN0513900000000,05,139,"Union County, AR",Apr-20 p,15225,13422,1803,11.8
42028,CN0514100000000,05,141,"Van Buren County, AR",Apr-20 p,5595,4945,650,11.6
42029,CN0514300000000,05,143,"Washington County, AR",Apr-20 p,119589,109705,9884,8.3
42030,CN0514500000000,05,145,"White County, AR",Apr-20 p,32600,29313,3287,10.1
42031,CN0514700000000,05,147,"Woodruff County, AR",Apr-20 p,2575,2365,210,8.2
42032,CN0514900000000,05,149,"Yell County, AR",Apr-20 p,8005,7415,590,7.4
42033,CN0600100000000,06,1,"Alameda County, CA",Apr-20 p,800321,687821,112500,14.1
42034,CN0600300000000,06,3,"Alpine County, CA",Apr-20 p,484,377,107,22.1
42035,CN0600500000000,06,5,"Amador County, CA",Apr-20 p,14391,12337,2054,14.3
42036,CN0600700000000,06,7,"Butte County, CA",Apr-20 p,98272,83668,14604,14.9
42037,CN0600900000000,06,9,"Calaveras County, CA",Apr-20 p,20564,17830,2734,13.3
42038,CN0601100000000,06,11,"Colusa County, CA",Apr-20 p,11234,8274,2960,26.3
42039,CN0601300000000,06,13,"Contra Costa County, CA",Apr-20 p,534109,456473,77636,14.5
42040,CN0601500000000,06,15,"Del Norte County, CA",Apr-20 p,9481,8241,1240,13.1
42041,CN0601700000000,06,17,"El Dorado County, CA",Apr-20 p,88112,74585,13527,15.4
42042,CN0601900000000,06,19,"Fresno County, CA",Apr-20 p,457591,381109,76482,16.7
42043,CN0602100000000,06,21,"Glenn County, CA",Apr-20 p,11304,9472,1832,16.2
42044,CN0602300000000,06,23,"Humboldt County, CA",Apr-20 p,62799,54195,8604,13.7
42045,CN0602500000000,06,25,"Imperial County, CA",Apr-20 p,71484,51437,20047,28.0
42046,CN0602700000000,06,27,"Inyo County, CA",Apr-20 p,8161,7041,1120,13.7
42047,CN0602900000000,06,29,"Kern County, CA",Apr-20 p,375771,305988,69783,18.6
42048,CN0603100000000,06,31,"Kings County, CA",Apr-20 p,58251,48441,9810,16.8
42049,CN0603300000000,06,33,"Lake County, CA",Apr-20 p,28316,24003,4313,15.2
42050,CN0603500000000,06,35,"Lassen County, CA",Apr-20 p,8942,7902,1040,11.6
42051,CN0603700000000,06,37,"Los Angeles County, CA",Apr-20 p,4759763,3791378,968385,20.3
42052,CN0603900000000,06,39,"Madera County, CA",Apr-20 p,63051,52601,10450,16.6
42053,CN0604100000000,06,41,"Marin County, CA",Apr-20 p,128788,114476,14312,11.1
42054,CN0604300000000,06,43,"Mariposa County, CA",Apr-20 p,7805,6413,1392,17.8
42055,CN0604500000000,06,45,"Mendocino County, CA",Apr-20 p,37245,31722,5523,14.8
42056,CN0604700000000,06,47,"Merced County, CA",Apr-20 p,116325,94488,21837,18.8
42057,CN0604900000000,06,49,"Modoc County, CA",Apr-20 p,3044,2609,435,14.3
42058,CN0605100000000,06,51,"Mono County, CA",Apr-20 p,8170,6361,1809,22.1
42059,CN0605300000000,06,53,"Monterey County, CA",Apr-20 p,207418,165571,41847,20.2
42060,CN0605500000000,06,55,"Napa County, CA",Apr-20 p,72717,61172,11545,15.9
42061,CN0605700000000,06,57,"Nevada County, CA",Apr-20 p,45085,38554,6531,14.5
42062,CN0605900000000,06,59,"Orange County, CA",Apr-20 p,1529552,1317796,211756,13.8
42063,CN0606100000000,06,61,"Placer County, CA",Apr-20 p,176640,153204,23436,13.3
42064,CN0606300000000,06,63,"Plumas County, CA",Apr-20 p,6890,5479,1411,20.5
42065,CN0606500000000,06,65,"Riverside County, CA",Apr-20 p,1100140,931311,168829,15.3
42066,CN0606700000000,06,67,"Sacramento County, CA",Apr-20 p,677062,577737,99325,14.7
42067,CN0606900000000,06,69,"San Benito County, CA",Apr-20 p,30755,24657,6098,19.8
42068,CN0607100000000,06,71,"San Bernardino County, CA",Apr-20 p,947393,820692,126701,13.4
42069,CN0607300000000,06,73,"San Diego County, CA",Apr-20 p,1543403,1312081,231322,15.0
42070,CN0607500000000,06,75,"San Francisco County/city, CA",Apr-20 p,551425,482070,69355,12.6
42071,CN0607700000000,06,77,"San Joaquin County, CA",Apr-20 p,317154,259140,58014,18.3
42072,CN0607900000000,06,79,"San Luis Obispo County, CA",Apr-20 p,135095,116543,18552,13.7
42073,CN0608100000000,06,81,"San Mateo County, CA",Apr-20 p,429534,380609,48925,11.4
42074,CN0608300000000,06,83,"Santa Barbara County, CA",Apr-20 p,215401,185864,29537,13.7
42075,CN0608500000000,06,85,"Santa Clara County, CA",Apr-20 p,1013319,894471,118848,11.7
42076,CN0608700000000,06,87,"Santa Cruz County, CA",Apr-20 p,132798,109656,23142,17.4
42077,CN0608900000000,06,89,"Shasta County, CA",Apr-20 p,70622,59394,11228,15.9
42078,CN0609100000000,06,91,"Sierra County, CA",Apr-20 p,1234,1059,175,14.2
42079,CN0609300000000,06,93,"Siskiyou County, CA",Apr-20 p,16583,13958,2625,15.8
42080,CN0609500000000,06,95,"Solano County, CA",Apr-20 p,203007,172744,30263,14.9
42081,CN0609700000000,06,97,"Sonoma County, CA",Apr-20 p,235793,199847,35946,15.2
42082,CN0609900000000,06,99,"Stanislaus County, CA",Apr-20 p,239405,198593,40812,17.0
42083,CN0610100000000,06,101,"Sutter County, CA",Apr-20 p,46076,37820,8256,17.9
42084,CN0610300000000,06,103,"Tehama County, CA",Apr-20 p,25240,21576,3664,14.5
42085,CN0610500000000,06,105,"Trinity County, CA",Apr-20 p,4348,3792,556,12.8
42086,CN0610700000000,06,107,"Tulare County, CA",Apr-20 p,200705,162559,38146,19.0
42087,CN0610900000000,06,109,"Tuolumne County, CA",Apr-20 p,21835,18090,3745,17.2
42088,CN0611100000000,06,111,"Ventura County, CA",Apr-20 p,409293,351876,57417,14.0
42089,CN0611300000000,06,113,"Yolo County, CA",Apr-20 p,99381,87530,11851,11.9
42090,CN0611500000000,06,115,"Yuba County, CA",Apr-20 p,30349,25545,4804,15.8
42091,CN0800100000000,08,1,"Adams County, CO",Apr-20 p,269354,235826,33528,12.4
42092,CN0800300000000,08,3,"Alamosa County, CO",Apr-20 p,7660,6941,719,9.4
42093,CN0800500000000,08,5,"Arapahoe County, CO",Apr-20 p,360277,316106,44171,12.3
42094,CN0800700000000,08,7,"Archuleta County, CO",Apr-20 p,6394,5374,1020,16.0
42095,CN0800900000000,08,9,"Baca County, CO",Apr-20 p,1840,1790,50,2.7
42096,CN0801100000000,08,11,"Bent County, CO",Apr-20 p,1663,1579,84,5.1
42097,CN0801300000000,08,13,"Boulder County, CO",Apr-20 p,191331,172831,18500,9.7
42098,CN0801400000000,08,14,"Broomfield County/city, CO",Apr-20 p,39117,34846,4271,10.9
42099,CN0801500000000,08,15,"Chaffee County, CO",Apr-20 p,8874,7715,1159,13.1
42100,CN0801700000000,08,17,"Cheyenne County, CO",Apr-20 p,1033,1008,25,2.4
42101,CN0801900000000,08,19,"Clear Creek County, CO",Apr-20 p,6223,5256,967,15.5
42102,CN0802100000000,08,21,"Conejos County, CO",Apr-20 p,3658,3354,304,8.3
42103,CN0802300000000,08,23,"Costilla County, CO",Apr-20 p,1635,1504,131,8.0
42104,CN0802500000000,08,25,"Crowley County, CO",Apr-20 p,1274,1191,83,6.5
42105,CN0802700000000,08,27,"Custer County, CO",Apr-20 p,1785,1657,128,7.2
42106,CN0802900000000,08,29,"Delta County, CO",Apr-20 p,12781,11476,1305,10.2
42107,CN0803100000000,08,31,"Denver County/city, CO",Apr-20 p,416427,361425,55002,13.2
42108,CN0803300000000,08,33,"Dolores County, CO",Apr-20 p,1057,924,133,12.6
42109,CN0803500000000,08,35,"Douglas County, CO",Apr-20 p,187467,168905,18562,9.9
42110,CN0803700000000,08,37,"Eagle County, CO",Apr-20 p,37488,29818,7670,20.5
42111,CN0803900000000,08,39,"Elbert County, CO",Apr-20 p,14358,13285,1073,7.5
42112,CN0804100000000,08,41,"El Paso County, CO",Apr-20 p,335350,294308,41042,12.2
42113,CN0804300000000,08,43,"Fremont County, CO",Apr-20 p,13341,11650,1691,12.7
42114,CN0804500000000,08,45,"Garfield County, CO",Apr-20 p,29855,25866,3989,13.4
42115,CN0804700000000,08,47,"Gilpin County, CO",Apr-20 p,4271,3290,981,23.0
42116,CN0804900000000,08,49,"Grand County, CO",Apr-20 p,9269,7510,1759,19.0
42117,CN0805100000000,08,51,"Gunnison County, CO",Apr-20 p,10687,8981,1706,16.0
42118,CN0805300000000,08,53,"Hinsdale County, CO",Apr-20 p,291,266,25,8.6
42119,CN0805500000000,08,55,"Huerfano County, CO",Apr-20 p,2192,1920,272,12.4
42120,CN0805700000000,08,57,"Jackson County, CO",Apr-20 p,883,818,65,7.4
42121,CN0805900000000,08,59,"Jefferson County, CO",Apr-20 p,330351,291065,39286,11.9
42122,CN0806100000000,08,61,"Kiowa County, CO",Apr-20 p,851,829,22,2.6
42123,CN0806300000000,08,63,"Kit Carson County, CO",Apr-20 p,3704,3561,143,3.9
42124,CN0806500000000,08,65,"Lake County, CO",Apr-20 p,4844,4035,809,16.7
42125,CN0806700000000,08,67,"La Plata County, CO",Apr-20 p,28940,25079,3861,13.3
42126,CN0806900000000,08,69,"Larimer County, CO",Apr-20 p,201895,179757,22138,11.0
42127,CN0807100000000,08,71,"Las Animas County, CO",Apr-20 p,5833,5219,614,10.5
42128,CN0807300000000,08,73,"Lincoln County, CO",Apr-20 p,1985,1863,122,6.1
42129,CN0807500000000,08,75,"Logan County, CO",Apr-20 p,9467,8806,661,7.0
42130,CN0807700000000,08,77,"Mesa County, CO",Apr-20 p,73342,64072,9270,12.6
42131,CN0807900000000,08,79,"Mineral County, CO",Apr-20 p,467,418,49,10.5
42132,CN0808100000000,08,81,"Moffat County, CO",Apr-20 p,6341,5675,666,10.5
42133,CN0808300000000,08,83,"Montezuma County, CO",Apr-20 p,11314,9970,1344,11.9
42134,CN0808500000000,08,85,"Montrose County, CO",Apr-20 p,19782,17410,2372,12.0
42135,CN0808700000000,08,87,"Morgan County, CO",Apr-20 p,14281,13314,967,6.8
42136,CN0808900000000,08,89,"Otero County, CO",Apr-20 p,7289,6736,553,7.6
42137,CN0809100000000,08,91,"Ouray County, CO",Apr-20 p,2210,1800,410,18.6
42138,CN0809300000000,08,93,"Park County, CO",Apr-20 p,10790,9720,1070,9.9
42139,CN0809500000000,08,95,"Phillips County, CO",Apr-20 p,2264,2178,86,3.8
42140,CN0809700000000,08,97,"Pitkin County, CO",Apr-20 p,11604,8921,2683,23.1
42141,CN0809900000000,08,99,"Prowers County, CO",Apr-20 p,5536,5259,277,5.0
42142,CN0810100000000,08,101,"Pueblo County, CO",Apr-20 p,72044,63579,8465,11.7
42143,CN0810300000000,08,103,"Rio Blanco County, CO",Apr-20 p,2638,2445,193,7.3
42144,CN0810500000000,08,105,"Rio Grande County, CO",Apr-20 p,4897,4375,522,10.7
42145,CN0810700000000,08,107,"Routt County, CO",Apr-20 p,15851,13038,2813,17.7
42146,CN0810900000000,08,109,"Saguache County, CO",Apr-20 p,3186,2963,223,7.0
42147,CN0811100000000,08,111,"San Juan County, CO",Apr-20 p,447,384,63,14.1
42148,CN0811300000000,08,113,"San Miguel County, CO",Apr-20 p,6022,4679,1343,22.3
42149,CN0811500000000,08,115,"Sedgwick County, CO",Apr-20 p,1094,1051,43,3.9
42150,CN0811700000000,08,117,"Summit County, CO",Apr-20 p,23810,18782,5028,21.1
42151,CN0811900000000,08,119,"Teller County, CO",Apr-20 p,12942,11028,1914,14.8
42152,CN0812100000000,08,121,"Washington County, CO",Apr-20 p,2460,2370,90,3.7
42153,CN0812300000000,08,123,"Weld County, CO",Apr-20 p,165122,148975,16147,9.8
42154,CN0812500000000,08,125,"Yuma County, CO",Apr-20 p,5240,5069,171,3.3
42155,CN0900100000000,09,1,"Fairfield County, CT",Apr-20 p,432344,398691,33653,7.8
42156,CN0900300000000,09,3,"Hartford County, CT",Apr-20 p,456005,420248,35757,7.8
42157,CN0900500000000,09,5,"Litchfield County, CT",Apr-20 p,96900,89735,7165,7.4
42158,CN0900700000000,09,7,"Middlesex County, CT",Apr-20 p,88043,82021,6022,6.8
42159,CN0900900000000,09,9,"New Haven County, CT",Apr-20 p,427171,393731,33440,7.8
42160,CN0901100000000,09,11,"New London County, CT",Apr-20 p,120257,105712,14545,12.1
42161,CN0901300000000,09,13,"Tolland County, CT",Apr-20 p,81576,76298,5278,6.5
42162,CN0901500000000,09,15,"Windham County, CT",Apr-20 p,59472,54670,4802,8.1
42163,CN1000100000000,10,1,"Kent County, DE",Apr-20 p,78850,66370,12480,15.8
42164,CN1000300000000,10,3,"New Castle County, DE",Apr-20 p,283987,244003,39984,14.1
42165,CN1000500000000,10,5,"Sussex County, DE",Apr-20 p,100509,84463,16046,16.0
42166,CN1100100000000,11,1,District of Columbia,Apr-20 p,403204,358366,44838,11.1
42167,CN1200100000000,12,1,"Alachua County, FL",Apr-20 p,124349,113209,11140,9.0
42168,CN1200300000000,12,3,"Baker County, FL",Apr-20 p,10283,9500,783,7.6
42169,CN1200500000000,12,5,"Bay County, FL",Apr-20 p,76916,67038,9878,12.8
42170,CN1200700000000,12,7,"Bradford County, FL",Apr-20 p,9871,9029,842,8.5
42171,CN1200900000000,12,9,"Brevard County, FL",Apr-20 p,268858,234043,34815,12.9
42172,CN1201100000000,12,11,"Broward County, FL",Apr-20 p,935487,799479,136008,14.5
42173,CN1201300000000,12,13,"Calhoun County, FL",Apr-20 p,4234,3893,341,8.1
42174,CN1201500000000,12,15,"Charlotte County, FL",Apr-20 p,64362,54296,10066,15.6
42175,CN1201700000000,12,17,"Citrus County, FL",Apr-20 p,44560,37536,7024,15.8
42176,CN1201900000000,12,19,"Clay County, FL",Apr-20 p,96175,86381,9794,10.2
42177,CN1202100000000,12,21,"Collier County, FL",Apr-20 p,164585,142513,22072,13.4
42178,CN1202300000000,12,23,"Columbia County, FL",Apr-20 p,26743,24182,2561,9.6
42179,CN1202700000000,12,27,"DeSoto County, FL",Apr-20 p,13573,12565,1008,7.4
42180,CN1202900000000,12,29,"Dixie County, FL",Apr-20 p,5231,4816,415,7.9
42181,CN1203100000000,12,31,"Duval County, FL",Apr-20 p,443680,393536,50144,11.3
42182,CN1203300000000,12,33,"Escambia County, FL",Apr-20 p,137914,120324,17590,12.8
42183,CN1203500000000,12,35,"Flagler County, FL",Apr-20 p,44185,37390,6795,15.4
42184,CN1203700000000,12,37,"Franklin County, FL",Apr-20 p,4136,3711,425,10.3
42185,CN1203900000000,12,39,"Gadsden County, FL",Apr-20 p,16836,15562,1274,7.6
42186,CN1204100000000,12,41,"Gilchrist County, FL",Apr-20 p,6258,5743,515,8.2
42187,CN1204300000000,12,43,"Glades County, FL",Apr-20 p,4920,4568,352,7.2
42188,CN1204500000000,12,45,"Gulf County, FL",Apr-20 p,5017,4545,472,9.4
42189,CN1204700000000,12,47,"Hamilton County, FL",Apr-20 p,3840,3456,384,10.0
42190,CN1204900000000,12,49,"Hardee County, FL",Apr-20 p,7916,7274,642,8.1
42191,CN1205100000000,12,51,"Hendry County, FL",Apr-20 p,14421,12914,1507,10.5
42192,CN1205300000000,12,53,"Hernando County, FL",Apr-20 p,66987,56966,10021,15.0
42193,CN1205500000000,12,55,"Highlands County, FL",Apr-20 p,33475,29656,3819,11.4
42194,CN1205700000000,12,57,"Hillsborough County, FL",Apr-20 p,684108,601754,82354,12.0
42195,CN1205900000000,12,59,"Holmes County, FL",Apr-20 p,6294,5713,581,9.2
42196,CN1206100000000,12,61,"Indian River County, FL",Apr-20 p,61883,53142,8741,14.1
42197,CN1206300000000,12,63,"Jackson County, FL",Apr-20 p,15305,14081,1224,8.0
42198,CN1206500000000,12,65,"Jefferson County, FL",Apr-20 p,4997,4613,384,7.7
42199,CN1206700000000,12,67,"Lafayette County, FL",Apr-20 p,2495,2357,138,5.5
42200,CN1206900000000,12,69,"Lake County, FL",Apr-20 p,143756,122638,21118,14.7
42201,CN1207100000000,12,71,"Lee County, FL",Apr-20 p,321446,274556,46890,14.6
42202,CN1207300000000,12,73,"Leon County, FL",Apr-20 p,138628,127243,11385,8.2
42203,CN1207500000000,12,75,"Levy County, FL",Apr-20 p,15172,13508,1664,11.0
42204,CN1207700000000,12,77,"Liberty County, FL",Apr-20 p,2323,2160,163,7.0
42205,CN1207900000000,12,79,"Madison County, FL",Apr-20 p,6645,6107,538,8.1
42206,CN1208100000000,12,81,"Manatee County, FL",Apr-20 p,161474,139654,21820,13.5
42207,CN1208300000000,12,83,"Marion County, FL",Apr-20 p,129422,113768,15654,12.1
42208,CN1208500000000,12,85,"Martin County, FL",Apr-20 p,68784,60572,8212,11.9
42209,CN1208600000000,12,86,"Miami-Dade County, FL",Apr-20 p,1215918,1071624,144294,11.9
42210,CN1208700000000,12,87,"Monroe County, FL",Apr-20 p,46816,38609,8207,17.5
42211,CN1208900000000,12,89,"Nassau County, FL",Apr-20 p,37751,33054,4697,12.4
42212,CN1209100000000,12,91,"Okaloosa County, FL",Apr-20 p,88976,77171,11805,13.3
42213,CN1209300000000,12,93,"Okeechobee County, FL",Apr-20 p,15858,14573,1285,8.1
42214,CN1209500000000,12,95,"Orange County, FL",Apr-20 p,703093,587057,116036,16.5
42215,CN1209700000000,12,97,"Osceola County, FL",Apr-20 p,177131,141222,35909,20.3
42216,CN1209900000000,12,99,"Palm Beach County, FL",Apr-20 p,653719,562585,91134,13.9
42217,CN1210100000000,12,101,"Pasco County, FL",Apr-20 p,220731,190035,30696,13.9
42218,CN1210300000000,12,103,"Pinellas County, FL",Apr-20 p,460388,396407,63981,13.9
42219,CN1210500000000,12,105,"Polk County, FL",Apr-20 p,285778,247526,38252,13.4
42220,CN1210700000000,12,107,"Putnam County, FL",Apr-20 p,24022,21391,2631,11.0
42221,CN1210900000000,12,109,"St. Johns County, FL",Apr-20 p,120714,106702,14012,11.6
42222,CN1211100000000,12,111,"St. Lucie County, FL",Apr-20 p,137026,117542,19484,14.2
42223,CN1211300000000,12,113,"Santa Rosa County, FL",Apr-20 p,76550,68484,8066,10.5
42224,CN1211500000000,12,115,"Sarasota County, FL",Apr-20 p,171832,146394,25438,14.8
42225,CN1211700000000,12,117,"Seminole County, FL",Apr-20 p,226241,196612,29629,13.1
42226,CN1211900000000,12,119,"Sumter County, FL",Apr-20 p,29930,26241,3689,12.3
42227,CN1212100000000,12,121,"Suwannee County, FL",Apr-20 p,16181,14812,1369,8.5
42228,CN1212300000000,12,123,"Taylor County, FL",Apr-20 p,7447,6866,581,7.8
42229,CN1212500000000,12,125,"Union County, FL",Apr-20 p,4136,3827,309,7.5
42230,CN1212700000000,12,127,"Volusia County, FL",Apr-20 p,237582,202847,34735,14.6
42231,CN1212900000000,12,129,"Wakulla County, FL",Apr-20 p,13298,12256,1042,7.8
42232,CN1213100000000,12,131,"Walton County, FL",Apr-20 p,29357,25098,4259,14.5
42233,CN1213300000000,12,133,"Washington County, FL",Apr-20 p,8680,7797,883,10.2
42234,CN1300100000000,13,1,"Appling County, GA",Apr-20 p,9275,8599,676,7.3
42235,CN1300300000000,13,3,"Atkinson County, GA",Apr-20 p,4309,3977,332,7.7
42236,CN1300500000000,13,5,"Bacon County, GA",Apr-20 p,4777,4416,361,7.6
42237,CN1300700000000,13,7,"Baker County, GA",Apr-20 p,1082,993,89,8.2
42238,CN1300900000000,13,9,"Baldwin County, GA",Apr-20 p,17605,15758,1847,10.5
42239,CN1301100000000,13,11,"Banks County, GA",Apr-20 p,9595,8697,898,9.4
42240,CN1301300000000,13,13,"Barrow County, GA",Apr-20 p,38118,33636,4482,11.8
42241,CN1301500000000,13,15,"Bartow County, GA",Apr-20 p,49179,41920,7259,14.8
42242,CN1301700000000,13,17,"Ben Hill County, GA",Apr-20 p,5308,4720,588,11.1
42243,CN1301900000000,13,19,"Berrien County, GA",Apr-20 p,7590,6521,1069,14.1
42244,CN1302100000000,13,21,"Bibb County, GA",Apr-20 p,64500,57023,7477,11.6
42245,CN1302300000000,13,23,"Bleckley County, GA",Apr-20 p,4284,3883,401,9.4
42246,CN1302500000000,13,25,"Brantley County, GA",Apr-20 p,6082,5382,700,11.5
42247,CN1302700000000,13,27,"Brooks County, GA",Apr-20 p,6378,5892,486,7.6
42248,CN1302900000000,13,29,"Bryan County, GA",Apr-20 p,16677,14575,2102,12.6
42249,CN1303100000000,13,31,"Bulloch County, GA",Apr-20 p,36601,32427,4174,11.4
42250,CN1303300000000,13,33,"Burke County, GA",Apr-20 p,8510,7618,892,10.5
42251,CN1303500000000,13,35,"Butts County, GA",Apr-20 p,10059,8903,1156,11.5
42252,CN1303700000000,13,37,"Calhoun County, GA",Apr-20 p,2239,2099,140,6.3
42253,CN1303900000000,13,39,"Camden County, GA",Apr-20 p,19963,18063,1900,9.5
42254,CN1304300000000,13,43,"Candler County, GA",Apr-20 p,5555,5173,382,6.9
42255,CN1304500000000,13,45,"Carroll County, GA",Apr-20 p,52476,45688,6788,12.9
42256,CN1304700000000,13,47,"Catoosa County, GA",Apr-20 p,32079,28881,3198,10.0
42257,CN1304900000000,13,49,"Charlton County, GA",Apr-20 p,4477,4220,257,5.7
42258,CN1305100000000,13,51,"Chatham County, GA",Apr-20 p,132629,110868,21761,16.4
42259,CN1305300000000,13,53,"Chattahoochee County, GA",Apr-20 p,1829,1632,197,10.8
42260,CN1305500000000,13,55,"Chattooga County, GA",Apr-20 p,10270,8510,1760,17.1
42261,CN1305700000000,13,57,"Cherokee County, GA",Apr-20 p,127165,113034,14131,11.1
42262,CN1305900000000,13,59,"Clarke County, GA",Apr-20 p,55913,49024,6889,12.3
42263,CN1306100000000,13,61,"Clay County, GA",Apr-20 p,947,776,171,18.1
42264,CN1306300000000,13,63,"Clayton County, GA",Apr-20 p,134591,113093,21498,16.0
42265,CN1306500000000,13,65,"Clinch County, GA",Apr-20 p,2512,2329,183,7.3
42266,CN1306700000000,13,67,"Cobb County, GA",Apr-20 p,398651,353055,45596,11.4
42267,CN1306900000000,13,69,"Coffee County, GA",Apr-20 p,18800,16947,1853,9.9
42268,CN1307100000000,13,71,"Colquitt County, GA",Apr-20 p,20765,19225,1540,7.4
42269,CN1307300000000,13,73,"Columbia County, GA",Apr-20 p,69464,63369,6095,8.8
42270,CN1307500000000,13,75,"Cook County, GA",Apr-20 p,7955,7317,638,8.0
42271,CN1307700000000,13,77,"Coweta County, GA",Apr-20 p,71382,62040,9342,13.1
42272,CN1307900000000,13,79,"Crawford County, GA",Apr-20 p,5246,4745,501,9.6
42273,CN1308100000000,13,81,"Crisp County, GA",Apr-20 p,9447,8520,927,9.8
42274,CN1308300000000,13,83,"Dade County, GA",Apr-20 p,7592,7006,586,7.7
42275,CN1308500000000,13,85,"Dawson County, GA",Apr-20 p,11650,10248,1402,12.0
42276,CN1308700000000,13,87,"Decatur County, GA",Apr-20 p,11138,10348,790,7.1
42277,CN1308900000000,13,89,"DeKalb County, GA",Apr-20 p,380317,330105,50212,13.2
42278,CN1309100000000,13,91,"Dodge County, GA",Apr-20 p,6480,5939,541,8.3
42279,CN1309300000000,13,93,"Dooly County, GA",Apr-20 p,5231,4444,787,15.0
42280,CN1309500000000,13,95,"Dougherty County, GA",Apr-20 p,36159,31538,4621,12.8
42281,CN1309700000000,13,97,"Douglas County, GA",Apr-20 p,69181,60455,8726,12.6
42282,CN1309900000000,13,99,"Early County, GA",Apr-20 p,4225,3992,233,5.5
42283,CN1310100000000,13,101,"Echols County, GA",Apr-20 p,1774,1663,111,6.3
42284,CN1310300000000,13,103,"Effingham County, GA",Apr-20 p,27978,24651,3327,11.9
42285,CN1310500000000,13,105,"Elbert County, GA",Apr-20 p,7878,6877,1001,12.7
42286,CN1310700000000,13,107,"Emanuel County, GA",Apr-20 p,7961,7223,738,9.3
42287,CN1310900000000,13,109,"Evans County, GA",Apr-20 p,4728,4363,365,7.7
42288,CN1311100000000,13,111,"Fannin County, GA",Apr-20 p,12355,11198,1157,9.4
42289,CN1311300000000,13,113,"Fayette County, GA",Apr-20 p,53580,48177,5403,10.1
42290,CN1311500000000,13,115,"Floyd County, GA",Apr-20 p,44399,38427,5972,13.5
42291,CN1311700000000,13,117,"Forsyth County, GA",Apr-20 p,113551,101691,11860,10.4
42292,CN1311900000000,13,119,"Franklin County, GA",Apr-20 p,10117,8954,1163,11.5
42293,CN1312100000000,13,121,"Fulton County, GA",Apr-20 p,533726,460297,73429,13.8
42294,CN1312300000000,13,123,"Gilmer County, GA",Apr-20 p,11263,10032,1231,10.9
42295,CN1312500000000,13,125,"Glascock County, GA",Apr-20 p,1188,1107,81,6.8
42296,CN1312700000000,13,127,"Glynn County, GA",Apr-20 p,34666,28775,5891,17.0
42297,CN1312900000000,13,129,"Gordon County, GA",Apr-20 p,29023,25332,3691,12.7
42298,CN1313100000000,13,131,"Grady County, GA",Apr-20 p,10222,9350,872,8.5
42299,CN1313300000000,13,133,"Greene County, GA",Apr-20 p,7130,6400,730,10.2
42300,CN1313500000000,13,135,"Gwinnett County, GA",Apr-20 p,463600,406251,57349,12.4
42301,CN1313700000000,13,137,"Habersham County, GA",Apr-20 p,18777,16745,2032,10.8
42302,CN1313900000000,13,139,"Hall County, GA",Apr-20 p,96929,86663,10266,10.6
42303,CN1314100000000,13,141,"Hancock County, GA",Apr-20 p,2488,2201,287,11.5
42304,CN1314300000000,13,143,"Haralson County, GA",Apr-20 p,11857,10385,1472,12.4
42305,CN1314500000000,13,145,"Harris County, GA",Apr-20 p,15277,13738,1539,10.1
42306,CN1314700000000,13,147,"Hart County, GA",Apr-20 p,10975,9846,1129,10.3
42307,CN1314900000000,13,149,"Heard County, GA",Apr-20 p,5128,4355,773,15.1
42308,CN1315100000000,13,151,"Henry County, GA",Apr-20 p,110250,95503,14747,13.4
42309,CN1315300000000,13,153,"Houston County, GA",Apr-20 p,65322,58646,6676,10.2
42310,CN1315500000000,13,155,"Irwin County, GA",Apr-20 p,3344,3050,294,8.8
42311,CN1315700000000,13,157,"Jackson County, GA",Apr-20 p,35877,31860,4017,11.2
42312,CN1315900000000,13,159,"Jasper County, GA",Apr-20 p,6381,5776,605,9.5
42313,CN1316100000000,13,161,"Jeff Davis County, GA",Apr-20 p,5839,5333,506,8.7
42314,CN1316300000000,13,163,"Jefferson County, GA",Apr-20 p,6453,5837,616,9.5
42315,CN1316500000000,13,165,"Jenkins County, GA",Apr-20 p,2978,2725,253,8.5
42316,CN1316700000000,13,167,"Johnson County, GA",Apr-20 p,3884,3586,298,7.7
42317,CN1316900000000,13,169,"Jones County, GA",Apr-20 p,12630,11610,1020,8.1
42318,CN1317100000000,13,171,"Lamar County, GA",Apr-20 p,7560,6766,794,10.5
42319,CN1317300000000,13,173,"Lanier County, GA",Apr-20 p,3497,3140,357,10.2
42320,CN1317500000000,13,175,"Laurens County, GA",Apr-20 p,18976,16798,2178,11.5
42321,CN1317700000000,13,177,"Lee County, GA",Apr-20 p,13620,12329,1291,9.5
42322,CN1317900000000,13,179,"Liberty County, GA",Apr-20 p,24694,22176,2518,10.2
42323,CN1318100000000,13,181,"Lincoln County, GA",Apr-20 p,3297,3002,295,8.9
42324,CN1318300000000,13,183,"Long County, GA",Apr-20 p,7515,6950,565,7.5
42325,CN1318500000000,13,185,"Lowndes County, GA",Apr-20 p,48009,43035,4974,10.4
42326,CN1318700000000,13,187,"Lumpkin County, GA",Apr-20 p,16217,14442,1775,10.9
42327,CN1318900000000,13,189,"McDuffie County, GA",Apr-20 p,8500,7322,1178,13.9
42328,CN1319100000000,13,191,"McIntosh County, GA",Apr-20 p,5192,4590,602,11.6
42329,CN1319300000000,13,193,"Macon County, GA",Apr-20 p,4519,4106,413,9.1
42330,CN1319500000000,13,195,"Madison County, GA",Apr-20 p,12408,11066,1342,10.8
42331,CN1319700000000,13,197,"Marion County, GA",Apr-20 p,2925,2697,228,7.8
42332,CN1319900000000,13,199,"Meriwether County, GA",Apr-20 p,8682,7306,1376,15.8
42333,CN1320100000000,13,201,"Miller County, GA",Apr-20 p,2632,2503,129,4.9
42334,CN1320500000000,13,205,"Mitchell County, GA",Apr-20 p,8079,7420,659,8.2
42335,CN1320700000000,13,207,"Monroe County, GA",Apr-20 p,12126,10997,1129,9.3
42336,CN1320900000000,13,209,"Montgomery County, GA",Apr-20 p,3800,3474,326,8.6
42337,CN1321100000000,13,211,"Morgan County, GA",Apr-20 p,8728,7703,1025,11.7
42338,CN1321300000000,13,213,"Murray County, GA",Apr-20 p,15701,12542,3159,20.1
42339,CN1321500000000,13,215,"Muscogee County, GA",Apr-20 p,72629,62805,9824,13.5
42340,CN1321700000000,13,217,"Newton County, GA",Apr-20 p,49108,43019,6089,12.4
42341,CN1321900000000,13,219,"Oconee County, GA",Apr-20 p,17936,16340,1596,8.9
42342,CN1322100000000,13,221,"Oglethorpe County, GA",Apr-20 p,6420,5806,614,9.6
42343,CN1322300000000,13,223,"Paulding County, GA",Apr-20 p,80541,71473,9068,11.3
42344,CN1322500000000,13,225,"Peach County, GA",Apr-20 p,11038,9829,1209,11.0
42345,CN1322700000000,13,227,"Pickens County, GA",Apr-20 p,14200,12687,1513,10.7
42346,CN1322900000000,13,229,"Pierce County, GA",Apr-20 p,8352,7649,703,8.4
42347,CN1323100000000,13,231,"Pike County, GA",Apr-20 p,8229,7396,833,10.1
42348,CN1323300000000,13,233,"Polk County, GA",Apr-20 p,18059,15905,2154,11.9
42349,CN1323500000000,13,235,"Pulaski County, GA",Apr-20 p,3644,3380,264,7.2
42350,CN1323700000000,13,237,"Putnam County, GA",Apr-20 p,7961,7020,941,11.8
42351,CN1323900000000,13,239,"Quitman County, GA",Apr-20 p,730,692,38,5.2
42352,CN1324100000000,13,241,"Rabun County, GA",Apr-20 p,7174,6263,911,12.7
42353,CN1324300000000,13,243,"Randolph County, GA",Apr-20 p,2462,2292,170,6.9
42354,CN1324500000000,13,245,"Richmond County, GA",Apr-20 p,80791,70756,10035,12.4
42355,CN1324700000000,13,247,"Rockdale County, GA",Apr-20 p,42184,36862,5322,12.6
42356,CN1324900000000,13,249,"Schley County, GA",Apr-20 p,2141,2018,123,5.7
42357,CN1325100000000,13,251,"Screven County, GA",Apr-20 p,5113,4445,668,13.1
42358,CN1325300000000,13,253,"Seminole County, GA",Apr-20 p,2969,2764,205,6.9
42359,CN1325500000000,13,255,"Spalding County, GA",Apr-20 p,27057,23591,3466,12.8
42360,CN1325700000000,13,257,"Stephens County, GA",Apr-20 p,10918,9615,1303,11.9
42361,CN1325900000000,13,259,"Stewart County, GA",Apr-20 p,2463,2291,172,7.0
42362,CN1326100000000,13,261,"Sumter County, GA",Apr-20 p,12785,11556,1229,9.6
42363,CN1326300000000,13,263,"Talbot County, GA",Apr-20 p,2643,2316,327,12.4
42364,CN1326500000000,13,265,"Taliaferro County, GA",Apr-20 p,572,511,61,10.7
42365,CN1326700000000,13,267,"Tattnall County, GA",Apr-20 p,9023,8436,587,6.5
42366,CN1326900000000,13,269,"Taylor County, GA",Apr-20 p,2791,2493,298,10.7
42367,CN1327100000000,13,271,"Telfair County, GA",Apr-20 p,3650,3205,445,12.2
42368,CN1327300000000,13,273,"Terrell County, GA",Apr-20 p,3192,2888,304,9.5
42369,CN1327500000000,13,275,"Thomas County, GA",Apr-20 p,16482,14784,1698,10.3
42370,CN1327700000000,13,277,"Tift County, GA",Apr-20 p,19923,18174,1749,8.8
42371,CN1327900000000,13,279,"Toombs County, GA",Apr-20 p,12096,10633,1463,12.1
42372,CN1328100000000,13,281,"Towns County, GA",Apr-20 p,3820,3275,545,14.3
42373,CN1328300000000,13,283,"Treutlen County, GA",Apr-20 p,2621,2349,272,10.4
42374,CN1328500000000,13,285,"Troup County, GA",Apr-20 p,39820,33682,6138,15.4
42375,CN1328700000000,13,287,"Turner County, GA",Apr-20 p,3166,2832,334,10.5
42376,CN1328900000000,13,289,"Twiggs County, GA",Apr-20 p,2677,2390,287,10.7
42377,CN1329100000000,13,291,"Union County, GA",Apr-20 p,10302,9331,971,9.4
42378,CN1329300000000,13,293,"Upson County, GA",Apr-20 p,11179,9805,1374,12.3
42379,CN1329500000000,13,295,"Walker County, GA",Apr-20 p,30181,26891,3290,10.9
42380,CN1329700000000,13,297,"Walton County, GA",Apr-20 p,43471,38223,5248,12.1
42381,CN1329900000000,13,299,"Ware County, GA",Apr-20 p,15270,13653,1617,10.6
42382,CN1330100000000,13,301,"Warren County, GA",Apr-20 p,2744,2457,287,10.5
42383,CN1330300000000,13,303,"Washington County, GA",Apr-20 p,6604,5997,607,9.2
42384,CN1330500000000,13,305,"Wayne County, GA",Apr-20 p,10974,9860,1114,10.2
42385,CN1330700000000,13,307,"Webster County, GA",Apr-20 p,968,910,58,6.0
42386,CN1330900000000,13,309,"Wheeler County, GA",Apr-20 p,1585,1429,156,9.8
42387,CN1331100000000,13,311,"White County, GA",Apr-20 p,16740,14945,1795,10.7
42388,CN1331300000000,13,313,"Whitfield County, GA",Apr-20 p,44568,35381,9187,20.6
42389,CN1331500000000,13,315,"Wilcox County, GA",Apr-20 p,2604,2415,189,7.3
42390,CN1331700000000,13,317,"Wilkes County, GA",Apr-20 p,3799,3474,325,8.6
42391,CN1331900000000,13,319,"Wilkinson County, GA",Apr-20 p,3849,3579,270,7.0
42392,CN1332100000000,13,321,"Worth County, GA",Apr-20 p,8165,7440,725,8.9
42393,CN1500100000000,15,1,"Hawaii County, HI",Apr-20 p,85957,65290,20667,24.0
42394,CN1500300000000,15,3,"Honolulu County/city, HI",Apr-20 p,419548,335666,83882,20.0
42395,CN1500700000000,15,7,"Kauai County, HI",Apr-20 p,36254,23766,12488,34.4
42396,CN1500900000000,15,9,"Maui County, HI",Apr-20 p,91266,59324,31942,35.0
42397,CN1600100000000,16,1,"Ada County, ID",Apr-20 p,256544,225376,31168,12.1
42398,CN1600300000000,16,3,"Adams County, ID",Apr-20 p,1746,1367,379,21.7
42399,CN1600500000000,16,5,"Bannock County, ID",Apr-20 p,41492,37405,4087,9.9
42400,CN1600700000000,16,7,"Bear Lake County, ID",Apr-20 p,2867,2625,242,8.4
42401,CN1600900000000,16,9,"Benewah County, ID",Apr-20 p,4202,3443,759,18.1
42402,CN1601100000000,16,11,"Bingham County, ID",Apr-20 p,23186,21663,1523,6.6
42403,CN1601300000000,16,13,"Blaine County, ID",Apr-20 p,13434,10403,3031,22.6
42404,CN1601500000000,16,15,"Boise County, ID",Apr-20 p,3678,3074,604,16.4
42405,CN1601700000000,16,17,"Bonner County, ID",Apr-20 p,20677,17015,3662,17.7
42406,CN1601900000000,16,19,"Bonneville County, ID",Apr-20 p,58896,54067,4829,8.2
42407,CN1602100000000,16,21,"Boundary County, ID",Apr-20 p,5331,4686,645,12.1
42408,CN1602300000000,16,23,"Butte County, ID",Apr-20 p,1416,1338,78,5.5
42409,CN1602500000000,16,25,"Camas County, ID",Apr-20 p,719,624,95,13.2
42410,CN1602700000000,16,27,"Canyon County, ID",Apr-20 p,105312,92096,13216,12.5
42411,CN1602900000000,16,29,"Caribou County, ID",Apr-20 p,3927,3668,259,6.6
42412,CN1603100000000,16,31,"Cassia County, ID",Apr-20 p,11684,10821,863,7.4
42413,CN1603300000000,16,33,"Clark County, ID",Apr-20 p,363,343,20,5.5
42414,CN1603500000000,16,35,"Clearwater County, ID",Apr-20 p,2892,2346,546,18.9
42415,CN1603700000000,16,37,"Custer County, ID",Apr-20 p,1972,1768,204,10.3
42416,CN1603900000000,16,39,"Elmore County, ID",Apr-20 p,11242,10155,1087,9.7
42417,CN1604100000000,16,41,"Franklin County, ID",Apr-20 p,7160,6577,583,8.1
42418,CN1604300000000,16,43,"Fremont County, ID",Apr-20 p,7532,6974,558,7.4
42419,CN1604500000000,16,45,"Gem County, ID",Apr-20 p,8364,7370,994,11.9
42420,CN1604700000000,16,47,"Gooding County, ID",Apr-20 p,8032,7477,555,6.9
42421,CN1604900000000,16,49,"Idaho County, ID",Apr-20 p,6572,5710,862,13.1
42422,CN1605100000000,16,51,"Jefferson County, ID",Apr-20 p,14222,13325,897,6.3
42423,CN1605300000000,16,53,"Jerome County, ID",Apr-20 p,12144,11215,929,7.6
42424,CN1605500000000,16,55,"Kootenai County, ID",Apr-20 p,80479,66802,13677,17.0
42425,CN1605700000000,16,57,"Latah County, ID",Apr-20 p,19736,17751,1985,10.1
42426,CN1605900000000,16,59,"Lemhi County, ID",Apr-20 p,3359,2950,409,12.2
42427,CN1606100000000,16,61,"Lewis County, ID",Apr-20 p,1702,1444,258,15.2
42428,CN1606300000000,16,63,"Lincoln County, ID",Apr-20 p,2709,2344,365,13.5
42429,CN1606500000000,16,65,"Madison County, ID",Apr-20 p,20094,19116,978,4.9
42430,CN1606700000000,16,67,"Minidoka County, ID",Apr-20 p,10979,10186,793,7.2
42431,CN1606900000000,16,69,"Nez Perce County, ID",Apr-20 p,19597,17237,2360,12.0
42432,CN1607100000000,16,71,"Oneida County, ID",Apr-20 p,2307,2134,173,7.5
42433,CN1607300000000,16,73,"Owyhee County, ID",Apr-20 p,5651,5035,616,10.9
42434,CN1607500000000,16,75,"Payette County, ID",Apr-20 p,11504,10406,1098,9.5
42435,CN1607700000000,16,77,"Power County, ID",Apr-20 p,3989,3743,246,6.2
42436,CN1607900000000,16,79,"Shoshone County, ID",Apr-20 p,5206,4116,1090,20.9
42437,CN1608100000000,16,81,"Teton County, ID",Apr-20 p,6487,5428,1059,16.3
42438,CN1608300000000,16,83,"Twin Falls County, ID",Apr-20 p,41435,36735,4700,11.3
42439,CN1608500000000,16,85,"Valley County, ID",Apr-20 p,5791,4500,1291,22.3
42440,CN1608700000000,16,87,"Washington County, ID",Apr-20 p,4495,4067,428,9.5
42441,CN1700100000000,17,1,"Adams County, IL",Apr-20 p,30317,26669,3648,12.0
42442,CN1700300000000,17,3,"Alexander County, IL",Apr-20 p,1809,1524,285,15.8
42443,CN1700500000000,17,5,"Bond County, IL",Apr-20 p,6837,5970,867,12.7
42444,CN1700700000000,17,7,"Boone County, IL",Apr-20 p,25010,19133,5877,23.5
42445,CN1700900000000,17,9,"Brown County, IL",Apr-20 p,2571,2356,215,8.4
42446,CN1701100000000,17,11,"Bureau County, IL",Apr-20 p,16097,13892,2205,13.7
42447,CN1701300000000,17,13,"Calhoun County, IL",Apr-20 p,2134,1767,367,17.2
42448,CN1701500000000,17,15,"Carroll County, IL",Apr-20 p,7013,5847,1166,16.6
42449,CN1701700000000,17,17,"Cass County, IL",Apr-20 p,5594,5009,585,10.5
42450,CN1701900000000,17,19,"Champaign County, IL",Apr-20 p,100205,89257,10948,10.9
42451,CN1702100000000,17,21,"Christian County, IL",Apr-20 p,13148,11290,1858,14.1
42452,CN1702300000000,17,23,"Clark County, IL",Apr-20 p,7235,5737,1498,20.7
42453,CN1702500000000,17,25,"Clay County, IL",Apr-20 p,6250,4764,1486,23.8
42454,CN1702700000000,17,27,"Clinton County, IL",Apr-20 p,18375,15854,2521,13.7
42455,CN1702900000000,17,29,"Coles County, IL",Apr-20 p,22484,19724,2760,12.3
42456,CN1703100000000,17,31,"Cook County, IL",Apr-20 p,2555193,2089720,465473,18.2
42457,CN1703300000000,17,33,"Crawford County, IL",Apr-20 p,8167,6854,1313,16.1
42458,CN1703500000000,17,35,"Cumberland County, IL",Apr-20 p,5692,5092,600,10.5
42459,CN1703700000000,17,37,"DeKalb County, IL",Apr-20 p,48633,41287,7346,15.1
42460,CN1703900000000,17,39,"De Witt County, IL",Apr-20 p,6452,5717,735,11.4
42461,CN1704100000000,17,41,"Douglas County, IL",Apr-20 p,9449,8462,987,10.4
42462,CN1704300000000,17,43,"DuPage County, IL",Apr-20 p,484462,412599,71863,14.8
42463,CN1704500000000,17,45,"Edgar County, IL",Apr-20 p,8499,7161,1338,15.7
42464,CN1704700000000,17,47,"Edwards County, IL",Apr-20 p,2673,2092,581,21.7
42465,CN1704900000000,17,49,"Effingham County, IL",Apr-20 p,18519,15920,2599,14.0
42466,CN1705100000000,17,51,"Fayette County, IL",Apr-20 p,9376,8086,1290,13.8
42467,CN1705300000000,17,53,"Ford County, IL",Apr-20 p,5826,5141,685,11.8
42468,CN1705500000000,17,55,"Franklin County, IL",Apr-20 p,16744,12753,3991,23.8
42469,CN1705700000000,17,57,"Fulton County, IL",Apr-20 p,14013,11724,2289,16.3
42470,CN1705900000000,17,59,"Gallatin County, IL",Apr-20 p,2139,1825,314,14.7
42471,CN1706100000000,17,61,"Greene County, IL",Apr-20 p,5506,4863,643,11.7
42472,CN1706300000000,17,63,"Grundy County, IL",Apr-20 p,24436,20292,4144,17.0
42473,CN1706500000000,17,65,"Hamilton County, IL",Apr-20 p,4002,3301,701,17.5
42474,CN1706700000000,17,67,"Hancock County, IL",Apr-20 p,7886,6719,1167,14.8
42475,CN1706900000000,17,69,"Hardin County, IL",Apr-20 p,1248,1070,178,14.3
42476,CN1707100000000,17,71,"Henderson County, IL",Apr-20 p,3432,2908,524,15.3
42477,CN1707300000000,17,73,"Henry County, IL",Apr-20 p,22452,19028,3424,15.3
42478,CN1707500000000,17,75,"Iroquois County, IL",Apr-20 p,13044,11615,1429,11.0
42479,CN1707700000000,17,77,"Jackson County, IL",Apr-20 p,25600,21953,3647,14.2
42480,CN1707900000000,17,79,"Jasper County, IL",Apr-20 p,4517,4043,474,10.5
42481,CN1708100000000,17,81,"Jefferson County, IL",Apr-20 p,16729,12214,4515,27.0
42482,CN1708300000000,17,83,"Jersey County, IL",Apr-20 p,9989,8441,1548,15.5
42483,CN1708500000000,17,85,"Jo Daviess County, IL",Apr-20 p,9935,8196,1739,17.5
42484,CN1708700000000,17,87,"Johnson County, IL",Apr-20 p,4149,3465,684,16.5
42485,CN1708900000000,17,89,"Kane County, IL",Apr-20 p,245799,204183,41616,16.9
42486,CN1709100000000,17,91,"Kankakee County, IL",Apr-20 p,51527,43320,8207,15.9
42487,CN1709300000000,17,93,"Kendall County, IL",Apr-20 p,66477,55445,11032,16.6
42488,CN1709500000000,17,95,"Knox County, IL",Apr-20 p,20155,17214,2941,14.6
42489,CN1709700000000,17,97,"Lake County, IL",Apr-20 p,334581,285147,49434,14.8
42490,CN1709900000000,17,99,"LaSalle County, IL",Apr-20 p,51645,42123,9522,18.4
42491,CN1710100000000,17,101,"Lawrence County, IL",Apr-20 p,5695,4355,1340,23.5
42492,CN1710300000000,17,103,"Lee County, IL",Apr-20 p,16404,14290,2114,12.9
42493,CN1710500000000,17,105,"Livingston County, IL",Apr-20 p,15249,13388,1861,12.2
42494,CN1710700000000,17,107,"Logan County, IL",Apr-20 p,11658,10306,1352,11.6
42495,CN1710900000000,17,109,"McDonough County, IL",Apr-20 p,12460,11011,1449,11.6
42496,CN1711100000000,17,111,"McHenry County, IL",Apr-20 p,160508,133818,26690,16.6
42497,CN1711300000000,17,113,"McLean County, IL",Apr-20 p,78832,68620,10212,13.0
42498,CN1711500000000,17,115,"Macon County, IL",Apr-20 p,41659,34931,6728,16.2
42499,CN1711700000000,17,117,"Macoupin County, IL",Apr-20 p,20490,17635,2855,13.9
42500,CN1711900000000,17,119,"Madison County, IL",Apr-20 p,122259,104073,18186,14.9
42501,CN1712100000000,17,121,"Marion County, IL",Apr-20 p,17392,13469,3923,22.6
42502,CN1712300000000,17,123,"Marshall County, IL",Apr-20 p,4440,3781,659,14.8
42503,CN1712500000000,17,125,"Mason County, IL",Apr-20 p,5753,4974,779,13.5
42504,CN1712700000000,17,127,"Massac County, IL",Apr-20 p,5398,4278,1120,20.7
42505,CN1712900000000,17,129,"Menard County, IL",Apr-20 p,5728,5020,708,12.4
42506,CN1713100000000,17,131,"Mercer County, IL",Apr-20 p,7247,6117,1130,15.6
42507,CN1713300000000,17,133,"Monroe County, IL",Apr-20 p,16790,14670,2120,12.6
42508,CN1713500000000,17,135,"Montgomery County, IL",Apr-20 p,11148,9342,1806,16.2
42509,CN1713700000000,17,137,"Morgan County, IL",Apr-20 p,15160,13471,1689,11.1
42510,CN1713900000000,17,139,"Moultrie County, IL",Apr-20 p,6800,6249,551,8.1
42511,CN1714100000000,17,141,"Ogle County, IL",Apr-20 p,23073,19572,3501,15.2
42512,CN1714300000000,17,143,"Peoria County, IL",Apr-20 p,75051,60503,14548,19.4
42513,CN1714500000000,17,145,"Perry County, IL",Apr-20 p,8580,6738,1842,21.5
42514,CN1714700000000,17,147,"Piatt County, IL",Apr-20 p,7749,6980,769,9.9
42515,CN1714900000000,17,149,"Pike County, IL",Apr-20 p,6440,5715,725,11.3
42516,CN1715100000000,17,151,"Pope County, IL",Apr-20 p,1595,1363,232,14.5
42517,CN1715300000000,17,153,"Pulaski County, IL",Apr-20 p,1773,1432,341,19.2
42518,CN1715500000000,17,155,"Putnam County, IL",Apr-20 p,2923,2436,487,16.7
42519,CN1715700000000,17,157,"Randolph County, IL",Apr-20 p,13567,11383,2184,16.1
42520,CN1715900000000,17,159,"Richland County, IL",Apr-20 p,7086,5996,1090,15.4
42521,CN1716100000000,17,161,"Rock Island County, IL",Apr-20 p,66222,54626,11596,17.5
42522,CN1716300000000,17,163,"St. Clair County, IL",Apr-20 p,116406,97700,18706,16.1
42523,CN1716500000000,17,165,"Saline County, IL",Apr-20 p,9496,7763,1733,18.2
42524,CN1716700000000,17,167,"Sangamon County, IL",Apr-20 p,91362,78251,13111,14.4
42525,CN1716900000000,17,169,"Schuyler County, IL",Apr-20 p,3060,2707,353,11.5
42526,CN1717100000000,17,171,"Scott County, IL",Apr-20 p,2312,2064,248,10.7
42527,CN1717300000000,17,173,"Shelby County, IL",Apr-20 p,9771,8649,1122,11.5
42528,CN1717500000000,17,175,"Stark County, IL",Apr-20 p,2058,1769,289,14.0
42529,CN1717700000000,17,177,"Stephenson County, IL",Apr-20 p,20044,17448,2596,13.0
42530,CN1717900000000,17,179,"Tazewell County, IL",Apr-20 p,55396,45683,9713,17.5
42531,CN1718100000000,17,181,"Union County, IL",Apr-20 p,7015,6032,983,14.0
42532,CN1718300000000,17,183,"Vermilion County, IL",Apr-20 p,30851,25559,5292,17.2
42533,CN1718500000000,17,185,"Wabash County, IL",Apr-20 p,6324,4838,1486,23.5
42534,CN1718700000000,17,187,"Warren County, IL",Apr-20 p,7736,6949,787,10.2
42535,CN1718900000000,17,189,"Washington County, IL",Apr-20 p,8426,6948,1478,17.5
42536,CN1719100000000,17,191,"Wayne County, IL",Apr-20 p,7034,5672,1362,19.4
42537,CN1719300000000,17,193,"White County, IL",Apr-20 p,6346,5239,1107,17.4
42538,CN1719500000000,17,195,"Whiteside County, IL",Apr-20 p,26834,22553,4281,16.0
42539,CN1719700000000,17,197,"Will County, IL",Apr-20 p,348416,287283,61133,17.5
42540,CN1719900000000,17,199,"Williamson County, IL",Apr-20 p,31105,25051,6054,19.5
42541,CN1720100000000,17,201,"Winnebago County, IL",Apr-20 p,131121,101959,29162,22.2
42542,CN1720300000000,17,203,"Woodford County, IL",Apr-20 p,15470,13504,1966,12.7
42543,CN1800100000000,18,1,"Adams County, IN",Apr-20 p,17017,13490,3527,20.7
42544,CN1800300000000,18,3,"Allen County, IN",Apr-20 p,184639,147684,36955,20.0
42545,CN1800500000000,18,5,"Bartholomew County, IN",Apr-20 p,41928,34228,7700,18.4
42546,CN1800700000000,18,7,"Benton County, IN",Apr-20 p,4091,3642,449,11.0
42547,CN1800900000000,18,9,"Blackford County, IN",Apr-20 p,4945,3829,1116,22.6
42548,CN1801100000000,18,11,"Boone County, IN",Apr-20 p,32273,29335,2938,9.1
42549,CN1801300000000,18,13,"Brown County, IN",Apr-20 p,7382,6185,1197,16.2
42550,CN1801500000000,18,15,"Carroll County, IN",Apr-20 p,9693,8241,1452,15.0
42551,CN1801700000000,18,17,"Cass County, IN",Apr-20 p,16932,13927,3005,17.7
42552,CN1801900000000,18,19,"Clark County, IN",Apr-20 p,57010,46756,10254,18.0
42553,CN1802100000000,18,21,"Clay County, IN",Apr-20 p,11101,9540,1561,14.1
42554,CN1802300000000,18,23,"Clinton County, IN",Apr-20 p,15955,13783,2172,13.6
42555,CN1802500000000,18,25,"Crawford County, IN",Apr-20 p,4464,3732,732,16.4
42556,CN1802700000000,18,27,"Daviess County, IN",Apr-20 p,14641,13412,1229,8.4
42557,CN1802900000000,18,29,"Dearborn County, IN",Apr-20 p,24345,19888,4457,18.3
42558,CN1803100000000,18,31,"Decatur County, IN",Apr-20 p,16127,12166,3961,24.6
42559,CN1803300000000,18,33,"DeKalb County, IN",Apr-20 p,23041,18034,5007,21.7
42560,CN1803500000000,18,35,"Delaware County, IN",Apr-20 p,52984,44237,8747,16.5
42561,CN1803700000000,18,37,"Dubois County, IN",Apr-20 p,20623,18431,2192,10.6
42562,CN1803900000000,18,39,"Elkhart County, IN",Apr-20 p,114147,80708,33439,29.3
42563,CN1804100000000,18,41,"Fayette County, IN",Apr-20 p,8821,6570,2251,25.5
42564,CN1804300000000,18,43,"Floyd County, IN",Apr-20 p,37778,31619,6159,16.3
42565,CN1804500000000,18,45,"Fountain County, IN",Apr-20 p,7728,6282,1446,18.7
42566,CN1804700000000,18,47,"Franklin County, IN",Apr-20 p,10905,8907,1998,18.3
42567,CN1804900000000,18,49,"Fulton County, IN",Apr-20 p,9169,7565,1604,17.5
42568,CN1805100000000,18,51,"Gibson County, IN",Apr-20 p,19867,16092,3775,19.0
42569,CN1805300000000,18,53,"Grant County, IN",Apr-20 p,29986,25386,4600,15.3
42570,CN1805500000000,18,55,"Greene County, IN",Apr-20 p,12440,10845,1595,12.8
42571,CN1805700000000,18,57,"Hamilton County, IN",Apr-20 p,166160,149233,16927,10.2
42572,CN1805900000000,18,59,"Hancock County, IN",Apr-20 p,37894,32517,5377,14.2
42573,CN1806100000000,18,61,"Harrison County, IN",Apr-20 p,18462,15394,3068,16.6
42574,CN1806300000000,18,63,"Hendricks County, IN",Apr-20 p,81859,73002,8857,10.8
42575,CN1806500000000,18,65,"Henry County, IN",Apr-20 p,21353,17634,3719,17.4
42576,CN1806700000000,18,67,"Howard County, IN",Apr-20 p,41165,27130,14035,34.1
42577,CN1806900000000,18,69,"Huntington County, IN",Apr-20 p,18072,14452,3620,20.0
42578,CN1807100000000,18,71,"Jackson County, IN",Apr-20 p,23280,18095,5185,22.3
42579,CN1807300000000,18,73,"Jasper County, IN",Apr-20 p,15376,12832,2544,16.5
42580,CN1807500000000,18,75,"Jay County, IN",Apr-20 p,9150,7300,1850,20.2
42581,CN1807700000000,18,77,"Jefferson County, IN",Apr-20 p,15293,11938,3355,21.9
42582,CN1807900000000,18,79,"Jennings County, IN",Apr-20 p,13913,10672,3241,23.3
42583,CN1808100000000,18,81,"Johnson County, IN",Apr-20 p,77806,67204,10602,13.6
42584,CN1808300000000,18,83,"Knox County, IN",Apr-20 p,17259,14473,2786,16.1
42585,CN1808500000000,18,85,"Kosciusko County, IN",Apr-20 p,41309,33366,7943,19.2
42586,CN1808700000000,18,87,"LaGrange County, IN",Apr-20 p,21453,15280,6173,28.8
42587,CN1808900000000,18,89,"Lake County, IN",Apr-20 p,228004,180845,47159,20.7
42588,CN1809100000000,18,91,"LaPorte County, IN",Apr-20 p,46875,37201,9674,20.6
42589,CN1809300000000,18,93,"Lawrence County, IN",Apr-20 p,20486,16881,3605,17.6
42590,CN1809500000000,18,95,"Madison County, IN",Apr-20 p,58282,47379,10903,18.7
42591,CN1809700000000,18,97,"Marion County, IN",Apr-20 p,460133,395645,64488,14.0
42592,CN1809900000000,18,99,"Marshall County, IN",Apr-20 p,22336,18150,4186,18.7
42593,CN1810100000000,18,101,"Martin County, IN",Apr-20 p,4706,4293,413,8.8
42594,CN1810300000000,18,103,"Miami County, IN",Apr-20 p,15346,11749,3597,23.4
42595,CN1810500000000,18,105,"Monroe County, IN",Apr-20 p,65468,58846,6622,10.1
42596,CN1810700000000,18,107,"Montgomery County, IN",Apr-20 p,16940,14922,2018,11.9
42597,CN1810900000000,18,109,"Morgan County, IN",Apr-20 p,33198,29253,3945,11.9
42598,CN1811100000000,18,111,"Newton County, IN",Apr-20 p,6467,5442,1025,15.8
42599,CN1811300000000,18,113,"Noble County, IN",Apr-20 p,25940,18493,7447,28.7
42600,CN1811500000000,18,115,"Ohio County, IN",Apr-20 p,3001,2461,540,18.0
42601,CN1811700000000,18,117,"Orange County, IN",Apr-20 p,9241,6853,2388,25.8
42602,CN1811900000000,18,119,"Owen County, IN",Apr-20 p,8825,7757,1068,12.1
42603,CN1812100000000,18,121,"Parke County, IN",Apr-20 p,6193,5461,732,11.8
42604,CN1812300000000,18,123,"Perry County, IN",Apr-20 p,8743,7188,1555,17.8
42605,CN1812500000000,18,125,"Pike County, IN",Apr-20 p,5719,4850,869,15.2
42606,CN1812700000000,18,127,"Porter County, IN",Apr-20 p,84218,68909,15309,18.2
42607,CN1812900000000,18,129,"Posey County, IN",Apr-20 p,12685,11225,1460,11.5
42608,CN1813100000000,18,131,"Pulaski County, IN",Apr-20 p,6027,5052,975,16.2
42609,CN1813300000000,18,133,"Putnam County, IN",Apr-20 p,15695,13434,2261,14.4
42610,CN1813500000000,18,135,"Randolph County, IN",Apr-20 p,10777,8860,1917,17.8
42611,CN1813700000000,18,137,"Ripley County, IN",Apr-20 p,13830,11298,2532,18.3
42612,CN1813900000000,18,139,"Rush County, IN",Apr-20 p,8713,7091,1622,18.6
42613,CN1814100000000,18,141,"St. Joseph County, IN",Apr-20 p,131513,104801,26712,20.3
42614,CN1814300000000,18,143,"Scott County, IN",Apr-20 p,10536,7984,2552,24.2
42615,CN1814500000000,18,145,"Shelby County, IN",Apr-20 p,23265,18679,4586,19.7
42616,CN1814700000000,18,147,"Spencer County, IN",Apr-20 p,10178,8841,1337,13.1
42617,CN1814900000000,18,149,"Starke County, IN",Apr-20 p,9566,7663,1903,19.9
42618,CN1815100000000,18,151,"Steuben County, IN",Apr-20 p,20643,16556,4087,19.8
42619,CN1815300000000,18,153,"Sullivan County, IN",Apr-20 p,7808,6579,1229,15.7
42620,CN1815500000000,18,155,"Switzerland County, IN",Apr-20 p,4755,3847,908,19.1
42621,CN1815700000000,18,157,"Tippecanoe County, IN",Apr-20 p,92143,81007,11136,12.1
42622,CN1815900000000,18,159,"Tipton County, IN",Apr-20 p,9067,7271,1796,19.8
42623,CN1816100000000,18,161,"Union County, IN",Apr-20 p,3270,2738,532,16.3
42624,CN1816300000000,18,163,"Vanderburgh County, IN",Apr-20 p,92930,78343,14587,15.7
42625,CN1816500000000,18,165,"Vermillion County, IN",Apr-20 p,6529,5425,1104,16.9
42626,CN1816700000000,18,167,"Vigo County, IN",Apr-20 p,45879,38019,7860,17.1
42627,CN1816900000000,18,169,"Wabash County, IN",Apr-20 p,14364,11946,2418,16.8
42628,CN1817100000000,18,171,"Warren County, IN",Apr-20 p,3802,3305,497,13.1
42629,CN1817300000000,18,173,"Warrick County, IN",Apr-20 p,31504,27379,4125,13.1
42630,CN1817500000000,18,175,"Washington County, IN",Apr-20 p,12729,10303,2426,19.1
42631,CN1817700000000,18,177,"Wayne County, IN",Apr-20 p,28870,24585,4285,14.8
42632,CN1817900000000,18,179,"Wells County, IN",Apr-20 p,13718,11445,2273,16.6
42633,CN1818100000000,18,181,"White County, IN",Apr-20 p,12367,10913,1454,11.8
42634,CN1818300000000,18,183,"Whitley County, IN",Apr-20 p,17153,14134,3019,17.6
42635,CN1900100000000,19,1,"Adair County, IA",Apr-20 p,4122,3738,384,9.3
42636,CN1900300000000,19,3,"Adams County, IA",Apr-20 p,2081,1934,147,7.1
42637,CN1900500000000,19,5,"Allamakee County, IA",Apr-20 p,7298,6548,750,10.3
42638,CN1900700000000,19,7,"Appanoose County, IA",Apr-20 p,5998,5365,633,10.6
42639,CN1900900000000,19,9,"Audubon County, IA",Apr-20 p,3017,2828,189,6.3
42640,CN1901100000000,19,11,"Benton County, IA",Apr-20 p,13343,11966,1377,10.3
42641,CN1901300000000,19,13,"Black Hawk County, IA",Apr-20 p,70389,61970,8419,12.0
42642,CN1901500000000,19,15,"Boone County, IA",Apr-20 p,14558,13272,1286,8.8
42643,CN1901700000000,19,17,"Bremer County, IA",Apr-20 p,13680,12510,1170,8.6
42644,CN1901900000000,19,19,"Buchanan County, IA",Apr-20 p,11038,10000,1038,9.4
42645,CN1902100000000,19,21,"Buena Vista County, IA",Apr-20 p,11605,10892,713,6.1
42646,CN1902300000000,19,23,"Butler County, IA",Apr-20 p,7824,7082,742,9.5
42647,CN1902500000000,19,25,"Calhoun County, IA",Apr-20 p,4126,3814,312,7.6
42648,CN1902700000000,19,27,"Carroll County, IA",Apr-20 p,10790,9837,953,8.8
42649,CN1902900000000,19,29,"Cass County, IA",Apr-20 p,6781,6285,496,7.3
42650,CN1903100000000,19,31,"Cedar County, IA",Apr-20 p,10739,9783,956,8.9
42651,CN1903300000000,19,33,"Cerro Gordo County, IA",Apr-20 p,23927,21152,2775,11.6
42652,CN1903500000000,19,35,"Cherokee County, IA",Apr-20 p,6131,5648,483,7.9
42653,CN1903700000000,19,37,"Chickasaw County, IA",Apr-20 p,6725,5928,797,11.9
42654,CN1903900000000,19,39,"Clarke County, IA",Apr-20 p,4841,4317,524,10.8
42655,CN1904100000000,19,41,"Clay County, IA",Apr-20 p,8560,7662,898,10.5
42656,CN1904300000000,19,43,"Clayton County, IA",Apr-20 p,9812,8717,1095,11.2
42657,CN1904500000000,19,45,"Clinton County, IA",Apr-20 p,23420,20388,3032,12.9
42658,CN1904700000000,19,47,"Crawford County, IA",Apr-20 p,8070,7371,699,8.7
42659,CN1904900000000,19,49,"Dallas County, IA",Apr-20 p,48524,44816,3708,7.6
42660,CN1905100000000,19,51,"Davis County, IA",Apr-20 p,4131,3823,308,7.5
42661,CN1905300000000,19,53,"Decatur County, IA",Apr-20 p,4208,3896,312,7.4
42662,CN1905500000000,19,55,"Delaware County, IA",Apr-20 p,10398,9489,909,8.7
42663,CN1905700000000,19,57,"Des Moines County, IA",Apr-20 p,19666,16739,2927,14.9
42664,CN1905900000000,19,59,"Dickinson County, IA",Apr-20 p,9740,8463,1277,13.1
42665,CN1906100000000,19,61,"Dubuque County, IA",Apr-20 p,54413,47512,6901,12.7
42666,CN1906300000000,19,63,"Emmet County, IA",Apr-20 p,5271,4754,517,9.8
42667,CN1906500000000,19,65,"Fayette County, IA",Apr-20 p,10236,9123,1113,10.9
42668,CN1906700000000,19,67,"Floyd County, IA",Apr-20 p,8790,7662,1128,12.8
42669,CN1906900000000,19,69,"Franklin County, IA",Apr-20 p,5534,5128,406,7.3
42670,CN1907100000000,19,71,"Fremont County, IA",Apr-20 p,3550,3338,212,6.0
42671,CN1907300000000,19,73,"Greene County, IA",Apr-20 p,5474,4915,559,10.2
42672,CN1907500000000,19,75,"Grundy County, IA",Apr-20 p,6400,5825,575,9.0
42673,CN1907700000000,19,77,"Guthrie County, IA",Apr-20 p,5572,4995,577,10.4
42674,CN1907900000000,19,79,"Hamilton County, IA",Apr-20 p,6744,6129,615,9.1
42675,CN1908100000000,19,81,"Hancock County, IA",Apr-20 p,6083,5412,671,11.0
42676,CN1908300000000,19,83,"Hardin County, IA",Apr-20 p,7874,7196,678,8.6
42677,CN1908500000000,19,85,"Harrison County, IA",Apr-20 p,7183,6619,564,7.9
42678,CN1908700000000,19,87,"Henry County, IA",Apr-20 p,9963,8807,1156,11.6
42679,CN1908900000000,19,89,"Howard County, IA",Apr-20 p,5337,4736,601,11.3
42680,CN1909100000000,19,91,"Humboldt County, IA",Apr-20 p,5077,4602,475,9.4
42681,CN1909300000000,19,93,"Ida County, IA",Apr-20 p,4128,3881,247,6.0
42682,CN1909500000000,19,95,"Iowa County, IA",Apr-20 p,10601,9570,1031,9.7
42683,CN1909700000000,19,97,"Jackson County, IA",Apr-20 p,10861,9640,1221,11.2
42684,CN1909900000000,19,99,"Jasper County, IA",Apr-20 p,19910,17806,2104,10.6
42685,CN1910100000000,19,101,"Jefferson County, IA",Apr-20 p,10262,9299,963,9.4
42686,CN1910300000000,19,103,"Johnson County, IA",Apr-20 p,84975,76836,8139,9.6
42687,CN1910500000000,19,105,"Jones County, IA",Apr-20 p,10618,9441,1177,11.1
42688,CN1910700000000,19,107,"Keokuk County, IA",Apr-20 p,5266,4748,518,9.8
42689,CN1910900000000,19,109,"Kossuth County, IA",Apr-20 p,8321,7608,713,8.6
42690,CN1911100000000,19,111,"Lee County, IA",Apr-20 p,16675,14453,2222,13.3
42691,CN1911300000000,19,113,"Linn County, IA",Apr-20 p,124060,108620,15440,12.4
42692,CN1911500000000,19,115,"Louisa County, IA",Apr-20 p,4994,4445,549,11.0
42693,CN1911700000000,19,117,"Lucas County, IA",Apr-20 p,4608,4280,328,7.1
42694,CN1911900000000,19,119,"Lyon County, IA",Apr-20 p,6539,6229,310,4.7
42695,CN1912100000000,19,121,"Madison County, IA",Apr-20 p,8664,7616,1048,12.1
42696,CN1912300000000,19,123,"Mahaska County, IA",Apr-20 p,11893,10730,1163,9.8
42697,CN1912500000000,19,125,"Marion County, IA",Apr-20 p,18082,16585,1497,8.3
42698,CN1912700000000,19,127,"Marshall County, IA",Apr-20 p,17782,15831,1951,11.0
42699,CN1912900000000,19,129,"Mills County, IA",Apr-20 p,7248,6664,584,8.1
42700,CN1913100000000,19,131,"Mitchell County, IA",Apr-20 p,7142,6656,486,6.8
42701,CN1913300000000,19,133,"Monona County, IA",Apr-20 p,4287,3792,495,11.5
42702,CN1913500000000,19,135,"Monroe County, IA",Apr-20 p,4070,3681,389,9.6
42703,CN1913700000000,19,137,"Montgomery County, IA",Apr-20 p,4965,4555,410,8.3
42704,CN1913900000000,19,139,"Muscatine County, IA",Apr-20 p,22724,20279,2445,10.8
42705,CN1914100000000,19,141,"O'Brien County, IA",Apr-20 p,8113,7560,553,6.8
42706,CN1914300000000,19,143,"Osceola County, IA",Apr-20 p,3413,3199,214,6.3
42707,CN1914500000000,19,145,"Page County, IA",Apr-20 p,6558,5896,662,10.1
42708,CN1914700000000,19,147,"Palo Alto County, IA",Apr-20 p,4831,4310,521,10.8
42709,CN1914900000000,19,149,"Plymouth County, IA",Apr-20 p,14310,13227,1083,7.6
42710,CN1915100000000,19,151,"Pocahontas County, IA",Apr-20 p,4448,4179,269,6.0
42711,CN1915300000000,19,153,"Polk County, IA",Apr-20 p,275794,241566,34228,12.4
42712,CN1915500000000,19,155,"Pottawattamie County, IA",Apr-20 p,49223,43838,5385,10.9
42713,CN1915700000000,19,157,"Poweshiek County, IA",Apr-20 p,9964,8970,994,10.0
42714,CN1915900000000,19,159,"Ringgold County, IA",Apr-20 p,2349,2178,171,7.3
42715,CN1916100000000,19,161,"Sac County, IA",Apr-20 p,5127,4776,351,6.8
42716,CN1916300000000,19,163,"Scott County, IA",Apr-20 p,90076,77967,12109,13.4
42717,CN1916500000000,19,165,"Shelby County, IA",Apr-20 p,6591,6078,513,7.8
42718,CN1916700000000,19,167,"Sioux County, IA",Apr-20 p,19961,18815,1146,5.7
42719,CN1916900000000,19,169,"Story County, IA",Apr-20 p,55060,50441,4619,8.4
42720,CN1917100000000,19,171,"Tama County, IA",Apr-20 p,9365,8600,765,8.2
42721,CN1917300000000,19,173,"Taylor County, IA",Apr-20 p,3123,2923,200,6.4
42722,CN1917500000000,19,175,"Union County, IA",Apr-20 p,6512,5713,799,12.3
42723,CN1917700000000,19,177,"Van Buren County, IA",Apr-20 p,3657,3289,368,10.1
42724,CN1917900000000,19,179,"Wapello County, IA",Apr-20 p,17811,15870,1941,10.9
42725,CN1918100000000,19,181,"Warren County, IA",Apr-20 p,28207,25489,2718,9.6
42726,CN1918300000000,19,183,"Washington County, IA",Apr-20 p,11566,10621,945,8.2
42727,CN1918500000000,19,185,"Wayne County, IA",Apr-20 p,2875,2591,284,9.9
42728,CN1918700000000,19,187,"Webster County, IA",Apr-20 p,19419,17498,1921,9.9
42729,CN1918900000000,19,189,"Winnebago County, IA",Apr-20 p,5617,4629,988,17.6
42730,CN1919100000000,19,191,"Winneshiek County, IA",Apr-20 p,10300,9130,1170,11.4
42731,CN1919300000000,19,193,"Woodbury County, IA",Apr-20 p,55320,49647,5673,10.3
42732,CN1919500000000,19,195,"Worth County, IA",Apr-20 p,4325,3707,618,14.3
42733,CN1919700000000,19,197,"Wright County, IA",Apr-20 p,7015,6496,519,7.4
42734,CN2000100000000,20,1,"Allen County, KS",Apr-20 p,6488,5935,553,8.5
42735,CN2000300000000,20,3,"Anderson County, KS",Apr-20 p,4087,3821,266,6.5
42736,CN2000500000000,20,5,"Atchison County, KS",Apr-20 p,7091,6267,824,11.6
42737,CN2000700000000,20,7,"Barber County, KS",Apr-20 p,2184,2075,109,5.0
42738,CN2000900000000,20,9,"Barton County, KS",Apr-20 p,13659,12613,1046,7.7
42739,CN2001100000000,20,11,"Bourbon County, KS",Apr-20 p,6586,6014,572,8.7
42740,CN2001300000000,20,13,"Brown County, KS",Apr-20 p,5341,4880,461,8.6
42741,CN2001500000000,20,15,"Butler County, KS",Apr-20 p,33102,28293,4809,14.5
42742,CN2001700000000,20,17,"Chase County, KS",Apr-20 p,1658,1492,166,10.0
42743,CN2001900000000,20,19,"Chautauqua County, KS",Apr-20 p,1461,1317,144,9.9
42744,CN2002100000000,20,21,"Cherokee County, KS",Apr-20 p,10174,9123,1051,10.3
42745,CN2002300000000,20,23,"Cheyenne County, KS",Apr-20 p,1177,1139,38,3.2
42746,CN2002500000000,20,25,"Clark County, KS",Apr-20 p,960,937,23,2.4
42747,CN2002700000000,20,27,"Clay County, KS",Apr-20 p,3650,3363,287,7.9
42748,CN2002900000000,20,29,"Cloud County, KS",Apr-20 p,3654,3450,204,5.6
42749,CN2003100000000,20,31,"Coffey County, KS",Apr-20 p,3944,3620,324,8.2
42750,CN2003300000000,20,33,"Comanche County, KS",Apr-20 p,829,794,35,4.2
42751,CN2003500000000,20,35,"Cowley County, KS",Apr-20 p,17324,14875,2449,14.1
42752,CN2003700000000,20,37,"Crawford County, KS",Apr-20 p,19094,17375,1719,9.0
42753,CN2003900000000,20,39,"Decatur County, KS",Apr-20 p,1128,1073,55,4.9
42754,CN2004100000000,20,41,"Dickinson County, KS",Apr-20 p,8779,8074,705,8.0
42755,CN2004300000000,20,43,"Doniphan County, KS",Apr-20 p,4015,3640,375,9.3
42756,CN2004500000000,20,45,"Douglas County, KS",Apr-20 p,66823,59308,7515,11.2
42757,CN2004700000000,20,47,"Edwards County, KS",Apr-20 p,1219,1170,49,4.0
42758,CN2004900000000,20,49,"Elk County, KS",Apr-20 p,1155,1049,106,9.2
42759,CN2005100000000,20,51,"Ellis County, KS",Apr-20 p,16856,15654,1202,7.1
42760,CN2005300000000,20,53,"Ellsworth County, KS",Apr-20 p,2571,2453,118,4.6
42761,CN2005500000000,20,55,"Finney County, KS",Apr-20 p,20127,18947,1180,5.9
42762,CN2005700000000,20,57,"Ford County, KS",Apr-20 p,16387,15640,747,4.6
42763,CN2005900000000,20,59,"Franklin County, KS",Apr-20 p,14194,12882,1312,9.2
42764,CN2006100000000,20,61,"Geary County, KS",Apr-20 p,11457,10205,1252,10.9
42765,CN2006300000000,20,63,"Gove County, KS",Apr-20 p,1400,1334,66,4.7
42766,CN2006500000000,20,65,"Graham County, KS",Apr-20 p,1046,991,55,5.3
42767,CN2006700000000,20,67,"Grant County, KS",Apr-20 p,2875,2754,121,4.2
42768,CN2006900000000,20,69,"Gray County, KS",Apr-20 p,2965,2885,80,2.7
42769,CN2007100000000,20,71,"Greeley County, KS",Apr-20 p,740,725,15,2.0
42770,CN2007300000000,20,73,"Greenwood County, KS",Apr-20 p,3292,2986,306,9.3
42771,CN2007500000000,20,75,"Hamilton County, KS",Apr-20 p,1425,1399,26,1.8
42772,CN2007700000000,20,77,"Harper County, KS",Apr-20 p,2804,2637,167,6.0
42773,CN2007900000000,20,79,"Harvey County, KS",Apr-20 p,16695,14828,1867,11.2
42774,CN2008100000000,20,81,"Haskell County, KS",Apr-20 p,2047,1982,65,3.2
42775,CN2008300000000,20,83,"Hodgeman County, KS",Apr-20 p,919,884,35,3.8
42776,CN2008500000000,20,85,"Jackson County, KS",Apr-20 p,7278,6374,904,12.4
42777,CN2008700000000,20,87,"Jefferson County, KS",Apr-20 p,9965,8954,1011,10.1
42778,CN2008900000000,20,89,"Jewell County, KS",Apr-20 p,1200,1151,49,4.1
42779,CN2009100000000,20,91,"Johnson County, KS",Apr-20 p,335068,299745,35323,10.5
42780,CN2009300000000,20,93,"Kearny County, KS",Apr-20 p,1908,1816,92,4.8
42781,CN2009500000000,20,95,"Kingman County, KS",Apr-20 p,3272,2954,318,9.7
42782,CN2009700000000,20,97,"Kiowa County, KS",Apr-20 p,1182,1125,57,4.8
42783,CN2009900000000,20,99,"Labette County, KS",Apr-20 p,9799,8998,801,8.2
42784,CN2010100000000,20,101,"Lane County, KS",Apr-20 p,694,671,23,3.3
42785,CN2010300000000,20,103,"Leavenworth County, KS",Apr-20 p,36161,32035,4126,11.4
42786,CN2010500000000,20,105,"Lincoln County, KS",Apr-20 p,1598,1541,57,3.6
42787,CN2010700000000,20,107,"Linn County, KS",Apr-20 p,4203,3774,429,10.2
42788,CN2010900000000,20,109,"Logan County, KS",Apr-20 p,1531,1465,66,4.3
42789,CN2011100000000,20,111,"Lyon County, KS",Apr-20 p,16894,15631,1263,7.5
42790,CN2011300000000,20,113,"McPherson County, KS",Apr-20 p,17022,16037,985,5.8
42791,CN2011500000000,20,115,"Marion County, KS",Apr-20 p,5829,5385,444,7.6
42792,CN2011700000000,20,117,"Marshall County, KS",Apr-20 p,5210,4940,270,5.2
42793,CN2011900000000,20,119,"Meade County, KS",Apr-20 p,1947,1867,80,4.1
42794,CN2012100000000,20,121,"Miami County, KS",Apr-20 p,16936,15364,1572,9.3
42795,CN2012300000000,20,123,"Mitchell County, KS",Apr-20 p,3163,3052,111,3.5
42796,CN2012500000000,20,125,"Montgomery County, KS",Apr-20 p,15211,13160,2051,13.5
42797,CN2012700000000,20,127,"Morris County, KS",Apr-20 p,2869,2672,197,6.9
42798,CN2012900000000,20,129,"Morton County, KS",Apr-20 p,1018,987,31,3.0
42799,CN2013100000000,20,131,"Nemaha County, KS",Apr-20 p,4939,4676,263,5.3
42800,CN2013300000000,20,133,"Neosho County, KS",Apr-20 p,6060,5445,615,10.1
42801,CN2013500000000,20,135,"Ness County, KS",Apr-20 p,1256,1190,66,5.3
42802,CN2013700000000,20,137,"Norton County, KS",Apr-20 p,2456,2378,78,3.2
42803,CN2013900000000,20,139,"Osage County, KS",Apr-20 p,7797,7026,771,9.9
42804,CN2014100000000,20,141,"Osborne County, KS",Apr-20 p,1884,1798,86,4.6
42805,CN2014300000000,20,143,"Ottawa County, KS",Apr-20 p,2922,2742,180,6.2
42806,CN2014500000000,20,145,"Pawnee County, KS",Apr-20 p,2599,2467,132,5.1
42807,CN2014700000000,20,147,"Phillips County, KS",Apr-20 p,2549,2382,167,6.6
42808,CN2014900000000,20,149,"Pottawatomie County, KS",Apr-20 p,11674,10786,888,7.6
42809,CN2015100000000,20,151,"Pratt County, KS",Apr-20 p,4789,4522,267,5.6
42810,CN2015300000000,20,153,"Rawlins County, KS",Apr-20 p,1368,1316,52,3.8
42811,CN2015500000000,20,155,"Reno County, KS",Apr-20 p,30726,27588,3138,10.2
42812,CN2015700000000,20,157,"Republic County, KS",Apr-20 p,2100,2015,85,4.0
42813,CN2015900000000,20,159,"Rice County, KS",Apr-20 p,5253,4900,353,6.7
42814,CN2016100000000,20,161,"Riley County, KS",Apr-20 p,33426,30545,2881,8.6
42815,CN2016300000000,20,163,"Rooks County, KS",Apr-20 p,2342,2210,132,5.6
42816,CN2016500000000,20,165,"Rush County, KS",Apr-20 p,1570,1432,138,8.8
42817,CN2016700000000,20,167,"Russell County, KS",Apr-20 p,3164,2929,235,7.4
42818,CN2016900000000,20,169,"Saline County, KS",Apr-20 p,30799,27856,2943,9.6
42819,CN2017100000000,20,171,"Scott County, KS",Apr-20 p,2586,2495,91,3.5
42820,CN2017300000000,20,173,"Sedgwick County, KS",Apr-20 p,268900,218542,50358,18.7
42821,CN2017500000000,20,175,"Seward County, KS",Apr-20 p,9058,8508,550,6.1
42822,CN2017700000000,20,177,"Shawnee County, KS",Apr-20 p,91356,80327,11029,12.1
42823,CN2017900000000,20,179,"Sheridan County, KS",Apr-20 p,1290,1249,41,3.2
42824,CN2018100000000,20,181,"Sherman County, KS",Apr-20 p,2630,2516,114,4.3
42825,CN2018300000000,20,183,"Smith County, KS",Apr-20 p,1834,1765,69,3.8
42826,CN2018500000000,20,185,"Stafford County, KS",Apr-20 p,1854,1756,98,5.3
42827,CN2018700000000,20,187,"Stanton County, KS",Apr-20 p,874,854,20,2.3
42828,CN2018900000000,20,189,"Stevens County, KS",Apr-20 p,2529,2441,88,3.5
42829,CN2019100000000,20,191,"Sumner County, KS",Apr-20 p,11446,9445,2001,17.5
42830,CN2019300000000,20,193,"Thomas County, KS",Apr-20 p,4022,3850,172,4.3
42831,CN2019500000000,20,195,"Trego County, KS",Apr-20 p,1285,1202,83,6.5
42832,CN2019700000000,20,197,"Wabaunsee County, KS",Apr-20 p,3461,3203,258,7.5
42833,CN2019900000000,20,199,"Wallace County, KS",Apr-20 p,910,888,22,2.4
42834,CN2020100000000,20,201,"Washington County, KS",Apr-20 p,2792,2680,112,4.0
42835,CN2020300000000,20,203,"Wichita County, KS",Apr-20 p,1180,1149,31,2.6
42836,CN2020500000000,20,205,"Wilson County, KS",Apr-20 p,4352,3542,810,18.6
42837,CN2020700000000,20,207,"Woodson County, KS",Apr-20 p,1607,1469,138,8.6
42838,CN2020900000000,20,209,"Wyandotte County, KS",Apr-20 p,78956,67258,11698,14.8
42839,CN2100100000000,21,1,"Adair County, KY",Apr-20 p,7266,6041,1225,16.9
42840,CN2100300000000,21,3,"Allen County, KY",Apr-20 p,8283,7108,1175,14.2
42841,CN2100500000000,21,5,"Anderson County, KY",Apr-20 p,12466,10671,1795,14.4
42842,CN2100700000000,21,7,"Ballard County, KY",Apr-20 p,3494,2969,525,15.0
42843,CN2100900000000,21,9,"Barren County, KY",Apr-20 p,18708,15246,3462,18.5
42844,CN2101100000000,21,11,"Bath County, KY",Apr-20 p,4761,3888,873,18.3
42845,CN2101300000000,21,13,"Bell County, KY",Apr-20 p,8678,7250,1428,16.5
42846,CN2101500000000,21,15,"Boone County, KY",Apr-20 p,68279,59339,8940,13.1
42847,CN2101700000000,21,17,"Bourbon County, KY",Apr-20 p,9751,8144,1607,16.5
42848,CN2101900000000,21,19,"Boyd County, KY",Apr-20 p,18546,15101,3445,18.6
42849,CN2102100000000,21,21,"Boyle County, KY",Apr-20 p,12836,10287,2549,19.9
42850,CN2102300000000,21,23,"Bracken County, KY",Apr-20 p,3664,3152,512,14.0
42851,CN2102500000000,21,25,"Breathitt County, KY",Apr-20 p,3494,2864,630,18.0
42852,CN2102700000000,21,27,"Breckinridge County, KY",Apr-20 p,8040,6668,1372,17.1
42853,CN2102900000000,21,29,"Bullitt County, KY",Apr-20 p,42668,34845,7823,18.3
42854,CN2103100000000,21,31,"Butler County, KY",Apr-20 p,4912,4036,876,17.8
42855,CN2103300000000,21,33,"Caldwell County, KY",Apr-20 p,5599,4782,817,14.6
42856,CN2103500000000,21,35,"Calloway County, KY",Apr-20 p,19699,17210,2489,12.6
42857,CN2103700000000,21,37,"Campbell County, KY",Apr-20 p,49196,42480,6716,13.7
42858,CN2103900000000,21,39,"Carlisle County, KY",Apr-20 p,2215,2023,192,8.7
42859,CN2104100000000,21,41,"Carroll County, KY",Apr-20 p,5325,4641,684,12.8
42860,CN2104300000000,21,43,"Carter County, KY",Apr-20 p,10256,8194,2062,20.1
42861,CN2104500000000,21,45,"Casey County, KY",Apr-20 p,7146,5912,1234,17.3
42862,CN2104700000000,21,47,"Christian County, KY",Apr-20 p,25960,21389,4571,17.6
42863,CN2104900000000,21,49,"Clark County, KY",Apr-20 p,17332,14497,2835,16.4
42864,CN2105100000000,21,51,"Clay County, KY",Apr-20 p,5398,4458,940,17.4
42865,CN2105300000000,21,53,"Clinton County, KY",Apr-20 p,3905,3577,328,8.4
42866,CN2105500000000,21,55,"Crittenden County, KY",Apr-20 p,3822,3372,450,11.8
42867,CN2105700000000,21,57,"Cumberland County, KY",Apr-20 p,3090,2778,312,10.1
42868,CN2105900000000,21,59,"Daviess County, KY",Apr-20 p,46708,40047,6661,14.3
42869,CN2106100000000,21,61,"Edmonson County, KY",Apr-20 p,4749,3765,984,20.7
42870,CN2106300000000,21,63,"Elliott County, KY",Apr-20 p,2132,1713,419,19.7
42871,CN2106500000000,21,65,"Estill County, KY",Apr-20 p,5510,4584,926,16.8
42872,CN2106700000000,21,67,"Fayette County, KY",Apr-20 p,172100,148555,23545,13.7
42873,CN2106900000000,21,69,"Fleming County, KY",Apr-20 p,6490,5295,1195,18.4
42874,CN2107100000000,21,71,"Floyd County, KY",Apr-20 p,11134,9208,1926,17.3
42875,CN2107300000000,21,73,"Franklin County, KY",Apr-20 p,26212,22364,3848,14.7
42876,CN2107500000000,21,75,"Fulton County, KY",Apr-20 p,2062,1821,241,11.7
42877,CN2107700000000,21,77,"Gallatin County, KY",Apr-20 p,3947,3389,558,14.1
42878,CN2107900000000,21,79,"Garrard County, KY",Apr-20 p,7660,6490,1170,15.3
42879,CN2108100000000,21,81,"Grant County, KY",Apr-20 p,11921,9737,2184,18.3
42880,CN2108300000000,21,83,"Graves County, KY",Apr-20 p,16109,14053,2056,12.8
42881,CN2108500000000,21,85,"Grayson County, KY",Apr-20 p,11638,9467,2171,18.7
42882,CN2108700000000,21,87,"Green County, KY",Apr-20 p,5129,4407,722,14.1
42883,CN2108900000000,21,89,"Greenup County, KY",Apr-20 p,13838,11228,2610,18.9
42884,CN2109100000000,21,91,"Hancock County, KY",Apr-20 p,3994,3361,633,15.8
42885,CN2109300000000,21,93,"Hardin County, KY",Apr-20 p,50549,41551,8998,17.8
42886,CN2109500000000,21,95,"Harlan County, KY",Apr-20 p,6825,5442,1383,20.3
42887,CN2109700000000,21,97,"Harrison County, KY",Apr-20 p,9333,7707,1626,17.4
42888,CN2109900000000,21,99,"Hart County, KY",Apr-20 p,8107,6932,1175,14.5
42889,CN2110100000000,21,101,"Henderson County, KY",Apr-20 p,22842,19499,3343,14.6
42890,CN2110300000000,21,103,"Henry County, KY",Apr-20 p,8018,6726,1292,16.1
42891,CN2110500000000,21,105,"Hickman County, KY",Apr-20 p,1710,1527,183,10.7
42892,CN2110700000000,21,107,"Hopkins County, KY",Apr-20 p,17828,14412,3416,19.2
42893,CN2110900000000,21,109,"Jackson County, KY",Apr-20 p,4295,3447,848,19.7
42894,CN2111100000000,21,111,"Jefferson County, KY",Apr-20 p,389570,326428,63142,16.2
42895,CN2111300000000,21,113,"Jessamine County, KY",Apr-20 p,26033,22498,3535,13.6
42896,CN2111500000000,21,115,"Johnson County, KY",Apr-20 p,6856,5734,1122,16.4
42897,CN2111700000000,21,117,"Kenton County, KY",Apr-20 p,85057,73333,11724,13.8
42898,CN2111900000000,21,119,"Knott County, KY",Apr-20 p,4426,3742,684,15.5
42899,CN2112100000000,21,121,"Knox County, KY",Apr-20 p,10485,8606,1879,17.9
42900,CN2112300000000,21,123,"Larue County, KY",Apr-20 p,6281,5055,1226,19.5
42901,CN2112500000000,21,125,"Laurel County, KY",Apr-20 p,26226,21619,4607,17.6
42902,CN2112700000000,21,127,"Lawrence County, KY",Apr-20 p,5423,4562,861,15.9
42903,CN2112900000000,21,129,"Lee County, KY",Apr-20 p,2118,1832,286,13.5
42904,CN2113100000000,21,131,"Leslie County, KY",Apr-20 p,2758,2219,539,19.5
42905,CN2113300000000,21,133,"Letcher County, KY",Apr-20 p,6509,5312,1197,18.4
42906,CN2113500000000,21,135,"Lewis County, KY",Apr-20 p,4886,3892,994,20.3
42907,CN2113700000000,21,137,"Lincoln County, KY",Apr-20 p,9589,7600,1989,20.7
42908,CN2113900000000,21,139,"Livingston County, KY",Apr-20 p,3663,3093,570,15.6
42909,CN2114100000000,21,141,"Logan County, KY",Apr-20 p,11686,9783,1903,16.3
42910,CN2114300000000,21,143,"Lyon County, KY",Apr-20 p,3016,2690,326,10.8
42911,CN2114500000000,21,145,"McCracken County, KY",Apr-20 p,29958,24942,5016,16.7
42912,CN2114700000000,21,147,"McCreary County, KY",Apr-20 p,4827,4062,765,15.8
42913,CN2114900000000,21,149,"McLean County, KY",Apr-20 p,4002,3526,476,11.9
42914,CN2115100000000,21,151,"Madison County, KY",Apr-20 p,46340,39395,6945,15.0
42915,CN2115300000000,21,153,"Magoffin County, KY",Apr-20 p,3666,2647,1019,27.8
42916,CN2115500000000,21,155,"Marion County, KY",Apr-20 p,9216,6576,2640,28.6
42917,CN2115700000000,21,157,"Marshall County, KY",Apr-20 p,15637,13444,2193,14.0
42918,CN2115900000000,21,159,"Martin County, KY",Apr-20 p,2925,2374,551,18.8
42919,CN2116100000000,21,161,"Mason County, KY",Apr-20 p,7376,5909,1467,19.9
42920,CN2116300000000,21,163,"Meade County, KY",Apr-20 p,12477,10332,2145,17.2
42921,CN2116500000000,21,165,"Menifee County, KY",Apr-20 p,2351,1946,405,17.2
42922,CN2116700000000,21,167,"Mercer County, KY",Apr-20 p,9683,7624,2059,21.3
42923,CN2116900000000,21,169,"Metcalfe County, KY",Apr-20 p,4203,3316,887,21.1
42924,CN2117100000000,21,171,"Monroe County, KY",Apr-20 p,4760,4130,630,13.2
42925,CN2117300000000,21,173,"Montgomery County, KY",Apr-20 p,12376,9976,2400,19.4
42926,CN2117500000000,21,175,"Morgan County, KY",Apr-20 p,4623,4047,576,12.5
42927,CN2117700000000,21,177,"Muhlenberg County, KY",Apr-20 p,10800,9046,1754,16.2
42928,CN2117900000000,21,179,"Nelson County, KY",Apr-20 p,24676,19814,4862,19.7
42929,CN2118100000000,21,181,"Nicholas County, KY",Apr-20 p,3431,2830,601,17.5
42930,CN2118300000000,21,183,"Ohio County, KY",Apr-20 p,10042,8586,1456,14.5
42931,CN2118500000000,21,185,"Oldham County, KY",Apr-20 p,31644,27375,4269,13.5
42932,CN2118700000000,21,187,"Owen County, KY",Apr-20 p,5172,4391,781,15.1
42933,CN2118900000000,21,189,"Owsley County, KY",Apr-20 p,1124,980,144,12.8
42934,CN2119100000000,21,191,"Pendleton County, KY",Apr-20 p,6612,5828,784,11.9
42935,CN2119300000000,21,193,"Perry County, KY",Apr-20 p,8395,6980,1415,16.9
42936,CN2119500000000,21,195,"Pike County, KY",Apr-20 p,18854,15545,3309,17.6
42937,CN2119700000000,21,197,"Powell County, KY",Apr-20 p,5107,4271,836,16.4
42938,CN2119900000000,21,199,"Pulaski County, KY",Apr-20 p,27785,23045,4740,17.1
42939,CN2120100000000,21,201,"Robertson County, KY",Apr-20 p,810,698,112,13.8
42940,CN2120300000000,21,203,"Rockcastle County, KY",Apr-20 p,6557,5509,1048,16.0
42941,CN2120500000000,21,205,"Rowan County, KY",Apr-20 p,10961,9102,1859,17.0
42942,CN2120700000000,21,207,"Russell County, KY",Apr-20 p,6800,5397,1403,20.6
42943,CN2120900000000,21,209,"Scott County, KY",Apr-20 p,31423,24674,6749,21.5
42944,CN2121100000000,21,211,"Shelby County, KY",Apr-20 p,24734,20910,3824,15.5
42945,CN2121300000000,21,213,"Simpson County, KY",Apr-20 p,9594,7719,1875,19.5
42946,CN2121500000000,21,215,"Spencer County, KY",Apr-20 p,10223,8372,1851,18.1
42947,CN2121700000000,21,217,"Taylor County, KY",Apr-20 p,12934,10586,2348,18.2
42948,CN2121900000000,21,219,"Todd County, KY",Apr-20 p,5349,4705,644,12.0
42949,CN2122100000000,21,221,"Trigg County, KY",Apr-20 p,6214,5155,1059,17.0
42950,CN2122300000000,21,223,"Trimble County, KY",Apr-20 p,3874,3148,726,18.7
42951,CN2122500000000,21,225,"Union County, KY",Apr-20 p,5725,4642,1083,18.9
42952,CN2122700000000,21,227,"Warren County, KY",Apr-20 p,62495,51285,11210,17.9
42953,CN2122900000000,21,229,"Washington County, KY",Apr-20 p,6876,5576,1300,18.9
42954,CN2123100000000,21,231,"Wayne County, KY",Apr-20 p,7444,6396,1048,14.1
42955,CN2123300000000,21,233,"Webster County, KY",Apr-20 p,5557,4702,855,15.4
42956,CN2123500000000,21,235,"Whitley County, KY",Apr-20 p,14156,11989,2167,15.3
42957,CN2123700000000,21,237,"Wolfe County, KY",Apr-20 p,2091,1763,328,15.7
42958,CN2123900000000,21,239,"Woodford County, KY",Apr-20 p,14376,12533,1843,12.8
42959,CN2200100000000,22,1,"Acadia Parish, LA",Apr-20 p,21195,18791,2404,11.3
42960,CN2200300000000,22,3,"Allen Parish, LA",Apr-20 p,8212,6935,1277,15.6
42961,CN2200500000000,22,5,"Ascension Parish, LA",Apr-20 p,59009,51447,7562,12.8
42962,CN2200700000000,22,7,"Assumption Parish, LA",Apr-20 p,8458,7102,1356,16.0
42963,CN2200900000000,22,9,"Avoyelles Parish, LA",Apr-20 p,14100,12069,2031,14.4
42964,CN2201100000000,22,11,"Beauregard Parish, LA",Apr-20 p,13054,11663,1391,10.7
42965,CN2201300000000,22,13,"Bienville Parish, LA",Apr-20 p,4769,4310,459,9.6
42966,CN2201500000000,22,15,"Bossier Parish, LA",Apr-20 p,52711,46489,6222,11.8
42967,CN2201700000000,22,17,"Caddo Parish, LA",Apr-20 p,96113,82513,13600,14.2
42968,CN2201900000000,22,19,"Calcasieu Parish, LA",Apr-20 p,92959,79315,13644,14.7
42969,CN2202100000000,22,21,"Caldwell Parish, LA",Apr-20 p,3304,2979,325,9.8
42970,CN2202300000000,22,23,"Cameron Parish, LA",Apr-20 p,3246,2953,293,9.0
42971,CN2202500000000,22,25,"Catahoula Parish, LA",Apr-20 p,3029,2729,300,9.9
42972,CN2202700000000,22,27,"Claiborne Parish, LA",Apr-20 p,4961,4579,382,7.7
42973,CN2202900000000,22,29,"Concordia Parish, LA",Apr-20 p,6296,5589,707,11.2
42974,CN2203100000000,22,31,"De Soto Parish, LA",Apr-20 p,9618,8604,1014,10.5
42975,CN2203300000000,22,33,"East Baton Rouge Parish, LA",Apr-20 p,213017,184860,28157,13.2
42976,CN2203500000000,22,35,"East Carroll Parish, LA",Apr-20 p,1581,1395,186,11.8
42977,CN2203700000000,22,37,"East Feliciana Parish, LA",Apr-20 p,7141,6379,762,10.7
42978,CN2203900000000,22,39,"Evangeline Parish, LA",Apr-20 p,10431,9234,1197,11.5
42979,CN2204100000000,22,41,"Franklin Parish, LA",Apr-20 p,6484,5809,675,10.4
42980,CN2204300000000,22,43,"Grant Parish, LA",Apr-20 p,7382,6665,717,9.7
42981,CN2204500000000,22,45,"Iberia Parish, LA",Apr-20 p,25765,22107,3658,14.2
42982,CN2204700000000,22,47,"Iberville Parish, LA",Apr-20 p,12909,11087,1822,14.1
42983,CN2204900000000,22,49,"Jackson Parish, LA",Apr-20 p,5835,5414,421,7.2
42984,CN2205100000000,22,51,"Jefferson Parish, LA",Apr-20 p,201568,163766,37802,18.8
42985,CN2205300000000,22,53,"Jefferson Davis Parish, LA",Apr-20 p,11796,10315,1481,12.6
42986,CN2205500000000,22,55,"Lafayette Parish, LA",Apr-20 p,104191,90397,13794,13.2
42987,CN2205700000000,22,57,"Lafourche Parish, LA",Apr-20 p,39034,34694,4340,11.1
42988,CN2205900000000,22,59,"LaSalle Parish, LA",Apr-20 p,5922,5493,429,7.2
42989,CN2206100000000,22,61,"Lincoln Parish, LA",Apr-20 p,18240,16562,1678,9.2
42990,CN2206300000000,22,63,"Livingston Parish, LA",Apr-20 p,63581,55289,8292,13.0
42991,CN2206500000000,22,65,"Madison Parish, LA",Apr-20 p,3100,2748,352,11.4
42992,CN2206700000000,22,67,"Morehouse Parish, LA",Apr-20 p,8866,7714,1152,13.0
42993,CN2206900000000,22,69,"Natchitoches Parish, LA",Apr-20 p,13985,12627,1358,9.7
42994,CN2207100000000,22,71,"Orleans Parish, LA",Apr-20 p,174608,136075,38533,22.1
42995,CN2207300000000,22,73,"Ouachita Parish, LA",Apr-20 p,64768,57094,7674,11.8
42996,CN2207500000000,22,75,"Plaquemines Parish, LA",Apr-20 p,9061,7708,1353,14.9
42997,CN2207700000000,22,77,"Pointe Coupee Parish, LA",Apr-20 p,8962,7836,1126,12.6
42998,CN2207900000000,22,79,"Rapides Parish, LA",Apr-20 p,50298,45316,4982,9.9
42999,CN2208100000000,22,81,"Red River Parish, LA",Apr-20 p,3251,3013,238,7.3
43000,CN2208300000000,22,83,"Richland Parish, LA",Apr-20 p,7240,6465,775,10.7
43001,CN2208500000000,22,85,"Sabine Parish, LA",Apr-20 p,7958,7316,642,8.1
43002,CN2208700000000,22,87,"St. Bernard Parish, LA",Apr-20 p,18798,15118,3680,19.6
43003,CN2208900000000,22,89,"St. Charles Parish, LA",Apr-20 p,22788,19233,3555,15.6
43004,CN2209100000000,22,91,"St. Helena Parish, LA",Apr-20 p,4011,3367,644,16.1
43005,CN2209300000000,22,93,"St. James Parish, LA",Apr-20 p,8099,6938,1161,14.3
43006,CN2209500000000,22,95,"St. John the Baptist Parish, LA",Apr-20 p,18123,14826,3297,18.2
43007,CN2209700000000,22,97,"St. Landry Parish, LA",Apr-20 p,28858,25044,3814,13.2
43008,CN2209900000000,22,99,"St. Martin Parish, LA",Apr-20 p,20292,17530,2762,13.6
43009,CN2210100000000,22,101,"St. Mary Parish, LA",Apr-20 p,18012,15411,2601,14.4
43010,CN2210300000000,22,103,"St. Tammany Parish, LA",Apr-20 p,107599,91474,16125,15.0
43011,CN2210500000000,22,105,"Tangipahoa Parish, LA",Apr-20 p,52028,43131,8897,17.1
43012,CN2210700000000,22,107,"Tensas Parish, LA",Apr-20 p,1178,1068,110,9.3
43013,CN2210900000000,22,109,"Terrebonne Parish, LA",Apr-20 p,44084,38192,5892,13.4
43014,CN2211100000000,22,111,"Union Parish, LA",Apr-20 p,8135,7373,762,9.4
43015,CN2211300000000,22,113,"Vermilion Parish, LA",Apr-20 p,21775,19019,2756,12.7
43016,CN2211500000000,22,115,"Vernon Parish, LA",Apr-20 p,13993,12448,1545,11.0
43017,CN2211700000000,22,117,"Washington Parish, LA",Apr-20 p,14963,13194,1769,11.8
43018,CN2211900000000,22,119,"Webster Parish, LA",Apr-20 p,13005,11478,1527,11.7
43019,CN2212100000000,22,121,"West Baton Rouge Parish, LA",Apr-20 p,12463,10931,1532,12.3
43020,CN2212300000000,22,123,"West Carroll Parish, LA",Apr-20 p,3189,2747,442,13.9
43021,CN2212500000000,22,125,"West Feliciana Parish, LA",Apr-20 p,4755,4327,428,9.0
43022,CN2212700000000,22,127,"Winn Parish, LA",Apr-20 p,4171,3798,373,8.9
43023,CN2300100000000,23,1,"Androscoggin County, ME",Apr-20 p,53351,47652,5699,10.7
43024,CN2300300000000,23,3,"Aroostook County, ME",Apr-20 p,28359,25359,3000,10.6
43025,CN2300500000000,23,5,"Cumberland County, ME",Apr-20 p,152695,135952,16743,11.0
43026,CN2300700000000,23,7,"Franklin County, ME",Apr-20 p,13663,11940,1723,12.6
43027,CN2300900000000,23,9,"Hancock County, ME",Apr-20 p,26293,23122,3171,12.1
43028,CN2301100000000,23,11,"Kennebec County, ME",Apr-20 p,60223,54142,6081,10.1
43029,CN2301300000000,23,13,"Knox County, ME",Apr-20 p,19332,16969,2363,12.2
43030,CN2301500000000,23,15,"Lincoln County, ME",Apr-20 p,15854,14075,1779,11.2
43031,CN2301700000000,23,17,"Oxford County, ME",Apr-20 p,25595,21999,3596,14.0
43032,CN2301900000000,23,19,"Penobscot County, ME",Apr-20 p,74655,66515,8140,10.9
43033,CN2302100000000,23,21,"Piscataquis County, ME",Apr-20 p,6873,6138,735,10.7
43034,CN2302300000000,23,23,"Sagadahoc County, ME",Apr-20 p,19203,17111,2092,10.9
43035,CN2302500000000,23,25,"Somerset County, ME",Apr-20 p,21933,18898,3035,13.8
43036,CN2302700000000,23,27,"Waldo County, ME",Apr-20 p,19551,17539,2012,10.3
43037,CN2302900000000,23,29,"Washington County, ME",Apr-20 p,12758,11335,1423,11.2
43038,CN2303100000000,23,31,"York County, ME",Apr-20 p,105342,93108,12234,11.6
43039,CN2400100000000,24,1,"Allegany County, MD",Apr-20 p,30474,26189,4285,14.1
43040,CN2400300000000,24,3,"Anne Arundel County, MD",Apr-20 p,292743,263486,29257,10.0
43041,CN2400500000000,24,5,"Baltimore County, MD",Apr-20 p,422244,376767,45477,10.8
43042,CN2400900000000,24,9,"Calvert County, MD",Apr-20 p,47388,43434,3954,8.3
43043,CN2401100000000,24,11,"Caroline County, MD",Apr-20 p,16583,15057,1526,9.2
43044,CN2401300000000,24,13,"Carroll County, MD",Apr-20 p,88846,80514,8332,9.4
43045,CN2401500000000,24,15,"Cecil County, MD",Apr-20 p,48135,43529,4606,9.6
43046,CN2401700000000,24,17,"Charles County, MD",Apr-20 p,83288,75506,7782,9.3
43047,CN2401900000000,24,19,"Dorchester County, MD",Apr-20 p,14493,12943,1550,10.7
43048,CN2402100000000,24,21,"Frederick County, MD",Apr-20 p,129770,117100,12670,9.8
43049,CN2402300000000,24,23,"Garrett County, MD",Apr-20 p,14890,12926,1964,13.2
43050,CN2402500000000,24,25,"Harford County, MD",Apr-20 p,131330,117617,13713,10.4
43051,CN2402700000000,24,27,"Howard County, MD",Apr-20 p,171159,157228,13931,8.1
43052,CN2402900000000,24,29,"Kent County, MD",Apr-20 p,9509,8577,932,9.8
43053,CN2403100000000,24,31,"Montgomery County, MD",Apr-20 p,531818,486541,45277,8.5
43054,CN2403300000000,24,33,"Prince George's County, MD",Apr-20 p,488684,439631,49053,10.0
43055,CN2403500000000,24,35,"Queen Anne's County, MD",Apr-20 p,26235,23566,2669,10.2
43056,CN2403700000000,24,37,"St. Mary's County, MD",Apr-20 p,53645,49730,3915,7.3
43057,CN2403900000000,24,39,"Somerset County, MD",Apr-20 p,8316,7337,979,11.8
43058,CN2404100000000,24,41,"Talbot County, MD",Apr-20 p,17594,15733,1861,10.6
43059,CN2404300000000,24,43,"Washington County, MD",Apr-20 p,69806,61388,8418,12.1
43060,CN2404500000000,24,45,"Wicomico County, MD",Apr-20 p,46835,40530,6305,13.5
43061,CN2404700000000,24,47,"Worcester County, MD",Apr-20 p,25550,19723,5827,22.8
43062,CN2451000000000,24,510,"Baltimore city, MD",Apr-20 p,267613,235862,31751,11.9
43063,CN2500100000000,25,1,"Barnstable County, MA",Apr-20 p,97331,76341,20990,21.6
43064,CN2500300000000,25,3,"Berkshire County, MA",Apr-20 p,57586,48003,9583,16.6
43065,CN2500500000000,25,5,"Bristol County, MA",Apr-20 p,282641,225386,57255,20.3
43066,CN2500700000000,25,7,"Dukes County, MA",Apr-20 p,8519,6596,1923,22.6
43067,CN2500900000000,25,9,"Essex County, MA",Apr-20 p,386540,318353,68187,17.6
43068,CN2501100000000,25,11,"Franklin County, MA",Apr-20 p,36485,31362,5123,14.0
43069,CN2501300000000,25,13,"Hampden County, MA",Apr-20 p,206298,170255,36043,17.5
43070,CN2501500000000,25,15,"Hampshire County, MA",Apr-20 p,77770,68213,9557,12.3
43071,CN2501700000000,25,17,"Middlesex County, MA",Apr-20 p,803171,701635,101536,12.6
43072,CN2501900000000,25,19,"Nantucket County/town, MA",Apr-20 p,7062,5068,1994,28.2
43073,CN2502100000000,25,21,"Norfolk County, MA",Apr-20 p,350876,297169,53707,15.3
43074,CN2502300000000,25,23,"Plymouth County, MA",Apr-20 p,259206,212367,46839,18.1
43075,CN2502500000000,25,25,"Suffolk County, MA",Apr-20 p,409939,346376,63563,15.5
43076,CN2502700000000,25,27,"Worcester County, MA",Apr-20 p,402784,340428,62356,15.5
43077,CN2600100000000,26,1,"Alcona County, MI",Apr-20 p,3446,2593,853,24.8
43078,CN2600300000000,26,3,"Alger County, MI",Apr-20 p,2903,2213,690,23.8
43079,CN2600500000000,26,5,"Allegan County, MI",Apr-20 p,57480,44388,13092,22.8
43080,CN2600700000000,26,7,"Alpena County, MI",Apr-20 p,12645,10291,2354,18.6
43081,CN2600900000000,26,9,"Antrim County, MI",Apr-20 p,9003,6388,2615,29.0
43082,CN2601100000000,26,11,"Arenac County, MI",Apr-20 p,5707,3862,1845,32.3
43083,CN2601300000000,26,13,"Baraga County, MI",Apr-20 p,3135,2263,872,27.8
43084,CN2601500000000,26,15,"Barry County, MI",Apr-20 p,29551,22942,6609,22.4
43085,CN2601700000000,26,17,"Bay County, MI",Apr-20 p,48693,36383,12310,25.3
43086,CN2601900000000,26,19,"Benzie County, MI",Apr-20 p,8839,6499,2340,26.5
43087,CN2602100000000,26,21,"Berrien County, MI",Apr-20 p,70427,56320,14107,20.0
43088,CN2602300000000,26,23,"Branch County, MI",Apr-20 p,18697,14395,4302,23.0
43089,CN2602500000000,26,25,"Calhoun County, MI",Apr-20 p,60383,45499,14884,24.6
43090,CN2602700000000,26,27,"Cass County, MI",Apr-20 p,26023,19543,6480,24.9
43091,CN2602900000000,26,29,"Charlevoix County, MI",Apr-20 p,11591,7858,3733,32.2
43092,CN2603100000000,26,31,"Cheboygan County, MI",Apr-20 p,9778,5749,4029,41.2
43093,CN2603300000000,26,33,"Chippewa County, MI",Apr-20 p,15840,12608,3232,20.4
43094,CN2603500000000,26,35,"Clare County, MI",Apr-20 p,10664,7155,3509,32.9
43095,CN2603700000000,26,37,"Clinton County, MI",Apr-20 p,39260,31888,7372,18.8
43096,CN2603900000000,26,39,"Crawford County, MI",Apr-20 p,5100,3600,1500,29.4
43097,CN2604100000000,26,41,"Delta County, MI",Apr-20 p,16376,12525,3851,23.5
43098,CN2604300000000,26,43,"Dickinson County, MI",Apr-20 p,12110,10101,2009,16.6
43099,CN2604500000000,26,45,"Eaton County, MI",Apr-20 p,56122,44039,12083,21.5
43100,CN2604700000000,26,47,"Emmet County, MI",Apr-20 p,17426,12133,5293,30.4
43101,CN2604900000000,26,49,"Genesee County, MI",Apr-20 p,184035,128576,55459,30.1
43102,CN2605100000000,26,51,"Gladwin County, MI",Apr-20 p,8790,6336,2454,27.9
43103,CN2605300000000,26,53,"Gogebic County, MI",Apr-20 p,5825,4799,1026,17.6
43104,CN2605500000000,26,55,"Grand Traverse County, MI",Apr-20 p,48803,36996,11807,24.2
43105,CN2605700000000,26,57,"Gratiot County, MI",Apr-20 p,17205,13334,3871,22.5
43106,CN2605900000000,26,59,"Hillsdale County, MI",Apr-20 p,19271,13926,5345,27.7
43107,CN2606100000000,26,61,"Houghton County, MI",Apr-20 p,15720,13233,2487,15.8
43108,CN2606300000000,26,63,"Huron County, MI",Apr-20 p,14677,10585,4092,27.9
43109,CN2606500000000,26,65,"Ingham County, MI",Apr-20 p,142118,116236,25882,18.2
43110,CN2606700000000,26,67,"Ionia County, MI",Apr-20 p,27658,20227,7431,26.9
43111,CN2606900000000,26,69,"Iosco County, MI",Apr-20 p,9725,7155,2570,26.4
43112,CN2607100000000,26,71,"Iron County, MI",Apr-20 p,4887,3964,923,18.9
43113,CN2607300000000,26,73,"Isabella County, MI",Apr-20 p,33721,26278,7443,22.1
43114,CN2607500000000,26,75,"Jackson County, MI",Apr-20 p,72711,54948,17763,24.4
43115,CN2607700000000,26,77,"Kalamazoo County, MI",Apr-20 p,123423,102140,21283,17.2
43116,CN2607900000000,26,79,"Kalkaska County, MI",Apr-20 p,8076,5759,2317,28.7
43117,CN2608100000000,26,81,"Kent County, MI",Apr-20 p,332443,260533,71910,21.6
43118,CN2608300000000,26,83,"Keweenaw County, MI",Apr-20 p,881,708,173,19.6
43119,CN2608500000000,26,85,"Lake County, MI",Apr-20 p,3349,2332,1017,30.4
43120,CN2608700000000,26,87,"Lapeer County, MI",Apr-20 p,39663,27518,12145,30.6
43121,CN2608900000000,26,89,"Leelanau County, MI",Apr-20 p,10076,7849,2227,22.1
43122,CN2609100000000,26,91,"Lenawee County, MI",Apr-20 p,43431,31186,12245,28.2
43123,CN2609300000000,26,93,"Livingston County, MI",Apr-20 p,90219,70432,19787,21.9
43124,CN2609500000000,26,95,"Luce County, MI",Apr-20 p,2241,1793,448,20.0
43125,CN2609700000000,26,97,"Mackinac County, MI",Apr-20 p,4343,2690,1653,38.1
43126,CN2609900000000,26,99,"Macomb County, MI",Apr-20 p,414804,301118,113686,27.4
43127,CN2610100000000,26,101,"Manistee County, MI",Apr-20 p,9058,6187,2871,31.7
43128,CN2610300000000,26,103,"Marquette County, MI",Apr-20 p,31270,24767,6503,20.8
43129,CN2610500000000,26,105,"Mason County, MI",Apr-20 p,12330,9182,3148,25.5
43130,CN2610700000000,26,107,"Mecosta County, MI",Apr-20 p,17334,12856,4478,25.8
43131,CN2610900000000,26,109,"Menominee County, MI",Apr-20 p,10370,8867,1503,14.5
43132,CN2611100000000,26,111,"Midland County, MI",Apr-20 p,38411,30725,7686,20.0
43133,CN2611300000000,26,113,"Missaukee County, MI",Apr-20 p,6611,4773,1838,27.8
43134,CN2611500000000,26,115,"Monroe County, MI",Apr-20 p,77017,57181,19836,25.8
43135,CN2611700000000,26,117,"Montcalm County, MI",Apr-20 p,27873,20360,7513,27.0
43136,CN2611900000000,26,119,"Montmorency County, MI",Apr-20 p,2742,1804,938,34.2
43137,CN2612100000000,26,121,"Muskegon County, MI",Apr-20 p,79064,55918,23146,29.3
43138,CN2612300000000,26,123,"Newaygo County, MI",Apr-20 p,21510,15925,5585,26.0
43139,CN2612500000000,26,125,"Oakland County, MI",Apr-20 p,571797,458446,113351,19.8
43140,CN2612700000000,26,127,"Oceana County, MI",Apr-20 p,11038,8063,2975,27.0
43141,CN2612900000000,26,129,"Ogemaw County, MI",Apr-20 p,7521,5279,2242,29.8
43142,CN2613100000000,26,131,"Ontonagon County, MI",Apr-20 p,1865,1348,517,27.7
43143,CN2613300000000,26,133,"Osceola County, MI",Apr-20 p,10470,7544,2926,27.9
43144,CN2613500000000,26,135,"Oscoda County, MI",Apr-20 p,2780,1857,923,33.2
43145,CN2613700000000,26,137,"Otsego County, MI",Apr-20 p,11116,7782,3334,30.0
43146,CN2613900000000,26,139,"Ottawa County, MI",Apr-20 p,148585,117116,31469,21.2
43147,CN2614100000000,26,141,"Presque Isle County, MI",Apr-20 p,4480,3207,1273,28.4
43148,CN2614300000000,26,143,"Roscommon County, MI",Apr-20 p,7014,4609,2405,34.3
43149,CN2614500000000,26,145,"Saginaw County, MI",Apr-20 p,84061,62523,21538,25.6
43150,CN2614700000000,26,147,"St. Clair County, MI",Apr-20 p,71792,50718,21074,29.4
43151,CN2614900000000,26,149,"St. Joseph County, MI",Apr-20 p,28955,20170,8785,30.3
43152,CN2615100000000,26,151,"Sanilac County, MI",Apr-20 p,18756,12934,5822,31.0
43153,CN2615300000000,26,153,"Schoolcraft County, MI",Apr-20 p,3223,2509,714,22.2
43154,CN2615500000000,26,155,"Shiawassee County, MI",Apr-20 p,31755,22473,9282,29.2
43155,CN2615700000000,26,157,"Tuscola County, MI",Apr-20 p,22322,15127,7195,32.2
43156,CN2615900000000,26,159,"Van Buren County, MI",Apr-20 p,33775,26736,7039,20.8
43157,CN2616100000000,26,161,"Washtenaw County, MI",Apr-20 p,186137,158475,27662,14.9
43158,CN2616300000000,26,163,"Wayne County, MI",Apr-20 p,741441,549699,191742,25.9
43159,CN2616500000000,26,165,"Wexford County, MI",Apr-20 p,14490,9928,4562,31.5
43160,CN2700100000000,27,1,"Aitkin County, MN",Apr-20 p,7189,6374,815,11.3
43161,CN2700300000000,27,3,"Anoka County, MN",Apr-20 p,195521,177809,17712,9.1
43162,CN2700500000000,27,5,"Becker County, MN",Apr-20 p,18983,17088,1895,10.0
43163,CN2700700000000,27,7,"Beltrami County, MN",Apr-20 p,24413,22198,2215,9.1
43164,CN2700900000000,27,9,"Benton County, MN",Apr-20 p,22292,20193,2099,9.4
43165,CN2701100000000,27,11,"Big Stone County, MN",Apr-20 p,2397,2240,157,6.5
43166,CN2701300000000,27,13,"Blue Earth County, MN",Apr-20 p,41174,37991,3183,7.7
43167,CN2701500000000,27,15,"Brown County, MN",Apr-20 p,14230,13294,936,6.6
43168,CN2701700000000,27,17,"Carlton County, MN",Apr-20 p,17459,15583,1876,10.7
43169,CN2701900000000,27,19,"Carver County, MN",Apr-20 p,57111,52936,4175,7.3
43170,CN2702100000000,27,21,"Cass County, MN",Apr-20 p,14437,12533,1904,13.2
43171,CN2702300000000,27,23,"Chippewa County, MN",Apr-20 p,6844,6313,531,7.8
43172,CN2702500000000,27,25,"Chisago County, MN",Apr-20 p,29549,26774,2775,9.4
43173,CN2702700000000,27,27,"Clay County, MN",Apr-20 p,36302,34150,2152,5.9
43174,CN2702900000000,27,29,"Clearwater County, MN",Apr-20 p,4409,3805,604,13.7
43175,CN2703100000000,27,31,"Cook County, MN",Apr-20 p,3143,2667,476,15.1
43176,CN2703300000000,27,33,"Cottonwood County, MN",Apr-20 p,5934,5650,284,4.8
43177,CN2703500000000,27,35,"Crow Wing County, MN",Apr-20 p,32474,28923,3551,10.9
43178,CN2703700000000,27,37,"Dakota County, MN",Apr-20 p,239425,217821,21604,9.0
43179,CN2703900000000,27,39,"Dodge County, MN",Apr-20 p,11579,10841,738,6.4
43180,CN2704100000000,27,41,"Douglas County, MN",Apr-20 p,20882,19308,1574,7.5
43181,CN2704300000000,27,43,"Faribault County, MN",Apr-20 p,6913,6326,587,8.5
43182,CN2704500000000,27,45,"Fillmore County, MN",Apr-20 p,11357,10611,746,6.6
43183,CN2704700000000,27,47,"Freeborn County, MN",Apr-20 p,16215,14936,1279,7.9
43184,CN2704900000000,27,49,"Goodhue County, MN",Apr-20 p,26842,24532,2310,8.6
43185,CN2705100000000,27,51,"Grant County, MN",Apr-20 p,3285,3065,220,6.7
43186,CN2705300000000,27,53,"Hennepin County, MN",Apr-20 p,698640,636522,62118,8.9
43187,CN2705500000000,27,55,"Houston County, MN",Apr-20 p,10008,9400,608,6.1
43188,CN2705700000000,27,57,"Hubbard County, MN",Apr-20 p,9780,8764,1016,10.4
43189,CN2705900000000,27,59,"Isanti County, MN",Apr-20 p,21022,18995,2027,9.6
43190,CN2706100000000,27,61,"Itasca County, MN",Apr-20 p,21254,18821,2433,11.4
43191,CN2706300000000,27,63,"Jackson County, MN",Apr-20 p,5598,5308,290,5.2
43192,CN2706500000000,27,65,"Kanabec County, MN",Apr-20 p,9020,8044,976,10.8
43193,CN2706700000000,27,67,"Kandiyohi County, MN",Apr-20 p,23792,22342,1450,6.1
43194,CN2706900000000,27,69,"Kittson County, MN",Apr-20 p,2332,2183,149,6.4
43195,CN2707100000000,27,71,"Koochiching County, MN",Apr-20 p,5712,5108,604,10.6
43196,CN2707300000000,27,73,"Lac qui Parle County, MN",Apr-20 p,3517,3313,204,5.8
43197,CN2707500000000,27,75,"Lake County, MN",Apr-20 p,5306,4783,523,9.9
43198,CN2707700000000,27,77,"Lake of the Woods County, MN",Apr-20 p,2428,2165,263,10.8
43199,CN2707900000000,27,79,"Le Sueur County, MN",Apr-20 p,15935,14385,1550,9.7
43200,CN2708100000000,27,81,"Lincoln County, MN",Apr-20 p,3146,3000,146,4.6
43201,CN2708300000000,27,83,"Lyon County, MN",Apr-20 p,14196,13410,786,5.5
43202,CN2708500000000,27,85,"McLeod County, MN",Apr-20 p,18817,17430,1387,7.4
43203,CN2708700000000,27,87,"Mahnomen County, MN",Apr-20 p,2530,2091,439,17.4
43204,CN2708900000000,27,89,"Marshall County, MN",Apr-20 p,5355,4873,482,9.0
43205,CN2709100000000,27,91,"Martin County, MN",Apr-20 p,9807,9162,645,6.6
43206,CN2709300000000,27,93,"Meeker County, MN",Apr-20 p,13067,12202,865,6.6
43207,CN2709500000000,27,95,"Mille Lacs County, MN",Apr-20 p,12829,11374,1455,11.3
43208,CN2709700000000,27,97,"Morrison County, MN",Apr-20 p,17541,15965,1576,9.0
43209,CN2709900000000,27,99,"Mower County, MN",Apr-20 p,20286,19057,1229,6.1
43210,CN2710100000000,27,101,"Murray County, MN",Apr-20 p,4608,4323,285,6.2
43211,CN2710300000000,27,103,"Nicollet County, MN",Apr-20 p,21064,19643,1421,6.7
43212,CN2710500000000,27,105,"Nobles County, MN",Apr-20 p,11065,10591,474,4.3
43213,CN2710700000000,27,107,"Norman County, MN",Apr-20 p,3289,2995,294,8.9
43214,CN2710900000000,27,109,"Olmsted County, MN",Apr-20 p,86928,80906,6022,6.9
43215,CN2711100000000,27,111,"Otter Tail County, MN",Apr-20 p,30728,28301,2427,7.9
43216,CN2711300000000,27,113,"Pennington County, MN",Apr-20 p,8636,7765,871,10.1
43217,CN2711500000000,27,115,"Pine County, MN",Apr-20 p,15085,13277,1808,12.0
43218,CN2711700000000,27,117,"Pipestone County, MN",Apr-20 p,4634,4427,207,4.5
43219,CN2711900000000,27,119,"Polk County, MN",Apr-20 p,16530,15334,1196,7.2
43220,CN2712100000000,27,121,"Pope County, MN",Apr-20 p,6412,6028,384,6.0
43221,CN2712300000000,27,123,"Ramsey County, MN",Apr-20 p,286768,260527,26241,9.2
43222,CN2712500000000,27,125,"Red Lake County, MN",Apr-20 p,2204,1995,209,9.5
43223,CN2712700000000,27,127,"Redwood County, MN",Apr-20 p,7745,7065,680,8.8
43224,CN2712900000000,27,129,"Renville County, MN",Apr-20 p,8404,7803,601,7.2
43225,CN2713100000000,27,131,"Rice County, MN",Apr-20 p,36782,34236,2546,6.9
43226,CN2713300000000,27,133,"Rock County, MN",Apr-20 p,5547,5336,211,3.8
43227,CN2713500000000,27,135,"Roseau County, MN",Apr-20 p,7860,7197,663,8.4
43228,CN2713700000000,27,137,"St. Louis County, MN",Apr-20 p,99886,89407,10479,10.5
43229,CN2713900000000,27,139,"Scott County, MN",Apr-20 p,82924,75397,7527,9.1
43230,CN2714100000000,27,141,"Sherburne County, MN",Apr-20 p,51637,47015,4622,9.0
43231,CN2714300000000,27,143,"Sibley County, MN",Apr-20 p,8402,7793,609,7.2
43232,CN2714500000000,27,145,"Stearns County, MN",Apr-20 p,91032,83878,7154,7.9
43233,CN2714700000000,27,147,"Steele County, MN",Apr-20 p,21113,19654,1459,6.9
43234,CN2714900000000,27,149,"Stevens County, MN",Apr-20 p,5205,5005,200,3.8
43235,CN2715100000000,27,151,"Swift County, MN",Apr-20 p,4830,4434,396,8.2
43236,CN2715300000000,27,153,"Todd County, MN",Apr-20 p,13405,12560,845,6.3
43237,CN2715500000000,27,155,"Traverse County, MN",Apr-20 p,1770,1669,101,5.7
43238,CN2715700000000,27,157,"Wabasha County, MN",Apr-20 p,12198,11284,914,7.5
43239,CN2715900000000,27,159,"Wadena County, MN",Apr-20 p,6105,5425,680,11.1
43240,CN2716100000000,27,161,"Waseca County, MN",Apr-20 p,8959,8240,719,8.0
43241,CN2716300000000,27,163,"Washington County, MN",Apr-20 p,140886,129370,11516,8.2
43242,CN2716500000000,27,165,"Watonwan County, MN",Apr-20 p,6399,6049,350,5.5
43243,CN2716700000000,27,167,"Wilkin County, MN",Apr-20 p,3521,3320,201,5.7
43244,CN2716900000000,27,169,"Winona County, MN",Apr-20 p,28496,26433,2063,7.2
43245,CN2717100000000,27,171,"Wright County, MN",Apr-20 p,74125,67997,6128,8.3
43246,CN2717300000000,27,173,"Yellow Medicine County, MN",Apr-20 p,5324,4928,396,7.4
43247,CN2800100000000,28,1,"Adams County, MS",Apr-20 p,10330,8606,1724,16.7
43248,CN2800300000000,28,3,"Alcorn County, MS",Apr-20 p,14826,12864,1962,13.2
43249,CN2800500000000,28,5,"Amite County, MS",Apr-20 p,4079,3592,487,11.9
43250,CN2800700000000,28,7,"Attala County, MS",Apr-20 p,6491,5618,873,13.4
43251,CN2800900000000,28,9,"Benton County, MS",Apr-20 p,2803,2379,424,15.1
43252,CN2801100000000,28,11,"Bolivar County, MS",Apr-20 p,11128,9970,1158,10.4
43253,CN2801300000000,28,13,"Calhoun County, MS",Apr-20 p,6035,4750,1285,21.3
43254,CN2801500000000,28,15,"Carroll County, MS",Apr-20 p,3199,2778,421,13.2
43255,CN2801700000000,28,17,"Chickasaw County, MS",Apr-20 p,8019,5504,2515,31.4
43256,CN2801900000000,28,19,"Choctaw County, MS",Apr-20 p,3363,3034,329,9.8
43257,CN2802100000000,28,21,"Claiborne County, MS",Apr-20 p,2762,2268,494,17.9
43258,CN2802300000000,28,23,"Clarke County, MS",Apr-20 p,5353,4667,686,12.8
43259,CN2802500000000,28,25,"Clay County, MS",Apr-20 p,8216,6194,2022,24.6
43260,CN2802700000000,28,27,"Coahoma County, MS",Apr-20 p,8386,6661,1725,20.6
43261,CN2802900000000,28,29,"Copiah County, MS",Apr-20 p,10057,8876,1181,11.7
43262,CN2803100000000,28,31,"Covington County, MS",Apr-20 p,7094,6464,630,8.9
43263,CN2803300000000,28,33,"DeSoto County, MS",Apr-20 p,81895,72173,9722,11.9
43264,CN2803500000000,28,35,"Forrest County, MS",Apr-20 p,30575,26711,3864,12.6
43265,CN2803700000000,28,37,"Franklin County, MS",Apr-20 p,2577,2263,314,12.2
43266,CN2803900000000,28,39,"George County, MS",Apr-20 p,8191,7006,1185,14.5
43267,CN2804100000000,28,41,"Greene County, MS",Apr-20 p,4060,3502,558,13.7
43268,CN2804300000000,28,43,"Grenada County, MS",Apr-20 p,8618,7527,1091,12.7
43269,CN2804500000000,28,45,"Hancock County, MS",Apr-20 p,17549,14161,3388,19.3
43270,CN2804700000000,28,47,"Harrison County, MS",Apr-20 p,85260,65483,19777,23.2
43271,CN2804900000000,28,49,"Hinds County, MS",Apr-20 p,100272,84401,15871,15.8
43272,CN2805100000000,28,51,"Holmes County, MS",Apr-20 p,6160,4382,1778,28.9
43273,CN2805300000000,28,53,"Humphreys County, MS",Apr-20 p,2233,1863,370,16.6
43274,CN2805500000000,28,55,"Issaquena County, MS",Apr-20 p,345,308,37,10.7
43275,CN2805700000000,28,57,"Itawamba County, MS",Apr-20 p,10618,8345,2273,21.4
43276,CN2805900000000,28,59,"Jackson County, MS",Apr-20 p,55871,43933,11938,21.4
43277,CN2806100000000,28,61,"Jasper County, MS",Apr-20 p,5516,4927,589,10.7
43278,CN2806300000000,28,63,"Jefferson County, MS",Apr-20 p,1834,1474,360,19.6
43279,CN2806500000000,28,65,"Jefferson Davis County, MS",Apr-20 p,3690,3271,419,11.4
43280,CN2806700000000,28,67,"Jones County, MS",Apr-20 p,23219,20994,2225,9.6
43281,CN2806900000000,28,69,"Kemper County, MS",Apr-20 p,3282,2826,456,13.9
43282,CN2807100000000,28,71,"Lafayette County, MS",Apr-20 p,25336,22527,2809,11.1
43283,CN2807300000000,28,73,"Lamar County, MS",Apr-20 p,27703,24824,2879,10.4
43284,CN2807500000000,28,75,"Lauderdale County, MS",Apr-20 p,27261,23963,3298,12.1
43285,CN2807700000000,28,77,"Lawrence County, MS",Apr-20 p,4221,3655,566,13.4
43286,CN2807900000000,28,79,"Leake County, MS",Apr-20 p,7504,6520,984,13.1
43287,CN2808100000000,28,81,"Lee County, MS",Apr-20 p,41223,32333,8890,21.6
43288,CN2808300000000,28,83,"Leflore County, MS",Apr-20 p,9425,7846,1579,16.8
43289,CN2808500000000,28,85,"Lincoln County, MS",Apr-20 p,13312,11586,1726,13.0
43290,CN2808700000000,28,87,"Lowndes County, MS",Apr-20 p,23754,20021,3733,15.7
43291,CN2808900000000,28,89,"Madison County, MS",Apr-20 p,49387,42404,6983,14.1
43292,CN2809100000000,28,91,"Marion County, MS",Apr-20 p,8850,7868,982,11.1
43293,CN2809300000000,28,93,"Marshall County, MS",Apr-20 p,12727,11341,1386,10.9
43294,CN2809500000000,28,95,"Monroe County, MS",Apr-20 p,15697,12044,3653,23.3
43295,CN2809700000000,28,97,"Montgomery County, MS",Apr-20 p,3631,3183,448,12.3
43296,CN2809900000000,28,99,"Neshoba County, MS",Apr-20 p,9756,8179,1577,16.2
43297,CN2810100000000,28,101,"Newton County, MS",Apr-20 p,8059,7018,1041,12.9
43298,CN2810300000000,28,103,"Noxubee County, MS",Apr-20 p,3689,3087,602,16.3
43299,CN2810500000000,28,105,"Oktibbeha County, MS",Apr-20 p,20627,17838,2789,13.5
43300,CN2810700000000,28,107,"Panola County, MS",Apr-20 p,11706,9828,1878,16.0
43301,CN2810900000000,28,109,"Pearl River County, MS",Apr-20 p,21251,18458,2793,13.1
43302,CN2811100000000,28,111,"Perry County, MS",Apr-20 p,3907,3420,487,12.5
43303,CN2811300000000,28,113,"Pike County, MS",Apr-20 p,13232,11559,1673,12.6
43304,CN2811500000000,28,115,"Pontotoc County, MS",Apr-20 p,15674,11661,4013,25.6
43305,CN2811700000000,28,117,"Prentiss County, MS",Apr-20 p,10979,9053,1926,17.5
43306,CN2811900000000,28,119,"Quitman County, MS",Apr-20 p,2344,1973,371,15.8
43307,CN2812100000000,28,121,"Rankin County, MS",Apr-20 p,68545,60905,7640,11.1
43308,CN2812300000000,28,123,"Scott County, MS",Apr-20 p,11447,10389,1058,9.2
43309,CN2812500000000,28,125,"Sharkey County, MS",Apr-20 p,1517,1312,205,13.5
43310,CN2812700000000,28,127,"Simpson County, MS",Apr-20 p,9551,8612,939,9.8
43311,CN2812900000000,28,129,"Smith County, MS",Apr-20 p,6046,5588,458,7.6
43312,CN2813100000000,28,131,"Stone County, MS",Apr-20 p,6343,5417,926,14.6
43313,CN2813300000000,28,133,"Sunflower County, MS",Apr-20 p,7324,6297,1027,14.0
43314,CN2813500000000,28,135,"Tallahatchie County, MS",Apr-20 p,4811,4364,447,9.3
43315,CN2813700000000,28,137,"Tate County, MS",Apr-20 p,11181,9814,1367,12.2
43316,CN2813900000000,28,139,"Tippah County, MS",Apr-20 p,9325,7504,1821,19.5
43317,CN2814100000000,28,141,"Tishomingo County, MS",Apr-20 p,8310,6997,1313,15.8
43318,CN2814300000000,28,143,"Tunica County, MS",Apr-20 p,5244,3583,1661,31.7
43319,CN2814500000000,28,145,"Union County, MS",Apr-20 p,14335,11237,3098,21.6
43320,CN2814700000000,28,147,"Walthall County, MS",Apr-20 p,4441,3879,562,12.7
43321,CN2814900000000,28,149,"Warren County, MS",Apr-20 p,18936,15866,3070,16.2
43322,CN2815100000000,28,151,"Washington County, MS",Apr-20 p,15724,13309,2415,15.4
43323,CN2815300000000,28,153,"Wayne County, MS",Apr-20 p,6731,6069,662,9.8
43324,CN2815500000000,28,155,"Webster County, MS",Apr-20 p,3707,3211,496,13.4
43325,CN2815700000000,28,157,"Wilkinson County, MS",Apr-20 p,2504,2101,403,16.1
43326,CN2815900000000,28,159,"Winston County, MS",Apr-20 p,6883,5857,1026,14.9
43327,CN2816100000000,28,161,"Yalobusha County, MS",Apr-20 p,4611,3877,734,15.9
43328,CN2816300000000,28,163,"Yazoo County, MS",Apr-20 p,9116,7588,1528,16.8
43329,CN2900100000000,29,1,"Adair County, MO",Apr-20 p,10082,9373,709,7.0
43330,CN2900300000000,29,3,"Andrew County, MO",Apr-20 p,9518,8949,569,6.0
43331,CN2900500000000,29,5,"Atchison County, MO",Apr-20 p,2857,2691,166,5.8
43332,CN2900700000000,29,7,"Audrain County, MO",Apr-20 p,10916,9802,1114,10.2
43333,CN2900900000000,29,9,"Barry County, MO",Apr-20 p,16005,14597,1408,8.8
43334,CN2901100000000,29,11,"Barton County, MO",Apr-20 p,5336,4887,449,8.4
43335,CN2901300000000,29,13,"Bates County, MO",Apr-20 p,7596,7082,514,6.8
43336,CN2901500000000,29,15,"Benton County, MO",Apr-20 p,7205,6509,696,9.7
43337,CN2901700000000,29,17,"Bollinger County, MO",Apr-20 p,5372,4857,515,9.6
43338,CN2901900000000,29,19,"Boone County, MO",Apr-20 p,95725,89488,6237,6.5
43339,CN2902100000000,29,21,"Buchanan County, MO",Apr-20 p,43575,40418,3157,7.2
43340,CN2902300000000,29,23,"Butler County, MO",Apr-20 p,18162,16209,1953,10.8
43341,CN2902500000000,29,25,"Caldwell County, MO",Apr-20 p,4384,3976,408,9.3
43342,CN2902700000000,29,27,"Callaway County, MO",Apr-20 p,20581,19164,1417,6.9
43343,CN2902900000000,29,29,"Camden County, MO",Apr-20 p,18905,16388,2517,13.3
43344,CN2903100000000,29,31,"Cape Girardeau County, MO",Apr-20 p,39253,35528,3725,9.5
43345,CN2903300000000,29,33,"Carroll County, MO",Apr-20 p,4782,4440,342,7.2
43346,CN2903500000000,29,35,"Carter County, MO",Apr-20 p,2519,2308,211,8.4
43347,CN2903700000000,29,37,"Cass County, MO",Apr-20 p,52638,48057,4581,8.7
43348,CN2903900000000,29,39,"Cedar County, MO",Apr-20 p,5720,5437,283,4.9
43349,CN2904100000000,29,41,"Chariton County, MO",Apr-20 p,3775,3578,197,5.2
43350,CN2904300000000,29,43,"Christian County, MO",Apr-20 p,44433,40488,3945,8.9
43351,CN2904500000000,29,45,"Clark County, MO",Apr-20 p,3356,3017,339,10.1
43352,CN2904700000000,29,47,"Clay County, MO",Apr-20 p,136277,119228,17049,12.5
43353,CN2904900000000,29,49,"Clinton County, MO",Apr-20 p,10825,9562,1263,11.7
43354,CN2905100000000,29,51,"Cole County, MO",Apr-20 p,37333,34819,2514,6.7
43355,CN2905300000000,29,53,"Cooper County, MO",Apr-20 p,7433,6760,673,9.1
43356,CN2905500000000,29,55,"Crawford County, MO",Apr-20 p,10893,9857,1036,9.5
43357,CN2905700000000,29,57,"Dade County, MO",Apr-20 p,3631,3439,192,5.3
43358,CN2905900000000,29,59,"Dallas County, MO",Apr-20 p,7073,6445,628,8.9
43359,CN2906100000000,29,61,"Daviess County, MO",Apr-20 p,4303,4067,236,5.5
43360,CN2906300000000,29,63,"DeKalb County, MO",Apr-20 p,4830,4534,296,6.1
43361,CN2906500000000,29,65,"Dent County, MO",Apr-20 p,6182,5803,379,6.1
43362,CN2906700000000,29,67,"Douglas County, MO",Apr-20 p,5377,4633,744,13.8
43363,CN2906900000000,29,69,"Dunklin County, MO",Apr-20 p,11729,10705,1024,8.7
43364,CN2907100000000,29,71,"Franklin County, MO",Apr-20 p,52229,46643,5586,10.7
43365,CN2907300000000,29,73,"Gasconade County, MO",Apr-20 p,7831,7086,745,9.5
43366,CN2907500000000,29,75,"Gentry County, MO",Apr-20 p,3594,3434,160,4.5
43367,CN2907700000000,29,77,"Greene County, MO",Apr-20 p,150949,136714,14235,9.4
43368,CN2907900000000,29,79,"Grundy County, MO",Apr-20 p,4492,4182,310,6.9
43369,CN2908100000000,29,81,"Harrison County, MO",Apr-20 p,3926,3721,205,5.2
43370,CN2908300000000,29,83,"Henry County, MO",Apr-20 p,9580,8835,745,7.8
43371,CN2908500000000,29,85,"Hickory County, MO",Apr-20 p,3860,3597,263,6.8
43372,CN2908700000000,29,87,"Holt County, MO",Apr-20 p,2648,2520,128,4.8
43373,CN2908900000000,29,89,"Howard County, MO",Apr-20 p,4728,4467,261,5.5
43374,CN2909100000000,29,91,"Howell County, MO",Apr-20 p,16396,14837,1559,9.5
43375,CN2909300000000,29,93,"Iron County, MO",Apr-20 p,3482,3187,295,8.5
43376,CN2909500000000,29,95,"Jackson County, MO",Apr-20 p,353609,313494,40115,11.3
43377,CN2909700000000,29,97,"Jasper County, MO",Apr-20 p,56667,51025,5642,10.0
43378,CN2909900000000,29,99,"Jefferson County, MO",Apr-20 p,114702,102837,11865,10.3
43379,CN2910100000000,29,101,"Johnson County, MO",Apr-20 p,23292,21355,1937,8.3
43380,CN2910300000000,29,103,"Knox County, MO",Apr-20 p,1784,1712,72,4.0
43381,CN2910500000000,29,105,"Laclede County, MO",Apr-20 p,17961,15297,2664,14.8
43382,CN2910700000000,29,107,"Lafayette County, MO",Apr-20 p,16467,15059,1408,8.6
43383,CN2910900000000,29,109,"Lawrence County, MO",Apr-20 p,18150,16628,1522,8.4
43384,CN2911100000000,29,111,"Lewis County, MO",Apr-20 p,5144,4780,364,7.1
43385,CN2911300000000,29,113,"Lincoln County, MO",Apr-20 p,28558,25027,3531,12.4
43386,CN2911500000000,29,115,"Linn County, MO",Apr-20 p,5107,4686,421,8.2
43387,CN2911700000000,29,117,"Livingston County, MO",Apr-20 p,7485,7041,444,5.9
43388,CN2911900000000,29,119,"McDonald County, MO",Apr-20 p,10501,9808,693,6.6
43389,CN2912100000000,29,121,"Macon County, MO",Apr-20 p,7411,6954,457,6.2
43390,CN2912300000000,29,123,"Madison County, MO",Apr-20 p,5631,5059,572,10.2
43391,CN2912500000000,29,125,"Maries County, MO",Apr-20 p,3815,3600,215,5.6
43392,CN2912700000000,29,127,"Marion County, MO",Apr-20 p,14324,13340,984,6.9
43393,CN2912900000000,29,129,"Mercer County, MO",Apr-20 p,2046,1974,72,3.5
43394,CN2913100000000,29,131,"Miller County, MO",Apr-20 p,12565,11090,1475,11.7
43395,CN2913300000000,29,133,"Mississippi County, MO",Apr-20 p,5733,5425,308,5.4
43396,CN2913500000000,29,135,"Moniteau County, MO",Apr-20 p,7189,6785,404,5.6
43397,CN2913700000000,29,137,"Monroe County, MO",Apr-20 p,3820,3497,323,8.5
43398,CN2913900000000,29,139,"Montgomery County, MO",Apr-20 p,5852,5383,469,8.0
43399,CN2914100000000,29,141,"Morgan County, MO",Apr-20 p,8192,7370,822,10.0
43400,CN2914300000000,29,143,"New Madrid County, MO",Apr-20 p,8606,7970,636,7.4
43401,CN2914500000000,29,145,"Newton County, MO",Apr-20 p,27400,24589,2811,10.3
43402,CN2914700000000,29,147,"Nodaway County, MO",Apr-20 p,11654,10591,1063,9.1
43403,CN2914900000000,29,149,"Oregon County, MO",Apr-20 p,4087,3745,342,8.4
43404,CN2915100000000,29,151,"Osage County, MO",Apr-20 p,6869,6531,338,4.9
43405,CN2915300000000,29,153,"Ozark County, MO",Apr-20 p,3576,3209,367,10.3
43406,CN2915500000000,29,155,"Pemiscot County, MO",Apr-20 p,6470,5895,575,8.9
43407,CN2915700000000,29,157,"Perry County, MO",Apr-20 p,10699,9119,1580,14.8
43408,CN2915900000000,29,159,"Pettis County, MO",Apr-20 p,21380,19239,2141,10.0
43409,CN2916100000000,29,161,"Phelps County, MO",Apr-20 p,19164,17892,1272,6.6
43410,CN2916300000000,29,163,"Pike County, MO",Apr-20 p,7475,6866,609,8.1
43411,CN2916500000000,29,165,"Platte County, MO",Apr-20 p,57171,51501,5670,9.9
43412,CN2916700000000,29,167,"Polk County, MO",Apr-20 p,14111,13249,862,6.1
43413,CN2916900000000,29,169,"Pulaski County, MO",Apr-20 p,14366,13261,1105,7.7
43414,CN2917100000000,29,171,"Putnam County, MO",Apr-20 p,2347,2229,118,5.0
43415,CN2917300000000,29,173,"Ralls County, MO",Apr-20 p,5623,5251,372,6.6
43416,CN2917500000000,29,175,"Randolph County, MO",Apr-20 p,10263,9363,900,8.8
43417,CN2917700000000,29,177,"Ray County, MO",Apr-20 p,11362,9640,1722,15.2
43418,CN2917900000000,29,179,"Reynolds County, MO",Apr-20 p,2968,2753,215,7.2
43419,CN2918100000000,29,181,"Ripley County, MO",Apr-20 p,5150,4517,633,12.3
43420,CN2918300000000,29,183,"St. Charles County, MO",Apr-20 p,221121,199996,21125,9.6
43421,CN2918500000000,29,185,"St. Clair County, MO",Apr-20 p,3802,3509,293,7.7
43422,CN2918600000000,29,186,"Ste. Genevieve County, MO",Apr-20 p,9170,8389,781,8.5
43423,CN2918700000000,29,187,"St. Francois County, MO",Apr-20 p,26409,23766,2643,10.0
43424,CN2918900000000,29,189,"St. Louis County, MO",Apr-20 p,511717,465043,46674,9.1
43425,CN2919500000000,29,195,"Saline County, MO",Apr-20 p,10739,10230,509,4.7
43426,CN2919700000000,29,197,"Schuyler County, MO",Apr-20 p,1970,1846,124,6.3
43427,CN2919900000000,29,199,"Scotland County, MO",Apr-20 p,2440,2332,108,4.4
43428,CN2920100000000,29,201,"Scott County, MO",Apr-20 p,19679,18175,1504,7.6
43429,CN2920300000000,29,203,"Shannon County, MO",Apr-20 p,3402,3024,378,11.1
43430,CN2920500000000,29,205,"Shelby County, MO",Apr-20 p,3136,3004,132,4.2
43431,CN2920700000000,29,207,"Stoddard County, MO",Apr-20 p,13646,12277,1369,10.0
43432,CN2920900000000,29,209,"Stone County, MO",Apr-20 p,14444,12081,2363,16.4
43433,CN2921100000000,29,211,"Sullivan County, MO",Apr-20 p,2771,2610,161,5.8
43434,CN2921300000000,29,213,"Taney County, MO",Apr-20 p,31245,23604,7641,24.5
43435,CN2921500000000,29,215,"Texas County, MO",Apr-20 p,8909,8262,647,7.3
43436,CN2921700000000,29,217,"Vernon County, MO",Apr-20 p,9426,8977,449,4.8
43437,CN2921900000000,29,219,"Warren County, MO",Apr-20 p,17744,15856,1888,10.6
43438,CN2922100000000,29,221,"Washington County, MO",Apr-20 p,10192,9132,1060,10.4
43439,CN2922300000000,29,223,"Wayne County, MO",Apr-20 p,4955,4533,422,8.5
43440,CN2922500000000,29,225,"Webster County, MO",Apr-20 p,17323,15775,1548,8.9
43441,CN2922700000000,29,227,"Worth County, MO",Apr-20 p,1258,1173,85,6.8
43442,CN2922900000000,29,229,"Wright County, MO",Apr-20 p,7908,7009,899,11.4
43443,CN2951000000000,29,510,"St. Louis city, MO",Apr-20 p,149920,132416,17504,11.7
43444,CN3000100000000,30,1,"Beaverhead County, MT",Apr-20 p,4735,4395,340,7.2
43445,CN3000300000000,30,3,"Big Horn County, MT",Apr-20 p,4358,3896,462,10.6
43446,CN3000500000000,30,5,"Blaine County, MT",Apr-20 p,2353,2225,128,5.4
43447,CN3000700000000,30,7,"Broadwater County, MT",Apr-20 p,2456,2182,274,11.2
43448,CN3000900000000,30,9,"Carbon County, MT",Apr-20 p,5495,4813,682,12.4
43449,CN3001100000000,30,11,"Carter County, MT",Apr-20 p,626,606,20,3.2
43450,CN3001300000000,30,13,"Cascade County, MT",Apr-20 p,36972,32481,4491,12.1
43451,CN3001500000000,30,15,"Chouteau County, MT",Apr-20 p,2355,2214,141,6.0
43452,CN3001700000000,30,17,"Custer County, MT",Apr-20 p,5594,5127,467,8.3
43453,CN3001900000000,30,19,"Daniels County, MT",Apr-20 p,835,799,36,4.3
43454,CN3002100000000,30,21,"Dawson County, MT",Apr-20 p,4227,3919,308,7.3
43455,CN3002300000000,30,23,"Deer Lodge County, MT",Apr-20 p,4765,4265,500,10.5
43456,CN3002500000000,30,25,"Fallon County, MT",Apr-20 p,1576,1483,93,5.9
43457,CN3002700000000,30,27,"Fergus County, MT",Apr-20 p,5552,5088,464,8.4
43458,CN3002900000000,30,29,"Flathead County, MT",Apr-20 p,47724,39811,7913,16.6
43459,CN3003100000000,30,31,"Gallatin County, MT",Apr-20 p,67039,58770,8269,12.3
43460,CN3003300000000,30,33,"Garfield County, MT",Apr-20 p,721,689,32,4.4
43461,CN3003500000000,30,35,"Glacier County, MT",Apr-20 p,5179,4507,672,13.0
43462,CN3003700000000,30,37,"Golden Valley County, MT",Apr-20 p,352,328,24,6.8
43463,CN3003900000000,30,39,"Granite County, MT",Apr-20 p,1715,1434,281,16.4
43464,CN3004100000000,30,41,"Hill County, MT",Apr-20 p,7042,6432,610,8.7
43465,CN3004300000000,30,43,"Jefferson County, MT",Apr-20 p,5351,4842,509,9.5
43466,CN3004500000000,30,45,"Judith Basin County, MT",Apr-20 p,1027,951,76,7.4
43467,CN3004700000000,30,47,"Lake County, MT",Apr-20 p,12421,11221,1200,9.7
43468,CN3004900000000,30,49,"Lewis and Clark County, MT",Apr-20 p,33925,30309,3616,10.7
43469,CN3005100000000,30,51,"Liberty County, MT",Apr-20 p,944,918,26,2.8
43470,CN3005300000000,30,53,"Lincoln County, MT",Apr-20 p,7925,6459,1466,18.5
43471,CN3005500000000,30,55,"McCone County, MT",Apr-20 p,898,871,27,3.0
43472,CN3005700000000,30,57,"Madison County, MT",Apr-20 p,4906,4497,409,8.3
43473,CN3005900000000,30,59,"Meagher County, MT",Apr-20 p,904,833,71,7.9
43474,CN3006100000000,30,61,"Mineral County, MT",Apr-20 p,1763,1441,322,18.3
43475,CN3006300000000,30,63,"Missoula County, MT",Apr-20 p,64828,56316,8512,13.1
43476,CN3006500000000,30,65,"Musselshell County, MT",Apr-20 p,2139,1933,206,9.6
43477,CN3006700000000,30,67,"Park County, MT",Apr-20 p,9018,7493,1525,16.9
43478,CN3006900000000,30,69,"Petroleum County, MT",Apr-20 p,263,255,8,3.0
43479,CN3007100000000,30,71,"Phillips County, MT",Apr-20 p,1805,1665,140,7.8
43480,CN3007300000000,30,73,"Pondera County, MT",Apr-20 p,2517,2331,186,7.4
43481,CN3007500000000,30,75,"Powder River County, MT",Apr-20 p,928,879,49,5.3
43482,CN3007700000000,30,77,"Powell County, MT",Apr-20 p,2735,2455,280,10.2
43483,CN3007900000000,30,79,"Prairie County, MT",Apr-20 p,438,411,27,6.2
43484,CN3008100000000,30,81,"Ravalli County, MT",Apr-20 p,19414,17330,2084,10.7
43485,CN3008300000000,30,83,"Richland County, MT",Apr-20 p,5472,4856,616,11.3
43486,CN3008500000000,30,85,"Roosevelt County, MT",Apr-20 p,4054,3730,324,8.0
43487,CN3008700000000,30,87,"Rosebud County, MT",Apr-20 p,3510,3238,272,7.7
43488,CN3008900000000,30,89,"Sanders County, MT",Apr-20 p,4714,4062,652,13.8
43489,CN3009100000000,30,91,"Sheridan County, MT",Apr-20 p,1687,1546,141,8.4
43490,CN3009300000000,30,93,"Silver Bow County, MT",Apr-20 p,16548,14254,2294,13.9
43491,CN3009500000000,30,95,"Stillwater County, MT",Apr-20 p,5173,4685,488,9.4
43492,CN3009700000000,30,97,"Sweet Grass County, MT",Apr-20 p,1704,1588,116,6.8
43493,CN3009900000000,30,99,"Teton County, MT",Apr-20 p,2612,2431,181,6.9
43494,CN3010100000000,30,101,"Toole County, MT",Apr-20 p,1982,1821,161,8.1
43495,CN3010300000000,30,103,"Treasure County, MT",Apr-20 p,325,310,15,4.6
43496,CN3010500000000,30,105,"Valley County, MT",Apr-20 p,3812,3525,287,7.5
43497,CN3010700000000,30,107,"Wheatland County, MT",Apr-20 p,816,717,99,12.1
43498,CN3010900000000,30,109,"Wibaux County, MT",Apr-20 p,440,394,46,10.5
43499,CN3011100000000,30,111,"Yellowstone County, MT",Apr-20 p,79769,70945,8824,11.1
43500,CN3100100000000,31,1,"Adams County, NE",Apr-20 p,17738,16264,1474,8.3
43501,CN3100300000000,31,3,"Antelope County, NE",Apr-20 p,3732,3601,131,3.5
43502,CN3100500000000,31,5,"Arthur County, NE",Apr-20 p,240,226,14,5.8
43503,CN3100700000000,31,7,"Banner County, NE",Apr-20 p,404,384,20,5.0
43504,CN3100900000000,31,9,"Blaine County, NE",Apr-20 p,280,272,8,2.9
43505,CN3101100000000,31,11,"Boone County, NE",Apr-20 p,3086,2977,109,3.5
43506,CN3101300000000,31,13,"Box Butte County, NE",Apr-20 p,5623,5197,426,7.6
43507,CN3101500000000,31,15,"Boyd County, NE",Apr-20 p,1142,1089,53,4.6
43508,CN3101700000000,31,17,"Brown County, NE",Apr-20 p,1434,1386,48,3.3
43509,CN3101900000000,31,19,"Buffalo County, NE",Apr-20 p,29859,26913,2946,9.9
43510,CN3102100000000,31,21,"Burt County, NE",Apr-20 p,3602,3379,223,6.2
43511,CN3102300000000,31,23,"Butler County, NE",Apr-20 p,4692,4372,320,6.8
43512,CN3102500000000,31,25,"Cass County, NE",Apr-20 p,13529,12382,1147,8.5
43513,CN3102700000000,31,27,"Cedar County, NE",Apr-20 p,4682,4432,250,5.3
43514,CN3102900000000,31,29,"Chase County, NE",Apr-20 p,2354,2299,55,2.3
43515,CN3103100000000,31,31,"Cherry County, NE",Apr-20 p,3527,3384,143,4.1
43516,CN3103300000000,31,33,"Cheyenne County, NE",Apr-20 p,4453,4088,365,8.2
43517,CN3103500000000,31,35,"Clay County, NE",Apr-20 p,3477,3263,214,6.2
43518,CN3103700000000,31,37,"Colfax County, NE",Apr-20 p,5684,5426,258,4.5
43519,CN3103900000000,31,39,"Cuming County, NE",Apr-20 p,4840,4626,214,4.4
43520,CN3104100000000,31,41,"Custer County, NE",Apr-20 p,6613,6333,280,4.2
43521,CN3104300000000,31,43,"Dakota County, NE",Apr-20 p,10510,9695,815,7.8
43522,CN3104500000000,31,45,"Dawes County, NE",Apr-20 p,4981,4757,224,4.5
43523,CN3104700000000,31,47,"Dawson County, NE",Apr-20 p,13525,12775,750,5.5
43524,CN3104900000000,31,49,"Deuel County, NE",Apr-20 p,995,941,54,5.4
43525,CN3105100000000,31,51,"Dixon County, NE",Apr-20 p,3027,2840,187,6.2
43526,CN3105300000000,31,53,"Dodge County, NE",Apr-20 p,20052,18655,1397,7.0
43527,CN3105500000000,31,55,"Douglas County, NE",Apr-20 p,303794,271912,31882,10.5
43528,CN3105700000000,31,57,"Dundy County, NE",Apr-20 p,1235,1202,33,2.7
43529,CN3105900000000,31,59,"Fillmore County, NE",Apr-20 p,3269,3110,159,4.9
43530,CN3106100000000,31,61,"Franklin County, NE",Apr-20 p,1530,1448,82,5.4
43531,CN3106300000000,31,63,"Frontier County, NE",Apr-20 p,1660,1601,59,3.6
43532,CN3106500000000,31,65,"Furnas County, NE",Apr-20 p,2694,2558,136,5.0
43533,CN3106700000000,31,67,"Gage County, NE",Apr-20 p,11639,10551,1088,9.3
43534,CN3106900000000,31,69,"Garden County, NE",Apr-20 p,1117,1055,62,5.6
43535,CN3107100000000,31,71,"Garfield County, NE",Apr-20 p,1168,1133,35,3.0
43536,CN3107300000000,31,73,"Gosper County, NE",Apr-20 p,1122,1074,48,4.3
43537,CN3107500000000,31,75,"Grant County, NE",Apr-20 p,449,440,9,2.0
43538,CN3107700000000,31,77,"Greeley County, NE",Apr-20 p,1293,1229,64,4.9
43539,CN3107900000000,31,79,"Hall County, NE",Apr-20 p,33237,29287,3950,11.9
43540,CN3108100000000,31,81,"Hamilton County, NE",Apr-20 p,4837,4482,355,7.3
43541,CN3108300000000,31,83,"Harlan County, NE",Apr-20 p,1846,1766,80,4.3
43542,CN3108500000000,31,85,"Hayes County, NE",Apr-20 p,650,633,17,2.6
43543,CN3108700000000,31,87,"Hitchcock County, NE",Apr-20 p,1300,1237,63,4.8
43544,CN3108900000000,31,89,"Holt County, NE",Apr-20 p,5993,5755,238,4.0
43545,CN3109100000000,31,91,"Hooker County, NE",Apr-20 p,378,361,17,4.5
43546,CN3109300000000,31,93,"Howard County, NE",Apr-20 p,3498,3144,354,10.1
43547,CN3109500000000,31,95,"Jefferson County, NE",Apr-20 p,4273,4070,203,4.8
43548,CN3109700000000,31,97,"Johnson County, NE",Apr-20 p,2137,1997,140,6.6
43549,CN3109900000000,31,99,"Kearney County, NE",Apr-20 p,4042,3760,282,7.0
43550,CN3110100000000,31,101,"Keith County, NE",Apr-20 p,4664,4365,299,6.4
43551,CN3110300000000,31,103,"Keya Paha County, NE",Apr-20 p,637,619,18,2.8
43552,CN3110500000000,31,105,"Kimball County, NE",Apr-20 p,2040,1946,94,4.6
43553,CN3110700000000,31,107,"Knox County, NE",Apr-20 p,4789,4567,222,4.6
43554,CN3110900000000,31,109,"Lancaster County, NE",Apr-20 p,180362,163463,16899,9.4
43555,CN3111100000000,31,111,"Lincoln County, NE",Apr-20 p,19066,17630,1436,7.5
43556,CN3111300000000,31,113,"Logan County, NE",Apr-20 p,503,476,27,5.4
43557,CN3111500000000,31,115,"Loup County, NE",Apr-20 p,424,412,12,2.8
43558,CN3111700000000,31,117,"McPherson County, NE",Apr-20 p,454,437,17,3.7
43559,CN3111900000000,31,119,"Madison County, NE",Apr-20 p,20503,19201,1302,6.4
43560,CN3112100000000,31,121,"Merrick County, NE",Apr-20 p,4130,3768,362,8.8
43561,CN3112300000000,31,123,"Morrill County, NE",Apr-20 p,2726,2578,148,5.4
43562,CN3112500000000,31,125,"Nance County, NE",Apr-20 p,2072,1959,113,5.5
43563,CN3112700000000,31,127,"Nemaha County, NE",Apr-20 p,3687,3465,222,6.0
43564,CN3112900000000,31,129,"Nuckolls County, NE",Apr-20 p,2494,2393,101,4.0
43565,CN3113100000000,31,131,"Otoe County, NE",Apr-20 p,8722,8129,593,6.8
43566,CN3113300000000,31,133,"Pawnee County, NE",Apr-20 p,1528,1456,72,4.7
43567,CN3113500000000,31,135,"Perkins County, NE",Apr-20 p,1870,1828,42,2.2
43568,CN3113700000000,31,137,"Phelps County, NE",Apr-20 p,5197,4904,293,5.6
43569,CN3113900000000,31,139,"Pierce County, NE",Apr-20 p,4217,4016,201,4.8
43570,CN3114100000000,31,141,"Platte County, NE",Apr-20 p,18677,17126,1551,8.3
43571,CN3114300000000,31,143,"Polk County, NE",Apr-20 p,3120,2938,182,5.8
43572,CN3114500000000,31,145,"Red Willow County, NE",Apr-20 p,5986,5686,300,5.0
43573,CN3114700000000,31,147,"Richardson County, NE",Apr-20 p,4348,4115,233,5.4
43574,CN3114900000000,31,149,"Rock County, NE",Apr-20 p,921,887,34,3.7
43575,CN3115100000000,31,151,"Saline County, NE",Apr-20 p,7593,7131,462,6.1
43576,CN3115300000000,31,153,"Sarpy County, NE",Apr-20 p,96906,88021,8885,9.2
43577,CN3115500000000,31,155,"Saunders County, NE",Apr-20 p,11153,10286,867,7.8
43578,CN3115700000000,31,157,"Scotts Bluff County, NE",Apr-20 p,18660,17287,1373,7.4
43579,CN3115900000000,31,159,"Seward County, NE",Apr-20 p,9089,8353,736,8.1
43580,CN3116100000000,31,161,"Sheridan County, NE",Apr-20 p,2728,2641,87,3.2
43581,CN3116300000000,31,163,"Sherman County, NE",Apr-20 p,1749,1649,100,5.7
43582,CN3116500000000,31,165,"Sioux County, NE",Apr-20 p,777,747,30,3.9
43583,CN3116700000000,31,167,"Stanton County, NE",Apr-20 p,3624,3427,197,5.4
43584,CN3116900000000,31,169,"Thayer County, NE",Apr-20 p,2870,2741,129,4.5
43585,CN3117100000000,31,171,"Thomas County, NE",Apr-20 p,430,418,12,2.8
43586,CN3117300000000,31,173,"Thurston County, NE",Apr-20 p,3321,3004,317,9.5
43587,CN3117500000000,31,175,"Valley County, NE",Apr-20 p,2218,2095,123,5.5
43588,CN3117700000000,31,177,"Washington County, NE",Apr-20 p,11158,10365,793,7.1
43589,CN3117900000000,31,179,"Wayne County, NE",Apr-20 p,5881,5616,265,4.5
43590,CN3118100000000,31,181,"Webster County, NE",Apr-20 p,1777,1668,109,6.1
43591,CN3118300000000,31,183,"Wheeler County, NE",Apr-20 p,618,599,19,3.1
43592,CN3118500000000,31,185,"York County, NE",Apr-20 p,7567,7107,460,6.1
43593,CN3200100000000,32,1,"Churchill County, NV",Apr-20 p,9435,8232,1203,12.8
43594,CN3200300000000,32,3,"Clark County, NV",Apr-20 p,1063731,707079,356652,33.5
43595,CN3200500000000,32,5,"Douglas County, NV",Apr-20 p,20454,16498,3956,19.3
43596,CN3200700000000,32,7,"Elko County, NV",Apr-20 p,23788,20054,3734,15.7
43597,CN3200900000000,32,9,"Esmeralda County, NV",Apr-20 p,355,329,26,7.3
43598,CN3201100000000,32,11,"Eureka County, NV",Apr-20 p,910,851,59,6.5
43599,CN3201300000000,32,13,"Humboldt County, NV",Apr-20 p,6859,6202,657,9.6
43600,CN3201500000000,32,15,"Lander County, NV",Apr-20 p,2605,2370,235,9.0
43601,CN3201700000000,32,17,"Lincoln County, NV",Apr-20 p,1722,1549,173,10.0
43602,CN3201900000000,32,19,"Lyon County, NV",Apr-20 p,20735,16576,4159,20.1
43603,CN3202100000000,32,21,"Mineral County, NV",Apr-20 p,1726,1510,216,12.5
43604,CN3202300000000,32,23,"Nye County, NV",Apr-20 p,15685,12343,3342,21.3
43605,CN3202700000000,32,27,"Pershing County, NV",Apr-20 p,2139,1925,214,10.0
43606,CN3202900000000,32,29,"Storey County, NV",Apr-20 p,1834,1430,404,22.0
43607,CN3203100000000,32,31,"Washoe County, NV",Apr-20 p,225766,181481,44285,19.6
43608,CN3203300000000,32,33,"White Pine County, NV",Apr-20 p,3821,3484,337,8.8
43609,CN3251000000000,32,510,"Carson City, NV",Apr-20 p,23131,18179,4952,21.4
43610,CN3300100000000,33,1,"Belknap County, NH",Apr-20 p,29301,23231,6070,20.7
43611,CN3300300000000,33,3,"Carroll County, NH",Apr-20 p,21692,16415,5277,24.3
43612,CN3300500000000,33,5,"Cheshire County, NH",Apr-20 p,37156,31623,5533,14.9
43613,CN3300700000000,33,7,"Coos County, NH",Apr-20 p,13750,10648,3102,22.6
43614,CN3300900000000,33,9,"Grafton County, NH",Apr-20 p,45100,37908,7192,15.9
43615,CN3301100000000,33,11,"Hillsborough County, NH",Apr-20 p,228070,188842,39228,17.2
43616,CN3301300000000,33,13,"Merrimack County, NH",Apr-20 p,77235,65063,12172,15.8
43617,CN3301500000000,33,15,"Rockingham County, NH",Apr-20 p,172342,142078,30264,17.6
43618,CN3301700000000,33,17,"Strafford County, NH",Apr-20 p,68383,57395,10988,16.1
43619,CN3301900000000,33,19,"Sullivan County, NH",Apr-20 p,20514,17764,2750,13.4
43620,CN3400100000000,34,1,"Atlantic County, NJ",Apr-20 p,123337,82267,41070,33.3
43621,CN3400300000000,34,3,"Bergen County, NJ",Apr-20 p,476855,402418,74437,15.6
43622,CN3400500000000,34,5,"Burlington County, NJ",Apr-20 p,229950,199662,30288,13.2
43623,CN3400700000000,34,7,"Camden County, NJ",Apr-20 p,257973,217248,40725,15.8
43624,CN3400900000000,34,9,"Cape May County, NJ",Apr-20 p,42984,31553,11431,26.6
43625,CN3401100000000,34,11,"Cumberland County, NJ",Apr-20 p,67334,56407,10927,16.2
43626,CN3401300000000,34,13,"Essex County, NJ",Apr-20 p,365603,304277,61326,16.8
43627,CN3401500000000,34,15,"Gloucester County, NJ",Apr-20 p,152757,129095,23662,15.5
43628,CN3401700000000,34,17,"Hudson County, NJ",Apr-20 p,358022,300446,57576,16.1
43629,CN3401900000000,34,19,"Hunterdon County, NJ",Apr-20 p,61710,54298,7412,12.0
43630,CN3402100000000,34,21,"Mercer County, NJ",Apr-20 p,204228,182685,21543,10.5
43631,CN3402300000000,34,23,"Middlesex County, NJ",Apr-20 p,424661,364254,60407,14.2
43632,CN3402500000000,34,25,"Monmouth County, NJ",Apr-20 p,322367,272485,49882,15.5
43633,CN3402700000000,34,27,"Morris County, NJ",Apr-20 p,247738,215475,32263,13.0
43634,CN3402900000000,34,29,"Ocean County, NJ",Apr-20 p,274115,226718,47397,17.3
43635,CN3403100000000,34,31,"Passaic County, NJ",Apr-20 p,249345,199389,49956,20.0
43636,CN3403300000000,34,33,"Salem County, NJ",Apr-20 p,29416,25305,4111,14.0
43637,CN3403500000000,34,35,"Somerset County, NJ",Apr-20 p,163839,143619,20220,12.3
43638,CN3403700000000,34,37,"Sussex County, NJ",Apr-20 p,74301,61757,12544,16.9
43639,CN3403900000000,34,39,"Union County, NJ",Apr-20 p,271917,229914,42003,15.4
43640,CN3404100000000,34,41,"Warren County, NJ",Apr-20 p,57486,49502,7984,13.9
43641,CN3500100000000,35,1,"Bernalillo County, NM",Apr-20 p,315463,276361,39102,12.4
43642,CN3500300000000,35,3,"Catron County, NM",Apr-20 p,1027,954,73,7.1
43643,CN3500500000000,35,5,"Chaves County, NM",Apr-20 p,27225,24603,2622,9.6
43644,CN3500600000000,35,6,"Cibola County, NM",Apr-20 p,8666,7883,783,9.0
43645,CN3500700000000,35,7,"Colfax County, NM",Apr-20 p,5209,4756,453,8.7
43646,CN3500900000000,35,9,"Curry County, NM",Apr-20 p,21078,19745,1333,6.3
43647,CN3501100000000,35,11,"De Baca County, NM",Apr-20 p,674,644,30,4.5
43648,CN3501300000000,35,13,"Dona Ana County, NM",Apr-20 p,91434,80837,10597,11.6
43649,CN3501500000000,35,15,"Eddy County, NM",Apr-20 p,35650,33467,2183,6.1
43650,CN3501700000000,35,17,"Grant County, NM",Apr-20 p,11784,10976,808,6.9
43651,CN3501900000000,35,19,"Guadalupe County, NM",Apr-20 p,1427,1333,94,6.6
43652,CN3502100000000,35,21,"Harding County, NM",Apr-20 p,259,251,8,3.1
43653,CN3502300000000,35,23,"Hidalgo County, NM",Apr-20 p,1982,1892,90,4.5
43654,CN3502500000000,35,25,"Lea County, NM",Apr-20 p,32330,29489,2841,8.8
43655,CN3502700000000,35,27,"Lincoln County, NM",Apr-20 p,9007,7804,1203,13.4
43656,CN3502800000000,35,28,"Los Alamos County, NM",Apr-20 p,9140,8696,444,4.9
43657,CN3502900000000,35,29,"Luna County, NM",Apr-20 p,10066,8290,1776,17.6
43658,CN3503100000000,35,31,"McKinley County, NM",Apr-20 p,23916,21450,2466,10.3
43659,CN3503300000000,35,33,"Mora County, NM",Apr-20 p,2002,1828,174,8.7
43660,CN3503500000000,35,35,"Otero County, NM",Apr-20 p,25381,22392,2989,11.8
43661,CN3503700000000,35,37,"Quay County, NM",Apr-20 p,3032,2831,201,6.6
43662,CN3503900000000,35,39,"Rio Arriba County, NM",Apr-20 p,16186,14448,1738,10.7
43663,CN3504100000000,35,41,"Roosevelt County, NM",Apr-20 p,7744,7252,492,6.4
43664,CN3504300000000,35,43,"Sandoval County, NM",Apr-20 p,62773,54561,8212,13.1
43665,CN3504500000000,35,45,"San Juan County, NM",Apr-20 p,48300,41886,6414,13.3
43666,CN3504700000000,35,47,"San Miguel County, NM",Apr-20 p,10683,9595,1088,10.2
43667,CN3504900000000,35,49,"Santa Fe County, NM",Apr-20 p,69551,60963,8588,12.3
43668,CN3505100000000,35,51,"Sierra County, NM",Apr-20 p,3714,3280,434,11.7
43669,CN3505300000000,35,53,"Socorro County, NM",Apr-20 p,6077,5575,502,8.3
43670,CN3505500000000,35,55,"Taos County, NM",Apr-20 p,16413,13835,2578,15.7
43671,CN3505700000000,35,57,"Torrance County, NM",Apr-20 p,5003,4424,579,11.6
43672,CN3505900000000,35,59,"Union County, NM",Apr-20 p,1644,1553,91,5.5
43673,CN3506100000000,35,61,"Valencia County, NM",Apr-20 p,28106,25119,2987,10.6
43674,CN3600100000000,36,1,"Albany County, NY",Apr-20 p,153435,135329,18106,11.8
43675,CN3600300000000,36,3,"Allegany County, NY",Apr-20 p,19568,17007,2561,13.1
43676,CN3600500000000,36,5,"Bronx County, NY",Apr-20 p,552273,461208,91065,16.5
43677,CN3600700000000,36,7,"Broome County, NY",Apr-20 p,85401,72583,12818,15.0
43678,CN3600900000000,36,9,"Cattaraugus County, NY",Apr-20 p,35466,29249,6217,17.5
43679,CN3601100000000,36,11,"Cayuga County, NY",Apr-20 p,35872,30369,5503,15.3
43680,CN3601300000000,36,13,"Chautauqua County, NY",Apr-20 p,55798,47127,8671,15.5
43681,CN3601500000000,36,15,"Chemung County, NY",Apr-20 p,36415,30620,5795,15.9
43682,CN3601700000000,36,17,"Chenango County, NY",Apr-20 p,21792,19244,2548,11.7
43683,CN3601900000000,36,19,"Clinton County, NY",Apr-20 p,37441,31808,5633,15.0
43684,CN3602100000000,36,21,"Columbia County, NY",Apr-20 p,30643,27316,3327,10.9
43685,CN3602300000000,36,23,"Cortland County, NY",Apr-20 p,22620,19430,3190,14.1
43686,CN3602500000000,36,25,"Delaware County, NY",Apr-20 p,18546,16244,2302,12.4
43687,CN3602700000000,36,27,"Dutchess County, NY",Apr-20 p,142161,122169,19992,14.1
43688,CN3602900000000,36,29,"Erie County, NY",Apr-20 p,438336,356813,81523,18.6
43689,CN3603100000000,36,31,"Essex County, NY",Apr-20 p,16624,13830,2794,16.8
43690,CN3603300000000,36,33,"Franklin County, NY",Apr-20 p,20051,17190,2861,14.3
43691,CN3603500000000,36,35,"Fulton County, NY",Apr-20 p,22599,19172,3427,15.2
43692,CN3603700000000,36,37,"Genesee County, NY",Apr-20 p,29421,25170,4251,14.4
43693,CN3603900000000,36,39,"Greene County, NY",Apr-20 p,20656,17590,3066,14.8
43694,CN3604100000000,36,41,"Hamilton County, NY",Apr-20 p,2159,1855,304,14.1
43695,CN3604300000000,36,43,"Herkimer County, NY",Apr-20 p,27337,23233,4104,15.0
43696,CN3604500000000,36,45,"Jefferson County, NY",Apr-20 p,43637,36257,7380,16.9
43697,CN3604700000000,36,47,"Kings County, NY",Apr-20 p,1098187,938295,159892,14.6
43698,CN3604900000000,36,49,"Lewis County, NY",Apr-20 p,11232,9612,1620,14.4
43699,CN3605100000000,36,51,"Livingston County, NY",Apr-20 p,29322,25190,4132,14.1
43700,CN3605300000000,36,53,"Madison County, NY",Apr-20 p,31956,26754,5202,16.3
43701,CN3605500000000,36,55,"Monroe County, NY",Apr-20 p,351110,298327,52783,15.0
43702,CN3605700000000,36,57,"Montgomery County, NY",Apr-20 p,21717,18524,3193,14.7
43703,CN3605900000000,36,59,"Nassau County, NY",Apr-20 p,677948,572452,105496,15.6
43704,CN3606100000000,36,61,"New York County, NY",Apr-20 p,806470,718250,88220,10.9
43705,CN3606300000000,36,63,"Niagara County, NY",Apr-20 p,101429,79202,22227,21.9
43706,CN3606500000000,36,65,"Oneida County, NY",Apr-20 p,99997,84895,15102,15.1
43707,CN3606700000000,36,67,"Onondaga County, NY",Apr-20 p,216901,182066,34835,16.1
43708,CN3606900000000,36,69,"Ontario County, NY",Apr-20 p,53515,45735,7780,14.5
43709,CN3607100000000,36,71,"Orange County, NY",Apr-20 p,176223,148724,27499,15.6
43710,CN3607300000000,36,73,"Orleans County, NY",Apr-20 p,16935,14264,2671,15.8
43711,CN3607500000000,36,75,"Oswego County, NY",Apr-20 p,51865,42989,8876,17.1
43712,CN3607700000000,36,77,"Otsego County, NY",Apr-20 p,26735,23519,3216,12.0
43713,CN3607900000000,36,79,"Putnam County, NY",Apr-20 p,50615,43482,7133,14.1
43714,CN3608100000000,36,81,"Queens County, NY",Apr-20 p,1073758,897570,176188,16.4
43715,CN3608300000000,36,83,"Rensselaer County, NY",Apr-20 p,79342,69582,9760,12.3
43716,CN3608500000000,36,85,"Richmond County, NY",Apr-20 p,202476,174170,28306,14.0
43717,CN3608700000000,36,87,"Rockland County, NY",Apr-20 p,145031,125618,19413,13.4
43718,CN3608900000000,36,89,"St. Lawrence County, NY",Apr-20 p,44648,38383,6265,14.0
43719,CN3609100000000,36,91,"Saratoga County, NY",Apr-20 p,118022,102439,15583,13.2
43720,CN3609300000000,36,93,"Schenectady County, NY",Apr-20 p,75217,65217,10000,13.3
43721,CN3609500000000,36,95,"Schoharie County, NY",Apr-20 p,14011,12349,1662,11.9
43722,CN3609700000000,36,97,"Schuyler County, NY",Apr-20 p,8328,6939,1389,16.7
43723,CN3609900000000,36,99,"Seneca County, NY",Apr-20 p,15959,13529,2430,15.2
43724,CN3610100000000,36,101,"Steuben County, NY",Apr-20 p,43025,36451,6574,15.3
43725,CN3610300000000,36,103,"Suffolk County, NY",Apr-20 p,749303,626653,122650,16.4
43726,CN3610500000000,36,105,"Sullivan County, NY",Apr-20 p,36955,32132,4823,13.1
43727,CN3610700000000,36,107,"Tioga County, NY",Apr-20 p,23247,19809,3438,14.8
43728,CN3610900000000,36,109,"Tompkins County, NY",Apr-20 p,48859,43939,4920,10.1
43729,CN3611100000000,36,111,"Ulster County, NY",Apr-20 p,89971,76823,13148,14.6
43730,CN3611300000000,36,113,"Warren County, NY",Apr-20 p,30846,25563,5283,17.1
43731,CN3611500000000,36,115,"Washington County, NY",Apr-20 p,26371,22698,3673,13.9
43732,CN3611700000000,36,117,"Wayne County, NY",Apr-20 p,42000,35979,6021,14.3
43733,CN3611900000000,36,119,"Westchester County, NY",Apr-20 p,455845,391614,64231,14.1
43734,CN3612100000000,36,121,"Wyoming County, NY",Apr-20 p,17930,15188,2742,15.3
43735,CN3612300000000,36,123,"Yates County, NY",Apr-20 p,11155,9681,1474,13.2
43736,CN3700100000000,37,1,"Alamance County, NC",Apr-20 p,73413,64082,9331,12.7
43737,CN3700300000000,37,3,"Alexander County, NC",Apr-20 p,17388,13890,3498,20.1
43738,CN3700500000000,37,5,"Alleghany County, NC",Apr-20 p,4364,3904,460,10.5
43739,CN3700700000000,37,7,"Anson County, NC",Apr-20 p,10052,9226,826,8.2
43740,CN3700900000000,37,9,"Ashe County, NC",Apr-20 p,12827,11456,1371,10.7
43741,CN3701100000000,37,11,"Avery County, NC",Apr-20 p,7384,6632,752,10.2
43742,CN3701300000000,37,13,"Beaufort County, NC",Apr-20 p,18517,17013,1504,8.1
43743,CN3701500000000,37,15,"Bertie County, NC",Apr-20 p,7472,6993,479,6.4
43744,CN3701700000000,37,17,"Bladen County, NC",Apr-20 p,14665,13340,1325,9.0
43745,CN3701900000000,37,19,"Brunswick County, NC",Apr-20 p,46674,38589,8085,17.3
43746,CN3702100000000,37,21,"Buncombe County, NC",Apr-20 p,131385,108421,22964,17.5
43747,CN3702300000000,37,23,"Burke County, NC",Apr-20 p,37190,31422,5768,15.5
43748,CN3702500000000,37,25,"Cabarrus County, NC",Apr-20 p,100146,87871,12275,12.3
43749,CN3702700000000,37,27,"Caldwell County, NC",Apr-20 p,33291,27921,5370,16.1
43750,CN3702900000000,37,29,"Camden County, NC",Apr-20 p,4502,4114,388,8.6
43751,CN3703100000000,37,31,"Carteret County, NC",Apr-20 p,31149,27647,3502,11.2
43752,CN3703300000000,37,33,"Caswell County, NC",Apr-20 p,9515,8167,1348,14.2
43753,CN3703500000000,37,35,"Catawba County, NC",Apr-20 p,74490,60492,13998,18.8
43754,CN3703700000000,37,37,"Chatham County, NC",Apr-20 p,32193,29448,2745,8.5
43755,CN3703900000000,37,39,"Cherokee County, NC",Apr-20 p,11375,10033,1342,11.8
43756,CN3704100000000,37,41,"Chowan County, NC",Apr-20 p,5442,5014,428,7.9
43757,CN3704300000000,37,43,"Clay County, NC",Apr-20 p,4209,3753,456,10.8
43758,CN3704500000000,37,45,"Cleveland County, NC",Apr-20 p,49140,42886,6254,12.7
43759,CN3704700000000,37,47,"Columbus County, NC",Apr-20 p,22407,19950,2457,11.0
43760,CN3704900000000,37,49,"Craven County, NC",Apr-20 p,39565,35424,4141,10.5
43761,CN3705100000000,37,51,"Cumberland County, NC",Apr-20 p,118888,101283,17605,14.8
43762,CN3705300000000,37,53,"Currituck County, NC",Apr-20 p,13593,11773,1820,13.4
43763,CN3705500000000,37,55,"Dare County, NC",Apr-20 p,20221,15272,4949,24.5
43764,CN3705700000000,37,57,"Davidson County, NC",Apr-20 p,74892,64778,10114,13.5
43765,CN3705900000000,37,59,"Davie County, NC",Apr-20 p,19122,16601,2521,13.2
43766,CN3706100000000,37,61,"Duplin County, NC",Apr-20 p,24767,22986,1781,7.2
43767,CN3706300000000,37,63,"Durham County, NC",Apr-20 p,157296,141658,15638,9.9
43768,CN3706500000000,37,65,"Edgecombe County, NC",Apr-20 p,19751,17141,2610,13.2
43769,CN3706700000000,37,67,"Forsyth County, NC",Apr-20 p,171089,150278,20811,12.2
43770,CN3706900000000,37,69,"Franklin County, NC",Apr-20 p,28187,25037,3150,11.2
43771,CN3707100000000,37,71,"Gaston County, NC",Apr-20 p,103559,89187,14372,13.9
43772,CN3707300000000,37,73,"Gates County, NC",Apr-20 p,4809,4461,348,7.2
43773,CN3707500000000,37,75,"Graham County, NC",Apr-20 p,3410,2930,480,14.1
43774,CN3707700000000,37,77,"Granville County, NC",Apr-20 p,28786,26125,2661,9.2
43775,CN3707900000000,37,79,"Greene County, NC",Apr-20 p,9184,8471,713,7.8
43776,CN3708100000000,37,81,"Guilford County, NC",Apr-20 p,236165,201248,34917,14.8
43777,CN3708300000000,37,83,"Halifax County, NC",Apr-20 p,19797,17591,2206,11.1
43778,CN3708500000000,37,85,"Harnett County, NC",Apr-20 p,51096,44915,6181,12.1
43779,CN3708700000000,37,87,"Haywood County, NC",Apr-20 p,26991,23039,3952,14.6
43780,CN3708900000000,37,89,"Henderson County, NC",Apr-20 p,49174,42467,6707,13.6
43781,CN3709100000000,37,91,"Hertford County, NC",Apr-20 p,8918,8305,613,6.9
43782,CN3709300000000,37,93,"Hoke County, NC",Apr-20 p,18408,15995,2413,13.1
43783,CN3709500000000,37,95,"Hyde County, NC",Apr-20 p,1803,1537,266,14.8
43784,CN3709700000000,37,97,"Iredell County, NC",Apr-20 p,84000,72080,11920,14.2
43785,CN3709900000000,37,99,"Jackson County, NC",Apr-20 p,21231,18777,2454,11.6
43786,CN3710100000000,37,101,"Johnston County, NC",Apr-20 p,89340,79638,9702,10.9
43787,CN3710300000000,37,103,"Jones County, NC",Apr-20 p,4083,3741,342,8.4
43788,CN3710500000000,37,105,"Lee County, NC",Apr-20 p,25879,22276,3603,13.9
43789,CN3710700000000,37,107,"Lenoir County, NC",Apr-20 p,27378,25519,1859,6.8
43790,CN3710900000000,37,109,"Lincoln County, NC",Apr-20 p,40252,35027,5225,13.0
43791,CN3711100000000,37,111,"McDowell County, NC",Apr-20 p,21003,18537,2466,11.7
43792,CN3711300000000,37,113,"Macon County, NC",Apr-20 p,15375,13631,1744,11.3
43793,CN3711500000000,37,115,"Madison County, NC",Apr-20 p,8920,7810,1110,12.4
43794,CN3711700000000,37,117,"Martin County, NC",Apr-20 p,8604,7881,723,8.4
43795,CN3711900000000,37,119,"Mecklenburg County, NC",Apr-20 p,573840,500268,73572,12.8
43796,CN3712100000000,37,121,"Mitchell County, NC",Apr-20 p,6128,5350,778,12.7
43797,CN3712300000000,37,123,"Montgomery County, NC",Apr-20 p,10887,9750,1137,10.4
43798,CN3712500000000,37,125,"Moore County, NC",Apr-20 p,40936,35721,5215,12.7
43799,CN3712700000000,37,127,"Nash County, NC",Apr-20 p,40163,35222,4941,12.3
43800,CN3712900000000,37,129,"New Hanover County, NC",Apr-20 p,112165,95288,16877,15.0
43801,CN3713100000000,37,131,"Northampton County, NC",Apr-20 p,7260,6712,548,7.5
43802,CN3713300000000,37,133,"Onslow County, NC",Apr-20 p,61868,54543,7325,11.8
43803,CN3713500000000,37,135,"Orange County, NC",Apr-20 p,71033,65240,5793,8.2
43804,CN3713700000000,37,137,"Pamlico County, NC",Apr-20 p,4955,4550,405,8.2
43805,CN3713900000000,37,139,"Pasquotank County, NC",Apr-20 p,16596,14720,1876,11.3
43806,CN3714100000000,37,141,"Pender County, NC",Apr-20 p,25381,22187,3194,12.6
43807,CN3714300000000,37,143,"Perquimans County, NC",Apr-20 p,4810,4327,483,10.0
43808,CN3714500000000,37,145,"Person County, NC",Apr-20 p,17409,15154,2255,13.0
43809,CN3714700000000,37,147,"Pitt County, NC",Apr-20 p,81519,73791,7728,9.5
43810,CN3714900000000,37,149,"Polk County, NC",Apr-20 p,8601,7695,906,10.5
43811,CN3715100000000,37,151,"Randolph County, NC",Apr-20 p,60123,51055,9068,15.1
43812,CN3715300000000,37,153,"Richmond County, NC",Apr-20 p,16694,14755,1939,11.6
43813,CN3715500000000,37,155,"Robeson County, NC",Apr-20 p,48634,43664,4970,10.2
43814,CN3715700000000,37,157,"Rockingham County, NC",Apr-20 p,36495,30715,5780,15.8
43815,CN3715900000000,37,159,"Rowan County, NC",Apr-20 p,62014,53098,8916,14.4
43816,CN3716100000000,37,161,"Rutherford County, NC",Apr-20 p,25642,22031,3611,14.1
43817,CN3716300000000,37,163,"Sampson County, NC",Apr-20 p,28538,26472,2066,7.2
43818,CN3716500000000,37,165,"Scotland County, NC",Apr-20 p,11923,10218,1705,14.3
43819,CN3716700000000,37,167,"Stanly County, NC",Apr-20 p,29158,26257,2901,9.9
43820,CN3716900000000,37,169,"Stokes County, NC",Apr-20 p,19532,17393,2139,11.0
43821,CN3717100000000,37,171,"Surry County, NC",Apr-20 p,33764,29424,4340,12.9
43822,CN3717300000000,37,173,"Swain County, NC",Apr-20 p,7369,6284,1085,14.7
43823,CN3717500000000,37,175,"Transylvania County, NC",Apr-20 p,14088,12614,1474,10.5
43824,CN3717700000000,37,177,"Tyrrell County, NC",Apr-20 p,1327,1133,194,14.6
43825,CN3717900000000,37,179,"Union County, NC",Apr-20 p,111384,99881,11503,10.3
43826,CN3718100000000,37,181,"Vance County, NC",Apr-20 p,17736,15557,2179,12.3
43827,CN3718300000000,37,183,"Wake County, NC",Apr-20 p,538607,479413,59194,11.0
43828,CN3718500000000,37,185,"Warren County, NC",Apr-20 p,6616,5812,804,12.2
43829,CN3718700000000,37,187,"Washington County, NC",Apr-20 p,4133,3719,414,10.0
43830,CN3718900000000,37,189,"Watauga County, NC",Apr-20 p,29281,26028,3253,11.1
43831,CN3719100000000,37,191,"Wayne County, NC",Apr-20 p,45924,41537,4387,9.6
43832,CN3719300000000,37,193,"Wilkes County, NC",Apr-20 p,28381,25095,3286,11.6
43833,CN3719500000000,37,195,"Wilson County, NC",Apr-20 p,35062,30499,4563,13.0
43834,CN3719700000000,37,197,"Yadkin County, NC",Apr-20 p,16873,14270,2603,15.4
43835,CN3719900000000,37,199,"Yancey County, NC",Apr-20 p,7971,7115,856,10.7
43836,CN3800100000000,38,1,"Adams County, ND",Apr-20 p,1030,979,51,5.0
43837,CN3800300000000,38,3,"Barnes County, ND",Apr-20 p,5138,4766,372,7.2
43838,CN3800500000000,38,5,"Benson County, ND",Apr-20 p,2416,2128,288,11.9
43839,CN3800700000000,38,7,"Billings County, ND",Apr-20 p,363,341,22,6.1
43840,CN3800900000000,38,9,"Bottineau County, ND",Apr-20 p,2879,2615,264,9.2
43841,CN3801100000000,38,11,"Bowman County, ND",Apr-20 p,1611,1501,110,6.8
43842,CN3801300000000,38,13,"Burke County, ND",Apr-20 p,1051,961,90,8.6
43843,CN3801500000000,38,15,"Burleigh County, ND",Apr-20 p,48547,44010,4537,9.3
43844,CN3801700000000,38,17,"Cass County, ND",Apr-20 p,103901,94383,9518,9.2
43845,CN3801900000000,38,19,"Cavalier County, ND",Apr-20 p,1874,1765,109,5.8
43846,CN3802100000000,38,21,"Dickey County, ND",Apr-20 p,2368,2135,233,9.8
43847,CN3802300000000,38,23,"Divide County, ND",Apr-20 p,1378,1305,73,5.3
43848,CN3802500000000,38,25,"Dunn County, ND",Apr-20 p,3297,3139,158,4.8
43849,CN3802700000000,38,27,"Eddy County, ND",Apr-20 p,1212,1121,91,7.5
43850,CN3802900000000,38,29,"Emmons County, ND",Apr-20 p,1424,1311,113,7.9
43851,CN3803100000000,38,31,"Foster County, ND",Apr-20 p,1466,1372,94,6.4
43852,CN3803300000000,38,33,"Golden Valley County, ND",Apr-20 p,822,786,36,4.4
43853,CN3803500000000,38,35,"Grand Forks County, ND",Apr-20 p,37076,33653,3423,9.2
43854,CN3803700000000,38,37,"Grant County, ND",Apr-20 p,1193,1144,49,4.1
43855,CN3803900000000,38,39,"Griggs County, ND",Apr-20 p,1004,965,39,3.9
43856,CN3804100000000,38,41,"Hettinger County, ND",Apr-20 p,1363,1297,66,4.8
43857,CN3804300000000,38,43,"Kidder County, ND",Apr-20 p,1277,1174,103,8.1
43858,CN3804500000000,38,45,"LaMoure County, ND",Apr-20 p,2047,1935,112,5.5
43859,CN3804700000000,38,47,"Logan County, ND",Apr-20 p,872,827,45,5.2
43860,CN3804900000000,38,49,"McHenry County, ND",Apr-20 p,3083,2829,254,8.2
43861,CN3805100000000,38,51,"McIntosh County, ND",Apr-20 p,1067,1030,37,3.5
43862,CN3805300000000,38,53,"McKenzie County, ND",Apr-20 p,9965,9056,909,9.1
43863,CN3805500000000,38,55,"McLean County, ND",Apr-20 p,4577,4269,308,6.7
43864,CN3805700000000,38,57,"Mercer County, ND",Apr-20 p,3422,3134,288,8.4
43865,CN3805900000000,38,59,"Morton County, ND",Apr-20 p,16159,14467,1692,10.5
43866,CN3806100000000,38,61,"Mountrail County, ND",Apr-20 p,7251,6818,433,6.0
43867,CN3806300000000,38,63,"Nelson County, ND",Apr-20 p,1359,1260,99,7.3
43868,CN3806500000000,38,65,"Oliver County, ND",Apr-20 p,847,778,69,8.1
43869,CN3806700000000,38,67,"Pembina County, ND",Apr-20 p,3463,3012,451,13.0
43870,CN3806900000000,38,69,"Pierce County, ND",Apr-20 p,1678,1534,144,8.6
43871,CN3807100000000,38,71,"Ramsey County, ND",Apr-20 p,5533,5048,485,8.8
43872,CN3807300000000,38,73,"Ransom County, ND",Apr-20 p,3097,2612,485,15.7
43873,CN3807500000000,38,75,"Renville County, ND",Apr-20 p,1210,1120,90,7.4
43874,CN3807700000000,38,77,"Richland County, ND",Apr-20 p,8819,7930,889,10.1
43875,CN3807900000000,38,79,"Rolette County, ND",Apr-20 p,4679,3941,738,15.8
43876,CN3808100000000,38,81,"Sargent County, ND",Apr-20 p,3094,2530,564,18.2
43877,CN3808300000000,38,83,"Sheridan County, ND",Apr-20 p,673,616,57,8.5
43878,CN3808500000000,38,85,"Sioux County, ND",Apr-20 p,1143,1102,41,3.6
43879,CN3808700000000,38,87,"Slope County, ND",Apr-20 p,389,375,14,3.6
43880,CN3808900000000,38,89,"Stark County, ND",Apr-20 p,18739,16891,1848,9.9
43881,CN3809100000000,38,91,"Steele County, ND",Apr-20 p,974,931,43,4.4
43882,CN3809300000000,38,93,"Stutsman County, ND",Apr-20 p,10139,9537,602,5.9
43883,CN3809500000000,38,95,"Towner County, ND",Apr-20 p,1081,1040,41,3.8
43884,CN3809700000000,38,97,"Traill County, ND",Apr-20 p,4298,4025,273,6.4
43885,CN3809900000000,38,99,"Walsh County, ND",Apr-20 p,5042,4687,355,7.0
43886,CN3810100000000,38,101,"Ward County, ND",Apr-20 p,31943,28636,3307,10.4
43887,CN3810300000000,38,103,"Wells County, ND",Apr-20 p,1889,1762,127,6.7
43888,CN3810500000000,38,105,"Williams County, ND",Apr-20 p,24014,21337,2677,11.1
43889,CN3900100000000,39,1,"Adams County, OH",Apr-20 p,10489,8651,1838,17.5
43890,CN3900300000000,39,3,"Allen County, OH",Apr-20 p,49248,39111,10137,20.6
43891,CN3900500000000,39,5,"Ashland County, OH",Apr-20 p,26263,22961,3302,12.6
43892,CN3900700000000,39,7,"Ashtabula County, OH",Apr-20 p,42943,36152,6791,15.8
43893,CN3900900000000,39,9,"Athens County, OH",Apr-20 p,26641,23629,3012,11.3
43894,CN3901100000000,39,11,"Auglaize County, OH",Apr-20 p,25641,20649,4992,19.5
43895,CN3901300000000,39,13,"Belmont County, OH",Apr-20 p,28790,23603,5187,18.0
43896,CN3901500000000,39,15,"Brown County, OH",Apr-20 p,18972,15964,3008,15.9
43897,CN3901700000000,39,17,"Butler County, OH",Apr-20 p,186913,160314,26599,14.2
43898,CN3901900000000,39,19,"Carroll County, OH",Apr-20 p,12793,10629,2164,16.9
43899,CN3902100000000,39,21,"Champaign County, OH",Apr-20 p,19674,15706,3968,20.2
43900,CN3902300000000,39,23,"Clark County, OH",Apr-20 p,65149,53787,11362,17.4
43901,CN3902500000000,39,25,"Clermont County, OH",Apr-20 p,102008,87776,14232,14.0
43902,CN3902700000000,39,27,"Clinton County, OH",Apr-20 p,17992,14898,3094,17.2
43903,CN3902900000000,39,29,"Columbiana County, OH",Apr-20 p,47185,37561,9624,20.4
43904,CN3903100000000,39,31,"Coshocton County, OH",Apr-20 p,13907,11603,2304,16.6
43905,CN3903300000000,39,33,"Crawford County, OH",Apr-20 p,18381,13978,4403,24.0
43906,CN3903500000000,39,35,"Cuyahoga County, OH",Apr-20 p,593568,453871,139697,23.5
43907,CN3903700000000,39,37,"Darke County, OH",Apr-20 p,25757,21218,4539,17.6
43908,CN3903900000000,39,39,"Defiance County, OH",Apr-20 p,18375,14275,4100,22.3
43909,CN3904100000000,39,41,"Delaware County, OH",Apr-20 p,104476,92981,11495,11.0
43910,CN3904300000000,39,43,"Erie County, OH",Apr-20 p,38111,28390,9721,25.5
43911,CN3904500000000,39,45,"Fairfield County, OH",Apr-20 p,76281,65628,10653,14.0
43912,CN3904700000000,39,47,"Fayette County, OH",Apr-20 p,14052,11778,2274,16.2
43913,CN3904900000000,39,49,"Franklin County, OH",Apr-20 p,678908,585183,93725,13.8
43914,CN3905100000000,39,51,"Fulton County, OH",Apr-20 p,22638,17862,4776,21.1
43915,CN3905300000000,39,53,"Gallia County, OH",Apr-20 p,12561,10872,1689,13.4
43916,CN3905500000000,39,55,"Geauga County, OH",Apr-20 p,44426,36837,7589,17.1
43917,CN3905700000000,39,57,"Greene County, OH",Apr-20 p,81141,70738,10403,12.8
43918,CN3905900000000,39,59,"Guernsey County, OH",Apr-20 p,18388,15645,2743,14.9
43919,CN3906100000000,39,61,"Hamilton County, OH",Apr-20 p,397468,341241,56227,14.1
43920,CN3906300000000,39,63,"Hancock County, OH",Apr-20 p,43118,35655,7463,17.3
43921,CN3906500000000,39,65,"Hardin County, OH",Apr-20 p,13626,10560,3066,22.5
43922,CN3906700000000,39,67,"Harrison County, OH",Apr-20 p,6508,5528,980,15.1
43923,CN3906900000000,39,69,"Henry County, OH",Apr-20 p,12981,10237,2744,21.1
43924,CN3907100000000,39,71,"Highland County, OH",Apr-20 p,16779,13395,3384,20.2
43925,CN3907300000000,39,73,"Hocking County, OH",Apr-20 p,12887,10844,2043,15.9
43926,CN3907500000000,39,75,"Holmes County, OH",Apr-20 p,20848,19494,1354,6.5
43927,CN3907700000000,39,77,"Huron County, OH",Apr-20 p,28176,22111,6065,21.5
43928,CN3907900000000,39,79,"Jackson County, OH",Apr-20 p,12772,10842,1930,15.1
43929,CN3908100000000,39,81,"Jefferson County, OH",Apr-20 p,27117,22222,4895,18.1
43930,CN3908300000000,39,83,"Knox County, OH",Apr-20 p,30659,26848,3811,12.4
43931,CN3908500000000,39,85,"Lake County, OH",Apr-20 p,120674,94265,26409,21.9
43932,CN3908700000000,39,87,"Lawrence County, OH",Apr-20 p,23789,19980,3809,16.0
43933,CN3908900000000,39,89,"Licking County, OH",Apr-20 p,87690,76051,11639,13.3
43934,CN3909100000000,39,91,"Logan County, OH",Apr-20 p,24047,16819,7228,30.1
43935,CN3909300000000,39,93,"Lorain County, OH",Apr-20 p,153539,114208,39331,25.6
43936,CN3909500000000,39,95,"Lucas County, OH",Apr-20 p,214215,163544,50671,23.7
43937,CN3909700000000,39,97,"Madison County, OH",Apr-20 p,20392,17747,2645,13.0
43938,CN3909900000000,39,99,"Mahoning County, OH",Apr-20 p,101452,81063,20389,20.1
43939,CN3910100000000,39,101,"Marion County, OH",Apr-20 p,28441,23459,4982,17.5
43940,CN3910300000000,39,103,"Medina County, OH",Apr-20 p,92750,73150,19600,21.1
43941,CN3910500000000,39,105,"Meigs County, OH",Apr-20 p,8655,7292,1363,15.7
43942,CN3910700000000,39,107,"Mercer County, OH",Apr-20 p,23638,20317,3321,14.0
43943,CN3910900000000,39,109,"Miami County, OH",Apr-20 p,54866,46096,8770,16.0
43944,CN3911100000000,39,111,"Monroe County, OH",Apr-20 p,5194,4350,844,16.2
43945,CN3911300000000,39,113,"Montgomery County, OH",Apr-20 p,256178,212905,43273,16.9
43946,CN3911500000000,39,115,"Morgan County, OH",Apr-20 p,6364,5245,1119,17.6
43947,CN3911700000000,39,117,"Morrow County, OH",Apr-20 p,16806,14080,2726,16.2
43948,CN3911900000000,39,119,"Muskingum County, OH",Apr-20 p,39699,33379,6320,15.9
43949,CN3912100000000,39,121,"Noble County, OH",Apr-20 p,4598,3830,768,16.7
43950,CN3912300000000,39,123,"Ottawa County, OH",Apr-20 p,19958,16074,3884,19.5
43951,CN3912500000000,39,125,"Paulding County, OH",Apr-20 p,8599,6896,1703,19.8
43952,CN3912700000000,39,127,"Perry County, OH",Apr-20 p,15897,13211,2686,16.9
43953,CN3912900000000,39,129,"Pickaway County, OH",Apr-20 p,25836,22272,3564,13.8
43954,CN3913100000000,39,131,"Pike County, OH",Apr-20 p,10853,8906,1947,17.9
43955,CN3913300000000,39,133,"Portage County, OH",Apr-20 p,81758,69717,12041,14.7
43956,CN3913500000000,39,135,"Preble County, OH",Apr-20 p,20199,17292,2907,14.4
43957,CN3913700000000,39,137,"Putnam County, OH",Apr-20 p,18599,15831,2768,14.9
43958,CN3913900000000,39,139,"Richland County, OH",Apr-20 p,53775,42851,10924,20.3
43959,CN3914100000000,39,141,"Ross County, OH",Apr-20 p,35756,29171,6585,18.4
43960,CN3914300000000,39,143,"Sandusky County, OH",Apr-20 p,30447,24388,6059,19.9
43961,CN3914500000000,39,145,"Scioto County, OH",Apr-20 p,28767,24439,4328,15.0
43962,CN3914700000000,39,147,"Seneca County, OH",Apr-20 p,27501,21656,5845,21.3
43963,CN3914900000000,39,149,"Shelby County, OH",Apr-20 p,25366,19869,5497,21.7
43964,CN3915100000000,39,151,"Stark County, OH",Apr-20 p,181371,151901,29470,16.2
43965,CN3915300000000,39,153,"Summit County, OH",Apr-20 p,259552,217047,42505,16.4
43966,CN3915500000000,39,155,"Trumbull County, OH",Apr-20 p,85885,67869,18016,21.0
43967,CN3915700000000,39,157,"Tuscarawas County, OH",Apr-20 p,44758,37929,6829,15.3
43968,CN3915900000000,39,159,"Union County, OH",Apr-20 p,29588,24656,4932,16.7
43969,CN3916100000000,39,161,"Van Wert County, OH",Apr-20 p,15272,12794,2478,16.2
43970,CN3916300000000,39,163,"Vinton County, OH",Apr-20 p,5412,4507,905,16.7
43971,CN3916500000000,39,165,"Warren County, OH",Apr-20 p,113207,98179,15028,13.3
43972,CN3916700000000,39,167,"Washington County, OH",Apr-20 p,28049,23894,4155,14.8
43973,CN3916900000000,39,169,"Wayne County, OH",Apr-20 p,61725,54460,7265,11.8
43974,CN3917100000000,39,171,"Williams County, OH",Apr-20 p,19396,15312,4084,21.1
43975,CN3917300000000,39,173,"Wood County, OH",Apr-20 p,67733,56122,11611,17.1
43976,CN3917500000000,39,175,"Wyandot County, OH",Apr-20 p,13313,10591,2722,20.4
43977,CN4000100000000,40,1,"Adair County, OK",Apr-20 p,7573,6764,809,10.7
43978,CN4000300000000,40,3,"Alfalfa County, OK",Apr-20 p,2578,2421,157,6.1
43979,CN4000500000000,40,5,"Atoka County, OK",Apr-20 p,4721,4091,630,13.3
43980,CN4000700000000,40,7,"Beaver County, OK",Apr-20 p,2531,2433,98,3.9
43981,CN4000900000000,40,9,"Beckham County, OK",Apr-20 p,9268,7860,1408,15.2
43982,CN4001100000000,40,11,"Blaine County, OK",Apr-20 p,4449,3960,489,11.0
43983,CN4001300000000,40,13,"Bryan County, OK",Apr-20 p,20134,17730,2404,11.9
43984,CN4001500000000,40,15,"Caddo County, OK",Apr-20 p,11325,9912,1413,12.5
43985,CN4001700000000,40,17,"Canadian County, OK",Apr-20 p,72000,60805,11195,15.5
43986,CN4001900000000,40,19,"Carter County, OK",Apr-20 p,21405,17491,3914,18.3
43987,CN4002100000000,40,21,"Cherokee County, OK",Apr-20 p,17679,15749,1930,10.9
43988,CN4002300000000,40,23,"Choctaw County, OK",Apr-20 p,5207,4466,741,14.2
43989,CN4002500000000,40,25,"Cimarron County, OK",Apr-20 p,1261,1228,33,2.6
43990,CN4002700000000,40,27,"Cleveland County, OK",Apr-20 p,135468,116455,19013,14.0
43991,CN4002900000000,40,29,"Coal County, OK",Apr-20 p,2251,2001,250,11.1
43992,CN4003100000000,40,31,"Comanche County, OK",Apr-20 p,47347,38352,8995,19.0
43993,CN4003300000000,40,33,"Cotton County, OK",Apr-20 p,2757,2237,520,18.9
43994,CN4003500000000,40,35,"Craig County, OK",Apr-20 p,5541,4915,626,11.3
43995,CN4003700000000,40,37,"Creek County, OK",Apr-20 p,30031,25741,4290,14.3
43996,CN4003900000000,40,39,"Custer County, OK",Apr-20 p,14530,13030,1500,10.3
43997,CN4004100000000,40,41,"Delaware County, OK",Apr-20 p,17623,15389,2234,12.7
43998,CN4004300000000,40,43,"Dewey County, OK",Apr-20 p,2740,2538,202,7.4
43999,CN4004500000000,40,45,"Ellis County, OK",Apr-20 p,1963,1830,133,6.8
44000,CN4004700000000,40,47,"Garfield County, OK",Apr-20 p,25751,22814,2937,11.4
44001,CN4004900000000,40,49,"Garvin County, OK",Apr-20 p,11938,10320,1618,13.6
44002,CN4005100000000,40,51,"Grady County, OK",Apr-20 p,25250,21772,3478,13.8
44003,CN4005300000000,40,53,"Grant County, OK",Apr-20 p,2468,2314,154,6.2
44004,CN4005500000000,40,55,"Greer County, OK",Apr-20 p,1867,1604,263,14.1
44005,CN4005700000000,40,57,"Harmon County, OK",Apr-20 p,1119,1057,62,5.5
44006,CN4005900000000,40,59,"Harper County, OK",Apr-20 p,1654,1572,82,5.0
44007,CN4006100000000,40,61,"Haskell County, OK",Apr-20 p,4082,3473,609,14.9
44008,CN4006300000000,40,63,"Hughes County, OK",Apr-20 p,5186,4457,729,14.1
44009,CN4006500000000,40,65,"Jackson County, OK",Apr-20 p,10494,9644,850,8.1
44010,CN4006700000000,40,67,"Jefferson County, OK",Apr-20 p,2466,2105,361,14.6
44011,CN4006900000000,40,69,"Johnston County, OK",Apr-20 p,3336,2700,636,19.1
44012,CN4007100000000,40,71,"Kay County, OK",Apr-20 p,17841,15160,2681,15.0
44013,CN4007300000000,40,73,"Kingfisher County, OK",Apr-20 p,8251,7591,660,8.0
44014,CN4007500000000,40,75,"Kiowa County, OK",Apr-20 p,3258,2897,361,11.1
44015,CN4007700000000,40,77,"Latimer County, OK",Apr-20 p,3002,2482,520,17.3
44016,CN4007900000000,40,79,"Le Flore County, OK",Apr-20 p,17905,15426,2479,13.8
44017,CN4008100000000,40,81,"Lincoln County, OK",Apr-20 p,14714,12897,1817,12.3
44018,CN4008300000000,40,83,"Logan County, OK",Apr-20 p,20582,18139,2443,11.9
44019,CN4008500000000,40,85,"Love County, OK",Apr-20 p,5893,5183,710,12.0
44020,CN4008700000000,40,87,"McClain County, OK",Apr-20 p,18727,16246,2481,13.2
44021,CN4008900000000,40,89,"McCurtain County, OK",Apr-20 p,14018,12365,1653,11.8
44022,CN4009100000000,40,91,"McIntosh County, OK",Apr-20 p,7101,5953,1148,16.2
44023,CN4009300000000,40,93,"Major County, OK",Apr-20 p,3567,3269,298,8.4
44024,CN4009500000000,40,95,"Marshall County, OK",Apr-20 p,7026,5827,1199,17.1
44025,CN4009700000000,40,97,"Mayes County, OK",Apr-20 p,18131,16297,1834,10.1
44026,CN4009900000000,40,99,"Murray County, OK",Apr-20 p,6068,5332,736,12.1
44027,CN4010100000000,40,101,"Muskogee County, OK",Apr-20 p,28029,24351,3678,13.1
44028,CN4010300000000,40,103,"Noble County, OK",Apr-20 p,5185,4687,498,9.6
44029,CN4010500000000,40,105,"Nowata County, OK",Apr-20 p,4293,3864,429,10.0
44030,CN4010700000000,40,107,"Okfuskee County, OK",Apr-20 p,4299,3746,553,12.9
44031,CN4010900000000,40,109,"Oklahoma County, OK",Apr-20 p,369676,312877,56799,15.4
44032,CN4011100000000,40,111,"Okmulgee County, OK",Apr-20 p,14969,12695,2274,15.2
44033,CN4011300000000,40,113,"Osage County, OK",Apr-20 p,19669,16913,2756,14.0
44034,CN4011500000000,40,115,"Ottawa County, OK",Apr-20 p,15148,12832,2316,15.3
44035,CN4011700000000,40,117,"Pawnee County, OK",Apr-20 p,7014,6022,992,14.1
44036,CN4011900000000,40,119,"Payne County, OK",Apr-20 p,35748,31203,4545,12.7
44037,CN4012100000000,40,121,"Pittsburg County, OK",Apr-20 p,16573,13797,2776,16.8
44038,CN4012300000000,40,123,"Pontotoc County, OK",Apr-20 p,17934,15652,2282,12.7
44039,CN4012500000000,40,125,"Pottawatomie County, OK",Apr-20 p,31493,27247,4246,13.5
44040,CN4012700000000,40,127,"Pushmataha County, OK",Apr-20 p,4133,3598,535,12.9
44041,CN4012900000000,40,129,"Roger Mills County, OK",Apr-20 p,1756,1588,168,9.6
44042,CN4013100000000,40,131,"Rogers County, OK",Apr-20 p,42706,36949,5757,13.5
44043,CN4013300000000,40,133,"Seminole County, OK",Apr-20 p,9119,7812,1307,14.3
44044,CN4013500000000,40,135,"Sequoyah County, OK",Apr-20 p,15762,13172,2590,16.4
44045,CN4013700000000,40,137,"Stephens County, OK",Apr-20 p,18169,15468,2701,14.9
44046,CN4013900000000,40,139,"Texas County, OK",Apr-20 p,10961,10660,301,2.7
44047,CN4014100000000,40,141,"Tillman County, OK",Apr-20 p,3174,2548,626,19.7
44048,CN4014300000000,40,143,"Tulsa County, OK",Apr-20 p,312554,264180,48374,15.5
44049,CN4014500000000,40,145,"Wagoner County, OK",Apr-20 p,36083,31076,5007,13.9
44050,CN4014700000000,40,147,"Washington County, OK",Apr-20 p,20685,17991,2694,13.0
44051,CN4014900000000,40,149,"Washita County, OK",Apr-20 p,4887,4283,604,12.4
44052,CN4015100000000,40,151,"Woods County, OK",Apr-20 p,4250,3971,279,6.6
44053,CN4015300000000,40,153,"Woodward County, OK",Apr-20 p,8882,7857,1025,11.5
44054,CN4100100000000,41,1,"Baker County, OR",Apr-20 p,7175,6205,970,13.5
44055,CN4100300000000,41,3,"Benton County, OR",Apr-20 p,48077,43159,4918,10.2
44056,CN4100500000000,41,5,"Clackamas County, OR",Apr-20 p,218729,188517,30212,13.8
44057,CN4100700000000,41,7,"Clatsop County, OR",Apr-20 p,19161,14492,4669,24.4
44058,CN4100900000000,41,9,"Columbia County, OR",Apr-20 p,24541,20794,3747,15.3
44059,CN4101100000000,41,11,"Coos County, OR",Apr-20 p,26903,21832,5071,18.8
44060,CN4101300000000,41,13,"Crook County, OR",Apr-20 p,9714,7903,1811,18.6
44061,CN4101500000000,41,15,"Curry County, OR",Apr-20 p,8687,7120,1567,18.0
44062,CN4101700000000,41,17,"Deschutes County, OR",Apr-20 p,96492,78936,17556,18.2
44063,CN4101900000000,41,19,"Douglas County, OR",Apr-20 p,47674,39728,7946,16.7
44064,CN4102100000000,41,21,"Gilliam County, OR",Apr-20 p,899,797,102,11.3
44065,CN4102300000000,41,23,"Grant County, OR",Apr-20 p,3234,2738,496,15.3
44066,CN4102500000000,41,25,"Harney County, OR",Apr-20 p,3524,3168,356,10.1
44067,CN4102700000000,41,27,"Hood River County, OR",Apr-20 p,13581,11680,1901,14.0
44068,CN4102900000000,41,29,"Jackson County, OR",Apr-20 p,103221,86653,16568,16.1
44069,CN4103100000000,41,31,"Jefferson County, OR",Apr-20 p,9848,8439,1409,14.3
44070,CN4103300000000,41,33,"Josephine County, OR",Apr-20 p,35775,30212,5563,15.5
44071,CN4103500000000,41,35,"Klamath County, OR",Apr-20 p,29206,24559,4647,15.9
44072,CN4103700000000,41,37,"Lake County, OR",Apr-20 p,3520,3180,340,9.7
44073,CN4103900000000,41,39,"Lane County, OR",Apr-20 p,179746,150845,28901,16.1
44074,CN4104100000000,41,41,"Lincoln County, OR",Apr-20 p,20968,15472,5496,26.2
44075,CN4104300000000,41,43,"Linn County, OR",Apr-20 p,60870,51401,9469,15.6
44076,CN4104500000000,41,45,"Malheur County, OR",Apr-20 p,12500,11463,1037,8.3
44077,CN4104700000000,41,47,"Marion County, OR",Apr-20 p,159116,137775,21341,13.4
44078,CN4104900000000,41,49,"Morrow County, OR",Apr-20 p,5561,5113,448,8.1
44079,CN4105100000000,41,51,"Multnomah County, OR",Apr-20 p,462804,390174,72630,15.7
44080,CN4105300000000,41,53,"Polk County, OR",Apr-20 p,38840,33828,5012,12.9
44081,CN4105500000000,41,55,"Sherman County, OR",Apr-20 p,964,843,121,12.6
44082,CN4105700000000,41,57,"Tillamook County, OR",Apr-20 p,11923,9728,2195,18.4
44083,CN4105900000000,41,59,"Umatilla County, OR",Apr-20 p,37132,31817,5315,14.3
44084,CN4106100000000,41,61,"Union County, OR",Apr-20 p,12304,9931,2373,19.3
44085,CN4106300000000,41,63,"Wallowa County, OR",Apr-20 p,3368,2892,476,14.1
44086,CN4106500000000,41,65,"Wasco County, OR",Apr-20 p,12465,10615,1850,14.8
44087,CN4106700000000,41,67,"Washington County, OR",Apr-20 p,317871,279816,38055,12.0
44088,CN4106900000000,41,69,"Wheeler County, OR",Apr-20 p,686,646,40,5.8
44089,CN4107100000000,41,71,"Yamhill County, OR",Apr-20 p,54601,47417,7184,13.2
44090,CN4200100000000,42,1,"Adams County, PA",Apr-20 p,53988,46075,7913,14.7
44091,CN4200300000000,42,3,"Allegheny County, PA",Apr-20 p,630144,532706,97438,15.5
44092,CN4200500000000,42,5,"Armstrong County, PA",Apr-20 p,31743,26228,5515,17.4
44093,CN4200700000000,42,7,"Beaver County, PA",Apr-20 p,84024,68715,15309,18.2
44094,CN4200900000000,42,9,"Bedford County, PA",Apr-20 p,23460,19272,4188,17.9
44095,CN4201100000000,42,11,"Berks County, PA",Apr-20 p,219873,182086,37787,17.2
44096,CN4201300000000,42,13,"Blair County, PA",Apr-20 p,61376,50788,10588,17.3
44097,CN4201500000000,42,15,"Bradford County, PA",Apr-20 p,27720,24228,3492,12.6
44098,CN4201700000000,42,17,"Bucks County, PA",Apr-20 p,334223,284620,49603,14.8
44099,CN4201900000000,42,19,"Butler County, PA",Apr-20 p,96940,82164,14776,15.2
44100,CN4202100000000,42,21,"Cambria County, PA",Apr-20 p,58635,48442,10193,17.4
44101,CN4202300000000,42,23,"Cameron County, PA",Apr-20 p,2228,1686,542,24.3
44102,CN4202500000000,42,25,"Carbon County, PA",Apr-20 p,33124,26971,6153,18.6
44103,CN4202700000000,42,27,"Centre County, PA",Apr-20 p,79765,72045,7720,9.7
44104,CN4202900000000,42,29,"Chester County, PA",Apr-20 p,268194,237757,30437,11.3
44105,CN4203100000000,42,31,"Clarion County, PA",Apr-20 p,17114,14258,2856,16.7
44106,CN4203300000000,42,33,"Clearfield County, PA",Apr-20 p,36779,30526,6253,17.0
44107,CN4203500000000,42,35,"Clinton County, PA",Apr-20 p,17766,14966,2800,15.8
44108,CN4203700000000,42,37,"Columbia County, PA",Apr-20 p,34936,29699,5237,15.0
44109,CN4203900000000,42,39,"Crawford County, PA",Apr-20 p,37882,31696,6186,16.3
44110,CN4204100000000,42,41,"Cumberland County, PA",Apr-20 p,129863,114171,15692,12.1
44111,CN4204300000000,42,43,"Dauphin County, PA",Apr-20 p,145010,123885,21125,14.6
44112,CN4204500000000,42,45,"Delaware County, PA",Apr-20 p,297374,254732,42642,14.3
44113,CN4204700000000,42,47,"Elk County, PA",Apr-20 p,16982,12664,4318,25.4
44114,CN4204900000000,42,49,"Erie County, PA",Apr-20 p,128271,106893,21378,16.7
44115,CN4205100000000,42,51,"Fayette County, PA",Apr-20 p,57590,46061,11529,20.0
44116,CN4205300000000,42,53,"Forest County, PA",Apr-20 p,1859,1529,330,17.8
44117,CN4205500000000,42,55,"Franklin County, PA",Apr-20 p,76578,66622,9956,13.0
44118,CN4205700000000,42,57,"Fulton County, PA",Apr-20 p,8078,6682,1396,17.3
44119,CN4205900000000,42,59,"Greene County, PA",Apr-20 p,15589,13398,2191,14.1
44120,CN4206100000000,42,61,"Huntingdon County, PA",Apr-20 p,19882,16438,3444,17.3
44121,CN4206300000000,42,63,"Indiana County, PA",Apr-20 p,37865,32121,5744,15.2
44122,CN4206500000000,42,65,"Jefferson County, PA",Apr-20 p,20355,17015,3340,16.4
44123,CN4206700000000,42,67,"Juniata County, PA",Apr-20 p,12851,10531,2320,18.1
44124,CN4206900000000,42,69,"Lackawanna County, PA",Apr-20 p,104016,86228,17788,17.1
44125,CN4207100000000,42,71,"Lancaster County, PA",Apr-20 p,277006,236220,40786,14.7
44126,CN4207300000000,42,73,"Lawrence County, PA",Apr-20 p,40614,33136,7478,18.4
44127,CN4207500000000,42,75,"Lebanon County, PA",Apr-20 p,73494,63365,10129,13.8
44128,CN4207700000000,42,77,"Lehigh County, PA",Apr-20 p,194876,163219,31657,16.2
44129,CN4207900000000,42,79,"Luzerne County, PA",Apr-20 p,157132,128168,28964,18.4
44130,CN4208100000000,42,81,"Lycoming County, PA",Apr-20 p,53178,44157,9021,17.0
44131,CN4208300000000,42,83,"McKean County, PA",Apr-20 p,17289,14107,3182,18.4
44132,CN4208500000000,42,85,"Mercer County, PA",Apr-20 p,48412,40078,8334,17.2
44133,CN4208700000000,42,87,"Mifflin County, PA",Apr-20 p,21182,17690,3492,16.5
44134,CN4208900000000,42,89,"Monroe County, PA",Apr-20 p,80387,63633,16754,20.8
44135,CN4209100000000,42,91,"Montgomery County, PA",Apr-20 p,435345,377450,57895,13.3
44136,CN4209300000000,42,93,"Montour County, PA",Apr-20 p,9210,8177,1033,11.2
44137,CN4209500000000,42,95,"Northampton County, PA",Apr-20 p,162340,136684,25656,15.8
44138,CN4209700000000,42,97,"Northumberland County, PA",Apr-20 p,43059,35688,7371,17.1
44139,CN4209900000000,42,99,"Perry County, PA",Apr-20 p,24314,21065,3249,13.4
44140,CN4210100000000,42,101,"Philadelphia County/city, PA",Apr-20 p,734343,613160,121183,16.5
44141,CN4210300000000,42,103,"Pike County, PA",Apr-20 p,24854,20060,4794,19.3
44142,CN4210500000000,42,105,"Potter County, PA",Apr-20 p,7010,5922,1088,15.5
44143,CN4210700000000,42,107,"Schuylkill County, PA",Apr-20 p,66996,55954,11042,16.5
44144,CN4210900000000,42,109,"Snyder County, PA",Apr-20 p,20580,16982,3598,17.5
44145,CN4211100000000,42,111,"Somerset County, PA",Apr-20 p,32666,26845,5821,17.8
44146,CN4211300000000,42,113,"Sullivan County, PA",Apr-20 p,2496,2118,378,15.1
44147,CN4211500000000,42,115,"Susquehanna County, PA",Apr-20 p,19268,16785,2483,12.9
44148,CN4211700000000,42,117,"Tioga County, PA",Apr-20 p,18472,15696,2776,15.0
44149,CN4211900000000,42,119,"Union County, PA",Apr-20 p,19354,16636,2718,14.0
44150,CN4212100000000,42,121,"Venango County, PA",Apr-20 p,21764,18481,3283,15.1
44151,CN4212300000000,42,123,"Warren County, PA",Apr-20 p,18263,15888,2375,13.0
44152,CN4212500000000,42,125,"Washington County, PA",Apr-20 p,105366,87622,17744,16.8
44153,CN4212700000000,42,127,"Wayne County, PA",Apr-20 p,21654,17667,3987,18.4
44154,CN4212900000000,42,129,"Westmoreland County, PA",Apr-20 p,179040,148204,30836,17.2
44155,CN4213100000000,42,131,"Wyoming County, PA",Apr-20 p,13200,11159,2041,15.5
44156,CN4213300000000,42,133,"York County, PA",Apr-20 p,241180,205340,35840,14.9
44157,CN4400100000000,44,1,"Bristol County, RI",Apr-20 p,23759,20301,3458,14.6
44158,CN4400300000000,44,3,"Kent County, RI",Apr-20 p,86318,70670,15648,18.1
44159,CN4400500000000,44,5,"Newport County, RI",Apr-20 p,41147,34526,6621,16.1
44160,CN4400700000000,44,7,"Providence County, RI",Apr-20 p,309545,251831,57714,18.6
44161,CN4400900000000,44,9,"Washington County, RI",Apr-20 p,62343,52467,9876,15.8
44162,CN4500100000000,45,1,"Abbeville County, SC",Apr-20 p,10107,8709,1398,13.8
44163,CN4500300000000,45,3,"Aiken County, SC",Apr-20 p,75469,67974,7495,9.9
44164,CN4500500000000,45,5,"Allendale County, SC",Apr-20 p,2575,2246,329,12.8
44165,CN4500700000000,45,7,"Anderson County, SC",Apr-20 p,93272,81525,11747,12.6
44166,CN4500900000000,45,9,"Bamberg County, SC",Apr-20 p,4813,4248,565,11.7
44167,CN4501100000000,45,11,"Barnwell County, SC",Apr-20 p,7822,7007,815,10.4
44168,CN4501300000000,45,13,"Beaufort County, SC",Apr-20 p,76501,67424,9077,11.9
44169,CN4501500000000,45,15,"Berkeley County, SC",Apr-20 p,101834,90936,10898,10.7
44170,CN4501700000000,45,17,"Calhoun County, SC",Apr-20 p,6401,5850,551,8.6
44171,CN4501900000000,45,19,"Charleston County, SC",Apr-20 p,212814,185087,27727,13.0
44172,CN4502100000000,45,21,"Cherokee County, SC",Apr-20 p,26704,22318,4386,16.4
44173,CN4502300000000,45,23,"Chester County, SC",Apr-20 p,13347,11403,1944,14.6
44174,CN4502500000000,45,25,"Chesterfield County, SC",Apr-20 p,21705,19316,2389,11.0
44175,CN4502700000000,45,27,"Clarendon County, SC",Apr-20 p,12687,11240,1447,11.4
44176,CN4502900000000,45,29,"Colleton County, SC",Apr-20 p,16225,14759,1466,9.0
44177,CN4503100000000,45,31,"Darlington County, SC",Apr-20 p,30131,27028,3103,10.3
44178,CN4503300000000,45,33,"Dillon County, SC",Apr-20 p,12782,11612,1170,9.2
44179,CN4503500000000,45,35,"Dorchester County, SC",Apr-20 p,76958,68330,8628,11.2
44180,CN4503700000000,45,37,"Edgefield County, SC",Apr-20 p,10846,9729,1117,10.3
44181,CN4503900000000,45,39,"Fairfield County, SC",Apr-20 p,9558,8452,1106,11.6
44182,CN4504100000000,45,41,"Florence County, SC",Apr-20 p,65224,59607,5617,8.6
44183,CN4504300000000,45,43,"Georgetown County, SC",Apr-20 p,26182,22187,3995,15.3
44184,CN4504500000000,45,45,"Greenville County, SC",Apr-20 p,260275,228430,31845,12.2
44185,CN4504700000000,45,47,"Greenwood County, SC",Apr-20 p,30780,27309,3471,11.3
44186,CN4504900000000,45,49,"Hampton County, SC",Apr-20 p,7966,7395,571,7.2
44187,CN4505100000000,45,51,"Horry County, SC",Apr-20 p,147357,113966,33391,22.7
44188,CN4505300000000,45,53,"Jasper County, SC",Apr-20 p,12091,10961,1130,9.3
44189,CN4505500000000,45,55,"Kershaw County, SC",Apr-20 p,28827,26133,2694,9.3
44190,CN4505700000000,45,57,"Lancaster County, SC",Apr-20 p,40538,35311,5227,12.9
44191,CN4505900000000,45,59,"Laurens County, SC",Apr-20 p,31363,26896,4467,14.2
44192,CN4506100000000,45,61,"Lee County, SC",Apr-20 p,6631,5835,796,12.0
44193,CN4506300000000,45,63,"Lexington County, SC",Apr-20 p,145978,134758,11220,7.7
44194,CN4506500000000,45,65,"McCormick County, SC",Apr-20 p,3316,2929,387,11.7
44195,CN4506700000000,45,67,"Marion County, SC",Apr-20 p,12512,11020,1492,11.9
44196,CN4506900000000,45,69,"Marlboro County, SC",Apr-20 p,9560,7887,1673,17.5
44197,CN4507100000000,45,71,"Newberry County, SC",Apr-20 p,18485,16863,1622,8.8
44198,CN4507300000000,45,73,"Oconee County, SC",Apr-20 p,35393,31109,4284,12.1
44199,CN4507500000000,45,75,"Orangeburg County, SC",Apr-20 p,35089,30429,4660,13.3
44200,CN4507700000000,45,77,"Pickens County, SC",Apr-20 p,57613,51254,6359,11.0
44201,CN4507900000000,45,79,"Richland County, SC",Apr-20 p,195439,177807,17632,9.0
44202,CN4508100000000,45,81,"Saluda County, SC",Apr-20 p,8618,8004,614,7.1
44203,CN4508300000000,45,83,"Spartanburg County, SC",Apr-20 p,161055,137034,24021,14.9
44204,CN4508500000000,45,85,"Sumter County, SC",Apr-20 p,45226,40225,5001,11.1
44205,CN4508700000000,45,87,"Union County, SC",Apr-20 p,12667,10323,2344,18.5
44206,CN4508900000000,45,89,"Williamsburg County, SC",Apr-20 p,11886,10446,1440,12.1
44207,CN4509100000000,45,91,"York County, SC",Apr-20 p,136997,120623,16374,12.0
44208,CN4600300000000,46,3,"Aurora County, SD",Apr-20 p,1483,1402,81,5.5
44209,CN4600500000000,46,5,"Beadle County, SD",Apr-20 p,9501,8804,697,7.3
44210,CN4600700000000,46,7,"Bennett County, SD",Apr-20 p,1041,972,69,6.6
44211,CN4600900000000,46,9,"Bon Homme County, SD",Apr-20 p,2831,2596,235,8.3
44212,CN4601100000000,46,11,"Brookings County, SD",Apr-20 p,19284,17618,1666,8.6
44213,CN4601300000000,46,13,"Brown County, SD",Apr-20 p,21317,19138,2179,10.2
44214,CN4601500000000,46,15,"Brule County, SD",Apr-20 p,2523,2245,278,11.0
44215,CN4601700000000,46,17,"Buffalo County, SD",Apr-20 p,698,596,102,14.6
44216,CN4601900000000,46,19,"Butte County, SD",Apr-20 p,5239,4592,647,12.3
44217,CN4602100000000,46,21,"Campbell County, SD",Apr-20 p,750,700,50,6.7
44218,CN4602300000000,46,23,"Charles Mix County, SD",Apr-20 p,3821,3381,440,11.5
44219,CN4602500000000,46,25,"Clark County, SD",Apr-20 p,1872,1698,174,9.3
44220,CN4602700000000,46,27,"Clay County, SD",Apr-20 p,7801,7149,652,8.4
44221,CN4602900000000,46,29,"Codington County, SD",Apr-20 p,16313,14176,2137,13.1
44222,CN4603100000000,46,31,"Corson County, SD",Apr-20 p,1290,1209,81,6.3
44223,CN4603300000000,46,33,"Custer County, SD",Apr-20 p,4038,3507,531,13.2
44224,CN4603500000000,46,35,"Davison County, SD",Apr-20 p,11095,10134,961,8.7
44225,CN4603700000000,46,37,"Day County, SD",Apr-20 p,2797,2421,376,13.4
44226,CN4603900000000,46,39,"Deuel County, SD",Apr-20 p,2207,1943,264,12.0
44227,CN4604100000000,46,41,"Dewey County, SD",Apr-20 p,2139,1944,195,9.1
44228,CN4604300000000,46,43,"Douglas County, SD",Apr-20 p,1501,1437,64,4.3
44229,CN4604500000000,46,45,"Edmunds County, SD",Apr-20 p,1969,1880,89,4.5
44230,CN4604700000000,46,47,"Fall River County, SD",Apr-20 p,2999,2692,307,10.2
44231,CN4604900000000,46,49,"Faulk County, SD",Apr-20 p,1004,954,50,5.0
44232,CN4605100000000,46,51,"Grant County, SD",Apr-20 p,4438,4046,392,8.8
44233,CN4605300000000,46,53,"Gregory County, SD",Apr-20 p,1999,1858,141,7.1
44234,CN4605500000000,46,55,"Haakon County, SD",Apr-20 p,1005,961,44,4.4
44235,CN4605700000000,46,57,"Hamlin County, SD",Apr-20 p,3206,2961,245,7.6
44236,CN4605900000000,46,59,"Hand County, SD",Apr-20 p,1697,1616,81,4.8
44237,CN4606100000000,46,61,"Hanson County, SD",Apr-20 p,1719,1559,160,9.3
44238,CN4606300000000,46,63,"Harding County, SD",Apr-20 p,706,658,48,6.8
44239,CN4606500000000,46,65,"Hughes County, SD",Apr-20 p,9861,9099,762,7.7
44240,CN4606700000000,46,67,"Hutchinson County, SD",Apr-20 p,3529,3286,243,6.9
44241,CN4606900000000,46,69,"Hyde County, SD",Apr-20 p,646,621,25,3.9
44242,CN4607100000000,46,71,"Jackson County, SD",Apr-20 p,1179,1113,66,5.6
44243,CN4607300000000,46,73,"Jerauld County, SD",Apr-20 p,1067,1017,50,4.7
44244,CN4607500000000,46,75,"Jones County, SD",Apr-20 p,513,480,33,6.4
44245,CN4607700000000,46,77,"Kingsbury County, SD",Apr-20 p,2649,2466,183,6.9
44246,CN4607900000000,46,79,"Lake County, SD",Apr-20 p,6658,6191,467,7.0
44247,CN4608100000000,46,81,"Lawrence County, SD",Apr-20 p,15310,11981,3329,21.7
44248,CN4608300000000,46,83,"Lincoln County, SD",Apr-20 p,34234,31107,3127,9.1
44249,CN4608500000000,46,85,"Lyman County, SD",Apr-20 p,1643,1477,166,10.1
44250,CN4608700000000,46,87,"McCook County, SD",Apr-20 p,3011,2776,235,7.8
44251,CN4608900000000,46,89,"McPherson County, SD",Apr-20 p,995,900,95,9.5
44252,CN4609100000000,46,91,"Marshall County, SD",Apr-20 p,2364,2088,276,11.7
44253,CN4609300000000,46,93,"Meade County, SD",Apr-20 p,14229,12361,1868,13.1
44254,CN4609500000000,46,95,"Mellette County, SD",Apr-20 p,725,663,62,8.6
44255,CN4609700000000,46,97,"Miner County, SD",Apr-20 p,1144,1061,83,7.3
44256,CN4609900000000,46,99,"Minnehaha County, SD",Apr-20 p,114059,101322,12737,11.2
44257,CN4610100000000,46,101,"Moody County, SD",Apr-20 p,4116,3608,508,12.3
44258,CN4610200000000,46,102,"Oglala Lakota County, SD",Apr-20 p,3412,3049,363,10.6
44259,CN4610300000000,46,103,"Pennington County, SD",Apr-20 p,57504,49483,8021,13.9
44260,CN4610500000000,46,105,"Perkins County, SD",Apr-20 p,1373,1305,68,5.0
44261,CN4610700000000,46,107,"Potter County, SD",Apr-20 p,992,938,54,5.4
44262,CN4610900000000,46,109,"Roberts County, SD",Apr-20 p,5194,4291,903,17.4
44263,CN4611100000000,46,111,"Sanborn County, SD",Apr-20 p,1134,1047,87,7.7
44264,CN4611500000000,46,115,"Spink County, SD",Apr-20 p,3135,2886,249,7.9
44265,CN4611700000000,46,117,"Stanley County, SD",Apr-20 p,1845,1673,172,9.3
44266,CN4611900000000,46,119,"Sully County, SD",Apr-20 p,767,726,41,5.3
44267,CN4612100000000,46,121,"Todd County, SD",Apr-20 p,3114,2840,274,8.8
44268,CN4612300000000,46,123,"Tripp County, SD",Apr-20 p,2940,2780,160,5.4
44269,CN4612500000000,46,125,"Turner County, SD",Apr-20 p,4632,4258,374,8.1
44270,CN4612700000000,46,127,"Union County, SD",Apr-20 p,8564,7522,1042,12.2
44271,CN4612900000000,46,129,"Walworth County, SD",Apr-20 p,2090,1856,234,11.2
44272,CN4613500000000,46,135,"Yankton County, SD",Apr-20 p,12495,11038,1457,11.7
44273,CN4613700000000,46,137,"Ziebach County, SD",Apr-20 p,878,832,46,5.2
44274,CN4700100000000,47,1,"Anderson County, TN",Apr-20 p,33802,28779,5023,14.9
44275,CN4700300000000,47,3,"Bedford County, TN",Apr-20 p,21741,17673,4068,18.7
44276,CN4700500000000,47,5,"Benton County, TN",Apr-20 p,6825,5818,1007,14.8
44277,CN4700700000000,47,7,"Bledsoe County, TN",Apr-20 p,4407,3671,736,16.7
44278,CN4700900000000,47,9,"Blount County, TN",Apr-20 p,61980,53036,8944,14.4
44279,CN4701100000000,47,11,"Bradley County, TN",Apr-20 p,50091,43304,6787,13.5
44280,CN4701300000000,47,13,"Campbell County, TN",Apr-20 p,14678,12212,2466,16.8
44281,CN4701500000000,47,15,"Cannon County, TN",Apr-20 p,6426,5383,1043,16.2
44282,CN4701700000000,47,17,"Carroll County, TN",Apr-20 p,11538,9934,1604,13.9
44283,CN4701900000000,47,19,"Carter County, TN",Apr-20 p,22958,20061,2897,12.6
44284,CN4702100000000,47,21,"Cheatham County, TN",Apr-20 p,20317,17952,2365,11.6
44285,CN4702300000000,47,23,"Chester County, TN",Apr-20 p,7490,6666,824,11.0
44286,CN4702500000000,47,25,"Claiborne County, TN",Apr-20 p,12870,10928,1942,15.1
44287,CN4702700000000,47,27,"Clay County, TN",Apr-20 p,2652,2288,364,13.7
44288,CN4702900000000,47,29,"Cocke County, TN",Apr-20 p,16129,12006,4123,25.6
44289,CN4703100000000,47,31,"Coffee County, TN",Apr-20 p,26777,21483,5294,19.8
44290,CN4703300000000,47,33,"Crockett County, TN",Apr-20 p,6159,5502,657,10.7
44291,CN4703500000000,47,35,"Cumberland County, TN",Apr-20 p,22686,19795,2891,12.7
44292,CN4703700000000,47,37,"Davidson County, TN",Apr-20 p,393655,331041,62614,15.9
44293,CN4703900000000,47,39,"Decatur County, TN",Apr-20 p,4457,3787,670,15.0
44294,CN4704100000000,47,41,"DeKalb County, TN",Apr-20 p,7793,6047,1746,22.4
44295,CN4704300000000,47,43,"Dickson County, TN",Apr-20 p,25650,22052,3598,14.0
44296,CN4704500000000,47,45,"Dyer County, TN",Apr-20 p,16132,13792,2340,14.5
44297,CN4704700000000,47,47,"Fayette County, TN",Apr-20 p,17538,15895,1643,9.4
44298,CN4704900000000,47,49,"Fentress County, TN",Apr-20 p,7280,6547,733,10.1
44299,CN4705100000000,47,51,"Franklin County, TN",Apr-20 p,21715,17128,4587,21.1
44300,CN4705300000000,47,53,"Gibson County, TN",Apr-20 p,21138,18584,2554,12.1
44301,CN4705500000000,47,55,"Giles County, TN",Apr-20 p,15401,12371,3030,19.7
44302,CN4705700000000,47,57,"Grainger County, TN",Apr-20 p,9228,7896,1332,14.4
44303,CN4705900000000,47,59,"Greene County, TN",Apr-20 p,29951,24842,5109,17.1
44304,CN4706100000000,47,61,"Grundy County, TN",Apr-20 p,5731,4281,1450,25.3
44305,CN4706300000000,47,63,"Hamblen County, TN",Apr-20 p,27728,23506,4222,15.2
44306,CN4706500000000,47,65,"Hamilton County, TN",Apr-20 p,184295,157832,26463,14.4
44307,CN4706700000000,47,67,"Hancock County, TN",Apr-20 p,2064,1804,260,12.6
44308,CN4706900000000,47,69,"Hardeman County, TN",Apr-20 p,8935,8064,871,9.7
44309,CN4707100000000,47,71,"Hardin County, TN",Apr-20 p,10263,9115,1148,11.2
44310,CN4707300000000,47,73,"Hawkins County, TN",Apr-20 p,23284,19674,3610,15.5
44311,CN4707500000000,47,75,"Haywood County, TN",Apr-20 p,7381,6450,931,12.6
44312,CN4707700000000,47,77,"Henderson County, TN",Apr-20 p,12082,10143,1939,16.0
44313,CN4707900000000,47,79,"Henry County, TN",Apr-20 p,14001,11938,2063,14.7
44314,CN4708100000000,47,81,"Hickman County, TN",Apr-20 p,10690,9348,1342,12.6
44315,CN4708300000000,47,83,"Houston County, TN",Apr-20 p,3178,2747,431,13.6
44316,CN4708500000000,47,85,"Humphreys County, TN",Apr-20 p,8633,7599,1034,12.0
44317,CN4708700000000,47,87,"Jackson County, TN",Apr-20 p,4725,3919,806,17.1
44318,CN4708900000000,47,89,"Jefferson County, TN",Apr-20 p,24920,20569,4351,17.5
44319,CN4709100000000,47,91,"Johnson County, TN",Apr-20 p,7496,6622,874,11.7
44320,CN4709300000000,47,93,"Knox County, TN",Apr-20 p,234458,204138,30320,12.9
44321,CN4709500000000,47,95,"Lake County, TN",Apr-20 p,1716,1484,232,13.5
44322,CN4709700000000,47,97,"Lauderdale County, TN",Apr-20 p,9469,8149,1320,13.9
44323,CN4709900000000,47,99,"Lawrence County, TN",Apr-20 p,19809,16113,3696,18.7
44324,CN4710100000000,47,101,"Lewis County, TN",Apr-20 p,5356,4285,1071,20.0
44325,CN4710300000000,47,103,"Lincoln County, TN",Apr-20 p,16042,13358,2684,16.7
44326,CN4710500000000,47,105,"Loudon County, TN",Apr-20 p,23106,19599,3507,15.2
44327,CN4710700000000,47,107,"McMinn County, TN",Apr-20 p,24495,20268,4227,17.3
44328,CN4710900000000,47,109,"McNairy County, TN",Apr-20 p,8269,7237,1032,12.5
44329,CN4711100000000,47,111,"Macon County, TN",Apr-20 p,10759,9260,1499,13.9
44330,CN4711300000000,47,113,"Madison County, TN",Apr-20 p,44467,38017,6450,14.5
44331,CN4711500000000,47,115,"Marion County, TN",Apr-20 p,12426,10607,1819,14.6
44332,CN4711700000000,47,117,"Marshall County, TN",Apr-20 p,16774,12755,4019,24.0
44333,CN4711900000000,47,119,"Maury County, TN",Apr-20 p,51657,40283,11374,22.0
44334,CN4712100000000,47,121,"Meigs County, TN",Apr-20 p,5357,4362,995,18.6
44335,CN4712300000000,47,123,"Monroe County, TN",Apr-20 p,21381,16708,4673,21.9
44336,CN4712500000000,47,125,"Montgomery County, TN",Apr-20 p,83065,70297,12768,15.4
44337,CN4712700000000,47,127,"Moore County, TN",Apr-20 p,3621,3171,450,12.4
44338,CN4712900000000,47,129,"Morgan County, TN",Apr-20 p,7311,6526,785,10.7
44339,CN4713100000000,47,131,"Obion County, TN",Apr-20 p,12248,10988,1260,10.3
44340,CN4713300000000,47,133,"Overton County, TN",Apr-20 p,9784,8451,1333,13.6
44341,CN4713500000000,47,135,"Perry County, TN",Apr-20 p,2982,2286,696,23.3
44342,CN4713700000000,47,137,"Pickett County, TN",Apr-20 p,2231,1992,239,10.7
44343,CN4713900000000,47,139,"Polk County, TN",Apr-20 p,7185,6224,961,13.4
44344,CN4714100000000,47,141,"Putnam County, TN",Apr-20 p,34989,29863,5126,14.7
44345,CN4714300000000,47,143,"Rhea County, TN",Apr-20 p,14056,10618,3438,24.5
44346,CN4714500000000,47,145,"Roane County, TN",Apr-20 p,21989,19360,2629,12.0
44347,CN4714700000000,47,147,"Robertson County, TN",Apr-20 p,35755,31108,4647,13.0
44348,CN4714900000000,47,149,"Rutherford County, TN",Apr-20 p,180933,150670,30263,16.7
44349,CN4715100000000,47,151,"Scott County, TN",Apr-20 p,8506,7016,1490,17.5
44350,CN4715300000000,47,153,"Sequatchie County, TN",Apr-20 p,6324,5268,1056,16.7
44351,CN4715500000000,47,155,"Sevier County, TN",Apr-20 p,57367,40432,16935,29.5
44352,CN4715700000000,47,157,"Shelby County, TN",Apr-20 p,420621,366297,54324,12.9
44353,CN4715900000000,47,159,"Smith County, TN",Apr-20 p,9026,7733,1293,14.3
44354,CN4716100000000,47,161,"Stewart County, TN",Apr-20 p,5272,4674,598,11.3
44355,CN4716300000000,47,163,"Sullivan County, TN",Apr-20 p,68349,58456,9893,14.5
44356,CN4716500000000,47,165,"Sumner County, TN",Apr-20 p,98366,83781,14585,14.8
44357,CN4716700000000,47,167,"Tipton County, TN",Apr-20 p,26026,23233,2793,10.7
44358,CN4716900000000,47,169,"Trousdale County, TN",Apr-20 p,5049,4431,618,12.2
44359,CN4717100000000,47,171,"Unicoi County, TN",Apr-20 p,6794,5898,896,13.2
44360,CN4717300000000,47,173,"Union County, TN",Apr-20 p,7254,6316,938,12.9
44361,CN4717500000000,47,175,"Van Buren County, TN",Apr-20 p,2103,1680,423,20.1
44362,CN4717700000000,47,177,"Warren County, TN",Apr-20 p,17496,13253,4243,24.3
44363,CN4717900000000,47,179,"Washington County, TN",Apr-20 p,58602,50754,7848,13.4
44364,CN4718100000000,47,181,"Wayne County, TN",Apr-20 p,6139,5349,790,12.9
44365,CN4718300000000,47,183,"Weakley County, TN",Apr-20 p,14661,13255,1406,9.6
44366,CN4718500000000,47,185,"White County, TN",Apr-20 p,12126,10076,2050,16.9
44367,CN4718700000000,47,187,"Williamson County, TN",Apr-20 p,117675,105441,12234,10.4
44368,CN4718900000000,47,189,"Wilson County, TN",Apr-20 p,72917,62726,10191,14.0
44369,CN4800100000000,48,1,"Anderson County, TX",Apr-20 p,20916,19295,1621,7.8
44370,CN4800300000000,48,3,"Andrews County, TX",Apr-20 p,8911,7954,957,10.7
44371,CN4800500000000,48,5,"Angelina County, TX",Apr-20 p,32356,28530,3826,11.8
44372,CN4800700000000,48,7,"Aransas County, TX",Apr-20 p,8377,7137,1240,14.8
44373,CN4800900000000,48,9,"Archer County, TX",Apr-20 p,3574,3267,307,8.6
44374,CN4801100000000,48,11,"Armstrong County, TX",Apr-20 p,820,766,54,6.6
44375,CN4801300000000,48,13,"Atascosa County, TX",Apr-20 p,19952,17366,2586,13.0
44376,CN4801500000000,48,15,"Austin County, TX",Apr-20 p,12542,11340,1202,9.6
44377,CN4801700000000,48,17,"Bailey County, TX",Apr-20 p,2096,1961,135,6.4
44378,CN4801900000000,48,19,"Bandera County, TX",Apr-20 p,8895,8059,836,9.4
44379,CN4802100000000,48,21,"Bastrop County, TX",Apr-20 p,38520,34396,4124,10.7
44380,CN4802300000000,48,23,"Baylor County, TX",Apr-20 p,1523,1459,64,4.2
44381,CN4802500000000,48,25,"Bee County, TX",Apr-20 p,8939,7781,1158,13.0
44382,CN4802700000000,48,27,"Bell County, TX",Apr-20 p,132527,117177,15350,11.6
44383,CN4802900000000,48,29,"Bexar County, TX",Apr-20 p,884673,763079,121594,13.7
44384,CN4803100000000,48,31,"Blanco County, TX",Apr-20 p,5657,5270,387,6.8
44385,CN4803300000000,48,33,"Borden County, TX",Apr-20 p,358,344,14,3.9
44386,CN4803500000000,48,35,"Bosque County, TX",Apr-20 p,7268,6634,634,8.7
44387,CN4803700000000,48,37,"Bowie County, TX",Apr-20 p,36181,31044,5137,14.2
44388,CN4803900000000,48,39,"Brazoria County, TX",Apr-20 p,165699,143372,22327,13.5
44389,CN4804100000000,48,41,"Brazos County, TX",Apr-20 p,108557,98914,9643,8.9
44390,CN4804300000000,48,43,"Brewster County, TX",Apr-20 p,3872,3399,473,12.2
44391,CN4804500000000,48,45,"Briscoe County, TX",Apr-20 p,493,463,30,6.1
44392,CN4804700000000,48,47,"Brooks County, TX",Apr-20 p,2392,2077,315,13.2
44393,CN4804900000000,48,49,"Brown County, TX",Apr-20 p,13533,12165,1368,10.1
44394,CN4805100000000,48,51,"Burleson County, TX",Apr-20 p,7566,6905,661,8.7
44395,CN4805300000000,48,53,"Burnet County, TX",Apr-20 p,20624,18788,1836,8.9
44396,CN4805500000000,48,55,"Caldwell County, TX",Apr-20 p,17549,15715,1834,10.5
44397,CN4805700000000,48,57,"Calhoun County, TX",Apr-20 p,10900,9929,971,8.9
44398,CN4805900000000,48,59,"Callahan County, TX",Apr-20 p,5399,4983,416,7.7
44399,CN4806100000000,48,61,"Cameron County, TX",Apr-20 p,155287,128710,26577,17.1
44400,CN4806300000000,48,63,"Camp County, TX",Apr-20 p,4437,3975,462,10.4
44401,CN4806500000000,48,65,"Carson County, TX",Apr-20 p,2658,2486,172,6.5
44402,CN4806700000000,48,67,"Cass County, TX",Apr-20 p,11223,9862,1361,12.1
44403,CN4806900000000,48,69,"Castro County, TX",Apr-20 p,2916,2798,118,4.0
44404,CN4807100000000,48,71,"Chambers County, TX",Apr-20 p,18256,15495,2761,15.1
44405,CN4807300000000,48,73,"Cherokee County, TX",Apr-20 p,19102,16653,2449,12.8
44406,CN4807500000000,48,75,"Childress County, TX",Apr-20 p,2486,2346,140,5.6
44407,CN4807700000000,48,77,"Clay County, TX",Apr-20 p,4276,3892,384,9.0
44408,CN4807900000000,48,79,"Cochran County, TX",Apr-20 p,1003,904,99,9.9
44409,CN4808100000000,48,81,"Coke County, TX",Apr-20 p,1246,1154,92,7.4
44410,CN4808300000000,48,83,"Coleman County, TX",Apr-20 p,2532,2239,293,11.6
44411,CN4808500000000,48,85,"Collin County, TX",Apr-20 p,524670,460662,64008,12.2
44412,CN4808700000000,48,87,"Collingsworth County, TX",Apr-20 p,946,895,51,5.4
44413,CN4808900000000,48,89,"Colorado County, TX",Apr-20 p,8487,7866,621,7.3
44414,CN4809100000000,48,91,"Comal County, TX",Apr-20 p,66789,58843,7946,11.9
44415,CN4809300000000,48,93,"Comanche County, TX",Apr-20 p,4833,4499,334,6.9
44416,CN4809500000000,48,95,"Concho County, TX",Apr-20 p,1175,1103,72,6.1
44417,CN4809700000000,48,97,"Cooke County, TX",Apr-20 p,18736,16112,2624,14.0
44418,CN4809900000000,48,99,"Coryell County, TX",Apr-20 p,21948,19620,2328,10.6
44419,CN4810100000000,48,101,"Cottle County, TX",Apr-20 p,450,420,30,6.7
44420,CN4810300000000,48,103,"Crane County, TX",Apr-20 p,1459,1190,269,18.4
44421,CN4810500000000,48,105,"Crockett County, TX",Apr-20 p,1471,1302,169,11.5
44422,CN4810700000000,48,107,"Crosby County, TX",Apr-20 p,2168,2014,154,7.1
44423,CN4810900000000,48,109,"Culberson County, TX",Apr-20 p,892,800,92,10.3
44424,CN4811100000000,48,111,"Dallam County, TX",Apr-20 p,3226,3116,110,3.4
44425,CN4811300000000,48,113,"Dallas County, TX",Apr-20 p,1274059,1109777,164282,12.9
44426,CN4811500000000,48,115,"Dawson County, TX",Apr-20 p,4170,3727,443,10.6
44427,CN4811700000000,48,117,"Deaf Smith County, TX",Apr-20 p,7282,6938,344,4.7
44428,CN4811900000000,48,119,"Delta County, TX",Apr-20 p,2143,1955,188,8.8
44429,CN4812100000000,48,121,"Denton County, TX",Apr-20 p,464928,405095,59833,12.9
44430,CN4812300000000,48,123,"DeWitt County, TX",Apr-20 p,8637,7971,666,7.7
44431,CN4812500000000,48,125,"Dickens County, TX",Apr-20 p,592,538,54,9.1
44432,CN4812700000000,48,127,"Dimmit County, TX",Apr-20 p,6316,5856,460,7.3
44433,CN4812900000000,48,129,"Donley County, TX",Apr-20 p,1152,1087,65,5.6
44434,CN4813100000000,48,131,"Duval County, TX",Apr-20 p,4535,3836,699,15.4
44435,CN4813300000000,48,133,"Eastland County, TX",Apr-20 p,6754,6147,607,9.0
44436,CN4813500000000,48,135,"Ector County, TX",Apr-20 p,79055,68405,10650,13.5
44437,CN4813700000000,48,137,"Edwards County, TX",Apr-20 p,949,916,33,3.5
44438,CN4813900000000,48,139,"Ellis County, TX",Apr-20 p,84894,75681,9213,10.9
44439,CN4814100000000,48,141,"El Paso County, TX",Apr-20 p,333526,284198,49328,14.8
44440,CN4814300000000,48,143,"Erath County, TX",Apr-20 p,18380,16780,1600,8.7
44441,CN4814500000000,48,145,"Falls County, TX",Apr-20 p,5841,5316,525,9.0
44442,CN4814700000000,48,147,"Fannin County, TX",Apr-20 p,15552,14377,1175,7.6
44443,CN4814900000000,48,149,"Fayette County, TX",Apr-20 p,10318,9587,731,7.1
44444,CN4815100000000,48,151,"Fisher County, TX",Apr-20 p,1356,1289,67,4.9
44445,CN4815300000000,48,153,"Floyd County, TX",Apr-20 p,2234,2051,183,8.2
44446,CN4815500000000,48,155,"Foard County, TX",Apr-20 p,515,477,38,7.4
44447,CN4815700000000,48,157,"Fort Bend County, TX",Apr-20 p,361957,315105,46852,12.9
44448,CN4815900000000,48,159,"Franklin County, TX",Apr-20 p,4084,3726,358,8.8
44449,CN4816100000000,48,161,"Freestone County, TX",Apr-20 p,5582,4964,618,11.1
44450,CN4816300000000,48,163,"Frio County, TX",Apr-20 p,9021,8435,586,6.5
44451,CN4816500000000,48,165,"Gaines County, TX",Apr-20 p,8538,7930,608,7.1
44452,CN4816700000000,48,167,"Galveston County, TX",Apr-20 p,156686,132203,24483,15.6
44453,CN4816900000000,48,169,"Garza County, TX",Apr-20 p,1874,1718,156,8.3
44454,CN4817100000000,48,171,"Gillespie County, TX",Apr-20 p,12001,10756,1245,10.4
44455,CN4817300000000,48,173,"Glasscock County, TX",Apr-20 p,682,649,33,4.8
44456,CN4817500000000,48,175,"Goliad County, TX",Apr-20 p,2825,2518,307,10.9
44457,CN4817700000000,48,177,"Gonzales County, TX",Apr-20 p,8341,7734,607,7.3
44458,CN4817900000000,48,179,"Gray County, TX",Apr-20 p,7149,6415,734,10.3
44459,CN4818100000000,48,181,"Grayson County, TX",Apr-20 p,58740,52525,6215,10.6
44460,CN4818300000000,48,183,"Gregg County, TX",Apr-20 p,53012,46006,7006,13.2
44461,CN4818500000000,48,185,"Grimes County, TX",Apr-20 p,10087,8985,1102,10.9
44462,CN4818700000000,48,187,"Guadalupe County, TX",Apr-20 p,73753,65715,8038,10.9
44463,CN4818900000000,48,189,"Hale County, TX",Apr-20 p,10457,9502,955,9.1
44464,CN4819100000000,48,191,"Hall County, TX",Apr-20 p,910,835,75,8.2
44465,CN4819300000000,48,193,"Hamilton County, TX",Apr-20 p,3131,2916,215,6.9
44466,CN4819500000000,48,195,"Hansford County, TX",Apr-20 p,2250,2174,76,3.4
44467,CN4819700000000,48,197,"Hardeman County, TX",Apr-20 p,1478,1398,80,5.4
44468,CN4819900000000,48,199,"Hardin County, TX",Apr-20 p,23269,19595,3674,15.8
44469,CN4820100000000,48,201,"Harris County, TX",Apr-20 p,2165453,1852552,312901,14.4
44470,CN4820300000000,48,203,"Harrison County, TX",Apr-20 p,26058,23029,3029,11.6
44471,CN4820500000000,48,205,"Hartley County, TX",Apr-20 p,2316,2255,61,2.6
44472,CN4820700000000,48,207,"Haskell County, TX",Apr-20 p,1950,1816,134,6.9
44473,CN4820900000000,48,209,"Hays County, TX",Apr-20 p,110437,96335,14102,12.8
44474,CN4821100000000,48,211,"Hemphill County, TX",Apr-20 p,1554,1460,94,6.0
44475,CN4821300000000,48,213,"Henderson County, TX",Apr-20 p,32783,29476,3307,10.1
44476,CN4821500000000,48,215,"Hidalgo County, TX",Apr-20 p,338467,276811,61656,18.2
44477,CN4821700000000,48,217,"Hill County, TX",Apr-20 p,14595,13113,1482,10.2
44478,CN4821900000000,48,219,"Hockley County, TX",Apr-20 p,10092,8920,1172,11.6
44479,CN4822100000000,48,221,"Hood County, TX",Apr-20 p,24627,21915,2712,11.0
44480,CN4822300000000,48,223,"Hopkins County, TX",Apr-20 p,15413,14112,1301,8.4
44481,CN4822500000000,48,225,"Houston County, TX",Apr-20 p,8760,8171,589,6.7
44482,CN4822700000000,48,227,"Howard County, TX",Apr-20 p,12594,11285,1309,10.4
44483,CN4822900000000,48,229,"Hudspeth County, TX",Apr-20 p,1645,1448,197,12.0
44484,CN4823100000000,48,231,"Hunt County, TX",Apr-20 p,39660,35268,4392,11.1
44485,CN4823300000000,48,233,"Hutchinson County, TX",Apr-20 p,7590,6776,814,10.7
44486,CN4823500000000,48,235,"Irion County, TX",Apr-20 p,647,601,46,7.1
44487,CN4823700000000,48,237,"Jack County, TX",Apr-20 p,2932,2636,296,10.1
44488,CN4823900000000,48,239,"Jackson County, TX",Apr-20 p,6619,6089,530,8.0
44489,CN4824100000000,48,241,"Jasper County, TX",Apr-20 p,11906,9845,2061,17.3
44490,CN4824300000000,48,243,"Jeff Davis County, TX",Apr-20 p,872,800,72,8.3
44491,CN4824500000000,48,245,"Jefferson County, TX",Apr-20 p,100715,81681,19034,18.9
44492,CN4824700000000,48,247,"Jim Hogg County, TX",Apr-20 p,1592,1396,196,12.3
44493,CN4824900000000,48,249,"Jim Wells County, TX",Apr-20 p,15703,13087,2616,16.7
44494,CN4825100000000,48,251,"Johnson County, TX",Apr-20 p,74413,65652,8761,11.8
44495,CN4825300000000,48,253,"Jones County, TX",Apr-20 p,5157,4670,487,9.4
44496,CN4825500000000,48,255,"Karnes County, TX",Apr-20 p,6390,5925,465,7.3
44497,CN4825700000000,48,257,"Kaufman County, TX",Apr-20 p,59641,52754,6887,11.5
44498,CN4825900000000,48,259,"Kendall County, TX",Apr-20 p,19655,17814,1841,9.4
44499,CN4826100000000,48,261,"Kenedy County, TX",Apr-20 p,171,160,11,6.4
44500,CN4826300000000,48,263,"Kent County, TX",Apr-20 p,409,388,21,5.1
44501,CN4826500000000,48,265,"Kerr County, TX",Apr-20 p,20014,17748,2266,11.3
44502,CN4826700000000,48,267,"Kimble County, TX",Apr-20 p,1547,1461,86,5.6
44503,CN4826900000000,48,269,"King County, TX",Apr-20 p,203,198,5,2.5
44504,CN4827100000000,48,271,"Kinney County, TX",Apr-20 p,1193,1107,86,7.2
44505,CN4827300000000,48,273,"Kleberg County, TX",Apr-20 p,12218,10683,1535,12.6
44506,CN4827500000000,48,275,"Knox County, TX",Apr-20 p,1241,1153,88,7.1
44507,CN4827700000000,48,277,"Lamar County, TX",Apr-20 p,21929,19614,2315,10.6
44508,CN4827900000000,48,279,"Lamb County, TX",Apr-20 p,4603,4291,312,6.8
44509,CN4828100000000,48,281,"Lampasas County, TX",Apr-20 p,8199,7527,672,8.2
44510,CN4828300000000,48,283,"La Salle County, TX",Apr-20 p,3749,3446,303,8.1
44511,CN4828500000000,48,285,"Lavaca County, TX",Apr-20 p,7167,6642,525,7.3
44512,CN4828700000000,48,287,"Lee County, TX",Apr-20 p,8653,8029,624,7.2
44513,CN4828900000000,48,289,"Leon County, TX",Apr-20 p,5534,4959,575,10.4
44514,CN4829100000000,48,291,"Liberty County, TX",Apr-20 p,30911,26171,4740,15.3
44515,CN4829300000000,48,293,"Limestone County, TX",Apr-20 p,7523,6845,678,9.0
44516,CN4829500000000,48,295,"Lipscomb County, TX",Apr-20 p,1353,1281,72,5.3
44517,CN4829700000000,48,297,"Live Oak County, TX",Apr-20 p,4938,4481,457,9.3
44518,CN4829900000000,48,299,"Llano County, TX",Apr-20 p,7593,6881,712,9.4
44519,CN4830100000000,48,301,"Loving County, TX",Apr-20 p,602,594,8,1.3
44520,CN4830300000000,48,303,"Lubbock County, TX",Apr-20 p,140603,126550,14053,10.0
44521,CN4830500000000,48,305,"Lynn County, TX",Apr-20 p,2415,2251,164,6.8
44522,CN4830700000000,48,307,"McCulloch County, TX",Apr-20 p,2865,2567,298,10.4
44523,CN4830900000000,48,309,"McLennan County, TX",Apr-20 p,107527,96052,11475,10.7
44524,CN4831100000000,48,311,"McMullen County, TX",Apr-20 p,743,724,19,2.6
44525,CN4831300000000,48,313,"Madison County, TX",Apr-20 p,3930,3573,357,9.1
44526,CN4831500000000,48,315,"Marion County, TX",Apr-20 p,3780,3293,487,12.9
44527,CN4831700000000,48,317,"Martin County, TX",Apr-20 p,2433,2258,175,7.2
44528,CN4831900000000,48,319,"Mason County, TX",Apr-20 p,1502,1392,110,7.3
44529,CN4832100000000,48,321,"Matagorda County, TX",Apr-20 p,15477,13240,2237,14.5
44530,CN4832300000000,48,323,"Maverick County, TX",Apr-20 p,22568,18093,4475,19.8
44531,CN4832500000000,48,325,"Medina County, TX",Apr-20 p,19597,17573,2024,10.3
44532,CN4832700000000,48,327,"Menard County, TX",Apr-20 p,737,681,56,7.6
44533,CN4832900000000,48,329,"Midland County, TX",Apr-20 p,93005,83462,9543,10.3
44534,CN4833100000000,48,331,"Milam County, TX",Apr-20 p,8552,7603,949,11.1
44535,CN4833300000000,48,333,"Mills County, TX",Apr-20 p,1596,1518,78,4.9
44536,CN4833500000000,48,335,"Mitchell County, TX",Apr-20 p,2030,1841,189,9.3
44537,CN4833700000000,48,337,"Montague County, TX",Apr-20 p,8404,7445,959,11.4
44538,CN4833900000000,48,339,"Montgomery County, TX",Apr-20 p,262503,228008,34495,13.1
44539,CN4834100000000,48,341,"Moore County, TX",Apr-20 p,9177,8739,438,4.8
44540,CN4834300000000,48,343,"Morris County, TX",Apr-20 p,4377,3767,610,13.9
44541,CN4834500000000,48,345,"Motley County, TX",Apr-20 p,405,381,24,5.9
44542,CN4834700000000,48,347,"Nacogdoches County, TX",Apr-20 p,24716,22125,2591,10.5
44543,CN4834900000000,48,349,"Navarro County, TX",Apr-20 p,21299,19208,2091,9.8
44544,CN4835100000000,48,351,"Newton County, TX",Apr-20 p,4734,3951,783,16.5
44545,CN4835300000000,48,353,"Nolan County, TX",Apr-20 p,6179,5781,398,6.4
44546,CN4835500000000,48,355,"Nueces County, TX",Apr-20 p,150800,127021,23779,15.8
44547,CN4835700000000,48,357,"Ochiltree County, TX",Apr-20 p,3633,3348,285,7.8
44548,CN4835900000000,48,359,"Oldham County, TX",Apr-20 p,804,758,46,5.7
44549,CN4836100000000,48,361,"Orange County, TX",Apr-20 p,33934,27963,5971,17.6
44550,CN4836300000000,48,363,"Palo Pinto County, TX",Apr-20 p,12048,10774,1274,10.6
44551,CN4836500000000,48,365,"Panola County, TX",Apr-20 p,8899,7944,955,10.7
44552,CN4836700000000,48,367,"Parker County, TX",Apr-20 p,60279,53922,6357,10.5
44553,CN4836900000000,48,369,"Parmer County, TX",Apr-20 p,4051,3944,107,2.6
44554,CN4837100000000,48,371,"Pecos County, TX",Apr-20 p,5541,4992,549,9.9
44555,CN4837300000000,48,373,"Polk County, TX",Apr-20 p,16208,14256,1952,12.0
44556,CN4837500000000,48,375,"Potter County, TX",Apr-20 p,49749,45166,4583,9.2
44557,CN4837700000000,48,377,"Presidio County, TX",Apr-20 p,3025,2398,627,20.7
44558,CN4837900000000,48,379,"Rains County, TX",Apr-20 p,5379,4971,408,7.6
44559,CN4838100000000,48,381,"Randall County, TX",Apr-20 p,65008,59438,5570,8.6
44560,CN4838300000000,48,383,"Reagan County, TX",Apr-20 p,1729,1540,189,10.9
44561,CN4838500000000,48,385,"Real County, TX",Apr-20 p,866,785,81,9.4
44562,CN4838700000000,48,387,"Red River County, TX",Apr-20 p,4424,4026,398,9.0
44563,CN4838900000000,48,389,"Reeves County, TX",Apr-20 p,10700,10127,573,5.4
44564,CN4839100000000,48,391,"Refugio County, TX",Apr-20 p,2790,2473,317,11.4
44565,CN4839300000000,48,393,"Roberts County, TX",Apr-20 p,356,334,22,6.2
44566,CN4839500000000,48,395,"Robertson County, TX",Apr-20 p,6911,6309,602,8.7
44567,CN4839700000000,48,397,"Rockwall County, TX",Apr-20 p,48212,42513,5699,11.8
44568,CN4839900000000,48,399,"Runnels County, TX",Apr-20 p,3996,3687,309,7.7
44569,CN4840100000000,48,401,"Rusk County, TX",Apr-20 p,20319,18220,2099,10.3
44570,CN4840300000000,48,403,"Sabine County, TX",Apr-20 p,3409,2825,584,17.1
44571,CN4840500000000,48,405,"San Augustine County, TX",Apr-20 p,3118,2777,341,10.9
44572,CN4840700000000,48,407,"San Jacinto County, TX",Apr-20 p,10466,9283,1183,11.3
44573,CN4840900000000,48,409,"San Patricio County, TX",Apr-20 p,26950,22444,4506,16.7
44574,CN4841100000000,48,411,"San Saba County, TX",Apr-20 p,2154,2017,137,6.4
44575,CN4841300000000,48,413,"Schleicher County, TX",Apr-20 p,1081,993,88,8.1
44576,CN4841500000000,48,415,"Scurry County, TX",Apr-20 p,5828,5210,618,10.6
44577,CN4841700000000,48,417,"Shackelford County, TX",Apr-20 p,1608,1501,107,6.7
44578,CN4841900000000,48,419,"Shelby County, TX",Apr-20 p,9722,8853,869,8.9
44579,CN4842100000000,48,421,"Sherman County, TX",Apr-20 p,1175,1143,32,2.7
44580,CN4842300000000,48,423,"Smith County, TX",Apr-20 p,98894,86859,12035,12.2
44581,CN4842500000000,48,425,"Somervell County, TX",Apr-20 p,3872,3468,404,10.4
44582,CN4842700000000,48,427,"Starr County, TX",Apr-20 p,24458,18507,5951,24.3
44583,CN4842900000000,48,429,"Stephens County, TX",Apr-20 p,3444,3212,232,6.7
44584,CN4843100000000,48,431,"Sterling County, TX",Apr-20 p,509,469,40,7.9
44585,CN4843300000000,48,433,"Stonewall County, TX",Apr-20 p,478,451,27,5.6
44586,CN4843500000000,48,435,"Sutton County, TX",Apr-20 p,1164,1027,137,11.8
44587,CN4843700000000,48,437,"Swisher County, TX",Apr-20 p,2238,2076,162,7.2
44588,CN4843900000000,48,439,"Tarrant County, TX",Apr-20 p,997947,863704,134243,13.5
44589,CN4844100000000,48,441,"Taylor County, TX",Apr-20 p,60388,55012,5376,8.9
44590,CN4844300000000,48,443,"Terrell County, TX",Apr-20 p,310,294,16,5.2
44591,CN4844500000000,48,445,"Terry County, TX",Apr-20 p,4323,3909,414,9.6
44592,CN4844700000000,48,447,"Throckmorton County, TX",Apr-20 p,529,505,24,4.5
44593,CN4844900000000,48,449,"Titus County, TX",Apr-20 p,11639,10394,1245,10.7
44594,CN4845100000000,48,451,"Tom Green County, TX",Apr-20 p,47781,42716,5065,10.6
44595,CN4845300000000,48,453,"Travis County, TX",Apr-20 p,680114,595892,84222,12.4
44596,CN4845500000000,48,455,"Trinity County, TX",Apr-20 p,4710,4197,513,10.9
44597,CN4845700000000,48,457,"Tyler County, TX",Apr-20 p,6541,5568,973,14.9
44598,CN4845900000000,48,459,"Upshur County, TX",Apr-20 p,15986,14128,1858,11.6
44599,CN4846100000000,48,461,"Upton County, TX",Apr-20 p,1454,1346,108,7.4
44600,CN4846300000000,48,463,"Uvalde County, TX",Apr-20 p,10077,9031,1046,10.4
44601,CN4846500000000,48,465,"Val Verde County, TX",Apr-20 p,20548,17843,2705,13.2
44602,CN4846700000000,48,467,"Van Zandt County, TX",Apr-20 p,23414,21003,2411,10.3
44603,CN4846900000000,48,469,"Victoria County, TX",Apr-20 p,38453,32897,5556,14.4
44604,CN4847100000000,48,471,"Walker County, TX",Apr-20 p,21669,19260,2409,11.1
44605,CN4847300000000,48,473,"Waller County, TX",Apr-20 p,21418,18843,2575,12.0
44606,CN4847500000000,48,475,"Ward County, TX",Apr-20 p,7001,6361,640,9.1
44607,CN4847700000000,48,477,"Washington County, TX",Apr-20 p,13250,12221,1029,7.8
44608,CN4847900000000,48,479,"Webb County, TX",Apr-20 p,104251,90038,14213,13.6
44609,CN4848100000000,48,481,"Wharton County, TX",Apr-20 p,19317,17460,1857,9.6
44610,CN4848300000000,48,483,"Wheeler County, TX",Apr-20 p,1945,1810,135,6.9
44611,CN4848500000000,48,485,"Wichita County, TX",Apr-20 p,49866,44019,5847,11.7
44612,CN4848700000000,48,487,"Wilbarger County, TX",Apr-20 p,4280,3958,322,7.5
44613,CN4848900000000,48,489,"Willacy County, TX",Apr-20 p,6256,5167,1089,17.4
44614,CN4849100000000,48,491,"Williamson County, TX",Apr-20 p,286258,252451,33807,11.8
44615,CN4849300000000,48,493,"Wilson County, TX",Apr-20 p,21994,20056,1938,8.8
44616,CN4849500000000,48,495,"Winkler County, TX",Apr-20 p,3491,3083,408,11.7
44617,CN4849700000000,48,497,"Wise County, TX",Apr-20 p,28790,25473,3317,11.5
44618,CN4849900000000,48,499,"Wood County, TX",Apr-20 p,15823,14161,1662,10.5
44619,CN4850100000000,48,501,"Yoakum County, TX",Apr-20 p,3614,3012,602,16.7
44620,CN4850300000000,48,503,"Young County, TX",Apr-20 p,6962,6378,584,8.4
44621,CN4850500000000,48,505,"Zapata County, TX",Apr-20 p,4236,3663,573,13.5
44622,CN4850700000000,48,507,"Zavala County, TX",Apr-20 p,2940,2422,518,17.6
44623,CN4900100000000,49,1,"Beaver County, UT",Apr-20 p,2811,2630,181,6.4
44624,CN4900300000000,49,3,"Box Elder County, UT",Apr-20 p,26475,23730,2745,10.4
44625,CN4900500000000,49,5,"Cache County, UT",Apr-20 p,62744,58976,3768,6.0
44626,CN4900700000000,49,7,"Carbon County, UT",Apr-20 p,8374,7569,805,9.6
44627,CN4900900000000,49,9,"Daggett County, UT",Apr-20 p,369,336,33,8.9
44628,CN4901100000000,49,11,"Davis County, UT",Apr-20 p,174197,158705,15492,8.9
44629,CN4901300000000,49,13,"Duchesne County, UT",Apr-20 p,7890,6890,1000,12.7
44630,CN4901500000000,49,15,"Emery County, UT",Apr-20 p,4231,3873,358,8.5
44631,CN4901700000000,49,17,"Garfield County, UT",Apr-20 p,2869,2182,687,23.9
44632,CN4901900000000,49,19,"Grand County, UT",Apr-20 p,6790,4961,1829,26.9
44633,CN4902100000000,49,21,"Iron County, UT",Apr-20 p,23356,21201,2155,9.2
44634,CN4902300000000,49,23,"Juab County, UT",Apr-20 p,5483,5175,308,5.6
44635,CN4902500000000,49,25,"Kane County, UT",Apr-20 p,3566,3023,543,15.2
44636,CN4902700000000,49,27,"Millard County, UT",Apr-20 p,5817,5487,330,5.7
44637,CN4902900000000,49,29,"Morgan County, UT",Apr-20 p,5510,5085,425,7.7
44638,CN4903100000000,49,31,"Piute County, UT",Apr-20 p,482,432,50,10.4
44639,CN4903300000000,49,33,"Rich County, UT",Apr-20 p,992,920,72,7.3
44640,CN4903500000000,49,35,"Salt Lake County, UT",Apr-20 p,630366,559768,70598,11.2
44641,CN4903700000000,49,37,"San Juan County, UT",Apr-20 p,5883,4908,975,16.6
44642,CN4903900000000,49,39,"Sanpete County, UT",Apr-20 p,12251,11524,727,5.9
44643,CN4904100000000,49,41,"Sevier County, UT",Apr-20 p,9513,8738,775,8.1
44644,CN4904300000000,49,43,"Summit County, UT",Apr-20 p,24094,19211,4883,20.3
44645,CN4904500000000,49,45,"Tooele County, UT",Apr-20 p,33340,29910,3430,10.3
44646,CN4904700000000,49,47,"Uintah County, UT",Apr-20 p,14100,11863,2237,15.9
44647,CN4904900000000,49,49,"Utah County, UT",Apr-20 p,301899,278334,23565,7.8
44648,CN4905100000000,49,51,"Wasatch County, UT",Apr-20 p,16099,13287,2812,17.5
44649,CN4905300000000,49,53,"Washington County, UT",Apr-20 p,75471,66189,9282,12.3
44650,CN4905500000000,49,55,"Wayne County, UT",Apr-20 p,1420,1192,228,16.1
44651,CN4905700000000,49,57,"Weber County, UT",Apr-20 p,129915,116043,13872,10.7
44652,CN5000100000000,50,1,"Addison County, VT",Apr-20 p,20688,17539,3149,15.2
44653,CN5000300000000,50,3,"Bennington County, VT",Apr-20 p,18223,14785,3438,18.9
44654,CN5000500000000,50,5,"Caledonia County, VT",Apr-20 p,14567,11946,2621,18.0
44655,CN5000700000000,50,7,"Chittenden County, VT",Apr-20 p,95580,82194,13386,14.0
44656,CN5000900000000,50,9,"Essex County, VT",Apr-20 p,2798,2220,578,20.7
44657,CN5001100000000,50,11,"Franklin County, VT",Apr-20 p,27439,23116,4323,15.8
44658,CN5001300000000,50,13,"Grand Isle County, VT",Apr-20 p,4114,3406,708,17.2
44659,CN5001500000000,50,15,"Lamoille County, VT",Apr-20 p,15356,11450,3906,25.4
44660,CN5001700000000,50,17,"Orange County, VT",Apr-20 p,15987,13675,2312,14.5
44661,CN5001900000000,50,19,"Orleans County, VT",Apr-20 p,14007,10650,3357,24.0
44662,CN5002100000000,50,21,"Rutland County, VT",Apr-20 p,32122,25229,6893,21.5
44663,CN5002300000000,50,23,"Washington County, VT",Apr-20 p,35397,30073,5324,15.0
44664,CN5002500000000,50,25,"Windham County, VT",Apr-20 p,22532,18494,4038,17.9
44665,CN5002700000000,50,27,"Windsor County, VT",Apr-20 p,29107,24647,4460,15.3
44666,CN5100100000000,51,1,"Accomack County, VA",Apr-20 p,16475,14868,1607,9.8
44667,CN5100300000000,51,3,"Albemarle County, VA",Apr-20 p,56442,51319,5123,9.1
44668,CN5100500000000,51,5,"Alleghany County, VA",Apr-20 p,6982,6177,805,11.5
44669,CN5100700000000,51,7,"Amelia County, VA",Apr-20 p,6018,5426,592,9.8
44670,CN5100900000000,51,9,"Amherst County, VA",Apr-20 p,13968,12634,1334,9.6
44671,CN5101100000000,51,11,"Appomattox County, VA",Apr-20 p,6631,6006,625,9.4
44672,CN5101300000000,51,13,"Arlington County, VA",Apr-20 p,147504,137176,10328,7.0
44673,CN5101500000000,51,15,"Augusta County, VA",Apr-20 p,37857,34682,3175,8.4
44674,CN5101700000000,51,17,"Bath County, VA",Apr-20 p,2859,2274,585,20.5
44675,CN5101900000000,51,19,"Bedford County, VA",Apr-20 p,35950,32390,3560,9.9
44676,CN5102100000000,51,21,"Bland County, VA",Apr-20 p,2873,2544,329,11.5
44677,CN5102300000000,51,23,"Botetourt County, VA",Apr-20 p,16497,15075,1422,8.6
44678,CN5102500000000,51,25,"Brunswick County, VA",Apr-20 p,5824,5219,605,10.4
44679,CN5102700000000,51,27,"Buchanan County, VA",Apr-20 p,6690,5747,943,14.1
44680,CN5102900000000,51,29,"Buckingham County, VA",Apr-20 p,6309,5662,647,10.3
44681,CN5103100000000,51,31,"Campbell County, VA",Apr-20 p,24313,21843,2470,10.2
44682,CN5103300000000,51,33,"Caroline County, VA",Apr-20 p,14812,13183,1629,11.0
44683,CN5103500000000,51,35,"Carroll County, VA",Apr-20 p,14183,11897,2286,16.1
44684,CN5103600000000,51,36,"Charles City County, VA",Apr-20 p,3527,3166,361,10.2
44685,CN5103700000000,51,37,"Charlotte County, VA",Apr-20 p,5113,4690,423,8.3
44686,CN5104100000000,51,41,"Chesterfield County, VA",Apr-20 p,182290,162869,19421,10.7
44687,CN5104300000000,51,43,"Clarke County, VA",Apr-20 p,7302,6705,597,8.2
44688,CN5104500000000,51,45,"Craig County, VA",Apr-20 p,2196,1975,221,10.1
44689,CN5104700000000,51,47,"Culpeper County, VA",Apr-20 p,23810,21646,2164,9.1
44690,CN5104900000000,51,49,"Cumberland County, VA",Apr-20 p,4535,4119,416,9.2
44691,CN5105100000000,51,51,"Dickenson County, VA",Apr-20 p,4836,4258,578,12.0
44692,CN5105300000000,51,53,"Dinwiddie County, VA",Apr-20 p,13032,11786,1246,9.6
44693,CN5105700000000,51,57,"Essex County, VA",Apr-20 p,5406,4805,601,11.1
44694,CN5105900000000,51,59,"Fairfax County, VA",Apr-20 p,625663,561807,63856,10.2
44695,CN5106100000000,51,61,"Fauquier County, VA",Apr-20 p,36071,32894,3177,8.8
44696,CN5106300000000,51,63,"Floyd County, VA",Apr-20 p,7805,6942,863,11.1
44697,CN5106500000000,51,65,"Fluvanna County, VA",Apr-20 p,13763,12498,1265,9.2
44698,CN5106700000000,51,67,"Franklin County, VA",Apr-20 p,25141,22742,2399,9.5
44699,CN5106900000000,51,69,"Frederick County, VA",Apr-20 p,46934,42469,4465,9.5
44700,CN5107100000000,51,71,"Giles County, VA",Apr-20 p,7621,6629,992,13.0
44701,CN5107300000000,51,73,"Gloucester County, VA",Apr-20 p,19040,17097,1943,10.2
44702,CN5107500000000,51,75,"Goochland County, VA",Apr-20 p,10671,9718,953,8.9
44703,CN5107700000000,51,77,"Grayson County, VA",Apr-20 p,8313,7414,899,10.8
44704,CN5107900000000,51,79,"Greene County, VA",Apr-20 p,10420,9417,1003,9.6
44705,CN5108100000000,51,81,"Greensville County, VA",Apr-20 p,4149,3800,349,8.4
44706,CN5108300000000,51,83,"Halifax County, VA",Apr-20 p,15483,13822,1661,10.7
44707,CN5108500000000,51,85,"Hanover County, VA",Apr-20 p,56755,51634,5121,9.0
44708,CN5108700000000,51,87,"Henrico County, VA",Apr-20 p,177712,158072,19640,11.1
44709,CN5108900000000,51,89,"Henry County, VA",Apr-20 p,24386,21257,3129,12.8
44710,CN5109100000000,51,91,"Highland County, VA",Apr-20 p,1145,1073,72,6.3
44711,CN5109300000000,51,93,"Isle of Wight County, VA",Apr-20 p,18494,16929,1565,8.5
44712,CN5109500000000,51,95,"James City County, VA",Apr-20 p,36980,31916,5064,13.7
44713,CN5109700000000,51,97,"King and Queen County, VA",Apr-20 p,3722,3435,287,7.7
44714,CN5109900000000,51,99,"King George County, VA",Apr-20 p,13136,12137,999,7.6
44715,CN5110100000000,51,101,"King William County, VA",Apr-20 p,8793,7937,856,9.7
44716,CN5110300000000,51,103,"Lancaster County, VA",Apr-20 p,5458,4839,619,11.3
44717,CN5110500000000,51,105,"Lee County, VA",Apr-20 p,8315,7409,906,10.9
44718,CN5110700000000,51,107,"Loudoun County, VA",Apr-20 p,218667,197063,21604,9.9
44719,CN5110900000000,51,109,"Louisa County, VA",Apr-20 p,19637,17885,1752,8.9
44720,CN5111100000000,51,111,"Lunenburg County, VA",Apr-20 p,5127,4737,390,7.6
44721,CN5111300000000,51,113,"Madison County, VA",Apr-20 p,7171,6664,507,7.1
44722,CN5111500000000,51,115,"Mathews County, VA",Apr-20 p,3956,3602,354,8.9
44723,CN5111700000000,51,117,"Mecklenburg County, VA",Apr-20 p,12254,10922,1332,10.9
44724,CN5111900000000,51,119,"Middlesex County, VA",Apr-20 p,5184,4719,465,9.0
44725,CN5112100000000,51,121,"Montgomery County, VA",Apr-20 p,46646,42297,4349,9.3
44726,CN5112500000000,51,125,"Nelson County, VA",Apr-20 p,7341,6622,719,9.8
44727,CN5112700000000,51,127,"New Kent County, VA",Apr-20 p,11939,10872,1067,8.9
44728,CN5113100000000,51,131,"Northampton County, VA",Apr-20 p,5287,4676,611,11.6
44729,CN5113300000000,51,133,"Northumberland County, VA",Apr-20 p,5517,4984,533,9.7
44730,CN5113500000000,51,135,"Nottoway County, VA",Apr-20 p,7064,6535,529,7.5
44731,CN5113700000000,51,137,"Orange County, VA",Apr-20 p,17279,15583,1696,9.8
44732,CN5113900000000,51,139,"Page County, VA",Apr-20 p,12337,10607,1730,14.0
44733,CN5114100000000,51,141,"Patrick County, VA",Apr-20 p,7293,6263,1030,14.1
44734,CN5114300000000,51,143,"Pittsylvania County, VA",Apr-20 p,30341,26485,3856,12.7
44735,CN5114500000000,51,145,"Powhatan County, VA",Apr-20 p,13595,12293,1302,9.6
44736,CN5114700000000,51,147,"Prince Edward County, VA",Apr-20 p,10388,9403,985,9.5
44737,CN5114900000000,51,149,"Prince George County, VA",Apr-20 p,14481,13028,1453,10.0
44738,CN5115300000000,51,153,"Prince William County, VA",Apr-20 p,244629,216922,27707,11.3
44739,CN5115500000000,51,155,"Pulaski County, VA",Apr-20 p,16248,13469,2779,17.1
44740,CN5115700000000,51,157,"Rappahannock County, VA",Apr-20 p,3535,3240,295,8.3
44741,CN5115900000000,51,159,"Richmond County, VA",Apr-20 p,4008,3717,291,7.3
44742,CN5116100000000,51,161,"Roanoke County, VA",Apr-20 p,47375,42719,4656,9.8
44743,CN5116300000000,51,163,"Rockbridge County, VA",Apr-20 p,10796,9783,1013,9.4
44744,CN5116500000000,51,165,"Rockingham County, VA",Apr-20 p,40848,36892,3956,9.7
44745,CN5116700000000,51,167,"Russell County, VA",Apr-20 p,11237,10027,1210,10.8
44746,CN5116900000000,51,169,"Scott County, VA",Apr-20 p,8754,7894,860,9.8
44747,CN5117100000000,51,171,"Shenandoah County, VA",Apr-20 p,22401,20263,2138,9.5
44748,CN5117300000000,51,173,"Smyth County, VA",Apr-20 p,13601,12143,1458,10.7
44749,CN5117500000000,51,175,"Southampton County, VA",Apr-20 p,8647,8054,593,6.9
44750,CN5117700000000,51,177,"Spotsylvania County, VA",Apr-20 p,66331,58981,7350,11.1
44751,CN5117900000000,51,179,"Stafford County, VA",Apr-20 p,70547,63557,6990,9.9
44752,CN5118100000000,51,181,"Surry County, VA",Apr-20 p,3524,3198,326,9.3
44753,CN5118300000000,51,183,"Sussex County, VA",Apr-20 p,3633,3258,375,10.3
44754,CN5118500000000,51,185,"Tazewell County, VA",Apr-20 p,15699,13733,1966,12.5
44755,CN5118700000000,51,187,"Warren County, VA",Apr-20 p,20191,17956,2235,11.1
44756,CN5119100000000,51,191,"Washington County, VA",Apr-20 p,25869,23086,2783,10.8
44757,CN5119300000000,51,193,"Westmoreland County, VA",Apr-20 p,9468,8650,818,8.6
44758,CN5119500000000,51,195,"Wise County, VA",Apr-20 p,13586,11968,1618,11.9
44759,CN5119700000000,51,197,"Wythe County, VA",Apr-20 p,14543,12040,2503,17.2
44760,CN5119900000000,51,199,"York County, VA",Apr-20 p,31930,28610,3320,10.4
44761,CN5151000000000,51,510,"Alexandria city, VA",Apr-20 p,99725,89845,9880,9.9
44762,CN5152000000000,51,520,"Bristol city, VA",Apr-20 p,7284,6170,1114,15.3
44763,CN5153000000000,51,530,"Buena Vista city, VA",Apr-20 p,3609,3295,314,8.7
44764,CN5154000000000,51,540,"Charlottesville city, VA",Apr-20 p,26646,23778,2868,10.8
44765,CN5155000000000,51,550,"Chesapeake city, VA",Apr-20 p,119075,106931,12144,10.2
44766,CN5157000000000,51,570,"Colonial Heights city, VA",Apr-20 p,8605,7612,993,11.5
44767,CN5158000000000,51,580,"Covington city, VA",Apr-20 p,2542,2135,407,16.0
44768,CN5159000000000,51,590,"Danville city, VA",Apr-20 p,19804,16643,3161,16.0
44769,CN5159500000000,51,595,"Emporia city, VA",Apr-20 p,2304,2004,300,13.0
44770,CN5160000000000,51,600,"Fairfax city, VA",Apr-20 p,13244,11910,1334,10.1
44771,CN5161000000000,51,610,"Falls Church city, VA",Apr-20 p,8092,7621,471,5.8
44772,CN5162000000000,51,620,"Franklin city, VA",Apr-20 p,3458,3126,332,9.6
44773,CN5163000000000,51,630,"Fredericksburg city, VA",Apr-20 p,14109,12401,1708,12.1
44774,CN5164000000000,51,640,"Galax city, VA",Apr-20 p,3150,2604,546,17.3
44775,CN5165000000000,51,650,"Hampton city, VA",Apr-20 p,64147,55581,8566,13.4
44776,CN5166000000000,51,660,"Harrisonburg city, VA",Apr-20 p,24579,21834,2745,11.2
44777,CN5167000000000,51,670,"Hopewell city, VA",Apr-20 p,9710,8285,1425,14.7
44778,CN5167800000000,51,678,"Lexington city, VA",Apr-20 p,2093,1877,216,10.3
44779,CN5168000000000,51,680,"Lynchburg city, VA",Apr-20 p,34572,30372,4200,12.1
44780,CN5168300000000,51,683,"Manassas city, VA",Apr-20 p,21846,19469,2377,10.9
44781,CN5168500000000,51,685,"Manassas Park city, VA",Apr-20 p,9356,8271,1085,11.6
44782,CN5169000000000,51,690,"Martinsville city, VA",Apr-20 p,5839,4854,985,16.9
44783,CN5170000000000,51,700,"Newport News city, VA",Apr-20 p,89403,76947,12456,13.9
44784,CN5171000000000,51,710,"Norfolk city, VA",Apr-20 p,111500,96715,14785,13.3
44785,CN5172000000000,51,720,"Norton city, VA",Apr-20 p,1717,1504,213,12.4
44786,CN5173000000000,51,730,"Petersburg city, VA",Apr-20 p,13189,10988,2201,16.7
44787,CN5173500000000,51,735,"Poquoson city, VA",Apr-20 p,6074,5588,486,8.0
44788,CN5174000000000,51,740,"Portsmouth city, VA",Apr-20 p,43774,38171,5603,12.8
44789,CN5175000000000,51,750,"Radford city, VA",Apr-20 p,8185,7244,941,11.5
44790,CN5176000000000,51,760,"Richmond city, VA",Apr-20 p,119111,102179,16932,14.2
44791,CN5177000000000,51,770,"Roanoke city, VA",Apr-20 p,48521,42319,6202,12.8
44792,CN5177500000000,51,775,"Salem city, VA",Apr-20 p,12564,11208,1356,10.8
44793,CN5179000000000,51,790,"Staunton city, VA",Apr-20 p,12750,11314,1436,11.3
44794,CN5180000000000,51,800,"Suffolk city, VA",Apr-20 p,43002,38848,4154,9.7
44795,CN5181000000000,51,810,"Virginia Beach city, VA",Apr-20 p,231672,203317,28355,12.2
44796,CN5182000000000,51,820,"Waynesboro city, VA",Apr-20 p,11118,9872,1246,11.2
44797,CN5183000000000,51,830,"Williamsburg city, VA",Apr-20 p,6786,5765,1021,15.0
44798,CN5184000000000,51,840,"Winchester city, VA",Apr-20 p,14653,13005,1648,11.2
44799,CN5300100000000,53,1,"Adams County, WA",Apr-20 p,9317,8521,796,8.5
44800,CN5300300000000,53,3,"Asotin County, WA",Apr-20 p,9522,8697,825,8.7
44801,CN5300500000000,53,5,"Benton County, WA",Apr-20 p,105822,92330,13492,12.7
44802,CN5300700000000,53,7,"Chelan County, WA",Apr-20 p,44088,37281,6807,15.4
44803,CN5300900000000,53,9,"Clallam County, WA",Apr-20 p,30773,24942,5831,18.9
44804,CN5301100000000,53,11,"Clark County, WA",Apr-20 p,244084,210369,33715,13.8
44805,CN5301300000000,53,13,"Columbia County, WA",Apr-20 p,1706,1528,178,10.4
44806,CN5301500000000,53,15,"Cowlitz County, WA",Apr-20 p,48734,41066,7668,15.7
44807,CN5301700000000,53,17,"Douglas County, WA",Apr-20 p,21123,18109,3014,14.3
44808,CN5301900000000,53,19,"Ferry County, WA",Apr-20 p,2433,2055,378,15.5
44809,CN5302100000000,53,21,"Franklin County, WA",Apr-20 p,44080,38519,5561,12.6
44810,CN5302300000000,53,23,"Garfield County, WA",Apr-20 p,794,698,96,12.1
44811,CN5302500000000,53,25,"Grant County, WA",Apr-20 p,47607,41612,5995,12.6
44812,CN5302700000000,53,27,"Grays Harbor County, WA",Apr-20 p,31455,25367,6088,19.4
44813,CN5302900000000,53,29,"Island County, WA",Apr-20 p,37892,32130,5762,15.2
44814,CN5303100000000,53,31,"Jefferson County, WA",Apr-20 p,14071,11639,2432,17.3
44815,CN5303300000000,53,33,"King County, WA",Apr-20 p,1252303,1066218,186085,14.9
44816,CN5303500000000,53,35,"Kitsap County, WA",Apr-20 p,131278,112827,18451,14.1
44817,CN5303700000000,53,37,"Kittitas County, WA",Apr-20 p,24591,20947,3644,14.8
44818,CN5303900000000,53,39,"Klickitat County, WA",Apr-20 p,10187,9023,1164,11.4
44819,CN5304100000000,53,41,"Lewis County, WA",Apr-20 p,37334,31252,6082,16.3
44820,CN5304300000000,53,43,"Lincoln County, WA",Apr-20 p,4467,3995,472,10.6
44821,CN5304500000000,53,45,"Mason County, WA",Apr-20 p,27610,23151,4459,16.1
44822,CN5304700000000,53,47,"Okanogan County, WA",Apr-20 p,19376,16567,2809,14.5
44823,CN5304900000000,53,49,"Pacific County, WA",Apr-20 p,9420,7823,1597,17.0
44824,CN5305100000000,53,51,"Pend Oreille County, WA",Apr-20 p,4846,4086,760,15.7
44825,CN5305300000000,53,53,"Pierce County, WA",Apr-20 p,453208,370515,82693,18.2
44826,CN5305500000000,53,55,"San Juan County, WA",Apr-20 p,8412,6956,1456,17.3
44827,CN5305700000000,53,57,"Skagit County, WA",Apr-20 p,65337,52852,12485,19.1
44828,CN5305900000000,53,59,"Skamania County, WA",Apr-20 p,5556,4756,800,14.4
44829,CN5306100000000,53,61,"Snohomish County, WA",Apr-20 p,453361,361978,91383,20.2
44830,CN5306300000000,53,63,"Spokane County, WA",Apr-20 p,256263,215644,40619,15.9
44831,CN5306500000000,53,65,"Stevens County, WA",Apr-20 p,18404,15496,2908,15.8
44832,CN5306700000000,53,67,"Thurston County, WA",Apr-20 p,150129,127815,22314,14.9
44833,CN5306900000000,53,69,"Wahkiakum County, WA",Apr-20 p,1383,1200,183,13.2
44834,CN5307100000000,53,71,"Walla Walla County, WA",Apr-20 p,30081,26752,3329,11.1
44835,CN5307300000000,53,73,"Whatcom County, WA",Apr-20 p,119559,99042,20517,17.2
44836,CN5307500000000,53,75,"Whitman County, WA",Apr-20 p,22583,21086,1497,6.6
44837,CN5307700000000,53,77,"Yakima County, WA",Apr-20 p,132966,114532,18434,13.9
44838,CN5400100000000,54,1,"Barbour County, WV",Apr-20 p,6778,5820,958,14.1
44839,CN5400300000000,54,3,"Berkeley County, WV",Apr-20 p,54664,47976,6688,12.2
44840,CN5400500000000,54,5,"Boone County, WV",Apr-20 p,7431,5974,1457,19.6
44841,CN5400700000000,54,7,"Braxton County, WV",Apr-20 p,4845,4020,825,17.0
44842,CN5400900000000,54,9,"Brooke County, WV",Apr-20 p,9568,8010,1558,16.3
44843,CN5401100000000,54,11,"Cabell County, WV",Apr-20 p,41690,34958,6732,16.1
44844,CN5401300000000,54,13,"Calhoun County, WV",Apr-20 p,2232,1706,526,23.6
44845,CN5401500000000,54,15,"Clay County, WV",Apr-20 p,3042,2446,596,19.6
44846,CN5401700000000,54,17,"Doddridge County, WV",Apr-20 p,3670,3283,387,10.5
44847,CN5401900000000,54,19,"Fayette County, WV",Apr-20 p,16430,13345,3085,18.8
44848,CN5402100000000,54,21,"Gilmer County, WV",Apr-20 p,2315,1978,337,14.6
44849,CN5402300000000,54,23,"Grant County, WV",Apr-20 p,5564,4936,628,11.3
44850,CN5402500000000,54,25,"Greenbrier County, WV",Apr-20 p,15105,12942,2163,14.3
44851,CN5402700000000,54,27,"Hampshire County, WV",Apr-20 p,10397,9371,1026,9.9
44852,CN5402900000000,54,29,"Hancock County, WV",Apr-20 p,13152,10480,2672,20.3
44853,CN5403100000000,54,31,"Hardy County, WV",Apr-20 p,5711,4983,728,12.7
44854,CN5403300000000,54,33,"Harrison County, WV",Apr-20 p,34080,28849,5231,15.3
44855,CN5403500000000,54,35,"Jackson County, WV",Apr-20 p,12497,10594,1903,15.2
44856,CN5403700000000,54,37,"Jefferson County, WV",Apr-20 p,28780,25465,3315,11.5
44857,CN5403900000000,54,39,"Kanawha County, WV",Apr-20 p,81185,66764,14421,17.8
44858,CN5404100000000,54,41,"Lewis County, WV",Apr-20 p,6369,5203,1166,18.3
44859,CN5404300000000,54,43,"Lincoln County, WV",Apr-20 p,7193,5917,1276,17.7
44860,CN5404500000000,54,45,"Logan County, WV",Apr-20 p,11153,8568,2585,23.2
44861,CN5404700000000,54,47,"McDowell County, WV",Apr-20 p,4332,3683,649,15.0
44862,CN5404900000000,54,49,"Marion County, WV",Apr-20 p,25119,20802,4317,17.2
44863,CN5405100000000,54,51,"Marshall County, WV",Apr-20 p,13245,10934,2311,17.4
44864,CN5405300000000,54,53,"Mason County, WV",Apr-20 p,9922,8240,1682,17.0
44865,CN5405500000000,54,55,"Mercer County, WV",Apr-20 p,21044,17527,3517,16.7
44866,CN5405700000000,54,57,"Mineral County, WV",Apr-20 p,11897,10257,1640,13.8
44867,CN5405900000000,54,59,"Mingo County, WV",Apr-20 p,6876,5176,1700,24.7
44868,CN5406100000000,54,61,"Monongalia County, WV",Apr-20 p,53851,47450,6401,11.9
44869,CN5406300000000,54,63,"Monroe County, WV",Apr-20 p,5690,4932,758,13.3
44870,CN5406500000000,54,65,"Morgan County, WV",Apr-20 p,7708,6655,1053,13.7
44871,CN5406700000000,54,67,"Nicholas County, WV",Apr-20 p,9123,7240,1883,20.6
44872,CN5406900000000,54,69,"Ohio County, WV",Apr-20 p,20060,16691,3369,16.8
44873,CN5407100000000,54,71,"Pendleton County, WV",Apr-20 p,3528,3220,308,8.7
44874,CN5407300000000,54,73,"Pleasants County, WV",Apr-20 p,2868,2420,448,15.6
44875,CN5407500000000,54,75,"Pocahontas County, WV",Apr-20 p,4020,3365,655,16.3
44876,CN5407700000000,54,77,"Preston County, WV",Apr-20 p,15542,13364,2178,14.0
44877,CN5407900000000,54,79,"Putnam County, WV",Apr-20 p,26904,22484,4420,16.4
44878,CN5408100000000,54,81,"Raleigh County, WV",Apr-20 p,30897,25291,5606,18.1
44879,CN5408300000000,54,83,"Randolph County, WV",Apr-20 p,12101,9820,2281,18.8
44880,CN5408500000000,54,85,"Ritchie County, WV",Apr-20 p,4232,3671,561,13.3
44881,CN5408700000000,54,87,"Roane County, WV",Apr-20 p,4803,3855,948,19.7
44882,CN5408900000000,54,89,"Summers County, WV",Apr-20 p,4065,3481,584,14.4
44883,CN5409100000000,54,91,"Taylor County, WV",Apr-20 p,7341,6282,1059,14.4
44884,CN5409300000000,54,93,"Tucker County, WV",Apr-20 p,3128,2546,582,18.6
44885,CN5409500000000,54,95,"Tyler County, WV",Apr-20 p,2904,2469,435,15.0
44886,CN5409700000000,54,97,"Upshur County, WV",Apr-20 p,9149,7598,1551,17.0
44887,CN5409900000000,54,99,"Wayne County, WV",Apr-20 p,15508,13139,2369,15.3
44888,CN5410100000000,54,101,"Webster County, WV",Apr-20 p,3053,2594,459,15.0
44889,CN5410300000000,54,103,"Wetzel County, WV",Apr-20 p,6216,5275,941,15.1
44890,CN5410500000000,54,105,"Wirt County, WV",Apr-20 p,2271,1906,365,16.1
44891,CN5410700000000,54,107,"Wood County, WV",Apr-20 p,37712,31360,6352,16.8
44892,CN5410900000000,54,109,"Wyoming County, WV",Apr-20 p,6197,5046,1151,18.6
44893,CN5500100000000,55,1,"Adams County, WI",Apr-20 p,8442,6591,1851,21.9
44894,CN5500300000000,55,3,"Ashland County, WI",Apr-20 p,7996,6361,1635,20.4
44895,CN5500500000000,55,5,"Barron County, WI",Apr-20 p,24013,20213,3800,15.8
44896,CN5500700000000,55,7,"Bayfield County, WI",Apr-20 p,7997,6066,1931,24.1
44897,CN5500900000000,55,9,"Brown County, WI",Apr-20 p,139959,120576,19383,13.8
44898,CN5501100000000,55,11,"Buffalo County, WI",Apr-20 p,6839,5493,1346,19.7
44899,CN5501300000000,55,13,"Burnett County, WI",Apr-20 p,7485,5726,1759,23.5
44900,CN5501500000000,55,15,"Calumet County, WI",Apr-20 p,26975,23785,3190,11.8
44901,CN5501700000000,55,17,"Chippewa County, WI",Apr-20 p,31882,27397,4485,14.1
44902,CN5501900000000,55,19,"Clark County, WI",Apr-20 p,16991,15295,1696,10.0
44903,CN5502100000000,55,21,"Columbia County, WI",Apr-20 p,30906,26289,4617,14.9
44904,CN5502300000000,55,23,"Crawford County, WI",Apr-20 p,7752,6260,1492,19.2
44905,CN5502500000000,55,25,"Dane County, WI",Apr-20 p,301761,267811,33950,11.3
44906,CN5502700000000,55,27,"Dodge County, WI",Apr-20 p,45846,40348,5498,12.0
44907,CN5502900000000,55,29,"Door County, WI",Apr-20 p,14444,11558,2886,20.0
44908,CN5503100000000,55,31,"Douglas County, WI",Apr-20 p,24873,19086,5787,23.3
44909,CN5503300000000,55,33,"Dunn County, WI",Apr-20 p,22414,19654,2760,12.3
44910,CN5503500000000,55,35,"Eau Claire County, WI",Apr-20 p,55954,48684,7270,13.0
44911,CN5503700000000,55,37,"Florence County, WI",Apr-20 p,2292,1862,430,18.8
44912,CN5503900000000,55,39,"Fond du Lac County, WI",Apr-20 p,58715,49155,9560,16.3
44913,CN5504100000000,55,41,"Forest County, WI",Apr-20 p,4001,3333,668,16.7
44914,CN5504300000000,55,43,"Grant County, WI",Apr-20 p,26236,23106,3130,11.9
44915,CN5504500000000,55,45,"Green County, WI",Apr-20 p,20082,17680,2402,12.0
44916,CN5504700000000,55,47,"Green Lake County, WI",Apr-20 p,9663,7683,1980,20.5
44917,CN5504900000000,55,49,"Iowa County, WI",Apr-20 p,14109,11607,2502,17.7
44918,CN5505100000000,55,51,"Iron County, WI",Apr-20 p,2809,2072,737,26.2
44919,CN5505300000000,55,53,"Jackson County, WI",Apr-20 p,10690,8555,2135,20.0
44920,CN5505500000000,55,55,"Jefferson County, WI",Apr-20 p,44565,38868,5697,12.8
44921,CN5505700000000,55,57,"Juneau County, WI",Apr-20 p,13567,11309,2258,16.6
44922,CN5505900000000,55,59,"Kenosha County, WI",Apr-20 p,90373,75831,14542,16.1
44923,CN5506100000000,55,61,"Kewaunee County, WI",Apr-20 p,10601,9521,1080,10.2
44924,CN5506300000000,55,63,"La Crosse County, WI",Apr-20 p,65088,56588,8500,13.1
44925,CN5506500000000,55,65,"Lafayette County, WI",Apr-20 p,9675,8734,941,9.7
44926,CN5506700000000,55,67,"Langlade County, WI",Apr-20 p,9089,7803,1286,14.1
44927,CN5506900000000,55,69,"Lincoln County, WI",Apr-20 p,14721,12617,2104,14.3
44928,CN5507100000000,55,71,"Manitowoc County, WI",Apr-20 p,41162,34508,6654,16.2
44929,CN5507300000000,55,73,"Marathon County, WI",Apr-20 p,71898,63042,8856,12.3
44930,CN5507500000000,55,75,"Marinette County, WI",Apr-20 p,19826,16006,3820,19.3
44931,CN5507700000000,55,77,"Marquette County, WI",Apr-20 p,7706,6442,1264,16.4
44932,CN5507800000000,55,78,"Menominee County, WI",Apr-20 p,1783,1315,468,26.2
44933,CN5507900000000,55,79,"Milwaukee County, WI",Apr-20 p,471243,396803,74440,15.8
44934,CN5508100000000,55,81,"Monroe County, WI",Apr-20 p,22909,19907,3002,13.1
44935,CN5508300000000,55,83,"Oconto County, WI",Apr-20 p,20745,17503,3242,15.6
44936,CN5508500000000,55,85,"Oneida County, WI",Apr-20 p,17683,14130,3553,20.1
44937,CN5508700000000,55,87,"Outagamie County, WI",Apr-20 p,102855,88353,14502,14.1
44938,CN5508900000000,55,89,"Ozaukee County, WI",Apr-20 p,48343,42202,6141,12.7
44939,CN5509100000000,55,91,"Pepin County, WI",Apr-20 p,4087,3471,616,15.1
44940,CN5509300000000,55,93,"Pierce County, WI",Apr-20 p,26147,21606,4541,17.4
44941,CN5509500000000,55,95,"Polk County, WI",Apr-20 p,24869,20462,4407,17.7
44942,CN5509700000000,55,97,"Portage County, WI",Apr-20 p,36006,31776,4230,11.7
44943,CN5509900000000,55,99,"Price County, WI",Apr-20 p,6487,5383,1104,17.0
44944,CN5510100000000,55,101,"Racine County, WI",Apr-20 p,101440,85749,15691,15.5
44945,CN5510300000000,55,103,"Richland County, WI",Apr-20 p,8969,7809,1160,12.9
44946,CN5510500000000,55,105,"Rock County, WI",Apr-20 p,86565,71821,14744,17.0
44947,CN5510700000000,55,107,"Rusk County, WI",Apr-20 p,6580,5581,999,15.2
44948,CN5510900000000,55,109,"St. Croix County, WI",Apr-20 p,52100,42818,9282,17.8
44949,CN5511100000000,55,111,"Sauk County, WI",Apr-20 p,37330,29657,7673,20.6
44950,CN5511300000000,55,113,"Sawyer County, WI",Apr-20 p,8009,6335,1674,20.9
44951,CN5511500000000,55,115,"Shawano County, WI",Apr-20 p,20963,17811,3152,15.0
44952,CN5511700000000,55,117,"Sheboygan County, WI",Apr-20 p,62458,53118,9340,15.0
44953,CN5511900000000,55,119,"Taylor County, WI",Apr-20 p,10442,9302,1140,10.9
44954,CN5512100000000,55,121,"Trempealeau County, WI",Apr-20 p,16656,13468,3188,19.1
44955,CN5512300000000,55,123,"Vernon County, WI",Apr-20 p,14837,13076,1761,11.9
44956,CN5512500000000,55,125,"Vilas County, WI",Apr-20 p,10064,7909,2155,21.4
44957,CN5512700000000,55,127,"Walworth County, WI",Apr-20 p,55614,47190,8424,15.1
44958,CN5512900000000,55,129,"Washburn County, WI",Apr-20 p,7999,6476,1523,19.0
44959,CN5513100000000,55,131,"Washington County, WI",Apr-20 p,76896,66483,10413,13.5
44960,CN5513300000000,55,133,"Waukesha County, WI",Apr-20 p,220414,193064,27350,12.4
44961,CN5513500000000,55,135,"Waupaca County, WI",Apr-20 p,25322,21957,3365,13.3
44962,CN5513700000000,55,137,"Waushara County, WI",Apr-20 p,11328,9581,1747,15.4
44963,CN5513900000000,55,139,"Winnebago County, WI",Apr-20 p,91430,78409,13021,14.2
44964,CN5514100000000,55,141,"Wood County, WI",Apr-20 p,34921,29540,5381,15.4
44965,CN5600100000000,56,1,"Albany County, WY",Apr-20 p,21227,20084,1143,5.4
44966,CN5600300000000,56,3,"Big Horn County, WY",Apr-20 p,5107,4768,339,6.6
44967,CN5600500000000,56,5,"Campbell County, WY",Apr-20 p,23587,21190,2397,10.2
44968,CN5600700000000,56,7,"Carbon County, WY",Apr-20 p,7536,7029,507,6.7
44969,CN5600900000000,56,9,"Converse County, WY",Apr-20 p,8782,8221,561,6.4
44970,CN5601100000000,56,11,"Crook County, WY",Apr-20 p,3560,3355,205,5.8
44971,CN5601300000000,56,13,"Fremont County, WY",Apr-20 p,18930,17173,1757,9.3
44972,CN5601500000000,56,15,"Goshen County, WY",Apr-20 p,6312,5923,389,6.2
44973,CN5601700000000,56,17,"Hot Springs County, WY",Apr-20 p,2157,2008,149,6.9
44974,CN5601900000000,56,19,"Johnson County, WY",Apr-20 p,4109,3706,403,9.8
44975,CN5602100000000,56,21,"Laramie County, WY",Apr-20 p,50631,46103,4528,8.9
44976,CN5602300000000,56,23,"Lincoln County, WY",Apr-20 p,8846,8061,785,8.9
44977,CN5602500000000,56,25,"Natrona County, WY",Apr-20 p,39924,34837,5087,12.7
44978,CN5602700000000,56,27,"Niobrara County, WY",Apr-20 p,1169,1117,52,4.4
44979,CN5602900000000,56,29,"Park County, WY",Apr-20 p,14864,13456,1408,9.5
44980,CN5603100000000,56,31,"Platte County, WY",Apr-20 p,4621,4295,326,7.1
44981,CN5603300000000,56,33,"Sheridan County, WY",Apr-20 p,15770,14431,1339,8.5
44982,CN5603500000000,56,35,"Sublette County, WY",Apr-20 p,4014,3559,455,11.3
44983,CN5603700000000,56,37,"Sweetwater County, WY",Apr-20 p,21198,18978,2220,10.5
44984,CN5603900000000,56,39,"Teton County, WY",Apr-20 p,15531,12696,2835,18.3
44985,CN5604100000000,56,41,"Uinta County, WY",Apr-20 p,8936,8104,832,9.3
44986,CN5604300000000,56,43,"Washakie County, WY",Apr-20 p,3775,3496,279,7.4
44987,CN5604500000000,56,45,"Weston County, WY",Apr-20 p,3722,3511,211,5.7
44988,CN7200100000000,72,1,"Adjuntas Municipio, PR",Apr-20 p,0,0,0,0.0
44989,CN7200300000000,72,3,"Aguada Municipio, PR",Apr-20 p,0,0,0,0.0
44990,CN7200500000000,72,5,"Aguadilla Municipio, PR",Apr-20 p,0,0,0,0.0
44991,CN7200700000000,72,7,"Aguas Buenas Municipio, PR",Apr-20 p,0,0,0,0.0
44992,CN7200900000000,72,9,"Aibonito Municipio, PR",Apr-20 p,0,0,0,0.0
44993,CN7201100000000,72,11,"Anasco Municipio, PR",Apr-20 p,0,0,0,0.0
44994,CN7201300000000,72,13,"Arecibo Municipio, PR",Apr-20 p,0,0,0,0.0
44995,CN7201500000000,72,15,"Arroyo Municipio, PR",Apr-20 p,0,0,0,0.0
44996,CN7201700000000,72,17,"Barceloneta Municipio, PR",Apr-20 p,0,0,0,0.0
44997,CN7201900000000,72,19,"Barranquitas Municipio, PR",Apr-20 p,0,0,0,0.0
44998,CN7202100000000,72,21,"Bayamon Municipio, PR",Apr-20 p,0,0,0,0.0
44999,CN7202300000000,72,23,"Cabo Rojo Municipio, PR",Apr-20 p,0,0,0,0.0
45000,CN7202500000000,72,25,"Caguas Municipio, PR",Apr-20 p,0,0,0,0.0
45001,CN7202700000000,72,27,"Camuy Municipio, PR",Apr-20 p,0,0,0,0.0
45002,CN7202900000000,72,29,"Canovanas Municipio, PR",Apr-20 p,0,0,0,0.0
45003,CN7203100000000,72,31,"Carolina Municipio, PR",Apr-20 p,0,0,0,0.0
45004,CN7203300000000,72,33,"Catano Municipio, PR",Apr-20 p,0,0,0,0.0
45005,CN7203500000000,72,35,"Cayey Municipio, PR",Apr-20 p,0,0,0,0.0
45006,CN7203700000000,72,37,"Ceiba Municipio, PR",Apr-20 p,0,0,0,0.0
45007,CN7203900000000,72,39,"Ciales Municipio, PR",Apr-20 p,0,0,0,0.0
45008,CN7204100000000,72,41,"Cidra Municipio, PR",Apr-20 p,0,0,0,0.0
45009,CN7204300000000,72,43,"Coamo Municipio, PR",Apr-20 p,0,0,0,0.0
45010,CN7204500000000,72,45,"Comerio Municipio, PR",Apr-20 p,0,0,0,0.0
45011,CN7204700000000,72,47,"Corozal Municipio, PR",Apr-20 p,0,0,0,0.0
45012,CN7204900000000,72,49,"Culebra Municipio, PR",Apr-20 p,0,0,0,0.0
45013,CN7205100000000,72,51,"Dorado Municipio, PR",Apr-20 p,0,0,0,0.0
45014,CN7205300000000,72,53,"Fajardo Municipio, PR",Apr-20 p,0,0,0,0.0
45015,CN7205400000000,72,54,"Florida Municipio, PR",Apr-20 p,0,0,0,0.0
45016,CN7205500000000,72,55,"Guanica Municipio, PR",Apr-20 p,0,0,0,0.0
45017,CN7205700000000,72,57,"Guayama Municipio, PR",Apr-20 p,0,0,0,0.0
45018,CN7205900000000,72,59,"Guayanilla Municipio, PR",Apr-20 p,0,0,0,0.0
45019,CN7206100000000,72,61,"Guaynabo Municipio, PR",Apr-20 p,0,0,0,0.0
45020,CN7206300000000,72,63,"Gurabo Municipio, PR",Apr-20 p,0,0,0,0.0
45021,CN7206500000000,72,65,"Hatillo Municipio, PR",Apr-20 p,0,0,0,0.0
45022,CN7206700000000,72,67,"Hormigueros Municipio, PR",Apr-20 p,0,0,0,0.0
45023,CN7206900000000,72,69,"Humacao Municipio, PR",Apr-20 p,0,0,0,0.0
45024,CN7207100000000,72,71,"Isabela Municipio, PR",Apr-20 p,0,0,0,0.0
45025,CN7207300000000,72,73,"Jayuya Municipio, PR",Apr-20 p,0,0,0,0.0
45026,CN7207500000000,72,75,"Juana Diaz Municipio, PR",Apr-20 p,0,0,0,0.0
45027,CN7207700000000,72,77,"Juncos Municipio, PR",Apr-20 p,0,0,0,0.0
45028,CN7207900000000,72,79,"Lajas Municipio, PR",Apr-20 p,0,0,0,0.0
45029,CN7208100000000,72,81,"Lares Municipio, PR",Apr-20 p,0,0,0,0.0
45030,CN7208300000000,72,83,"Las Marias Municipio, PR",Apr-20 p,0,0,0,0.0
45031,CN7208500000000,72,85,"Las Piedras Municipio, PR",Apr-20 p,0,0,0,0.0
45032,CN7208700000000,72,87,"Loiza Municipio, PR",Apr-20 p,0,0,0,0.0
45033,CN7208900000000,72,89,"Luquillo Municipio, PR",Apr-20 p,0,0,0,0.0
45034,CN7209100000000,72,91,"Manati Municipio, PR",Apr-20 p,0,0,0,0.0
45035,CN7209300000000,72,93,"Maricao Municipio, PR",Apr-20 p,0,0,0,0.0
45036,CN7209500000000,72,95,"Maunabo Municipio, PR",Apr-20 p,0,0,0,0.0
45037,CN7209700000000,72,97,"Mayaguez Municipio, PR",Apr-20 p,0,0,0,0.0
45038,CN7209900000000,72,99,"Moca Municipio, PR",Apr-20 p,0,0,0,0.0
45039,CN7210100000000,72,101,"Morovis Municipio, PR",Apr-20 p,0,0,0,0.0
45040,CN7210300000000,72,103,"Naguabo Municipio, PR",Apr-20 p,0,0,0,0.0
45041,CN7210500000000,72,105,"Naranjito Municipio, PR",Apr-20 p,0,0,0,0.0
45042,CN7210700000000,72,107,"Orocovis Municipio, PR",Apr-20 p,0,0,0,0.0
45043,CN7210900000000,72,109,"Patillas Municipio, PR",Apr-20 p,0,0,0,0.0
45044,CN7211100000000,72,111,"Penuelas Municipio, PR",Apr-20 p,0,0,0,0.0
45045,CN7211300000000,72,113,"Ponce Municipio, PR",Apr-20 p,0,0,0,0.0
45046,CN7211500000000,72,115,"Quebradillas Municipio, PR",Apr-20 p,0,0,0,0.0
45047,CN7211700000000,72,117,"Rincon Municipio, PR",Apr-20 p,0,0,0,0.0
45048,CN7211900000000,72,119,"Rio Grande Municipio, PR",Apr-20 p,0,0,0,0.0
45049,CN7212100000000,72,121,"Sabana Grande Municipio, PR",Apr-20 p,0,0,0,0.0
45050,CN7212300000000,72,123,"Salinas Municipio, PR",Apr-20 p,0,0,0,0.0
45051,CN7212500000000,72,125,"San German Municipio, PR",Apr-20 p,0,0,0,0.0
45052,CN7212700000000,72,127,"San Juan Municipio, PR",Apr-20 p,0,0,0,0.0
45053,CN7212900000000,72,129,"San Lorenzo Municipio, PR",Apr-20 p,0,0,0,0.0
45054,CN7213100000000,72,131,"San Sebastian Municipio, PR",Apr-20 p,0,0,0,0.0
45055,CN7213300000000,72,133,"Santa Isabel Municipio, PR",Apr-20 p,0,0,0,0.0
45056,CN7213500000000,72,135,"Toa Alta Municipio, PR",Apr-20 p,0,0,0,0.0
45057,CN7213700000000,72,137,"Toa Baja Municipio, PR",Apr-20 p,0,0,0,0.0
45058,CN7213900000000,72,139,"Trujillo Alto Municipio, PR",Apr-20 p,0,0,0,0.0
45059,CN7214100000000,72,141,"Utuado Municipio, PR",Apr-20 p,0,0,0,0.0
45060,CN7214300000000,72,143,"Vega Alta Municipio, PR",Apr-20 p,0,0,0,0.0
45061,CN7214500000000,72,145,"Vega Baja Municipio, PR",Apr-20 p,0,0,0,0.0
45062,CN7214700000000,72,147,"Vieques Municipio, PR",Apr-20 p,0,0,0,0.0
45063,CN7214900000000,72,149,"Villalba Municipio, PR",Apr-20 p,0,0,0,0.0
45064,CN7215100000000,72,151,"Yabucoa Municipio, PR",Apr-20 p,0,0,0,0.0
45065,CN7215300000000,72,153,"Yauco Municipio, PR",Apr-20 p,0,0,0,0.0
